account_id,mes_ano,transfer_in,transfer_out,pix_in,pix_out,saldo_mes,saldo_acumulado
2569200459575096,2020-01,2658.94,888.4,3963.21,937.9,4795.85,4795.85
2569200459575096,2020-02,250.49,3450.36,2260.1,1484.55,-2424.32,2371.53
2569200459575096,2020-03,2221.55,0,0,3205.17,-983.62,1387.91
2569200459575096,2020-04,2596.47,540.4,1896.27,0,3952.34,5340.25
2569200459575096,2020-05,1825.52,1617.57,0,811.98,-604.03,4736.22
2569200459575096,2020-06,1059.96,0,1262.72,3059.74,-737.06,3999.16
2569200459575096,2020-07,2568.21,6482.14,434.98,1580.45,-5059.4,-1060.24
2569200459575096,2020-08,80.6,877.32,0,1455.95,-2252.67,-3312.91
2569200459575096,2020-09,440.55,2311.77,1961.12,1484.37,-1394.47,-4707.38
2569200459575096,2020-11,253.42,3973.42,0,1631.82,-5351.82,-10059.2
2569200459575096,2020-12,4469.54,1251.81,3411.81,1927.26,4702.28,-5356.92
2572645138169593,2020-01,1498.34,1433.98,1816.04,33.33,1847.07,1847.07
2572645138169593,2020-02,0,1032.8,3027.06,0,1994.26,3841.33
2572645138169593,2020-03,0,4196.13,1491.24,2406.03,-5110.92,-1269.59
2572645138169593,2020-04,0,394.04,0,1162.48,-1556.52,-2826.11
2572645138169593,2020-05,2426.07,1049.01,0,3295.23,-1918.17,-4744.28
2572645138169593,2020-06,0,2282.97,0,0,-2282.97,-7027.25
2572645138169593,2020-07,1701.36,0,1350.48,959.94,2091.9,-4935.35
2572645138169593,2020-08,311.1,969.55,483.22,1983.47,-2158.7,-7094.05
2572645138169593,2020-10,2909.88,1909.49,2202.83,0,3203.22,-3890.83
2572645138169593,2020-11,122.07,0,0,3244.96,-3122.89,-7013.72
2572645138169593,2020-12,3918.27,1094.32,1607.26,2373.79,2057.42,-4956.3
2969674447809961,2020-01,1566.85,1382.57,7446.77,2186.91,5444.14,5444.14
2969674447809961,2020-02,2355.71,4479.76,3029.56,6313.34,-5407.83,36.31
2969674447809961,2020-03,2330.83,1380.66,5407.67,6966.48,-608.64,-572.33
2969674447809961,2020-04,4687.14,2127.64,6872,4095.2,5336.3,4763.97
2969674447809961,2020-05,2937.29,6522.27,1904.86,3934.34,-5614.46,-850.49
2969674447809961,2020-06,3620.29,7154.46,2851.71,4777.24,-5459.7,-6310.19
2969674447809961,2020-07,3729.47,2533.1,2191.77,2238.43,1149.71,-5160.48
2969674447809961,2020-08,3594.84,3307.96,1905.37,1956.19,236.06,-4924.42
2969674447809961,2020-09,7364.11,3126.12,3921.87,8361.16,-201.3,-5125.72
2969674447809961,2020-10,10268.55,1655.62,2823.29,4834.9,6601.32,1475.6
2969674447809961,2020-11,4690.79,4880.94,3400.24,5135.65,-1925.56,-449.96
2969674447809961,2020-12,3008.95,2420.25,3932.25,3184.72,1336.23,886.27
5756422114496119,2020-01,948.1,0,1978.81,2170.55,756.36,756.36
5756422114496119,2020-02,1558.4,1204.71,0,3832.36,-3478.67,-2722.31
5756422114496119,2020-03,42.52,684.58,2960.6,763.62,1554.92,-1167.39
5756422114496119,2020-04,1908.79,1944.89,1451.08,1196.43,218.55,-948.84
5756422114496119,2020-05,1464.69,993.32,3011.66,0,3483.03,2534.19
5756422114496119,2020-06,0,423.47,2438.9,1023.71,991.72,3525.91
5756422114496119,2020-07,89.54,285.35,54.57,1225.8,-1367.04,2158.87
5756422114496119,2020-08,0,1694.63,2068.28,0,373.65,2532.52
5756422114496119,2020-09,1604.91,1696.54,3531.42,612.2,2827.59,5360.11
5756422114496119,2020-10,1756.74,665.38,3111.35,0,4202.71,9562.82
5756422114496119,2020-11,0,3301.09,2541.35,1975.66,-2735.4,6827.42
5763135580788529,2020-01,4688.41,8390.76,1771.64,2639.35,-4570.06,-4570.06
5763135580788529,2020-02,5750.93,6501.28,3837.18,3998.9,-912.07,-5482.13
5763135580788529,2020-03,4229.14,3627.42,5002.65,2333.71,3270.66,-2211.47
5763135580788529,2020-04,2693.84,4639.04,5368.49,3822.57,-399.28,-2610.75
5763135580788529,2020-05,2673.92,2927.29,3559.03,3715.22,-409.56,-3020.31
5763135580788529,2020-06,5047.52,5663.91,8214.52,4473.74,3124.39,104.08
5763135580788529,2020-07,1834.24,5221.33,8821.24,7289.68,-1855.53,-1751.45
5763135580788529,2020-08,4562.13,8966.45,3272.93,6550.22,-7681.61,-9433.06
5763135580788529,2020-09,3797.21,1501.37,2331.92,8742.7,-4114.94,-13548
5763135580788529,2020-10,1933.38,2921.98,1074.96,1657.59,-1571.23,-15119.23
5763135580788529,2020-11,515.13,3051.74,4638.17,1828.21,273.35,-14845.88
5763135580788529,2020-12,1974.19,4556.91,3697.34,1406.42,-291.8,-15137.68
6731171884115662,2020-01,7895.88,1901.85,1764.94,3415,4343.97,4343.97
6731171884115662,2020-02,3869.21,4383.31,2317.84,5791.21,-3987.47,356.5
6731171884115662,2020-03,4820.03,3404.37,5756.36,3803.42,3368.6,3725.1
6731171884115662,2020-04,3084.14,1880.03,3882.63,7541.56,-2454.82,1270.28
6731171884115662,2020-05,2531.73,3153.1,6459.11,4169.78,1667.96,2938.24
6731171884115662,2020-06,1369.5,6477.57,946.29,4134.96,-8296.74,-5358.5
6731171884115662,2020-07,656.22,4207.84,8225.61,3670.18,1003.81,-4354.69
6731171884115662,2020-08,1860.23,8424.7,4726.76,5796.97,-7634.68,-11989.37
6731171884115662,2020-09,2916.21,3537.32,4472.94,2133.49,1718.34,-10271.03
6731171884115662,2020-10,5055.64,6404.91,510.04,7145.75,-7984.98,-18256.01
6731171884115662,2020-11,0,7329.69,1980.65,1940.6,-7289.64,-25545.65
6731171884115662,2020-12,6024.45,4120.78,5627.36,2814.54,4716.49,-20829.16
6754575908057409,2020-01,5320.6,0,460.14,0,5780.74,5780.74
6754575908057409,2020-02,0,4965.79,0,0,-4965.79,814.95
6754575908057409,2020-03,0,1798.52,730.27,0,-1068.25,-253.3
6754575908057409,2020-04,0,298.45,0,1608.12,-1906.57,-2159.87
6754575908057409,2020-05,776.89,0,0,1498.79,-721.9,-2881.77
6754575908057409,2020-06,79.69,0,1706.05,0,1785.74,-1096.03
6754575908057409,2020-07,2114.23,1410.57,0,4493.42,-3789.76,-4885.79
6754575908057409,2020-08,0,1511.51,1785.6,0,274.09,-4611.7
6754575908057409,2020-09,420.56,0,0,838.1,-417.54,-5029.24
6754575908057409,2020-11,269.57,928.88,1761.15,736.58,365.26,-4663.98
6754575908057409,2020-12,503.61,0,408.79,926.37,-13.97,-4677.95
6759884497455352,2020-01,2313.23,1542.19,1995.14,0,2766.18,2766.18
6759884497455352,2020-02,1767.93,1259.16,1923.77,1852.3,580.24,3346.42
6759884497455352,2020-03,0,2043.21,0,589.02,-2632.23,714.19
6759884497455352,2020-04,0,1134.68,504.99,1186.86,-1816.55,-1102.36
6759884497455352,2020-05,149.69,0,362.35,2294.56,-1782.52,-2884.88
6759884497455352,2020-06,1234.13,186.51,0,776.54,271.08,-2613.8
6759884497455352,2020-07,2362.1,1039.29,0,0,1322.81,-1290.99
6759884497455352,2020-09,1598.83,0,4685.84,0,6284.67,4993.68
6759884497455352,2020-10,779.91,744.91,2335.98,0,2370.98,7364.66
6759884497455352,2020-11,1853.01,535.81,741.33,1137.05,921.48,8286.14
6759884497455352,2020-12,2396.48,0,254.02,1534.41,1116.09,9402.23
7106839639082916,2020-01,2430.45,1402.65,632.43,0,1660.23,1660.23
7106839639082916,2020-03,2339.23,0,0,0,2339.23,3999.46
7106839639082916,2020-04,894.74,1315.25,1173.67,0,753.16,4752.62
7106839639082916,2020-06,0,1701.93,0,1639.58,-3341.51,1411.11
7106839639082916,2020-10,0,1659.94,0,0,-1659.94,-248.83
7106839639082916,2020-11,1773.14,1112.3,0,0,660.84,412.01
7106839639082916,2020-12,0,963.69,0,1817.16,-2780.85,-2368.84
7399497589386025,2020-01,1319.22,0,0,0,1319.22,1319.22
7399497589386025,2020-03,3681.91,4482.73,5826.56,0,5025.74,6344.96
7399497589386025,2020-04,1402.57,1731.43,1367.01,65.26,972.89,7317.85
7399497589386025,2020-05,687.18,2242.54,5137.69,432.87,3149.46,10467.31
7399497589386025,2020-06,2657.56,0,1826.5,2460.19,2023.87,12491.18
7399497589386025,2020-07,4254.54,3499.04,2485.19,0,3240.69,15731.87
7399497589386025,2020-08,0,1472.98,2203.68,0,730.7,16462.57
7399497589386025,2020-09,0,784.42,1937.92,1817.34,-663.84,15798.73
7399497589386025,2020-10,1702.42,0,1508.44,254.22,2956.64,18755.37
7399497589386025,2020-11,0,2607.81,1888.78,0,-719.03,18036.34
7399497589386025,2020-12,1477.46,3498.66,1984.29,437.21,-474.12,17562.22
8390860978077109,2020-01,4760.76,5038.09,2798.42,12026.66,-9505.57,-9505.57
8390860978077109,2020-02,2189.27,3673.6,6671.52,3282.42,1904.77,-7600.8
8390860978077109,2020-03,3106.54,5214.3,4555.51,4004.59,-1556.84,-9157.64
8390860978077109,2020-04,4585.72,4198.36,5452.45,4557.74,1282.07,-7875.57
8390860978077109,2020-05,189.7,5858.07,3766.47,5018.89,-6920.79,-14796.36
8390860978077109,2020-06,7660.38,11372.67,3874.96,2702.37,-2539.7,-17336.06
8390860978077109,2020-07,6621.52,2796,4776.92,5057.12,3545.32,-13790.74
8390860978077109,2020-08,7114.76,4064.47,8474.24,598.07,10926.46,-2864.28
8390860978077109,2020-09,5652.7,6425.4,7371.97,8397.93,-1798.66,-4662.94
8390860978077109,2020-10,3448.09,6272.47,3718.74,4641.23,-3746.87,-8409.81
8390860978077109,2020-11,6285.03,1251.36,5359.29,7238.24,3154.72,-5255.09
8390860978077109,2020-12,2275.79,4369.56,1697.17,6812.07,-7208.67,-12463.76
9682140161583058,2020-01,1477.24,8180.06,4648.54,2907.83,-4962.11,-4962.11
9682140161583058,2020-02,5389.47,5599.18,6218.57,0,6008.86,1046.75
9682140161583058,2020-03,1434.36,9341.4,9282.23,1843.68,-468.49,578.26
9682140161583058,2020-04,5313.93,4836.75,11590.53,4403.6,7664.11,8242.37
9682140161583058,2020-05,4833.23,3171.46,4791.11,3877.75,2575.13,10817.5
9682140161583058,2020-06,6908.66,4543.68,4338.12,889.55,5813.55,16631.05
9682140161583058,2020-07,5878.59,5228.82,0,384.29,265.48,16896.53
9682140161583058,2020-08,2932.91,2356.29,0,6411.19,-5834.57,11061.96
9682140161583058,2020-09,2381.9,3425.15,2451.51,1362.89,45.37,11107.33
9682140161583058,2020-10,2061.45,193.51,2131.62,5268.04,-1268.48,9838.85
9682140161583058,2020-11,2907.7,1326.36,2364.78,1369.73,2576.39,12415.24
9682140161583058,2020-12,477.83,1657.35,3706.03,1214.59,1311.92,13727.16
11972044772734216,2020-01,2022.82,0,2458.14,759.5,3721.46,3721.46
11972044772734216,2020-02,1444.61,3670.22,1110.45,0,-1115.16,2606.3
11972044772734216,2020-03,1068.56,2065.94,866.96,2939.47,-3069.89,-463.59
11972044772734216,2020-04,4176.65,2236.57,1398.29,1279.43,2058.94,1595.35
11972044772734216,2020-05,2425.84,2794.77,2927.81,493.65,2065.23,3660.58
11972044772734216,2020-06,1546.41,737.76,4936.09,1380.49,4364.25,8024.83
11972044772734216,2020-07,4628.4,2623.42,2860.91,3109.97,1755.92,9780.75
11972044772734216,2020-08,1389.46,3667.22,3284.15,1379.15,-372.76,9407.99
11972044772734216,2020-09,0,985,0,1842.86,-2827.86,6580.13
11972044772734216,2020-10,3477.41,2808.81,3020.6,625.16,3064.04,9644.17
11972044772734216,2020-11,0,836.64,2341.73,1888.55,-383.46,9260.71
11972044772734216,2020-12,1037.02,0,1962.11,0,2999.13,12259.84
14823956517654278,2020-01,6031.77,1507.52,5237.31,3433.14,6328.42,6328.42
14823956517654278,2020-02,6639.22,2376.62,4774.53,1110.24,7926.89,14255.31
14823956517654278,2020-03,5013.47,3783.46,3212.53,5078.45,-635.91,13619.4
14823956517654278,2020-04,3302.46,2644.93,3016.32,0,3673.85,17293.25
14823956517654278,2020-05,4545.52,2407.33,1288.75,4159,-732.06,16561.19
14823956517654278,2020-06,4398.43,2598.05,1064.49,1892.92,971.95,17533.14
14823956517654278,2020-07,1414.4,2629.07,3100.9,4433.41,-2547.18,14985.96
14823956517654278,2020-08,7211.76,1277.1,1676.49,1889.2,5721.95,20707.91
14823956517654278,2020-09,7801.99,1930.53,7748.03,2918.92,10700.57,31408.48
14823956517654278,2020-10,3083.14,3725.78,0,1967.74,-2610.38,28798.1
14823956517654278,2020-11,2657.75,4082.58,2651.45,5154.66,-3928.04,24870.06
14823956517654278,2020-12,3372.35,390.71,3587.71,4281.64,2287.71,27157.77
14960923507500004,2020-01,645.06,2233.3,1720.17,2191.45,-2059.52,-2059.52
14960923507500004,2020-02,3744.5,2796.58,0,1885.72,-937.8,-2997.32
14960923507500004,2020-03,42.58,249.98,427.96,0,220.56,-2776.76
14960923507500004,2020-04,0,2858.3,1065.75,2362.7,-4155.25,-6932.01
14960923507500004,2020-05,5837.74,4455.72,2266.3,101.47,3546.85,-3385.16
14960923507500004,2020-06,2054.37,1953.13,1164.33,320.49,945.08,-2440.08
14960923507500004,2020-07,1328.26,3271.38,54.79,1664.95,-3553.28,-5993.36
14960923507500004,2020-08,682.06,199.37,0,2346.74,-1864.05,-7857.41
14960923507500004,2020-09,231.2,1580.17,842.82,2985.52,-3491.67,-11349.08
14960923507500004,2020-10,1299.48,1700.77,0,1414.04,-1815.33,-13164.41
14960923507500004,2020-11,5595.07,788.11,1848.94,0,6655.9,-6508.51
14960923507500004,2020-12,3216.74,526.99,6139.77,1263.02,7566.5,1057.99
16488801170250194,2020-01,1382.95,0,0,0,1382.95,1382.95
16488801170250194,2020-02,382.27,0,0,0,382.27,1765.22
16488801170250194,2020-03,0,1191.63,1584.24,657.65,-265.04,1500.18
16488801170250194,2020-05,1824.07,0,1027.46,0,2851.53,4351.71
16488801170250194,2020-06,0,1925.2,0,0,-1925.2,2426.51
16488801170250194,2020-07,0,525.03,1512.57,0,987.54,3414.05
16488801170250194,2020-08,0,2856.08,0,244.02,-3100.1,313.95
16488801170250194,2020-09,878.67,1868.65,0,0,-989.98,-676.03
16488801170250194,2020-11,1338.69,0,1534.7,0,2873.39,2197.36
17010643349938116,2020-01,681.21,0,765.14,1812.93,-366.58,-366.58
17010643349938116,2020-02,0,437.01,0,1237.95,-1674.96,-2041.54
17010643349938116,2020-04,2401.8,0,4387.1,0,6788.9,4747.36
17010643349938116,2020-05,1255.94,2223.25,0,1254.78,-2222.09,2525.27
17010643349938116,2020-06,430.36,609.09,3175.37,5256.15,-2259.51,265.76
17010643349938116,2020-07,0,2306.96,669.53,310.71,-1948.14,-1682.38
17010643349938116,2020-08,0,3103.03,1772.47,1724.24,-3054.8,-4737.18
17010643349938116,2020-09,1299.27,571.69,1389.65,0,2117.23,-2619.95
17010643349938116,2020-10,1718.12,688.84,1352.24,0,2381.52,-238.43
17010643349938116,2020-11,0,1286.5,1262.8,909.53,-933.23,-1171.66
17352812883658752,2020-01,4776.16,4915.34,3981.67,8439.18,-4596.69,-4596.69
17352812883658752,2020-02,7044.66,1245.36,2966.61,669.35,8096.56,3499.87
17352812883658752,2020-03,0,7433.29,3714.69,2641.91,-6360.51,-2860.64
17352812883658752,2020-04,3196.37,2923.72,7166.77,5452.39,1987.03,-873.61
17352812883658752,2020-05,8382.15,2503.59,8364.27,5817.13,8425.7,7552.09
17352812883658752,2020-06,609.7,6196.9,4286.84,2957.41,-4257.77,3294.32
17352812883658752,2020-07,10380.72,2569.25,3408.38,6537.66,4682.19,7976.51
17352812883658752,2020-08,1756.77,1997.51,3771.91,3817.22,-286.05,7690.46
17352812883658752,2020-09,5489.87,4082.16,4993.54,5717.35,683.9,8374.36
17352812883658752,2020-10,7747.5,7513.67,5183.45,4106.23,1311.05,9685.41
17352812883658752,2020-11,1452.23,1937.8,3619.61,5410.94,-2276.9,7408.51
17352812883658752,2020-12,2393.63,1445.64,2412.44,3020.56,339.87,7748.38
18661351842096488,2020-01,0,3892.35,1148.46,1750.41,-4494.3,-4494.3
18661351842096488,2020-02,1689.87,579.07,619.9,0,1730.7,-2763.6
18661351842096488,2020-03,632.08,2185.43,2675.52,0,1122.17,-1641.43
18661351842096488,2020-04,284.84,1689.72,4137.34,5460.03,-2727.57,-4369
18661351842096488,2020-05,4096.87,0,2119.39,3939.12,2277.14,-2091.86
18661351842096488,2020-06,892.2,113.99,870.36,0,1648.57,-443.29
18661351842096488,2020-07,1060.44,2521.48,664.65,1618.04,-2414.43,-2857.72
18661351842096488,2020-08,2206.45,1270.52,1687.96,4602.71,-1978.82,-4836.54
18661351842096488,2020-09,943.96,771.39,8762.49,0,8935.06,4098.52
18661351842096488,2020-10,2528.18,3799.81,0,0,-1271.63,2826.89
18661351842096488,2020-11,2351.24,0,2592.94,3282.9,1661.28,4488.17
18661351842096488,2020-12,1613.88,0,1872.31,0,3486.19,7974.36
21312345113145264,2020-01,2224.92,0,8047.81,2697.03,7575.7,7575.7
21312345113145264,2020-02,9340.32,3949.58,10814.18,3777.1,12427.82,20003.52
21312345113145264,2020-03,4109.02,0,5646.07,1622.09,8133,28136.52
21312345113145264,2020-04,389.8,2261.34,1958.61,3847.49,-3760.42,24376.1
21312345113145264,2020-05,2020.4,466.97,5452.58,3270.86,3735.15,28111.25
21312345113145264,2020-06,4337.4,5196.67,2574.45,6345.82,-4630.64,23480.61
21312345113145264,2020-07,4927.31,1868.45,1888.8,2636.68,2310.98,25791.59
21312345113145264,2020-08,5597.13,2220.61,1358.78,2955.29,1780.01,27571.6
21312345113145264,2020-09,784.06,951.95,1779.55,1127.54,484.12,28055.72
21312345113145264,2020-10,5185.48,5237.93,3821.98,8077.27,-4307.74,23747.98
21312345113145264,2020-11,4873.69,4329.1,985.66,2466.69,-936.44,22811.54
21312345113145264,2020-12,4528.48,4520.38,2882.55,2740.1,150.55,22962.09
21621624814225668,2020-02,1423.62,1443.53,0,976.16,-996.07,-996.07
21621624814225668,2020-03,0,1816.6,1185.44,0,-631.16,-1627.23
21621624814225668,2020-04,1468.02,0,0,949.06,518.96,-1108.27
21621624814225668,2020-08,0,924.07,1998.39,272.06,802.26,-306.01
21621624814225668,2020-10,0,254.54,0,1704.24,-1958.78,-2264.79
21621624814225668,2020-12,0,1554.91,180.3,0,-1374.61,-3639.4
22491927182770952,2020-01,5129,1464.79,1008.4,2112.1,2560.51,2560.51
22491927182770952,2020-02,3717.42,8206.13,1030.95,5528.21,-8985.97,-6425.46
22491927182770952,2020-03,4309.69,4241.45,2937.46,4182.88,-1177.18,-7602.64
22491927182770952,2020-04,8554.89,8306.39,4040.9,5337.14,-1047.74,-8650.38
22491927182770952,2020-05,8746.89,2401.59,3692.29,2492.37,7545.22,-1105.16
22491927182770952,2020-06,7064.9,3926.33,5004.86,3548.84,4594.59,3489.43
22491927182770952,2020-07,3072.76,5680.22,1390.88,1543.14,-2759.72,729.71
22491927182770952,2020-08,8969.6,7812.21,11195.35,3040.13,9312.61,10042.32
22491927182770952,2020-09,3215.26,2090.34,5346.22,5203.22,1267.92,11310.24
22491927182770952,2020-10,4551.27,8038.62,6419.08,1520.6,1411.13,12721.37
22491927182770952,2020-11,1908.44,2635.36,2566.58,736.17,1103.49,13824.86
22491927182770952,2020-12,0,7144.97,3675.68,4742.55,-8211.84,5613.02
22831044469048256,2020-01,4970.31,0,2558.84,2431.77,5097.38,5097.38
22831044469048256,2020-02,668.19,1592.88,4766.84,5855.94,-2013.79,3083.59
22831044469048256,2020-03,5540.37,3167.5,4811.38,5814.12,1370.13,4453.72
22831044469048256,2020-04,957.23,1330.56,4115.66,2967.55,774.78,5228.5
22831044469048256,2020-05,9326.23,3639.54,7947.2,3556.56,10077.33,15305.83
22831044469048256,2020-06,6362.32,2989.96,1618.93,3673.6,1317.69,16623.52
22831044469048256,2020-07,933.16,3409.96,45.65,1274.88,-3706.03,12917.49
22831044469048256,2020-08,1651.7,7198.32,4227.93,2753.19,-4071.88,8845.61
22831044469048256,2020-09,5998.06,4272.02,1431.49,2906.82,250.71,9096.32
22831044469048256,2020-10,2362.15,3331.82,5825.79,2778.08,2078.04,11174.36
22831044469048256,2020-11,6707.66,5317.75,3013.29,3501.96,901.24,12075.6
22831044469048256,2020-12,3300.66,191.02,0,3125.59,-15.95,12059.65
23387120898112960,2020-01,2323.3,997.73,7285.47,3946.97,4664.07,4664.07
23387120898112960,2020-02,1583.89,2979.09,1337.37,5162.11,-5219.94,-555.87
23387120898112960,2020-03,2111.78,0,5218.52,6851.29,479.01,-76.86
23387120898112960,2020-04,5047.54,978.43,5196.31,4872.74,4392.68,4315.82
23387120898112960,2020-05,6031.91,4913.45,6863.53,2046.99,5935,10250.82
23387120898112960,2020-06,239.03,6364.85,5442.34,2870.77,-3554.25,6696.57
23387120898112960,2020-07,1940.63,8626.42,4542.61,2876.39,-5019.57,1677
23387120898112960,2020-08,3916.09,4640.62,4666.14,2112.06,1829.55,3506.55
23387120898112960,2020-09,1313.99,1677.64,1502.62,1979.15,-840.18,2666.37
23387120898112960,2020-10,2651.95,4405.4,5781.18,2775.61,1252.12,3918.49
23387120898112960,2020-11,5400.91,487.7,6972.99,3646.24,8239.96,12158.45
23387120898112960,2020-12,4429.13,5186.15,6778.87,6070.99,-49.14,12109.31
24030010077126692,2020-01,0,4810.77,4143.37,2841.89,-3509.29,-3509.29
24030010077126692,2020-02,1062.84,788.01,0,1982.06,-1707.23,-5216.52
24030010077126692,2020-03,1395.47,1912.55,1875.15,901.53,456.54,-4759.98
24030010077126692,2020-04,2333.48,3841.25,4212.74,2682.01,22.96,-4737.02
24030010077126692,2020-05,3600.59,2726.24,1994.15,864.95,2003.55,-2733.47
24030010077126692,2020-06,4254.41,4794.03,3937.29,0,3397.67,664.2
24030010077126692,2020-07,3004.83,1964.84,573.33,2188.72,-575.4,88.8
24030010077126692,2020-08,6278.49,1356.07,1627.52,1645.95,4903.99,4992.79
24030010077126692,2020-09,772.25,6541.37,1911.08,3147.96,-7006,-2013.21
24030010077126692,2020-10,1059.73,393.35,6162.93,3271.95,3557.36,1544.15
24030010077126692,2020-11,268.41,2897.66,3700.32,4907.47,-3836.4,-2292.25
24030010077126692,2020-12,2443.77,389.57,2841.45,2437.83,2457.82,165.57
27678495950901348,2020-01,4059.25,6228.15,608.34,1236.61,-2797.17,-2797.17
27678495950901348,2020-02,5079.96,2375.83,7102.65,4536.67,5270.11,2472.94
27678495950901348,2020-03,4795.59,5670.05,4653.62,2583.92,1195.24,3668.18
27678495950901348,2020-04,5418.13,1676.11,4181.33,4539.38,3383.97,7052.15
27678495950901348,2020-05,3321.28,5861.41,1322.81,5497.36,-6714.68,337.47
27678495950901348,2020-06,1795.44,6526.63,7408.21,0,2677.02,3014.49
27678495950901348,2020-07,3749.42,3323.57,6334.07,4113.62,2646.3,5660.79
27678495950901348,2020-08,7845.96,7587.31,1730.6,3873.35,-1884.1,3776.69
27678495950901348,2020-09,3581.94,5434.72,7635.88,5482.36,300.74,4077.43
27678495950901348,2020-10,3145.41,6291.22,623.93,7389.5,-9911.38,-5833.95
27678495950901348,2020-11,3261.95,3571.73,3309.52,4929.37,-1929.63,-7763.58
27678495950901348,2020-12,6433.84,2061.65,5512.86,7075.66,2809.39,-4954.19
29381966057388312,2020-01,1373.26,812.96,0,0,560.3,560.3
29381966057388312,2020-02,0,1992.81,0,0,-1992.81,-1432.51
29381966057388312,2020-03,3113.17,1940.94,0,557.88,614.35,-818.16
29381966057388312,2020-04,1766.89,1475.01,1979.07,1331.66,939.29,121.13
29381966057388312,2020-06,343.22,1599.09,1536.36,0,280.49,401.62
29381966057388312,2020-07,2603.26,2221.78,1798.19,0,2179.67,2581.29
29381966057388312,2020-08,1171.35,565.77,969.56,1782.76,-207.62,2373.67
29381966057388312,2020-10,1252.06,1789.27,0,1145.78,-1682.99,690.68
29381966057388312,2020-11,882.56,1648.32,0,1900.7,-2666.46,-1975.78
29381966057388312,2020-12,309.06,1876.28,0,1520.79,-3088.01,-5063.79
29633697113363720,2020-01,1787.51,2791.79,68.1,4171.73,-5107.91,-5107.91
29633697113363720,2020-02,4121.86,2128.93,3422.91,1835.94,3579.9,-1528.01
29633697113363720,2020-03,3026.16,2694.75,6838.87,3007.94,4162.34,2634.33
29633697113363720,2020-04,1917.08,6132.46,3697.83,4101.61,-4619.16,-1984.83
29633697113363720,2020-05,3832.38,1920.82,3144.82,6279.09,-1222.71,-3207.54
29633697113363720,2020-06,2126.09,2366.68,8066.7,506.71,7319.4,4111.86
29633697113363720,2020-07,219.58,0,2327.8,4294.76,-1747.38,2364.48
29633697113363720,2020-08,3114.78,3355.75,4929.03,3323.75,1364.31,3728.79
29633697113363720,2020-09,6609.34,440.46,3611.15,6048.74,3731.29,7460.08
29633697113363720,2020-10,3710.91,2093.58,6779.08,7918.45,477.96,7938.04
29633697113363720,2020-11,1045.97,5026.87,1754.64,3449.27,-5675.53,2262.51
29633697113363720,2020-12,285.28,1016.58,3508.92,4279.7,-1502.08,760.43
29934903285460276,2020-01,1452.53,1124.31,2336,448.02,2216.2,2216.2
29934903285460276,2020-02,2884.54,2271.06,1950.64,0,2564.12,4780.32
29934903285460276,2020-03,3532.29,2719.04,4901.22,3398.14,2316.33,7096.65
29934903285460276,2020-04,2104.17,3701.93,1920.02,1013.87,-691.61,6405.04
29934903285460276,2020-05,6620.04,1961.31,3373.89,2430.63,5601.99,12007.03
29934903285460276,2020-06,0,1646.32,0,5303.66,-6949.98,5057.05
29934903285460276,2020-07,3533.17,3519.9,4397.93,0,4411.2,9468.25
29934903285460276,2020-08,4208.64,1519.18,2712.6,4920.1,481.96,9950.21
29934903285460276,2020-09,0,791.67,5670.3,657.78,4220.85,14171.06
29934903285460276,2020-10,3904.5,1483.78,1037.96,3014.45,444.23,14615.29
29934903285460276,2020-11,2242.22,1003,240.21,186.65,1292.78,15908.07
29934903285460276,2020-12,22.46,1635.7,347.15,2813.75,-4079.84,11828.23
31300714193979064,2020-01,2109.52,2984.96,3205.53,1660.59,669.5,669.5
31300714193979064,2020-02,3219,234.71,1684.94,6583.44,-1914.21,-1244.71
31300714193979064,2020-03,2952.49,1882.95,1170.74,6935.88,-4695.6,-5940.31
31300714193979064,2020-04,9749.08,1498.89,351.21,456.13,8145.27,2204.96
31300714193979064,2020-05,3250.24,3685.46,1893,2956.51,-1498.73,706.23
31300714193979064,2020-06,253.53,4376.01,3206.97,1462.4,-2377.91,-1671.68
31300714193979064,2020-07,360.6,0,5903.96,8839.9,-2575.34,-4247.02
31300714193979064,2020-08,2342.93,3376.85,0,3290.02,-4323.94,-8570.96
31300714193979064,2020-09,1374.49,2806.59,2228.28,1948.17,-1151.99,-9722.95
31300714193979064,2020-10,4898.47,3798.96,4039.25,1927.22,3211.54,-6511.41
31300714193979064,2020-11,2993.72,24.29,63.47,3453.17,-420.27,-6931.68
31300714193979064,2020-12,5682.43,5801.93,316.13,3190.39,-2993.76,-9925.44
32062621905216280,2020-01,979.99,0,1883.08,1031.14,1831.93,1831.93
32062621905216280,2020-02,1914.71,1590.47,0,2309.59,-1985.35,-153.42
32062621905216280,2020-03,0,2316.33,0,1291.48,-3607.81,-3761.23
32062621905216280,2020-04,558.62,907.69,2291.14,0,1942.07,-1819.16
32062621905216280,2020-06,0,1263.46,3300.2,1995.15,41.59,-1777.57
32062621905216280,2020-07,434.22,959.68,155.22,1463.8,-1834.04,-3611.61
32062621905216280,2020-08,3415.9,55.67,1168.45,1820.94,2707.74,-903.87
32062621905216280,2020-09,1850.2,0,1051.71,3353.32,-451.41,-1355.28
32062621905216280,2020-10,0,5061.09,1693.44,3718.37,-7086.02,-8441.3
32062621905216280,2020-11,1734.68,742.04,194.45,0,1187.09,-7254.21
32538827994227980,2020-01,6927.6,2051.48,10557.37,3099.64,12333.85,12333.85
32538827994227980,2020-02,7175.77,608.25,3894.17,3045.58,7416.11,19749.96
32538827994227980,2020-03,4413.8,3493.02,4246.93,5664.56,-496.85,19253.11
32538827994227980,2020-04,7406.73,2860.59,1275.06,5510.12,311.08,19564.19
32538827994227980,2020-05,2467.53,4975.48,6566.25,5280.18,-1221.88,18342.31
32538827994227980,2020-06,707.17,4797.78,9749.05,3691.54,1966.9,20309.21
32538827994227980,2020-07,4648.33,1381.37,3221.76,5123.04,1365.68,21674.89
32538827994227980,2020-08,2116.32,1672.98,6992.8,5835.07,1601.07,23275.96
32538827994227980,2020-09,7882.4,0,3525.53,3354.45,8053.48,31329.44
32538827994227980,2020-10,6763.93,3097.91,1871.76,3649.68,1888.1,33217.54
32538827994227980,2020-11,4782.54,1870.84,2612.1,6642.92,-1119.12,32098.42
32538827994227980,2020-12,6492.88,3776.81,1956.55,3457.04,1215.58,33314
34042653646113448,2020-01,811,1767.22,3154.21,2420.6,-222.61,-222.61
34042653646113448,2020-02,1374.84,0,3188.7,3201.8,1361.74,1139.13
34042653646113448,2020-03,776.48,1369.85,2036.61,1640.8,-197.56,941.57
34042653646113448,2020-04,2392.51,211.88,1504.92,3511.37,174.18,1115.75
34042653646113448,2020-05,10649.67,2526.01,2967.87,3571.73,7519.8,8635.55
34042653646113448,2020-06,252.96,1653.94,0,2428.72,-3829.7,4805.85
34042653646113448,2020-07,0,176.82,5540.45,2310.93,3052.7,7858.55
34042653646113448,2020-08,1723.85,518.58,2902.23,6075.72,-1968.22,5890.33
34042653646113448,2020-09,526.66,1537.46,1183.1,0,172.3,6062.63
34042653646113448,2020-10,2733.55,467.57,4722.72,1107.25,5881.45,11944.08
34042653646113448,2020-11,3116.11,4672.52,2607.58,2957.17,-1906,10038.08
34042653646113448,2020-12,1986.45,589.98,3142.44,5451.93,-913.02,9125.06
34732358252147868,2020-01,7328.28,4809.23,3599.93,1242.86,4876.12,4876.12
34732358252147868,2020-02,1057.96,1545.43,1871.43,732.33,651.63,5527.75
34732358252147868,2020-03,5275.7,3759.54,1848,1469.22,1894.94,7422.69
34732358252147868,2020-04,1907.51,704.02,1894.73,1107.55,1990.67,9413.36
34732358252147868,2020-05,1198.76,1976.48,949.35,772.29,-600.66,8812.7
34732358252147868,2020-06,4404.78,5179.42,0,1283.47,-2058.11,6754.59
34732358252147868,2020-07,570.32,811.82,324.66,1663.49,-1580.33,5174.26
34732358252147868,2020-08,0,1755.25,4455.27,3231.73,-531.71,4642.55
34732358252147868,2020-09,4040.28,210.98,614,2148.53,2294.77,6937.32
34732358252147868,2020-10,629.5,3450.09,851.35,3126.57,-5095.81,1841.51
34732358252147868,2020-11,579.4,1112.5,1608.87,0,1075.77,2917.28
34732358252147868,2020-12,97.74,2353.16,0,1269,-3524.42,-607.14
34733646243686796,2020-01,0,622.57,901.35,154.47,124.31,124.31
34733646243686796,2020-02,0,779.83,0,2661.83,-3441.66,-3317.35
34733646243686796,2020-03,513.58,0,1612.65,0,2126.23,-1191.12
34733646243686796,2020-04,1229.71,0,0,546.55,683.16,-507.96
34733646243686796,2020-05,1017.37,1900.76,0,570.88,-1454.27,-1962.23
34733646243686796,2020-06,954.3,832.49,0,2419.3,-2297.49,-4259.72
34733646243686796,2020-07,0,668.94,0,0,-668.94,-4928.66
35346173375634168,2020-01,4024.26,2630.01,3902.57,2758.47,2538.35,2538.35
35346173375634168,2020-02,4821.19,3949.68,5306.68,6930.97,-752.78,1785.57
35346173375634168,2020-03,4080.25,1709.53,5312.96,4329.05,3354.63,5140.2
35346173375634168,2020-04,4035.36,5991.91,3913.76,0,1957.21,7097.41
35346173375634168,2020-05,5767.72,4716.61,1083.24,4430.09,-2295.74,4801.67
35346173375634168,2020-06,5577.5,5793.52,8610.92,4413.35,3981.55,8783.22
35346173375634168,2020-07,7228.1,0,7455.33,4307.92,10375.51,19158.73
35346173375634168,2020-08,4577.98,4070,2010.71,4198.3,-1679.61,17479.12
35346173375634168,2020-09,5564.45,3190.37,2227.83,3083.91,1518,18997.12
35346173375634168,2020-10,2678.57,4046.41,8231.36,4868.81,1994.71,20991.83
35346173375634168,2020-11,4261.6,2765.03,1641.68,2870.38,267.87,21259.7
35346173375634168,2020-12,4230.87,4271.66,2407.29,5430.74,-3064.24,18195.46
35516794642511832,2020-01,5163.15,5467.37,3785.92,1192.27,2289.43,2289.43
35516794642511832,2020-02,1541.44,3515.98,3740.46,7146.87,-5380.95,-3091.52
35516794642511832,2020-03,5583.3,1918.49,1164.29,2383.75,2445.35,-646.17
35516794642511832,2020-04,884.71,9150.93,0,7270.29,-15536.51,-16182.68
35516794642511832,2020-05,2279.51,5199.5,7244.2,131.85,4192.36,-11990.32
35516794642511832,2020-06,1354.63,2401.64,2369.47,1905.98,-583.52,-12573.84
35516794642511832,2020-07,2951.34,0,3150.19,4327.04,1774.49,-10799.35
35516794642511832,2020-08,2873.75,971.42,0,0,1902.33,-8897.02
35516794642511832,2020-09,3278.51,1486.58,197.22,0,1989.15,-6907.87
35516794642511832,2020-10,3760.43,623.69,2061.68,3091.55,2106.87,-4801
35516794642511832,2020-11,2573.91,815.16,1238.66,6660.1,-3662.69,-8463.69
35516794642511832,2020-12,964.69,654.02,0,0,310.67,-8153.02
38121094827850024,2020-01,1324.65,4860.07,1362.83,5737.53,-7910.12,-7910.12
38121094827850024,2020-02,0,2218.43,0,1924.21,-4142.64,-12052.76
38121094827850024,2020-03,5720.27,1997.47,5447.88,234.96,8935.72,-3117.04
38121094827850024,2020-04,3157.12,1392.33,6120.41,1806.16,6079.04,2962
38121094827850024,2020-05,1813.24,1132.95,2007.07,1642.56,1044.8,4006.8
38121094827850024,2020-06,3909.65,1253.39,207.22,2819.11,44.37,4051.17
38121094827850024,2020-07,4673.49,2274.26,436.83,4433.02,-1596.96,2454.21
38121094827850024,2020-08,6683.29,723.61,605.02,1261.96,5302.74,7756.95
38121094827850024,2020-09,309.36,1444.24,6754.77,4478.84,1141.05,8898
38121094827850024,2020-10,5205.34,2547.33,3480.18,0,6138.19,15036.19
38121094827850024,2020-11,0,6511.93,3394.56,5102.2,-8219.57,6816.62
38121094827850024,2020-12,727.61,1225.41,2740.79,0,2242.99,9059.61
38699651908488984,2020-01,4342.98,0,1874.59,3790.7,2426.87,2426.87
38699651908488984,2020-02,0,631.49,1155.66,1564.92,-1040.75,1386.12
38699651908488984,2020-03,182.79,1822.61,2172.14,972.09,-439.77,946.35
38699651908488984,2020-04,2556.94,1226.01,1724.98,1301.62,1754.29,2700.64
38699651908488984,2020-05,3323.81,2357.08,2044.8,2869.57,141.96,2842.6
38699651908488984,2020-06,322.21,1583.39,1566.41,2868,-2562.77,279.83
38699651908488984,2020-07,1139.87,2066.99,0,0,-927.12,-647.29
38699651908488984,2020-08,2696.55,608.22,1618.37,272.44,3434.26,2786.97
38699651908488984,2020-09,2509.78,1817.72,1746.4,220.09,2218.37,5005.34
38699651908488984,2020-10,3491.92,683.55,3411.26,3484.52,2735.11,7740.45
38699651908488984,2020-11,0,817.47,2332.33,785.37,729.49,8469.94
38699651908488984,2020-12,1040.64,0,3180.16,334.93,3885.87,12355.81
40759391581305632,2020-04,59.02,1175.27,2748.63,2066.12,-433.74,-433.74
40759391581305632,2020-05,0,1795.9,0,0,-1795.9,-2229.64
40759391581305632,2020-07,0,990.44,0,0,-990.44,-3220.08
40759391581305632,2020-10,1840.84,0,3442.68,0,5283.52,2063.44
40759391581305632,2020-11,2652.57,0,0,0,2652.57,4716.01
40759391581305632,2020-12,325.5,0,0,0,325.5,5041.51
40830563732074832,2020-01,5364.03,1889.96,1626.6,0,5100.67,5100.67
40830563732074832,2020-02,5645.93,503.22,1333.16,2955.93,3519.94,8620.61
40830563732074832,2020-03,1676.82,4317.9,315.67,1499.68,-3825.09,4795.52
40830563732074832,2020-04,1730.36,367.58,1359.76,1967.67,754.87,5550.39
40830563732074832,2020-05,1741.45,4826.85,2433.7,1407.45,-2059.15,3491.24
40830563732074832,2020-06,2716.8,3163.86,600.81,1850.06,-1696.31,1794.93
40830563732074832,2020-07,535.52,3078.92,4624.19,4952.42,-2871.63,-1076.7
40830563732074832,2020-08,1572.29,887.53,1394.09,2671.14,-592.29,-1668.99
40830563732074832,2020-09,1559.75,5020.47,956.03,6149.82,-8654.51,-10323.5
40830563732074832,2020-10,2804.17,1648.11,5811.01,4997.3,1969.77,-8353.73
40830563732074832,2020-11,3552.29,1507.45,5614.72,2778.5,4881.06,-3472.67
40830563732074832,2020-12,1021.44,155.13,1965.88,6019.68,-3187.49,-6660.16
41053188821172824,2020-01,4015.31,4203.39,8389.84,3598.44,4603.32,4603.32
41053188821172824,2020-02,3054.46,6146.03,3630.33,3513.98,-2975.22,1628.1
41053188821172824,2020-03,149.38,3152.6,4566.53,6484.52,-4921.21,-3293.11
41053188821172824,2020-04,6170.63,11564.09,6316.56,4689.22,-3766.12,-7059.23
41053188821172824,2020-05,4573.19,2484.49,3462.98,2514.6,3037.08,-4022.15
41053188821172824,2020-06,2597.56,3237.79,4354.73,3957.19,-242.69,-4264.84
41053188821172824,2020-07,4842.91,2761.92,3565.58,10918.44,-5271.87,-9536.71
41053188821172824,2020-08,1829.55,7866.39,5047.53,2733.04,-3722.35,-13259.06
41053188821172824,2020-09,3970.4,13413.91,5968.13,12675.48,-16150.86,-29409.92
41053188821172824,2020-10,714.67,4051.22,3175.97,3848.18,-4008.76,-33418.68
41053188821172824,2020-11,8560.93,2011.6,7218.05,3839.6,9927.78,-23490.9
41053188821172824,2020-12,6043.53,5752.13,6409.58,2620.96,4080.02,-19410.88
41141008423600128,2020-01,6425.77,1087.41,2194.58,2229.87,5303.07,5303.07
41141008423600128,2020-02,996.77,248.77,0,3628.82,-2880.82,2422.25
41141008423600128,2020-03,314.28,3762.24,1962.44,732,-2217.52,204.73
41141008423600128,2020-04,867.22,5398.55,3153.95,612.86,-1990.24,-1785.51
41141008423600128,2020-05,3406.13,0,2582.37,552.02,5436.48,3650.97
41141008423600128,2020-06,4353.32,725.19,1809.03,1456.99,3980.17,7631.14
41141008423600128,2020-07,1085.75,2575.76,2189.95,2627.59,-1927.65,5703.49
41141008423600128,2020-08,643.78,0,1355.59,1238.76,760.61,6464.1
41141008423600128,2020-09,3685.66,126.9,3606.82,0,7165.58,13629.68
41141008423600128,2020-10,2386.86,3283.12,0,2063.39,-2959.65,10670.03
41141008423600128,2020-12,34,0,2481.13,2468.94,46.19,10716.22
42124548604720824,2020-01,0,1888.79,2343.1,3165.88,-2711.57,-2711.57
42124548604720824,2020-02,3833.12,796.32,1600.77,1541.22,3096.35,384.78
42124548604720824,2020-03,3845.01,6108.9,1218.2,3141.67,-4187.36,-3802.58
42124548604720824,2020-04,2218.27,1252.34,0,752.75,213.18,-3589.4
42124548604720824,2020-05,4373.32,215.99,1649.02,686.75,5119.6,1530.2
42124548604720824,2020-06,0,1730.6,0,0,-1730.6,-200.4
42124548604720824,2020-07,4744.95,3053.73,2767.13,2868.28,1590.07,1389.67
42124548604720824,2020-08,2812.77,2952.11,722.07,0,582.73,1972.4
42124548604720824,2020-09,3058.37,984.45,1846.52,741.85,3178.59,5150.99
42124548604720824,2020-10,1366.74,1969.6,4176.95,4458.47,-884.38,4266.61
42124548604720824,2020-11,769.85,3340.3,3394.91,0,824.46,5091.07
42124548604720824,2020-12,1727.4,1227.14,3681.13,0,4181.39,9272.46
44494542202672384,2020-01,3960.3,7875.92,12126.55,2520.62,5690.31,5690.31
44494542202672384,2020-02,10036.95,1115.54,4911.38,5231.71,8601.08,14291.39
44494542202672384,2020-03,9618.25,2319.31,9237.07,5349.67,11186.34,25477.73
44494542202672384,2020-04,0,3483.38,4276.17,3830.38,-3037.59,22440.14
44494542202672384,2020-05,6841.3,5267.32,5043.78,1821.92,4795.84,27235.98
44494542202672384,2020-06,1545.5,1637.93,9689.84,2889.89,6707.52,33943.5
44494542202672384,2020-07,1775.57,5753.28,9743.49,7687.24,-1921.46,32022.04
44494542202672384,2020-08,4687.56,3665.11,3471.75,1474.73,3019.47,35041.51
44494542202672384,2020-09,2388.46,4777.97,1973.39,3392.13,-3808.25,31233.26
44494542202672384,2020-10,4369.38,4245.8,7188.06,1498.57,5813.07,37046.33
44494542202672384,2020-11,6432.34,4315.89,3810.96,7752.56,-1825.15,35221.18
44494542202672384,2020-12,2680.81,9379.68,6153.03,2340.6,-2886.44,32334.74
45613471011040976,2020-01,6939.25,5891.64,4922.93,6020.05,-49.51,-49.51
45613471011040976,2020-02,8084.87,3147.31,940.97,5141.63,736.9,687.39
45613471011040976,2020-03,6661.46,4212.61,5490.74,4464.72,3474.87,4162.26
45613471011040976,2020-04,2453.71,4999.16,3116.99,3433.32,-2861.78,1300.48
45613471011040976,2020-05,8594.38,2999.85,6049.28,0,11643.81,12944.29
45613471011040976,2020-06,3788.04,4222.37,5875.63,2396.44,3044.86,15989.15
45613471011040976,2020-07,14625.58,4842.14,8646.76,2719.66,15710.54,31699.69
45613471011040976,2020-08,3614.08,6892.68,6536.1,6345.85,-3088.35,28611.34
45613471011040976,2020-09,7323.6,4057.19,4432.14,6004.67,1693.88,30305.22
45613471011040976,2020-10,3284.91,6954.7,1928.92,3902.67,-5643.54,24661.68
45613471011040976,2020-11,6739.37,3391.22,2043.17,1775.44,3615.88,28277.56
45613471011040976,2020-12,10084.09,1965.84,4587.26,2022.2,10683.31,38960.87
45844730793302384,2020-01,4266.52,7456.94,1988.83,5742.96,-6944.55,-6944.55
45844730793302384,2020-02,4929.36,5040.37,3551.44,2912.98,527.45,-6417.1
45844730793302384,2020-03,1535.03,1832.84,285.26,5346.32,-5358.87,-11775.97
45844730793302384,2020-04,802.16,854.13,2035.39,3072.03,-1088.61,-12864.58
45844730793302384,2020-05,1355.86,835.83,0,4642.46,-4122.43,-16987.01
45844730793302384,2020-06,1501.2,2310.55,1098.51,965.2,-676.04,-17663.05
45844730793302384,2020-07,1837.74,2264.7,3311.63,2646.72,237.95,-17425.1
45844730793302384,2020-08,1542.88,3107.95,2583.8,3091.23,-2072.5,-19497.6
45844730793302384,2020-09,3680.01,1413.71,0,4216.66,-1950.36,-21447.96
45844730793302384,2020-10,5071.26,3485.38,2305.02,3480.88,410.02,-21037.94
45844730793302384,2020-11,0,913.87,5909.39,2031.72,2963.8,-18074.14
45844730793302384,2020-12,5290.92,1966.9,3753.93,2530.6,4547.35,-13526.79
46004302388957424,2020-01,8427.35,1602.78,11319.96,1888.27,16256.26,16256.26
46004302388957424,2020-02,387.35,4714.34,5165.25,4536.91,-3698.65,12557.61
46004302388957424,2020-03,3415.44,6557.68,2115.31,6122.64,-7149.57,5408.04
46004302388957424,2020-04,2322.32,5818.54,3448.33,1420.78,-1468.67,3939.37
46004302388957424,2020-05,7043.75,3954.41,3992.97,5480.63,1601.68,5541.05
46004302388957424,2020-06,2741.35,6436.33,5203.06,2557.42,-1049.34,4491.71
46004302388957424,2020-07,6482.04,4981.87,1763.57,5131.64,-1867.9,2623.81
46004302388957424,2020-08,4237.03,3577.33,3636.93,5109.15,-812.52,1811.29
46004302388957424,2020-09,2334.5,7961.77,6151.15,1928.45,-1404.57,406.72
46004302388957424,2020-10,5939.93,7393.49,6309.2,4158.96,696.68,1103.4
46004302388957424,2020-11,3453.63,4295.25,2281.5,3837.99,-2398.11,-1294.71
46004302388957424,2020-12,9860.11,2811.34,3569.6,3163.93,7454.44,6159.73
46449298451092056,2020-01,3652.79,1918.59,3279.79,3774,1239.99,1239.99
46449298451092056,2020-02,5086.47,2100.1,11090.81,6242.81,7834.37,9074.36
46449298451092056,2020-03,5460.6,1046.22,3962.6,2494.04,5882.94,14957.3
46449298451092056,2020-04,3724.37,5125.42,4765.59,3923.04,-558.5,14398.8
46449298451092056,2020-05,8729.22,6131.37,3391.36,4039.13,1950.08,16348.88
46449298451092056,2020-06,4000.26,6864.75,3706.02,2198.52,-1356.99,14991.89
46449298451092056,2020-07,4928.17,4863.51,12651.21,3935.74,8780.13,23772.02
46449298451092056,2020-08,4498.95,3153.56,2703.44,4816.89,-768.06,23003.96
46449298451092056,2020-09,1988.98,3325.18,8074.46,2928.02,3810.24,26814.2
46449298451092056,2020-10,4769.58,9746.33,3419.34,5515.76,-7073.17,19741.03
46449298451092056,2020-11,7085.6,3498.43,1519.65,3251.63,1855.19,21596.22
46449298451092056,2020-12,2677.14,5363.87,7459.45,1130.58,3642.14,25238.36
47143096662100560,2020-01,5657.1,5807.09,9763.41,8087.29,1526.13,1526.13
47143096662100560,2020-02,6734.25,7391.05,5015.08,4409.02,-50.74,1475.39
47143096662100560,2020-03,3180.43,1700.25,5729.49,5678.8,1530.87,3006.26
47143096662100560,2020-04,4090.98,4773.25,2564.04,2335.46,-453.69,2552.57
47143096662100560,2020-05,3294.03,13743.81,9020.01,3658.88,-5088.65,-2536.08
47143096662100560,2020-06,6041.31,2823.93,2508.42,4963.92,761.88,-1774.2
47143096662100560,2020-07,8266.33,2723.63,5585.55,3008.23,8120.02,6345.82
47143096662100560,2020-08,5625.14,4308.05,2893.85,5796.65,-1585.71,4760.11
47143096662100560,2020-09,3628.82,5527.67,9077.21,2472.3,4706.06,9466.17
47143096662100560,2020-10,3553.69,472.22,5427.21,4323.6,4185.08,13651.25
47143096662100560,2020-11,3313.38,7142.78,7275.83,6197.33,-2750.9,10900.35
47143096662100560,2020-12,3182.83,5241.26,2112.09,4125.29,-4071.63,6828.72
48009251797903856,2020-01,0,6741.06,487.21,0,-6253.85,-6253.85
48009251797903856,2020-02,2210.69,387.7,0,0,1822.99,-4430.86
48009251797903856,2020-03,0,2273.34,2048.43,311.74,-536.65,-4967.51
48009251797903856,2020-07,0,2716.49,1252.55,95.23,-1559.17,-6526.68
48009251797903856,2020-08,0,807.72,554.31,0,-253.41,-6780.09
48009251797903856,2020-09,170.52,1797.02,1373.62,2840.76,-3093.64,-9873.73
48009251797903856,2020-10,0,1640.86,0,0,-1640.86,-11514.59
48009251797903856,2020-11,3348.18,0,79.96,0,3428.14,-8086.45
48009251797903856,2020-12,123.19,729.24,1799.63,0,1193.58,-6892.87
48070920687086952,2020-01,1756.52,3846.27,3393.28,6165.13,-4861.6,-4861.6
48070920687086952,2020-02,7222.59,4487.82,3171.38,4292.4,1613.75,-3247.85
48070920687086952,2020-03,5662.06,3525.48,3652.58,1998.46,3790.7,542.85
48070920687086952,2020-04,4191.46,4566.14,5588.22,3229.74,1983.8,2526.65
48070920687086952,2020-05,2503.76,4557.13,2865.39,2620.74,-1808.72,717.93
48070920687086952,2020-06,4018.46,2784.25,6610.1,4097.2,3747.11,4465.04
48070920687086952,2020-07,2910.5,4863.35,3334.16,244.81,1136.5,5601.54
48070920687086952,2020-08,2825.83,5039.96,3539.61,11140.01,-9814.53,-4212.99
48070920687086952,2020-09,3431.98,6748.19,3761.4,1219.11,-773.92,-4986.91
48070920687086952,2020-10,2878.66,2953.8,6335.52,5701.34,559.04,-4427.87
48070920687086952,2020-11,1735.89,9302.37,7573.59,2895.62,-2888.51,-7316.38
48070920687086952,2020-12,4157.28,10467.12,3765.32,1262.22,-3806.74,-11123.12
48449219011492936,2020-01,1897.2,3914.52,1364.14,0,-653.18,-653.18
48449219011492936,2020-02,2451.59,5478.58,5396.01,3763.23,-1394.21,-2047.39
48449219011492936,2020-03,9191.99,8358.21,9186.92,4525.34,5495.36,3447.97
48449219011492936,2020-04,3981.75,7703.96,7622.85,4024.38,-123.74,3324.23
48449219011492936,2020-05,5659.13,6279.58,3103.23,6244.05,-3761.27,-437.04
48449219011492936,2020-06,4791.25,1238.34,4527.99,6700.93,1379.97,942.93
48449219011492936,2020-07,7911.88,3172.96,3517.13,4774.91,3481.14,4424.07
48449219011492936,2020-08,4572.69,4285.88,6332.77,6591.8,27.78,4451.85
48449219011492936,2020-09,1083.63,3437.26,6410.87,1114.56,2942.68,7394.53
48449219011492936,2020-10,2698.89,5108.51,5329.7,5112.05,-2191.97,5202.56
48449219011492936,2020-11,5660.98,4965.11,6583.01,6305.74,973.14,6175.7
48449219011492936,2020-12,3867.79,2971.69,5637.12,3888.44,2644.78,8820.48
48560400199935272,2020-01,614.08,6710.86,2690.72,3436.95,-6843.01,-6843.01
48560400199935272,2020-02,2231.98,1787.33,5404.15,1826.34,4022.46,-2820.55
48560400199935272,2020-03,6283.67,4999.5,7758.35,2917.02,6125.5,3304.95
48560400199935272,2020-04,5193.98,7448.39,10603.23,2708.93,5639.89,8944.84
48560400199935272,2020-05,3030.51,2769.16,7740.69,0,8002.04,16946.88
48560400199935272,2020-06,1886.67,1625.01,4821.75,3881.31,1202.1,18148.98
48560400199935272,2020-07,2256.37,5322.66,3868.41,3667.73,-2865.61,15283.37
48560400199935272,2020-08,9327.94,3626.49,3951.68,1621.72,8031.41,23314.78
48560400199935272,2020-09,4412.9,7457.34,3929.51,6430.38,-5545.31,17769.47
48560400199935272,2020-10,5634.91,3800.53,1574.15,2861.04,547.49,18316.96
48560400199935272,2020-11,3878.89,4470.79,2900.41,2989.3,-680.79,17636.17
48560400199935272,2020-12,9502.35,3127.82,2029.83,1456.57,6947.79,24583.96
49307434170331560,2020-01,3483.17,1501.53,5142.73,3328.26,3796.11,3796.11
49307434170331560,2020-02,6233.35,3468.35,2990.53,101.9,5653.63,9449.74
49307434170331560,2020-03,1588.14,7803.86,4009.35,8491.16,-10697.53,-1247.79
49307434170331560,2020-04,4573.87,8067.91,3616.29,2653.79,-2531.54,-3779.33
49307434170331560,2020-05,4246.05,5465.86,1603.35,4092.63,-3709.09,-7488.42
49307434170331560,2020-06,1871.45,8047.93,5720.36,3375.24,-3831.36,-11319.78
49307434170331560,2020-07,7597.39,1509.05,3196.97,1304.06,7981.25,-3338.53
49307434170331560,2020-08,1888.47,3343.52,784.09,4429.66,-5100.62,-8439.15
49307434170331560,2020-09,1927.27,3318.59,1071.41,7652.63,-7972.54,-16411.69
49307434170331560,2020-10,6299.52,3121.38,4219.36,5158.92,2238.58,-14173.11
49307434170331560,2020-11,8215.37,5685.24,5130.38,1963.65,5696.86,-8476.25
49307434170331560,2020-12,7371.19,4969.51,3077.21,4446.19,1032.7,-7443.55
50845708191590968,2020-01,0,479.61,3539.56,0,3059.95,3059.95
50845708191590968,2020-02,887.76,1054.68,0,3071.71,-3238.63,-178.68
50845708191590968,2020-03,508.85,1499.86,1525.26,0,534.25,355.57
50845708191590968,2020-04,1480.32,0,2242.23,1011.52,2711.03,3066.6
50845708191590968,2020-05,0,2727.85,1850.75,0,-877.1,2189.5
50845708191590968,2020-07,4069.71,1368.14,433.76,3373.6,-238.27,1951.23
50845708191590968,2020-08,3957.61,762.41,1577.15,2791.91,1980.44,3931.67
50845708191590968,2020-09,1408.47,1823.66,997.96,1100.91,-518.14,3413.53
50845708191590968,2020-10,1677.66,275.1,657.12,267.11,1792.57,5206.1
50845708191590968,2020-11,2875.66,1396.19,0,252.64,1226.83,6432.93
50845708191590968,2020-12,0,735.5,349.76,3322.98,-3708.72,2724.21
51649182393070296,2020-01,356.8,1326.93,4686.66,4333.11,-616.58,-616.58
51649182393070296,2020-02,1466.13,4298.06,5439.57,3842.64,-1235,-1851.58
51649182393070296,2020-03,4049.51,8478.96,2023,5729.81,-8136.26,-9987.84
51649182393070296,2020-04,3437.26,2410.97,1647.07,324.79,2348.57,-7639.27
51649182393070296,2020-05,2447.78,0,1379.91,1979.02,1848.67,-5790.6
51649182393070296,2020-06,1947.66,3985.92,7584.5,2382.42,3163.82,-2626.78
51649182393070296,2020-07,1673.33,4720.54,4667.84,3938.61,-2317.98,-4944.76
51649182393070296,2020-08,2024.16,2674.22,3987.26,6000.34,-2663.14,-7607.9
51649182393070296,2020-09,4260.13,3731.98,6822.07,5748.6,1601.62,-6006.28
51649182393070296,2020-10,3286.07,6496.29,277.21,4510.5,-7443.51,-13449.79
51649182393070296,2020-11,1536.16,4657.41,3524.67,0,403.42,-13046.37
51649182393070296,2020-12,2064.11,5831.52,4902,4467.77,-3333.18,-16379.55
51736742473566520,2020-01,2634.1,3798.66,4706.85,0,3542.29,3542.29
51736742473566520,2020-02,0,1331.33,3035.71,2110.15,-405.77,3136.52
51736742473566520,2020-03,1912.28,1334.98,192.3,5327.41,-4557.81,-1421.29
51736742473566520,2020-04,5090.59,2791.97,4546.51,1701.13,5144,3722.71
51736742473566520,2020-05,247.11,4551.71,350.66,2883.11,-6837.05,-3114.34
51736742473566520,2020-06,7720.37,3065.78,4618.66,3338.02,5935.23,2820.89
51736742473566520,2020-07,2296.94,3290.85,2022.01,0,1028.1,3848.99
51736742473566520,2020-08,2228.24,1521.41,2012.69,2094.8,624.72,4473.71
51736742473566520,2020-09,1117.43,3797.53,1165.65,5742.31,-7256.76,-2783.05
51736742473566520,2020-10,0,2484.27,4137.38,3423.03,-1769.92,-4552.97
51736742473566520,2020-11,1604.18,2693.96,0,1496.97,-2586.75,-7139.72
51736742473566520,2020-12,3671.13,1320.46,3677.73,2887.05,3141.35,-3998.37
51862026824646624,2020-01,512.2,6165.99,5293.59,3082.91,-3443.11,-3443.11
51862026824646624,2020-02,2823.17,586.2,5443.75,545.47,7135.25,3692.14
51862026824646624,2020-03,4215.42,4802.47,2028.2,305.81,1135.34,4827.48
51862026824646624,2020-04,939.97,3862.9,2563.28,486.18,-845.83,3981.65
51862026824646624,2020-05,3543.33,849.95,1949.56,3351.71,1291.23,5272.88
51862026824646624,2020-06,1662.08,1677.58,1893.77,3327.23,-1448.96,3823.92
51862026824646624,2020-07,5502.44,5930.88,1227.54,4257.68,-3458.58,365.34
51862026824646624,2020-08,2328.1,6237.86,5720.7,2597.4,-786.46,-421.12
51862026824646624,2020-09,1951.18,3103.68,7059.2,3242.09,2664.61,2243.49
51862026824646624,2020-10,1191.51,3203.44,0,3797.39,-5809.32,-3565.83
51862026824646624,2020-11,3187.47,778.99,1944.04,1011.63,3340.89,-224.94
51862026824646624,2020-12,6271.48,0,3170.66,2097.17,7344.97,7120.03
53908529173311768,2020-01,1772.99,341.7,0,0,1431.29,1431.29
53908529173311768,2020-02,997.43,0,0,1937.14,-939.71,491.58
53908529173311768,2020-03,801.7,443.75,604.46,1689.07,-726.66,-235.08
53908529173311768,2020-04,0,1578.78,0,2894.11,-4472.89,-4707.97
53908529173311768,2020-05,0,1271.67,947.44,1985.15,-2309.38,-7017.35
53908529173311768,2020-07,1409.91,0,525.47,928.98,1006.4,-6010.95
53908529173311768,2020-08,4357.51,0,0,1294.84,3062.67,-2948.28
53908529173311768,2020-09,429.74,0,1786.87,0,2216.61,-731.67
53908529173311768,2020-10,0,1876.98,0,548.15,-2425.13,-3156.8
53908529173311768,2020-11,269.7,1761.96,536.12,3534.53,-4490.67,-7647.47
53908529173311768,2020-12,2119.51,684.37,1703.97,0,3139.11,-4508.36
54267712063132040,2020-01,0,4795.14,2424.18,533.24,-2904.2,-2904.2
54267712063132040,2020-02,2157.39,5637.48,2253.12,3651.08,-4878.05,-7782.25
54267712063132040,2020-03,2443.1,3611.92,5895.26,5428.14,-701.7,-8483.95
54267712063132040,2020-04,0,2463.53,1552.74,4202.75,-5113.54,-13597.49
54267712063132040,2020-05,4320.09,238.79,3651.85,4669.86,3063.29,-10534.2
54267712063132040,2020-06,2783.09,6554.89,2759.25,1464.73,-2477.28,-13011.48
54267712063132040,2020-07,4088.97,1832.47,3744.98,1791.81,4209.67,-8801.81
54267712063132040,2020-08,1869.05,5491.33,7765.62,4324.94,-181.6,-8983.41
54267712063132040,2020-09,2296.08,3495.13,6036.45,4016.09,821.31,-8162.1
54267712063132040,2020-10,1148.73,0,2825.09,2017,1956.82,-6205.28
54267712063132040,2020-11,506.91,2069.38,1392.83,8752.17,-8921.81,-15127.09
54267712063132040,2020-12,3579.46,6745.47,3006.77,1854.03,-2013.27,-17140.36
55533234061754200,2020-01,8296.09,0,4539.16,934.84,11900.41,11900.41
55533234061754200,2020-02,1553.18,1534.52,4964.64,6003.34,-1020.04,10880.37
55533234061754200,2020-03,5282.48,3255.3,697.12,1455.73,1268.57,12148.94
55533234061754200,2020-04,1715.96,1084.36,1797.11,4629.82,-2201.11,9947.83
55533234061754200,2020-05,1825.81,2581.73,1801.54,2088.67,-1043.05,8904.78
55533234061754200,2020-06,728.61,1275.98,431,1430.14,-1546.51,7358.27
55533234061754200,2020-07,0,944.69,2535.52,0,1590.83,8949.1
55533234061754200,2020-08,3406.65,0,1872.57,3361.95,1917.27,10866.37
55533234061754200,2020-09,301.53,1453.93,6236.12,2277.64,2806.08,13672.45
55533234061754200,2020-10,0,1425.09,1598.46,3275.48,-3102.11,10570.34
55533234061754200,2020-11,2996.08,2023.51,3344.22,6626.63,-2309.84,8260.5
55533234061754200,2020-12,1789.03,5913,1902.99,1817.74,-4038.72,4221.78
55816037922410592,2020-01,3052.99,4047.81,3064.92,2001.25,68.85,68.85
55816037922410592,2020-02,1186.01,3041.56,0,3170.37,-5025.92,-4957.07
55816037922410592,2020-03,1812.85,1884.98,0,412.09,-484.22,-5441.29
55816037922410592,2020-04,112.25,7946.27,1699.98,601.81,-6735.85,-12177.14
55816037922410592,2020-05,3558.51,1146.43,9778.3,4524.11,7666.27,-4510.87
55816037922410592,2020-07,3947.31,708.43,2571.07,4038.78,1771.17,-2739.7
55816037922410592,2020-08,4093.49,145.6,3279.59,2201.57,5025.91,2286.21
55816037922410592,2020-09,120.45,1050.68,221.76,0,-708.47,1577.74
55816037922410592,2020-10,2674.67,996.75,282.48,2009.44,-49.04,1528.7
55816037922410592,2020-11,4765.8,5226.02,689.89,2045.39,-1815.72,-287.02
55816037922410592,2020-12,0,710.09,178.14,3280.59,-3812.54,-4099.56
56255560652299008,2020-02,0,1640.16,0,0,-1640.16,-1640.16
56323229787951792,2020-01,8549.61,4343.12,2636.81,5490.44,1352.86,1352.86
56323229787951792,2020-02,5070.08,618.7,4354.09,4081.7,4723.77,6076.63
56323229787951792,2020-03,5727.33,4671.94,5046.7,4656.39,1445.7,7522.33
56323229787951792,2020-04,1089.25,2669.52,0,1471.7,-3051.97,4470.36
56323229787951792,2020-05,4014.88,6105.07,637.23,321.47,-1774.43,2695.93
56323229787951792,2020-06,4480.63,6928.94,5071.96,9317.36,-6693.71,-3997.78
56323229787951792,2020-07,2180.55,2405.78,9772.83,1721.25,7826.35,3828.57
56323229787951792,2020-08,2560.92,2550.88,2425.72,4324.26,-1888.5,1940.07
56323229787951792,2020-09,3178.11,8106,1077.61,3023.61,-6873.89,-4933.82
56323229787951792,2020-10,6098.87,4793.31,2463.36,3830.44,-61.52,-4995.34
56323229787951792,2020-11,0,3525.53,4015.17,4047.92,-3558.28,-8553.62
56323229787951792,2020-12,4713.75,3403.49,1767.32,2600.17,477.41,-8076.21
56962984241899240,2020-01,2997.39,6088.76,4089.94,3030.67,-2032.1,-2032.1
56962984241899240,2020-02,4028.75,2239.21,4914.84,3431.14,3273.24,1241.14
56962984241899240,2020-03,5202.52,6364.09,5239.83,3451.87,626.39,1867.53
56962984241899240,2020-04,1233.94,1488.53,2919.02,2164.35,500.08,2367.61
56962984241899240,2020-05,1852.09,8446.96,7711.58,5264.93,-4148.22,-1780.61
56962984241899240,2020-06,3393.62,1889.97,5871.27,274.12,7100.8,5320.19
56962984241899240,2020-07,1114.65,1531.53,1851.38,6273.51,-4839.01,481.18
56962984241899240,2020-08,1766.87,2905.84,3348.35,5358.81,-3149.43,-2668.25
56962984241899240,2020-09,1093.05,843.14,4332.05,1407.11,3174.85,506.6
56962984241899240,2020-10,1744.61,5353.53,3716.77,5378.63,-5270.78,-4764.18
56962984241899240,2020-11,4244.06,7859.65,5123.7,6099.98,-4591.87,-9356.05
56962984241899240,2020-12,7226.03,2595.95,1021.56,711.18,4940.46,-4415.59
57013995831411376,2020-01,1132.14,2941.65,135.72,0,-1673.79,-1673.79
57013995831411376,2020-02,0,3760.42,0,0,-3760.42,-5434.21
57013995831411376,2020-03,1805.53,0,1960.79,162.96,3603.36,-1830.85
57013995831411376,2020-05,1788.85,1308.62,1400.02,942.29,937.96,-892.89
57013995831411376,2020-06,2155.85,1971.14,418.88,146.61,456.98,-435.91
57013995831411376,2020-07,1328.86,1741.51,2409,2236.69,-240.34,-676.25
57013995831411376,2020-08,1595.4,1747.2,1506.14,3891.56,-2537.22,-3213.47
57013995831411376,2020-09,1609.02,120.56,0,0,1488.46,-1725.01
57013995831411376,2020-10,428.8,1919.02,2387.1,3267.43,-2370.55,-4095.56
57013995831411376,2020-11,155.24,0,0,845.22,-689.98,-4785.54
57013995831411376,2020-12,2533.38,3.42,1299.05,4395.67,-566.66,-5352.2
57591087800910912,2020-01,1903.41,525.85,4874.71,0,6252.27,6252.27
57591087800910912,2020-02,1938,1627.11,2580.9,2632.61,259.18,6511.45
57591087800910912,2020-03,1717.55,4256.19,1592.89,4025.4,-4971.15,1540.3
57591087800910912,2020-04,1008.15,459.68,0,2812.2,-2263.73,-723.43
57591087800910912,2020-05,2330.5,994.49,1999.13,1497.51,1837.63,1114.2
57591087800910912,2020-06,1479.85,2362.6,2415.33,1840.37,-307.79,806.41
57591087800910912,2020-07,2563.53,0,0,0,2563.53,3369.94
57591087800910912,2020-08,0,1801.72,1100.36,1866.56,-2567.92,802.02
57591087800910912,2020-10,3114.68,1447.8,1274.14,0,2941.02,3743.04
57591087800910912,2020-11,937.66,0,806.07,3974.36,-2230.63,1512.41
57591087800910912,2020-12,451.07,1971.19,9275.2,6751.02,1004.06,2516.47
57912053632328176,2020-01,2290.18,2525.52,2420.1,1192.1,992.66,992.66
57912053632328176,2020-02,0,1023.03,3137.59,1976.14,138.42,1131.08
57912053632328176,2020-03,604.61,3489.27,1787.88,1332.4,-2429.18,-1298.1
57912053632328176,2020-04,0,1264.84,0,0,-1264.84,-2562.94
57912053632328176,2020-05,0,6098.22,1974.11,2439.97,-6564.08,-9127.02
57912053632328176,2020-06,1833.27,201.32,5801.04,2978.45,4454.54,-4672.48
57912053632328176,2020-07,1679.9,0,172.79,1677.67,175.02,-4497.46
57912053632328176,2020-08,2408.67,322.88,1185.01,7147.39,-3876.59,-8374.05
57912053632328176,2020-09,4371.71,1557.04,2524.66,0,5339.33,-3034.72
57912053632328176,2020-10,1399.88,1553.55,0,3954.72,-4108.39,-7143.11
57912053632328176,2020-11,0,2346.22,1933.97,0,-412.25,-7555.36
57912053632328176,2020-12,1606.02,0,1545.11,1055.88,2095.25,-5460.11
60067695162472792,2020-01,4920.07,0,2021.44,1455.74,5485.77,5485.77
60067695162472792,2020-02,2430.9,661.29,1914.14,3093.56,590.19,6075.96
60067695162472792,2020-03,514.35,2327.38,2583.09,3714.3,-2944.24,3131.72
60067695162472792,2020-04,3992.07,3163.19,3702.56,665.68,3865.76,6997.48
60067695162472792,2020-05,3130.55,1105.7,2497.81,1508.9,3013.76,10011.24
60067695162472792,2020-06,917.06,797.43,3441.54,1765.72,1795.45,11806.69
60067695162472792,2020-07,64.93,3358.76,0,1696.1,-4989.93,6816.76
60067695162472792,2020-08,4269.61,2004.21,1179.32,3200.79,243.93,7060.69
60067695162472792,2020-09,4708.22,563.11,2084.63,4370.51,1859.23,8919.92
60067695162472792,2020-10,825.79,1151.88,2460.79,1612.69,522.01,9441.93
60067695162472792,2020-11,1041.74,0,3142.46,2396.33,1787.87,11229.8
60067695162472792,2020-12,2209.46,1139.24,1057.55,1490.01,637.76,11867.56
60316834167041848,2020-01,208.62,2540.26,415.21,1438.4,-3354.83,-3354.83
60316834167041848,2020-02,1813.96,1888.03,3322.43,0,3248.36,-106.47
60316834167041848,2020-03,0,1821.99,620.74,557.63,-1758.88,-1865.35
60316834167041848,2020-04,0,4515.44,2139.94,2906.72,-5282.22,-7147.57
60316834167041848,2020-05,4603.92,3339.01,3572.25,124.02,4713.14,-2434.43
60316834167041848,2020-06,511.31,2257.23,2515.81,0,769.89,-1664.54
60316834167041848,2020-07,969.7,1116.88,1410.1,1003.66,259.26,-1405.28
60316834167041848,2020-08,1538.79,1429.7,778.24,319.25,568.08,-837.2
60316834167041848,2020-09,186.2,1617.62,3794.43,2144.91,218.1,-619.1
60316834167041848,2020-10,1840.08,1419.78,1711.9,649.48,1482.72,863.62
60316834167041848,2020-11,23.28,2140.59,739.49,1948.28,-3326.1,-2462.48
60316834167041848,2020-12,431.78,0,3571.62,0,4003.4,1540.92
60396900624082472,2020-01,4169.58,3561.05,4567.55,6491.3,-1315.22,-1315.22
60396900624082472,2020-02,4606.19,1354.98,4030.06,7070.47,210.8,-1104.42
60396900624082472,2020-03,2809.73,5361.07,1776.79,4030.2,-4804.75,-5909.17
60396900624082472,2020-04,3421.23,2420.72,317.3,3728.38,-2410.57,-8319.74
60396900624082472,2020-05,2708.25,7147.72,3704.97,4524.11,-5258.61,-13578.35
60396900624082472,2020-06,1318.21,3874.27,1607.99,8151.65,-9099.72,-22678.07
60396900624082472,2020-07,2607.16,6786.16,3975.98,4813.37,-5016.39,-27694.46
60396900624082472,2020-08,3720.83,9961.65,5485.58,4228.4,-4983.64,-32678.1
60396900624082472,2020-09,1658.31,3256.42,3525.84,3563.45,-1635.72,-34313.82
60396900624082472,2020-10,7143.12,3094.19,6321.29,2720.41,7649.81,-26664.01
60396900624082472,2020-11,3666.4,6006.67,7287.92,1676.03,3271.62,-23392.39
60396900624082472,2020-12,3819.89,4661.16,827.67,2275.93,-2289.53,-25681.92
61337575825666800,2020-01,1928.74,2311.89,1989.67,2301.99,-695.47,-695.47
61337575825666800,2020-02,0,1312.75,975.46,2828.78,-3166.07,-3861.54
61337575825666800,2020-03,4940.16,3864.53,3026.5,364.26,3737.87,-123.67
61337575825666800,2020-04,1789.01,0,2917.15,589.51,4116.65,3992.98
61337575825666800,2020-07,1691.37,2167.96,979.86,1872.95,-1369.68,2623.3
61337575825666800,2020-08,325.52,767.88,433.63,2211.09,-2219.82,403.48
61337575825666800,2020-09,4717.52,3962.24,4698.18,0,5453.46,5856.94
61337575825666800,2020-10,1754.06,1103.41,1718.9,2220.53,149.02,6005.96
61337575825666800,2020-11,5877.39,0,0,2499.74,3377.65,9383.61
61337575825666800,2020-12,0,988.12,958.92,3826.38,-3855.58,5528.03
61864458590284568,2020-01,2004.13,8435.34,9882.96,1761.88,1689.87,1689.87
61864458590284568,2020-02,1419.58,6168.6,1932.05,5213.18,-8030.15,-6340.28
61864458590284568,2020-03,5042.8,6248.88,4582.64,911.61,2464.95,-3875.33
61864458590284568,2020-04,5715.54,6715.92,3084.84,3667.59,-1583.13,-5458.46
61864458590284568,2020-05,3534.29,3846.36,3026.04,467.44,2246.53,-3211.93
61864458590284568,2020-06,5149.82,4329.01,9835.07,4292.95,6362.93,3151
61864458590284568,2020-07,8221.17,4521.97,3272.12,5211.69,1759.63,4910.63
61864458590284568,2020-08,3223.92,9166.92,6082.32,10188.91,-10049.59,-5138.96
61864458590284568,2020-09,4078.82,6661.76,5118.29,4900.38,-2365.03,-7503.99
61864458590284568,2020-10,4985.23,5143.43,4518.83,11644.41,-7283.78,-14787.77
61864458590284568,2020-11,3219.48,4452.52,2368.79,459.18,676.57,-14111.2
61864458590284568,2020-12,6471.63,4716.52,10985.28,3165.91,9574.48,-4536.72
62528355417961760,2020-01,3101.18,2391.71,5658.69,8054.94,-1686.78,-1686.78
62528355417961760,2020-02,2312.57,7459.37,6197.99,7387.12,-6335.93,-8022.71
62528355417961760,2020-03,4493.92,972.77,4154.51,3522.6,4153.06,-3869.65
62528355417961760,2020-04,5145.97,2296.61,2234.14,6538.77,-1455.27,-5324.92
62528355417961760,2020-05,7049.84,7192.39,7533.9,4732.41,2658.94,-2665.98
62528355417961760,2020-06,0,6101.56,1351.99,3289.51,-8039.08,-10705.06
62528355417961760,2020-07,1477.58,8367.27,1470.56,2595.74,-8014.87,-18719.93
62528355417961760,2020-08,4447.32,1601.66,7590.86,2288.04,8148.48,-10571.45
62528355417961760,2020-09,5447.01,4611.44,633.69,7962.37,-6493.11,-17064.56
62528355417961760,2020-10,2194.57,4388.22,3003.77,1899.17,-1089.05,-18153.61
62528355417961760,2020-11,2977.55,1169.51,2084.58,4041.45,-148.83,-18302.44
62528355417961760,2020-12,3106.68,3474.7,1763.77,1735.79,-340.04,-18642.48
62725486856205360,2020-01,0,301.98,0,0,-301.98,-301.98
62725486856205360,2020-02,1282.6,0,0,0,1282.6,980.62
62725486856205360,2020-03,2971.09,1414.48,0,0,1556.61,2537.23
62725486856205360,2020-06,486.36,0,0,0,486.36,3023.59
62725486856205360,2020-07,406.52,0,1295.5,1517.09,184.93,3208.52
62725486856205360,2020-08,1405.07,0,0,0,1405.07,4613.59
62725486856205360,2020-09,0,2464.46,0,0,-2464.46,2149.13
62725486856205360,2020-10,1178.95,0,0,540.98,637.97,2787.1
62725486856205360,2020-11,1324.45,1271.11,0,0,53.34,2840.44
62725486856205360,2020-12,1468.94,301.44,509.37,0,1676.87,4517.31
63577985048617496,2020-01,6868.77,9033.34,6424.77,10662.06,-6401.86,-6401.86
63577985048617496,2020-02,1901.87,1184.62,1260.33,5153.86,-3176.28,-9578.14
63577985048617496,2020-03,3660.29,5780.79,2964.97,5976.22,-5131.75,-14709.89
63577985048617496,2020-04,5227.34,11879.39,4821.68,3106.45,-4936.82,-19646.71
63577985048617496,2020-05,8244.77,923.14,2583.68,5969.51,3935.8,-15710.91
63577985048617496,2020-06,1679.38,3823.84,6732.37,5098.83,-510.92,-16221.83
63577985048617496,2020-07,3266.1,1512.28,6816.88,3282.86,5287.84,-10933.99
63577985048617496,2020-08,5552.27,1422.06,4844.06,13282.95,-4308.68,-15242.67
63577985048617496,2020-09,3767.84,5420.72,4482.27,6027.04,-3197.65,-18440.32
63577985048617496,2020-10,5905.06,5770.36,4682.78,4319.36,498.12,-17942.2
63577985048617496,2020-11,4184.7,4418.07,5274.97,2307.1,2734.5,-15207.7
63577985048617496,2020-12,5974.71,1474.77,2151.84,5626.81,1024.97,-14182.73
64761203857771520,2020-01,735.18,4893.11,829.51,8846.6,-12175.02,-12175.02
64761203857771520,2020-02,8050.57,2314.33,4549.56,3286.73,6999.07,-5175.95
64761203857771520,2020-03,5731.43,603.41,5223.96,4092.46,6259.52,1083.57
64761203857771520,2020-04,3190.1,1368,6045.85,4082.06,3785.89,4869.46
64761203857771520,2020-05,6720.57,4387.83,9646.34,5797.03,6182.05,11051.51
64761203857771520,2020-06,2884.28,2887.83,1802.56,3895.02,-2096.01,8955.5
64761203857771520,2020-07,4660.86,1197.5,2093.36,721.52,4835.2,13790.7
64761203857771520,2020-08,4337.74,9448.92,1238.69,5597.7,-9470.19,4320.51
64761203857771520,2020-09,6413.86,7507.89,5423.95,0,4329.92,8650.43
64761203857771520,2020-10,6553.32,4948.28,9606.35,2119.27,9092.12,17742.55
64761203857771520,2020-11,2869.92,5754.85,3186.49,5646.94,-5345.38,12397.17
64761203857771520,2020-12,2203.04,3767.27,3508.02,2753.89,-810.1,11587.07
65271295181741864,2020-01,3193.4,559.79,2136.79,2825.19,1945.21,1945.21
65271295181741864,2020-02,2328.25,2061.86,3184.59,0,3450.98,5396.19
65271295181741864,2020-03,4489.11,1579.99,5425.01,3916.3,4417.83,9814.02
65271295181741864,2020-04,1099.22,2903.43,0,1903.23,-3707.44,6106.58
65271295181741864,2020-05,1924.74,5428.24,0,3787.65,-7291.15,-1184.57
65271295181741864,2020-06,644.83,2125.77,6475.98,3047.99,1947.05,762.48
65271295181741864,2020-07,1184.65,752.19,2785.68,979.79,2238.35,3000.83
65271295181741864,2020-08,2817.24,6101.17,2368.13,984.41,-1900.21,1100.62
65271295181741864,2020-09,3304.3,4273.26,1340.67,1668.33,-1296.62,-196
65271295181741864,2020-10,4836.33,1532.81,2027.94,2206.27,3125.19,2929.19
65271295181741864,2020-11,1578.22,1670.19,7938.09,2707.74,5138.38,8067.57
65271295181741864,2020-12,126.08,524,670.7,1682.45,-1409.67,6657.9
66229395359203944,2020-01,1157.33,0,0,0,1157.33,1157.33
66229395359203944,2020-02,1044.61,0,72.84,761.1,356.35,1513.68
66229395359203944,2020-03,1367.99,638.52,1648.74,0,2378.21,3891.89
66229395359203944,2020-05,607.79,0,0,1902.28,-1294.49,2597.4
66229395359203944,2020-09,1535.49,0,0,0,1535.49,4132.89
66384040439454344,2020-01,1713.25,1776.85,0,1906.75,-1970.35,-1970.35
66384040439454344,2020-02,0,1560.77,0,270.92,-1831.69,-3802.04
66384040439454344,2020-03,0,1212.69,0,0,-1212.69,-5014.73
66384040439454344,2020-04,1614.77,1210.54,1220.55,1216.56,408.22,-4606.51
66384040439454344,2020-05,0,153.73,3489.71,1345.2,1990.78,-2615.73
66384040439454344,2020-06,0,1274.64,0,284.8,-1559.44,-4175.17
66384040439454344,2020-08,0,366.2,1644.77,0,1278.57,-2896.6
66384040439454344,2020-09,87.09,1193.62,1488.88,0,382.35,-2514.25
66384040439454344,2020-10,0,1557.87,0,0,-1557.87,-4072.12
66384040439454344,2020-11,757.02,0,0,702.15,54.87,-4017.25
66384040439454344,2020-12,1209.51,0,0,0,1209.51,-2807.74
66757042819681304,2020-01,3826.95,295.76,4353.56,6863.89,1020.86,1020.86
66757042819681304,2020-02,6374.93,7791.3,5502.81,7368.14,-3281.7,-2260.84
66757042819681304,2020-03,3816.66,2251.06,5385.97,2173.73,4777.84,2517
66757042819681304,2020-04,3118.99,4398.75,6441.27,3004.55,2156.96,4673.96
66757042819681304,2020-05,3976.82,2805.41,5000.23,4307.34,1864.3,6538.26
66757042819681304,2020-06,67.11,7714.21,7572.21,1613.43,-1688.32,4849.94
66757042819681304,2020-07,564.32,9751.93,4446.22,2625.88,-7367.27,-2517.33
66757042819681304,2020-08,10947.38,4870.48,5705.7,7820.62,3961.98,1444.65
66757042819681304,2020-09,1762.6,10338.3,6528.83,4281.02,-6327.89,-4883.24
66757042819681304,2020-10,5693.32,5449.66,4725.45,3663.44,1305.67,-3577.57
66757042819681304,2020-11,2795.45,3564.56,6847.19,6106.83,-28.75,-3606.32
66757042819681304,2020-12,6481.13,1007.5,2421.68,3464.81,4430.5,824.18
66882869408724712,2020-01,1900.34,0,1187.37,0,3087.71,3087.71
66882869408724712,2020-02,1478.28,0,61.46,1610.84,-71.1,3016.61
66882869408724712,2020-03,1182.13,0,506.19,0,1688.32,4704.93
66882869408724712,2020-04,1056.37,1911.82,0,1493.67,-2349.12,2355.81
66882869408724712,2020-07,215.7,3655.51,0,1123.66,-4563.47,-2207.66
66882869408724712,2020-08,404.48,0,748.35,1331.14,-178.31,-2385.97
66882869408724712,2020-09,1269.53,1500.06,645.43,0,414.9,-1971.07
66882869408724712,2020-10,577.08,820.85,1084.63,243.03,597.83,-1373.24
66882869408724712,2020-11,1638.2,0,121.28,1574.52,184.96,-1188.28
66882869408724712,2020-12,1811.78,1608.29,1699.23,159.16,1743.56,555.28
67693573615959560,2020-01,0,1427.33,0,268.63,-1695.96,-1695.96
67693573615959560,2020-02,0,78.03,465.71,1917.73,-1530.05,-3226.01
67693573615959560,2020-04,1478.66,1403.97,0,0,74.69,-3151.32
67693573615959560,2020-05,0,1998.79,2544.01,2618.09,-2072.87,-5224.19
67693573615959560,2020-06,0,1604.66,0,183.83,-1788.49,-7012.68
67693573615959560,2020-07,1954.62,461.74,1629.43,0,3122.31,-3890.37
67693573615959560,2020-08,255.54,1605.69,1875.4,75.45,449.8,-3440.57
67693573615959560,2020-09,2047.68,1806.11,2024.05,2071.46,194.16,-3246.41
67693573615959560,2020-10,2315.2,1644.29,0,2553.27,-1882.36,-5128.77
67693573615959560,2020-11,432.39,956.3,1657.39,0,1133.48,-3995.29
67693573615959560,2020-12,1811.23,1827.71,785.63,1947.41,-1178.26,-5173.55
67851450228682136,2020-01,4083.69,7922.58,5524.38,7066.28,-5380.79,-5380.79
67851450228682136,2020-02,7481,5599.37,4777.45,677.78,5981.3,600.51
67851450228682136,2020-03,2357.92,720.5,5404.43,1530.57,5511.28,6111.79
67851450228682136,2020-04,6881.31,3746.46,3514.88,1581.2,5068.53,11180.32
67851450228682136,2020-05,5476.18,6394.79,5220.83,2709.82,1592.4,12772.72
67851450228682136,2020-06,3699.79,1216.19,2413.86,5099.83,-202.37,12570.35
67851450228682136,2020-07,5145.58,5045.8,0,3642.5,-3542.72,9027.63
67851450228682136,2020-08,5317.37,3107.52,7159.66,1549.62,7819.89,16847.52
67851450228682136,2020-09,3188.47,6859.72,7123.16,6424.52,-2972.61,13874.91
67851450228682136,2020-10,5902.93,3735.02,4427.36,2405.94,4189.33,18064.24
67851450228682136,2020-11,5211.58,5300.42,5752.92,720.07,4944.01,23008.25
67851450228682136,2020-12,1194.64,6383.3,5540.24,3512.46,-3160.88,19847.37
68010319064394392,2020-01,1200.55,919.32,2235.53,5600.9,-3084.14,-3084.14
68010319064394392,2020-02,6139.7,1635.7,5360.57,1768.65,8095.92,5011.78
68010319064394392,2020-03,5280.01,3254.63,1623.79,5984.13,-2334.96,2676.82
68010319064394392,2020-04,6079.51,11964.61,5093.55,1805.9,-2597.45,79.37
68010319064394392,2020-05,2439.29,7430.44,6533.82,3965.41,-2422.74,-2343.37
68010319064394392,2020-06,1523.88,5799.41,3608.76,3696.88,-4363.65,-6707.02
68010319064394392,2020-07,11200.55,6557.61,0,0,4642.94,-2064.08
68010319064394392,2020-08,3871.66,4129.84,5153.07,2219.19,2675.7,611.62
68010319064394392,2020-09,1290.42,4809.93,5217.09,3087.57,-1389.99,-778.37
68010319064394392,2020-10,8094,2204.7,5392.12,879.47,10401.95,9623.58
68010319064394392,2020-11,3925.29,6682.88,7757.31,1120.95,3878.77,13502.35
68010319064394392,2020-12,4010.02,5419.47,2205.57,1768.2,-972.08,12530.27
68064537055543456,2020-01,6413.93,8030.84,1519.63,4784.17,-4881.45,-4881.45
68064537055543456,2020-02,5973.18,4865.87,177.15,5582.09,-4297.63,-9179.08
68064537055543456,2020-03,4993.76,11021.82,2915.49,5339.92,-8452.49,-17631.57
68064537055543456,2020-04,4414.69,4800.95,2464.26,2515.85,-437.85,-18069.42
68064537055543456,2020-05,699.4,3756.4,1689.43,4651.63,-6019.2,-24088.62
68064537055543456,2020-06,6143.75,4485.75,3666.18,2593.27,2730.91,-21357.71
68064537055543456,2020-07,4548.04,4169.71,4826.31,2774.47,2430.17,-18927.54
68064537055543456,2020-08,368.2,4465.09,2481.75,5154.74,-6769.88,-25697.42
68064537055543456,2020-09,735.29,5178.65,968.5,4495.92,-7970.78,-33668.2
68064537055543456,2020-10,5759.19,5442.63,2727.48,2638.55,405.49,-33262.71
68064537055543456,2020-11,9260.16,2627.18,3525.75,4612.06,5546.67,-27716.04
68064537055543456,2020-12,10252.46,3788.86,591.96,961.88,6093.68,-21622.36
68149436618038848,2020-01,2257.11,4525.54,9453.55,3329.84,3855.28,3855.28
68149436618038848,2020-02,5842.35,8854.22,2520.36,4457.1,-4948.61,-1093.33
68149436618038848,2020-03,3464.1,3134.49,5421.53,6084.6,-333.46,-1426.79
68149436618038848,2020-04,4685.71,4520.75,3815.67,3376.61,604.02,-822.77
68149436618038848,2020-05,2071.05,9022.45,2691.73,6514.98,-10774.65,-11597.42
68149436618038848,2020-06,6873.3,3641.23,4786.9,5190.02,2828.95,-8768.47
68149436618038848,2020-07,4672.81,3897.68,4754.94,9613.97,-4083.9,-12852.37
68149436618038848,2020-08,5673.44,3039.28,4558.01,4301.59,2890.58,-9961.79
68149436618038848,2020-09,4823.33,7818.65,380.42,3481.31,-6096.21,-16058
68149436618038848,2020-10,4514.05,3833.43,3640.8,5634.69,-1313.27,-17371.27
68149436618038848,2020-11,2128.32,8632.61,406.79,3845.31,-9942.81,-27314.08
68149436618038848,2020-12,5934.2,8245.38,5001.06,3006.64,-316.76,-27630.84
68992326641860528,2020-01,3212.83,2822.11,0,400.9,-10.18,-10.18
68992326641860528,2020-02,0,1311.27,0,2856.51,-4167.78,-4177.96
68992326641860528,2020-03,1392.33,1339.93,3107.89,681.96,2478.33,-1699.63
68992326641860528,2020-04,2702.42,1689.14,234.68,737.87,510.09,-1189.54
68992326641860528,2020-05,0,1913.25,1671.42,1406.81,-1648.64,-2838.18
68992326641860528,2020-06,0,1251.21,889.43,0,-361.78,-3199.96
68992326641860528,2020-07,2193.78,0,0,455.04,1738.74,-1461.22
68992326641860528,2020-08,911.62,1355.02,971.56,4016.99,-3488.83,-4950.05
68992326641860528,2020-09,899.38,1760.27,5224.03,2560.59,1802.55,-3147.5
68992326641860528,2020-10,2401.25,0,274.84,166.41,2509.68,-637.82
68992326641860528,2020-11,2574.47,1930.55,847.12,964.76,526.28,-111.54
72433336216498416,2020-01,4505.31,2326.27,2565.68,2009.42,2735.3,2735.3
72433336216498416,2020-02,675.89,6590.55,0,1501.16,-7415.82,-4680.52
72433336216498416,2020-03,2857.12,2474.56,8155.53,1455.76,7082.33,2401.81
72433336216498416,2020-04,3495.28,2789.09,2338.18,5463.55,-2419.18,-17.37
72433336216498416,2020-05,3348.6,0,4141.93,568.09,6922.44,6905.07
72433336216498416,2020-06,5086.29,3838.83,7863.18,8031.58,1079.06,7984.13
72433336216498416,2020-07,1313.12,4688.34,651.33,3072.6,-5796.49,2187.64
72433336216498416,2020-08,3255.88,3155.87,7152.87,1698.01,5554.87,7742.51
72433336216498416,2020-09,7250.97,2186.2,2927.83,4374.02,3618.58,11361.09
72433336216498416,2020-10,0,3010.67,723.4,4230.38,-6517.65,4843.44
72433336216498416,2020-11,3303.8,6123.33,1897.11,3511.56,-4433.98,409.46
72433336216498416,2020-12,5139.69,5156.57,3850.48,1860.37,1973.23,2382.69
73405787824663616,2020-01,6732.69,4733.5,7431.94,1898.71,7532.42,7532.42
73405787824663616,2020-02,5177.79,2844.11,558.91,101.33,2791.26,10323.68
73405787824663616,2020-03,0,1463.99,2256.48,0,792.49,11116.17
73405787824663616,2020-04,3680.86,1972.52,0,3873.06,-2164.72,8951.45
73405787824663616,2020-05,1492.98,2110.05,5848.86,4378.42,853.37,9804.82
73405787824663616,2020-06,4955.68,3172.09,1617.12,1037.55,2363.16,12167.98
73405787824663616,2020-07,3013.34,2467.36,1634.33,1903.37,276.94,12444.92
73405787824663616,2020-08,1775.58,4414.07,1746.13,4768.88,-5661.24,6783.68
73405787824663616,2020-09,2624.32,2583.95,3599.8,4930.62,-1290.45,5493.23
73405787824663616,2020-10,5301.33,1859.96,1021.36,3509.27,953.46,6446.69
73405787824663616,2020-11,5644.97,951.56,4567.89,0,9261.3,15707.99
73405787824663616,2020-12,2968.01,1571.05,3765.31,412.19,4750.08,20458.07
77093094428303520,2020-01,369.96,0,0,0,369.96,369.96
77093094428303520,2020-04,0,1287.1,1811.6,0,524.5,894.46
77093094428303520,2020-05,801.61,0,0,0,801.61,1696.07
77093094428303520,2020-06,1582.12,0,0,956.92,625.2,2321.27
77093094428303520,2020-09,0,530.76,0,416.47,-947.23,1374.04
77093094428303520,2020-12,1459.08,0,0,0,1459.08,2833.12
80384928863634592,2020-01,5315.06,2517.05,5402.14,2796.01,5404.14,5404.14
80384928863634592,2020-02,172.2,3652.97,5091.5,2369.39,-758.66,4645.48
80384928863634592,2020-03,691.88,3999.58,1925.01,8849.42,-10232.11,-5586.63
80384928863634592,2020-04,9825.19,2504.86,2091.28,7674.28,1737.33,-3849.3
80384928863634592,2020-05,6289.94,29.72,3858.98,2837.75,7281.45,3432.15
80384928863634592,2020-06,1949.77,2874.97,3123.46,1474.25,724.01,4156.16
80384928863634592,2020-07,7447.62,3174.26,5442.49,8790.77,925.08,5081.24
80384928863634592,2020-08,5712.09,9177.85,4718.4,1304.39,-51.75,5029.49
80384928863634592,2020-09,4073.42,1803.88,3019.06,5080.8,207.8,5237.29
80384928863634592,2020-10,4611.71,4545.09,1997.06,3181.01,-1117.33,4119.96
80384928863634592,2020-11,1885.38,3665.6,4066.69,1020.21,1266.26,5386.22
80384928863634592,2020-12,4138.24,843.99,2636.14,7949.73,-2019.34,3366.88
80440177658222192,2020-01,4406.19,7303.31,6406.64,8444.37,-4934.85,-4934.85
80440177658222192,2020-02,1802.2,3526.14,8254.21,3913.03,2617.24,-2317.61
80440177658222192,2020-03,4966.73,2180.53,8509.39,5479.2,5816.39,3498.78
80440177658222192,2020-04,6460.88,2597.17,3301.3,3403.88,3761.13,7259.91
80440177658222192,2020-05,8769.53,1890.76,4717.83,2047.11,9549.49,16809.4
80440177658222192,2020-06,1297.35,3370.51,2220.25,1862.04,-1714.95,15094.45
80440177658222192,2020-07,4899.23,3455.01,2625.72,7702.64,-3632.7,11461.75
80440177658222192,2020-08,2164.66,6321.28,3988.5,6181.19,-6349.31,5112.44
80440177658222192,2020-09,3037.29,5613.13,7212.93,8399.93,-3762.84,1349.6
80440177658222192,2020-10,3275.62,2464.3,6741.93,0,7553.25,8902.85
80440177658222192,2020-11,1187.68,3847.91,4761.37,1742.06,359.08,9261.93
80440177658222192,2020-12,3270.79,229.37,5372.08,2389.34,6024.16,15286.09
80459067466630336,2020-01,2158.47,5666.31,5472.86,4681.65,-2716.63,-2716.63
80459067466630336,2020-02,518.95,2297.56,2595.78,4135.31,-3318.14,-6034.77
80459067466630336,2020-03,2208.56,3348.09,2956.56,10770.43,-8953.4,-14988.17
80459067466630336,2020-04,6847.11,1687.12,5494.2,2724.05,7930.14,-7058.03
80459067466630336,2020-05,448.41,5766.02,3188.96,4078.68,-6207.33,-13265.36
80459067466630336,2020-06,4738.46,3452.11,4916.97,4218.83,1984.49,-11280.87
80459067466630336,2020-07,3355.95,3357.41,4076.02,4879,-804.44,-12085.31
80459067466630336,2020-08,5522.12,4517.14,1200.99,5535.21,-3329.24,-15414.55
80459067466630336,2020-09,920.83,2142.94,3913.53,7282.14,-4590.72,-20005.27
80459067466630336,2020-10,6797.56,1123.08,1703,639.1,6738.38,-13266.89
80459067466630336,2020-11,4229.79,3495.4,0,1424.02,-689.63,-13956.52
80459067466630336,2020-12,5360.24,3374.59,1352.25,4931.6,-1593.7,-15550.22
81726080963701360,2020-01,1221.46,2226.05,4049.28,5979.72,-2935.03,-2935.03
81726080963701360,2020-02,2007.39,1048.6,1346.16,0,2304.95,-630.08
81726080963701360,2020-03,2431.42,3256.45,4427.97,1582.46,2020.48,1390.4
81726080963701360,2020-04,3269.36,7697.15,1932.86,2154.42,-4649.35,-3258.95
81726080963701360,2020-05,1834.42,4142.27,1581.9,1985.5,-2711.45,-5970.4
81726080963701360,2020-06,837.23,0,6701.29,1466.85,6071.67,101.27
81726080963701360,2020-07,2203.82,2642.99,1757.55,1357.3,-38.92,62.35
81726080963701360,2020-08,5561.74,0,2652.61,6173.07,2041.28,2103.63
81726080963701360,2020-09,1944.21,2449.9,3326.45,2325.09,495.67,2599.3
81726080963701360,2020-10,5268.01,2079.01,2649.21,1784.66,4053.55,6652.85
81726080963701360,2020-11,2270.52,4056.51,2392.32,2100.65,-1494.32,5158.53
81726080963701360,2020-12,1348.54,772.31,803.28,5901.12,-4521.61,636.92
83385687667106592,2020-01,981.6,1343.19,0,0,-361.59,-361.59
83385687667106592,2020-02,1073.64,912.68,567.28,805.8,-77.56,-439.15
83385687667106592,2020-04,0,1941.14,0,0,-1941.14,-2380.29
83385687667106592,2020-05,0,945.2,0,0,-945.2,-3325.49
83385687667106592,2020-10,1533.91,0,0,0,1533.91,-1791.58
84416899763504176,2020-01,5071.11,6181.61,3827.64,11008.01,-8290.87,-8290.87
84416899763504176,2020-02,3952.18,952.2,6725.78,1651.54,8074.22,-216.65
84416899763504176,2020-03,2272.49,1757.49,2870.01,935.35,2449.66,2233.01
84416899763504176,2020-04,7913.41,5282.49,3084.22,3879.37,1835.77,4068.78
84416899763504176,2020-05,6157.37,4038.48,6937.9,2273.08,6783.71,10852.49
84416899763504176,2020-06,9.35,4387.34,2670.62,0,-1707.37,9145.12
84416899763504176,2020-07,2370.46,2598.06,3355.67,1096.75,2031.32,11176.44
84416899763504176,2020-08,2743.53,3507.58,494.92,4761.31,-5030.44,6146
84416899763504176,2020-09,1912.48,3252,5281.96,6752.98,-2810.54,3335.46
84416899763504176,2020-10,2161.98,5769.82,5575.58,3261.43,-1293.69,2041.77
84416899763504176,2020-11,3330.2,3916.14,7127.06,5310.64,1230.48,3272.25
84416899763504176,2020-12,4329.02,1925.1,12201.33,2680.02,11925.23,15197.48
85630755486815984,2020-01,112.35,1799.12,1147.01,1167.95,-1707.71,-1707.71
85630755486815984,2020-03,1654.64,3526.69,0,1976.46,-3848.51,-5556.22
85630755486815984,2020-04,1380.57,301.12,0,1799.1,-719.65,-6275.87
85630755486815984,2020-05,1380.95,1501.12,237.56,0,117.39,-6158.48
85630755486815984,2020-07,1629.28,2462.59,690.09,0,-143.22,-6301.7
85630755486815984,2020-08,865.49,1765.16,0,0,-899.67,-7201.37
85630755486815984,2020-09,324.31,0,0,78.88,245.43,-6955.94
85630755486815984,2020-10,1929.91,0,0,0,1929.91,-5026.03
85630755486815984,2020-11,0,2624.03,128.91,1570.15,-4065.27,-9091.3
85630755486815984,2020-12,0,287.61,3035.77,0,2748.16,-6343.14
85664718432010448,2020-01,3060.26,0,4831.58,1528.21,6363.63,6363.63
85664718432010448,2020-02,3453.21,2599.83,2477.18,1178.62,2151.94,8515.57
85664718432010448,2020-03,4494.02,3227.54,2418.72,3736.77,-51.57,8464
85664718432010448,2020-04,2271.73,3536.83,3736.35,8956.92,-6485.67,1978.33
85664718432010448,2020-05,9949.33,3813.24,2402.25,5448.53,3089.81,5068.14
85664718432010448,2020-06,2931.93,6295.84,7039.23,5220.99,-1545.67,3522.47
85664718432010448,2020-07,5849.49,4024.88,6555.52,4982.74,3397.39,6919.86
85664718432010448,2020-08,736.99,3463.66,2319.65,4151.72,-4558.74,2361.12
85664718432010448,2020-09,7151.31,4029.12,2792.67,7137.17,-1222.31,1138.81
85664718432010448,2020-10,7016.39,4317.36,2089.67,5287.2,-498.5,640.31
85664718432010448,2020-11,4480.93,4343.24,2870.82,4750.41,-1741.9,-1101.59
85664718432010448,2020-12,1162.41,3960.08,3353.74,5602.73,-5046.66,-6148.25
87645270095296064,2020-01,4180.57,4184.31,3258.6,6779.28,-3524.42,-3524.42
87645270095296064,2020-02,1887.81,9203.56,5402.39,9187.23,-11100.59,-14625.01
87645270095296064,2020-03,5158.2,4817.92,7467.19,8143.4,-335.93,-14960.94
87645270095296064,2020-04,3712.33,6074.33,7856.19,3961.31,1532.88,-13428.06
87645270095296064,2020-05,3228.19,11766.61,2531.08,1793.13,-7800.47,-21228.53
87645270095296064,2020-06,6913.86,5301.95,5678.81,4291.85,2998.87,-18229.66
87645270095296064,2020-07,5129.13,3499.36,3445.15,0,5074.92,-13154.74
87645270095296064,2020-08,3423.29,4834.13,2160.88,5888.5,-5138.46,-18293.2
87645270095296064,2020-09,4768.24,3788.12,4034.77,2488.2,2526.69,-15766.51
87645270095296064,2020-10,8804.47,2563.92,5862.3,4561.07,7541.78,-8224.73
87645270095296064,2020-11,9314.81,650.74,6064.15,4834.24,9893.98,1669.25
87645270095296064,2020-12,2179.49,6240.97,9526.73,1627.77,3837.48,5506.73
88036701449641744,2020-01,0,895.9,1392.87,279.44,217.53,217.53
88036701449641744,2020-02,1256.9,293.73,644.83,1818.52,-210.52,7.01
88036701449641744,2020-03,283.1,1154.3,1770.05,1326.55,-427.7,-420.69
88036701449641744,2020-04,1741.51,744.71,3124.69,0,4121.49,3700.8
88036701449641744,2020-05,2180.56,292,0,1857.68,30.88,3731.68
88036701449641744,2020-06,5180.59,2419.03,0,648.01,2113.55,5845.23
88036701449641744,2020-07,1322.49,1251.94,0,2348.82,-2278.27,3566.96
88036701449641744,2020-08,1768.81,2670.21,1330.5,940.34,-511.24,3055.72
88036701449641744,2020-09,5662.21,0,589.2,19.44,6231.97,9287.69
88036701449641744,2020-10,344.56,709.23,1761.7,0,1397.03,10684.72
88036701449641744,2020-11,1392.47,65.17,2778.59,5059.15,-953.26,9731.46
88036701449641744,2020-12,3041.29,3754.08,2005.5,0,1292.71,11024.17
88880365415442832,2020-01,1610.45,1514.93,2799.3,1317.81,1577.01,1577.01
88880365415442832,2020-02,3786.42,0,0,233.5,3552.92,5129.93
88880365415442832,2020-03,981.79,1748.16,1331.38,1411.72,-846.71,4283.22
88880365415442832,2020-04,2741.32,0,0,2522.49,218.83,4502.05
88880365415442832,2020-05,1933.43,2516.75,2532.5,0,1949.18,6451.23
88880365415442832,2020-06,2195.04,2343.91,190.48,1093.13,-1051.52,5399.71
88880365415442832,2020-07,2726.99,0,0,1033.14,1693.85,7093.56
88880365415442832,2020-08,646.15,5678.48,1791.68,534.3,-3774.95,3318.61
88880365415442832,2020-09,3659.9,624.06,1584.2,4034.98,585.06,3903.67
88880365415442832,2020-10,1890.47,0,0,3149.03,-1258.56,2645.11
88880365415442832,2020-11,1136.63,1400.45,1124.55,1101.45,-240.72,2404.39
88880365415442832,2020-12,6991.54,1434.56,0,0,5556.98,7961.37
89215663591259696,2020-02,1578.14,0,0,0,1578.14,1578.14
89215663591259696,2020-03,0,1416.31,0,0,-1416.31,161.83
89215663591259696,2020-04,1717.92,0,726.76,0,2444.68,2606.51
89215663591259696,2020-05,1539.7,0,1165.21,0,2704.91,5311.42
89215663591259696,2020-09,0,949.99,0,0,-949.99,4361.43
89215663591259696,2020-12,2475.82,0,204.82,0,2680.64,7042.07
89493970930208624,2020-01,2188.38,2742.08,0,3315.17,-3868.87,-3868.87
89493970930208624,2020-03,2409.53,2934.32,125.56,6860.93,-7260.16,-11129.03
89493970930208624,2020-04,2387.61,0,20.85,1238.79,1169.67,-9959.36
89493970930208624,2020-05,1407.77,924.2,1969.57,3725.39,-1272.25,-11231.61
89493970930208624,2020-06,2499.91,1863.11,0,3354.91,-2718.11,-13949.72
89493970930208624,2020-07,1012.11,0,1874.6,2306.09,580.62,-13369.1
89493970930208624,2020-08,483,5557.02,4164.63,0,-909.39,-14278.49
89493970930208624,2020-09,3028.43,3766.58,2968.03,1150.63,1079.25,-13199.24
89493970930208624,2020-10,5237.74,932.65,0,2450.75,1854.34,-11344.9
89493970930208624,2020-11,6132.39,0,1594.69,4807,2920.08,-8424.82
89493970930208624,2020-12,0,2142.5,0,0,-2142.5,-10567.32
90399245639765440,2020-01,2232.28,4193.98,5744.39,6648.41,-2865.72,-2865.72
90399245639765440,2020-02,3242.31,2556.73,3812.34,1579.75,2918.17,52.45
90399245639765440,2020-03,8003.32,3527.51,6711.47,2624.87,8562.41,8614.86
90399245639765440,2020-04,7191.16,6985.37,3496.42,5313.04,-1610.83,7004.03
90399245639765440,2020-05,5745.48,3515.25,3905.54,2954.61,3181.16,10185.19
90399245639765440,2020-06,4811.05,3044.43,3190.07,3700.4,1256.29,11441.48
90399245639765440,2020-07,2320.66,6750.81,4756.52,4808.71,-4482.34,6959.14
90399245639765440,2020-08,5088.89,4845.35,1753.29,8597.73,-6600.9,358.24
90399245639765440,2020-09,9951.5,2692.05,2189.48,4079.59,5369.34,5727.58
90399245639765440,2020-10,3515.36,1909.34,617.02,5824.94,-3601.9,2125.68
90399245639765440,2020-11,3778.97,2708,6356.4,5221.98,2205.39,4331.07
90399245639765440,2020-12,6885.84,9494.52,3699.45,5548.6,-4457.83,-126.76
90832062987605392,2020-01,709.29,1379.97,455.21,2541.87,-2757.34,-2757.34
90832062987605392,2020-02,2500.99,1211.82,0,1973.64,-684.47,-3441.81
90832062987605392,2020-03,2557.87,2381.79,2411.26,6245.54,-3658.2,-7100.01
90832062987605392,2020-04,1698.87,6039.63,6995.32,2259.93,394.63,-6705.38
90832062987605392,2020-05,2844.47,4329.54,4466.1,3547.2,-566.17,-7271.55
90832062987605392,2020-06,5076.77,3227.69,0,8954.46,-7105.38,-14376.93
90832062987605392,2020-07,2965.34,2590.42,4410.39,2162.75,2622.56,-11754.37
90832062987605392,2020-08,4249.27,6597.94,7359.62,3392.94,1618.01,-10136.36
90832062987605392,2020-09,80.63,1196.38,180.9,4769.61,-5704.46,-15840.82
90832062987605392,2020-10,5263.47,2177.27,2712.97,1878.14,3921.03,-11919.79
90832062987605392,2020-11,4681.48,5073.15,1648.99,4880.01,-3622.69,-15542.48
90832062987605392,2020-12,939.37,0,0,6247.2,-5307.83,-20850.31
91080204794237872,2020-01,9943.13,1234.91,449.63,3524.07,5633.78,5633.78
91080204794237872,2020-02,4498.17,1703.21,2406.19,1615.37,3585.78,9219.56
91080204794237872,2020-03,4727.54,5145.16,1423.11,3312.55,-2307.06,6912.5
91080204794237872,2020-04,1467.37,1871.18,4102.35,3524.37,174.17,7086.67
91080204794237872,2020-05,2518.92,3540.15,5525.91,4293.69,210.99,7297.66
91080204794237872,2020-06,4490.12,8963.54,6963.95,6544.51,-4053.98,3243.68
91080204794237872,2020-07,3575.24,1946.33,4578.19,2862.56,3344.54,6588.22
91080204794237872,2020-08,5538.91,2322.32,7096.34,3091.51,7221.42,13809.64
91080204794237872,2020-09,1408.01,1084.24,4660.27,2569.01,2415.03,16224.67
91080204794237872,2020-10,5067.29,677.2,2165.78,3194.41,3361.46,19586.13
91080204794237872,2020-11,188.91,2639.73,3526.32,4062.41,-2986.91,16599.22
91080204794237872,2020-12,732.8,1471.44,412.31,8427.59,-8753.92,7845.3
91451543311096832,2020-01,3161.87,7780.31,2177.46,5671.96,-8112.94,-8112.94
91451543311096832,2020-02,5278.17,0,1731.75,220.57,6789.35,-1323.59
91451543311096832,2020-03,3216.04,3099.93,2901.94,2849.73,168.32,-1155.27
91451543311096832,2020-04,6128.26,4008.97,2550.06,2771.51,1897.84,742.57
91451543311096832,2020-05,2845.97,6789.43,2879.04,3692.52,-4756.94,-4014.37
91451543311096832,2020-06,4369.45,5289.34,2629.64,1431.11,278.64,-3735.73
91451543311096832,2020-07,546.24,5598.42,8449.16,2340.64,1056.34,-2679.39
91451543311096832,2020-08,4390.34,7982.63,3576.25,1936.25,-1952.29,-4631.68
91451543311096832,2020-09,4308.38,6470.83,3143.41,4120.42,-3139.46,-7771.14
91451543311096832,2020-10,1644.23,576.63,1937.61,6069.64,-3064.43,-10835.57
91451543311096832,2020-11,5189.6,2717.89,9456.58,1105.26,10823.03,-12.54
91451543311096832,2020-12,6680.82,6575.53,2950.21,2599.72,455.78,443.24
94380364718482864,2020-01,3709.16,2076.14,4129.32,5087.31,675.03,675.03
94380364718482864,2020-02,463.98,3010.28,3717.66,3552.49,-2381.13,-1706.1
94380364718482864,2020-03,3214.57,3480.89,3142.9,31.98,2844.6,1138.5
94380364718482864,2020-04,2976.83,2465.31,4851.07,1918.15,3444.44,4582.94
94380364718482864,2020-05,10099.79,7627.5,2356.56,2374.31,2454.54,7037.48
94380364718482864,2020-06,4361.39,2445.51,8422.83,2246.16,8092.55,15130.03
94380364718482864,2020-07,6550.3,1323.8,2531.07,1113.74,6643.83,21773.86
94380364718482864,2020-08,3083.92,7423.82,5032.85,3869.85,-3176.9,18596.96
94380364718482864,2020-09,10463.47,1970.49,4827.06,1896.04,11424,30020.96
94380364718482864,2020-10,5053.31,9013.73,3772.5,1389.33,-1577.25,28443.71
94380364718482864,2020-11,1967.8,3557.26,5515.87,2661.07,1265.34,29709.05
94380364718482864,2020-12,2864.95,3531.68,1289.39,2938.53,-2315.87,27393.18
94852168151901536,2020-01,2009.74,2862.14,619.18,2924,-3157.22,-3157.22
94852168151901536,2020-02,1609.06,2078.55,1243.21,3125.48,-2351.76,-5508.98
94852168151901536,2020-03,1463.99,9292.62,3917.32,4500.19,-8411.5,-13920.48
94852168151901536,2020-04,1916.78,7410.61,1168.31,6409.05,-10734.57,-24655.05
94852168151901536,2020-05,2880.56,6703.93,0,208.74,-4032.11,-28687.16
94852168151901536,2020-06,3054.98,818.64,7925.91,1862.07,8300.18,-20386.98
94852168151901536,2020-07,5056.48,3492,0,4501.09,-2936.61,-23323.59
94852168151901536,2020-08,7462.96,5879.14,8486.3,2171.15,7898.97,-15424.62
94852168151901536,2020-09,3518.79,4697.56,2108.37,5458.04,-4528.44,-19953.06
94852168151901536,2020-10,3012.21,2073.18,3234.38,315.27,3858.14,-16094.92
94852168151901536,2020-11,999.58,0,3917.08,1035.32,3881.34,-12213.58
94852168151901536,2020-12,3800.52,3722.92,1816.41,0,1894.01,-10319.57
95722981952030608,2020-01,3007.53,1245.44,4502.12,353.07,5911.14,5911.14
95722981952030608,2020-02,6855.5,1454.58,1622.83,0,7023.75,12934.89
95722981952030608,2020-03,6659.52,2490.18,240.67,473.6,3936.41,16871.3
95722981952030608,2020-04,626.23,1528.72,2538.62,426.87,1209.26,18080.56
95722981952030608,2020-05,1945.34,0,1834.27,6891.46,-3111.85,14968.71
95722981952030608,2020-06,2440.53,5704.8,461.31,0,-2802.96,12165.75
95722981952030608,2020-07,1629.53,4254.58,3096.74,1638.42,-1166.73,10999.02
95722981952030608,2020-08,2098.37,5938.34,4341.11,4766.97,-4265.83,6733.19
95722981952030608,2020-09,1684.72,3413.91,0,1672.26,-3401.45,3331.74
95722981952030608,2020-10,1650.21,4890.21,0,0,-3240,91.74
95722981952030608,2020-11,4764.85,2962.5,4668.95,2429.14,4042.16,4133.9
95722981952030608,2020-12,992.37,75.03,3366.27,3837.01,446.6,4580.5
97027643794779296,2020-01,10553.02,2521.72,2966.98,5422.78,5575.5,5575.5
97027643794779296,2020-02,3580.41,5364.25,6371.33,3415.53,1171.96,6747.46
97027643794779296,2020-03,3695.6,3838.43,606.95,0,464.12,7211.58
97027643794779296,2020-04,1490.32,5190.02,879.45,5122.27,-7942.52,-730.94
97027643794779296,2020-05,5922.03,11746.35,2949.55,8392.1,-11266.87,-11997.81
97027643794779296,2020-06,4736.55,1033.19,986.86,1905.83,2784.39,-9213.42
97027643794779296,2020-07,7955.91,3581.46,3888.58,7104.24,1158.79,-8054.63
97027643794779296,2020-08,3767.19,3244.5,4926.86,7497.63,-2048.08,-10102.71
97027643794779296,2020-09,7070.9,7217.35,12357.38,3042.56,9168.37,-934.34
97027643794779296,2020-10,3437.59,13322.49,3508.59,6384.19,-12760.5,-13694.84
97027643794779296,2020-11,4063.04,6369.76,6905.56,4589.79,9.05,-13685.79
97027643794779296,2020-12,1330.46,11411.09,1484.53,3023.35,-11619.45,-25305.24
97646880850576656,2020-01,0,3810.14,5178.83,3699.78,-2331.09,-2331.09
97646880850576656,2020-02,3324.4,1830.93,4351.53,2528.15,3316.85,985.76
97646880850576656,2020-03,11176.05,2175.42,3914.18,2186.87,10727.94,11713.7
97646880850576656,2020-04,1414.75,3306.07,1030.16,3178.08,-4039.24,7674.46
97646880850576656,2020-05,5562.8,7644.53,2283.62,5204.87,-5002.98,2671.48
97646880850576656,2020-06,4078.17,7054.54,8477.46,2117.31,3383.78,6055.26
97646880850576656,2020-07,1753.42,1342.72,5415.64,4341.1,1485.24,7540.5
97646880850576656,2020-08,5136.2,3735.39,0,3388.11,-1987.3,5553.2
97646880850576656,2020-09,4091.07,2136.23,1881.13,10750.62,-6914.65,-1361.45
97646880850576656,2020-10,3440.2,3073.51,5489.3,2837.2,3018.79,1657.34
97646880850576656,2020-11,2510.98,2392.56,2688.7,2799.77,7.35,1664.69
97646880850576656,2020-12,124.52,4344.43,1963.39,5743.58,-8000.1,-6335.41
98935385187677248,2020-01,978.96,1268.48,2064.01,1941.22,-166.73,-166.73
98935385187677248,2020-02,0,2814.23,3203.03,1782.65,-1393.85,-1560.58
98935385187677248,2020-03,5201.85,2560.25,1660.48,5684.54,-1382.46,-2943.04
98935385187677248,2020-04,1775.85,2988.54,2498.11,2689.86,-1404.44,-4347.48
98935385187677248,2020-05,4216.31,4042.58,1608.72,4259.68,-2477.23,-6824.71
98935385187677248,2020-06,1440.89,5077.95,3388.9,6179.54,-6427.7,-13252.41
98935385187677248,2020-07,5826.18,246.98,2312.36,411,7480.56,-5771.85
98935385187677248,2020-08,2366.79,1695.82,4274.08,2722.53,2222.52,-3549.33
98935385187677248,2020-09,2599.03,3941.13,4965.6,10170.52,-6547.02,-10096.35
98935385187677248,2020-10,1856.68,2168.86,689.3,2477.42,-2100.3,-12196.65
98935385187677248,2020-11,1696.33,2510.82,1267.65,130.25,322.91,-11873.74
98935385187677248,2020-12,6057.11,4443.92,1765.81,1725.7,1653.3,-10220.44
99761083940083984,2020-01,6030.53,405.46,7713.45,3129.61,10208.91,10208.91
99761083940083984,2020-02,4690.81,0,3343.47,7143.89,890.39,11099.3
99761083940083984,2020-03,2415.76,6291.47,3876.97,8503.8,-8502.54,2596.76
99761083940083984,2020-04,5613.29,3214.22,3593.88,7864.32,-1871.37,725.39
99761083940083984,2020-05,2475.48,4541.3,6670.21,3746.11,858.28,1583.67
99761083940083984,2020-06,7668.58,1674.56,5171.38,3089.08,8076.32,9659.99
99761083940083984,2020-07,5082.24,2040.42,9182.28,835.86,11388.24,21048.23
99761083940083984,2020-08,7920.7,2984.23,7702.68,5948.71,6690.44,27738.67
99761083940083984,2020-09,7154.72,3098.97,2163.67,3423.4,2796.02,30534.69
99761083940083984,2020-10,5425.61,4885.18,3267.93,5313.56,-1505.2,29029.49
99761083940083984,2020-11,5798.42,4398.02,3717.69,4092.55,1025.54,30055.03
99761083940083984,2020-12,5349.62,6344.6,10028.4,3698.78,5334.64,35389.67
99970687267312864,2020-02,0,588.32,3648.58,1762.41,1297.85,1297.85
99970687267312864,2020-03,3277.13,1530.2,2407.64,726.5,3428.07,4725.92
99970687267312864,2020-04,765.47,3599.88,0,0,-2834.41,1891.51
99970687267312864,2020-05,3206.11,3811.31,0,0,-605.2,1286.31
99970687267312864,2020-06,621.94,242.39,2670.98,2652.92,397.61,1683.92
99970687267312864,2020-07,31.74,0,433.21,0,464.95,2148.87
99970687267312864,2020-09,3561.75,1187.03,0,612.07,1762.65,3911.52
99970687267312864,2020-10,0,5228.61,0,2628.17,-7856.78,-3945.26
99970687267312864,2020-11,1543.6,1294.02,0,1723.75,-1474.17,-5419.43
99970687267312864,2020-12,2503.28,1689.21,13.46,997.36,-169.83,-5589.26
100632473694499552,2020-01,2498.73,4468.17,0,2055.16,-4024.6,-4024.6
100632473694499552,2020-02,5329.39,3252.49,2096.12,2637.47,1535.55,-2489.05
100632473694499552,2020-03,0,2424.74,408.1,1234.59,-3251.23,-5740.28
100632473694499552,2020-04,1821.3,2012.74,0,1621.05,-1812.49,-7552.77
100632473694499552,2020-05,401.28,2663.73,1134.77,3550.97,-4678.65,-12231.42
100632473694499552,2020-06,1201.8,4902.97,811.84,1851.08,-4740.41,-16971.83
100632473694499552,2020-07,1861.63,3406.35,133.76,2463.29,-3874.25,-20846.08
100632473694499552,2020-08,1460.08,1667.96,1664.91,1766.61,-309.58,-21155.66
100632473694499552,2020-09,2924.3,1571.31,1073.08,477.91,1948.16,-19207.5
100632473694499552,2020-10,1200.05,0,880.59,1792.57,288.07,-18919.43
100632473694499552,2020-11,1030.59,2696.36,2572.03,3934.98,-3028.72,-21948.15
100632473694499552,2020-12,3722.34,1580.23,1780.79,638.55,3284.35,-18663.8
101189733877408608,2020-01,4041.92,7868.88,5829.26,7179.56,-5177.26,-5177.26
101189733877408608,2020-02,3552.09,2719.94,2822.56,10025.56,-6370.85,-11548.11
101189733877408608,2020-03,721.51,5627.39,5350.54,4992.48,-4547.82,-16095.93
101189733877408608,2020-04,5797.26,3114.11,4634.41,2098.37,5219.19,-10876.74
101189733877408608,2020-05,4165.74,3839.87,2570.6,3200.7,-304.23,-11180.97
101189733877408608,2020-06,3563.9,6163.05,7946.95,351.94,4995.86,-6185.11
101189733877408608,2020-07,5575.17,2360.13,3375.33,7849.55,-1259.18,-7444.29
101189733877408608,2020-08,8512.81,2330.4,3034.81,134.73,9082.49,1638.2
101189733877408608,2020-09,2768.89,1802.71,2570.46,5647.79,-2111.15,-472.95
101189733877408608,2020-10,244.72,7050.56,2280.43,4516.27,-9041.68,-9514.63
101189733877408608,2020-11,7164.55,1980.29,2641.95,3814.12,4012.09,-5502.54
101189733877408608,2020-12,3401.72,4482.28,2681.07,7431.1,-5830.59,-11333.13
101524635478686544,2020-01,7779.27,1773.82,3144.21,7153.98,1995.68,1995.68
101524635478686544,2020-02,823.13,3467.84,4327.05,1155.08,527.26,2522.94
101524635478686544,2020-03,2506.12,5698.25,5252.21,2083.4,-23.32,2499.62
101524635478686544,2020-04,121.18,0,2089.45,2480.07,-269.44,2230.18
101524635478686544,2020-05,4786.96,4352.72,9006.81,2072.56,7368.49,9598.67
101524635478686544,2020-06,3273.43,4860.77,2887.74,3373.69,-2073.29,7525.38
101524635478686544,2020-07,2498.69,3372.29,3002.48,1935.1,193.78,7719.16
101524635478686544,2020-08,6379.59,2822.55,7385.95,6163.35,4779.64,12498.8
101524635478686544,2020-09,5821.03,3180.8,1531.16,2739.12,1432.27,13931.07
101524635478686544,2020-10,383.71,1016.68,760.03,2864.46,-2737.4,11193.67
101524635478686544,2020-11,1610.2,468.9,1693.47,2740.2,94.57,11288.24
101524635478686544,2020-12,4029.4,5316.94,3593.72,5547.91,-3241.73,8046.51
101618097788883968,2020-01,575.52,2143.46,3369.44,3138.66,-1337.16,-1337.16
101618097788883968,2020-02,5679.19,1940.76,4289.94,3749.33,4279.04,2941.88
101618097788883968,2020-03,3150.21,300.55,1836.13,5536.41,-850.62,2091.26
101618097788883968,2020-04,1985.76,0,987.2,2972.98,-0.02,2091.24
101618097788883968,2020-05,1340.05,2278.45,2450.72,4473.21,-2960.89,-869.65
101618097788883968,2020-06,1425.38,2347.54,106.22,2424.2,-3240.14,-4109.79
101618097788883968,2020-07,3550.59,786.9,2910.18,0,5673.87,1564.08
101618097788883968,2020-08,1856.38,1181.55,2017,597.64,2094.19,3658.27
101618097788883968,2020-09,2983.45,5352.75,2287.4,2003.83,-2085.73,1572.54
101618097788883968,2020-10,2304.76,1698.19,2639.58,357.54,2888.61,4461.15
101618097788883968,2020-11,4593.95,4244.7,3147.63,74.7,3422.18,7883.33
101618097788883968,2020-12,2226.78,0,0,1954.97,271.81,8155.14
101784485174748432,2020-01,4093.2,6177.24,3311.06,4943.45,-3716.43,-3716.43
101784485174748432,2020-02,2373.25,7880.98,2960.98,4948.71,-7495.46,-11211.89
101784485174748432,2020-03,4879.52,10330.58,2838.8,1623.9,-4236.16,-15448.05
101784485174748432,2020-04,78.8,3900.56,1688.21,2816.18,-4949.73,-20397.78
101784485174748432,2020-05,6282.54,8750.77,3470.16,6697.19,-5695.26,-26093.04
101784485174748432,2020-06,6541.56,2593.64,3397.36,2224.71,5120.57,-20972.47
101784485174748432,2020-07,8557.66,8384.17,4387.23,9141.73,-4581.01,-25553.48
101784485174748432,2020-08,1051.58,7981.9,1246.94,5667.28,-11350.66,-36904.14
101784485174748432,2020-09,528.5,8148.07,6121.03,2718.21,-4216.75,-41120.89
101784485174748432,2020-10,4101.23,0,1188.62,898.49,4391.36,-36729.53
101784485174748432,2020-11,2496.94,4163.41,3092,1069.87,355.66,-36373.87
101784485174748432,2020-12,4211.01,4474.02,1784.46,3934.19,-2412.74,-38786.61
102141821767645248,2020-01,4358.71,6720.18,4665.26,8943.8,-6640.01,-6640.01
102141821767645248,2020-02,8697.41,3115.07,1305.65,6390.44,497.55,-6142.46
102141821767645248,2020-03,2412.61,1594.65,4591.03,194.65,5214.34,-928.12
102141821767645248,2020-04,7327.9,1073.93,5616.08,1910.28,9959.77,9031.65
102141821767645248,2020-05,5233.95,4984.37,2206.49,2169.22,286.85,9318.5
102141821767645248,2020-06,9293.95,1890.82,4711.83,4257.92,7857.04,17175.54
102141821767645248,2020-07,3319.39,6869.37,4886.47,6536.96,-5200.47,11975.07
102141821767645248,2020-08,3959.53,6979.19,5968.13,3269.23,-320.76,11654.31
102141821767645248,2020-09,3904.07,3872.88,5748.73,9146.1,-3366.18,8288.13
102141821767645248,2020-10,4908.1,6007.23,5340.03,3845.03,395.87,8684
102141821767645248,2020-11,1159.17,4341.32,4806.66,974.26,650.25,9334.25
102141821767645248,2020-12,5229.63,0,4534.83,7237.81,2526.65,11860.9
103207363609697376,2020-01,438.17,491.81,0,2903.67,-2957.31,-2957.31
103207363609697376,2020-02,683.48,3386.32,2162.41,915.73,-1456.16,-4413.47
103207363609697376,2020-03,2683.12,1632.3,3428.26,2885.17,1593.91,-2819.56
103207363609697376,2020-04,3047.83,2774.9,1843.3,1613.15,503.08,-2316.48
103207363609697376,2020-05,4297.6,583,2009.27,1072.35,4651.52,2335.04
103207363609697376,2020-06,1794.15,0,0,263.26,1530.89,3865.93
103207363609697376,2020-07,0,3707.92,2408.93,0,-1298.99,2566.94
103207363609697376,2020-08,1988.84,3372.94,1792.33,1392.02,-983.79,1583.15
103207363609697376,2020-09,880.48,1865.23,1443.91,0,459.16,2042.31
103207363609697376,2020-10,2114.7,744.78,1937.38,4633.92,-1326.62,715.69
103207363609697376,2020-11,2094.59,1141.62,3802.32,0,4755.29,5470.98
103207363609697376,2020-12,1581.83,178.44,0,0,1403.39,6874.37
105718477657994000,2020-01,591.6,0,4868.72,171.91,5288.41,5288.41
105718477657994000,2020-02,0,1329.52,0,2879.32,-4208.84,1079.57
105718477657994000,2020-03,1649.99,1019.47,8900.06,0,9530.58,10610.15
105718477657994000,2020-04,3070.52,1330.19,247,1735.78,251.55,10861.7
105718477657994000,2020-05,521.67,3026.18,5760.66,2678.44,577.71,11439.41
105718477657994000,2020-06,1283.7,0,3427.84,3751.12,960.42,12399.83
105718477657994000,2020-07,132.21,0,547.67,2377.83,-1697.95,10701.88
105718477657994000,2020-08,1016.88,2110.01,2375.68,1960.17,-677.62,10024.26
105718477657994000,2020-09,0,5441.79,6856.29,967.95,446.55,10470.81
105718477657994000,2020-10,0,2372.23,1424.36,1994.54,-2942.41,7528.4
105718477657994000,2020-12,652.72,1342.16,2071.47,1673.09,-291.06,7237.34
106544141261801168,2020-01,2102.23,3437.33,4854.24,3959.25,-440.11,-440.11
106544141261801168,2020-02,8504.98,696.99,5790.63,6100.93,7497.69,7057.58
106544141261801168,2020-03,3316.46,1922.07,4230.91,3228.94,2396.36,9453.94
106544141261801168,2020-04,6799.01,3200.44,5377.89,0,8976.46,18430.4
106544141261801168,2020-05,1220.62,12660.87,6038.22,3736.33,-9138.36,9292.04
106544141261801168,2020-06,6376.98,4321.34,5786.69,3325.55,4516.78,13808.82
106544141261801168,2020-07,2605.51,3955.01,4785.96,3032.28,404.18,14213
106544141261801168,2020-08,1044.8,2359.34,5762.85,1800.37,2647.94,16860.94
106544141261801168,2020-09,1319.39,2242.95,2989.45,7377.49,-5311.6,11549.34
106544141261801168,2020-10,6526.75,7932.16,5600.67,6149.01,-1953.75,9595.59
106544141261801168,2020-11,5326.49,4475.72,1750.26,6745.97,-4144.94,5450.65
106544141261801168,2020-12,8659.07,2040.49,6162.52,5906.43,6874.67,12325.32
106655959055214096,2020-02,217.52,0,0,0,217.52,217.52
106655959055214096,2020-03,281.12,0,0,0,281.12,498.64
106655959055214096,2020-06,732.12,0,0,0,732.12,1230.76
106655959055214096,2020-09,1650.23,0,1210.99,0,2861.22,4091.98
106655959055214096,2020-11,0,512.36,0,220.67,-733.03,3358.95
106655959055214096,2020-12,2946.02,901.23,1849.35,0,3894.14,7253.09
112435425030770816,2020-01,2589.44,3402.06,4213.17,3617.05,-216.5,-216.5
112435425030770816,2020-02,0,4062.28,3803.78,2496.96,-2755.46,-2971.96
112435425030770816,2020-03,8463.55,2751.75,4295.37,1318.57,8688.6,5716.64
112435425030770816,2020-04,2381.46,1711.07,1241.77,1933.33,-21.17,5695.47
112435425030770816,2020-05,1904.71,2932.3,2535.02,1760.05,-252.62,5442.85
112435425030770816,2020-06,1315.31,3018.12,3778.89,5643.3,-3567.22,1875.63
112435425030770816,2020-07,4613.94,3585.84,4550.17,5678.46,-100.19,1775.44
112435425030770816,2020-08,3712.85,1093.18,1085.63,0,3705.3,5480.74
112435425030770816,2020-09,1610.5,3932.18,1339.92,2960.99,-3942.75,1537.99
112435425030770816,2020-10,1959,1188.19,0,1393.16,-622.35,915.64
112435425030770816,2020-11,1020.49,303.1,3126.53,4094.2,-250.28,665.36
112435425030770816,2020-12,10519.88,3309.21,5228.11,0,12438.78,13104.14
114244083384430656,2020-01,3149.83,7231.45,1118.41,4646.06,-7609.27,-7609.27
114244083384430656,2020-02,3341.97,1916.85,3243.19,1.61,4666.7,-2942.57
114244083384430656,2020-03,5528.5,2767.46,1370.95,11170.84,-7038.85,-9981.42
114244083384430656,2020-04,6114.59,2408.07,379.36,4854.04,-768.16,-10749.58
114244083384430656,2020-05,4545.83,2813.43,1960.93,1937.59,1755.74,-8993.84
114244083384430656,2020-06,1959.34,3686.76,4246.55,1919.49,599.64,-8394.2
114244083384430656,2020-07,5713.44,1579.69,5116.91,3769.89,5480.77,-2913.43
114244083384430656,2020-08,2989.55,3327.55,2425.64,3706.91,-1619.27,-4532.7
114244083384430656,2020-09,3272.03,1954.37,4303.96,2788.89,2832.73,-1699.97
114244083384430656,2020-10,3524.36,1589.02,5564.38,1960.88,5538.84,3838.87
114244083384430656,2020-11,2680.02,225.48,8402.21,480.3,10376.45,14215.32
114244083384430656,2020-12,6726.77,1653.06,884.87,4632.9,1325.68,15541
115941320519204784,2020-01,1007.32,0,963.62,0,1970.94,1970.94
115941320519204784,2020-02,0,1167.58,1386.84,1976.2,-1756.94,214
115941320519204784,2020-03,0,1065.88,430.49,386.92,-1022.31,-808.31
115941320519204784,2020-05,289.84,230.39,2561.6,265.89,2355.16,1546.85
115941320519204784,2020-06,2581.67,2692.48,0,955.66,-1066.47,480.38
115941320519204784,2020-08,2307.34,1744.1,0,4110.13,-3546.89,-3066.51
115941320519204784,2020-10,0,1599.27,658.08,0,-941.19,-4007.7
115941320519204784,2020-11,1508.97,2692.59,2932.96,1627.38,121.96,-3885.74
115941320519204784,2020-12,2077.42,712.56,0,1238.02,126.84,-3758.9
116832098447238816,2020-01,2711.63,4263.24,1984.43,4025.91,-3593.09,-3593.09
116832098447238816,2020-03,4936.31,1667.82,1862.83,8578.91,-3447.59,-7040.68
116832098447238816,2020-04,1850.88,6243,3585.58,6105.46,-6912,-13952.68
116832098447238816,2020-05,2721.88,743.05,1341.67,1779.02,1541.48,-12411.2
116832098447238816,2020-06,0,2955.94,0,65.06,-3021,-15432.2
116832098447238816,2020-07,2278.31,3631.74,1772.77,2080.7,-1661.36,-17093.56
116832098447238816,2020-08,4611.82,780.63,3315.94,723.25,6423.88,-10669.68
116832098447238816,2020-09,3031.39,1655.31,5406.36,1140.88,5641.56,-5028.12
116832098447238816,2020-10,863.84,1188.86,2652.08,5682.15,-3355.09,-8383.21
116832098447238816,2020-11,4334.94,1878.05,0,3580.67,-1123.78,-9506.99
116832098447238816,2020-12,3419.03,3848.5,5513.93,3159.37,1925.09,-7581.9
117282333912587520,2020-01,1702.99,5950.7,0,5413.65,-9661.36,-9661.36
117282333912587520,2020-02,710.38,2062.08,2979.97,1716.79,-88.52,-9749.88
117282333912587520,2020-03,1781.51,3224.5,3453.11,2898.44,-888.32,-10638.2
117282333912587520,2020-04,4479.94,0,1282.8,2514.84,3247.9,-7390.3
117282333912587520,2020-05,6413.72,2604.27,122.94,3716.05,216.34,-7173.96
117282333912587520,2020-06,6372.12,5868.75,2434.35,5476.55,-2538.83,-9712.79
117282333912587520,2020-07,3599.54,622.8,5560.06,1409.46,7127.34,-2585.45
117282333912587520,2020-08,0,4663.11,2535.66,6885.5,-9012.95,-11598.4
117282333912587520,2020-09,3772.14,5125.48,3071.99,5862.66,-4144.01,-15742.41
117282333912587520,2020-10,3880.95,2224.1,2490.25,3259.81,887.29,-14855.12
117282333912587520,2020-11,3977.75,932.55,3912.1,1879.71,5077.59,-9777.53
117282333912587520,2020-12,3306.56,228.36,6794.18,1988.73,7883.65,-1893.88
119835037721484640,2020-01,0,1644.36,1296,0,-348.36,-348.36
119835037721484640,2020-02,996.09,647.62,0,0,348.47,0.11
119835037721484640,2020-03,442.87,3724.68,1758.58,2731.89,-4255.12,-4255.01
119835037721484640,2020-04,1404.36,0,3887.15,963.31,4328.2,73.19
119835037721484640,2020-05,1150.31,0,1949.76,0,3100.07,3173.26
119835037721484640,2020-06,592.03,0,650.27,558.35,683.95,3857.21
119835037721484640,2020-07,612.93,4721.4,1008.81,693.53,-3793.19,64.02
119835037721484640,2020-08,0,3164.43,3726.44,6093.75,-5531.74,-5467.72
119835037721484640,2020-09,0,2463.12,2580.42,1705.11,-1587.81,-7055.53
119835037721484640,2020-10,1642.91,0,0,564.89,1078.02,-5977.51
119835037721484640,2020-12,0,3537.18,0,0,-3537.18,-9514.69
121447147964535328,2020-01,5595.86,2556.01,552.41,1114.07,2478.19,2478.19
121447147964535328,2020-03,2710.43,2835.39,2126.52,6142.75,-4141.19,-1663
121447147964535328,2020-04,3847.16,2271.71,3356.07,4640.21,291.31,-1371.69
121447147964535328,2020-05,4315.09,3698.73,3490.2,1263.29,2843.27,1471.58
121447147964535328,2020-06,1097.74,1584.43,2817.09,4378.28,-2047.88,-576.3
121447147964535328,2020-07,3137.64,3633.99,1488.2,4932,-3940.15,-4516.45
121447147964535328,2020-08,6364.67,709.36,4661.28,3935.59,6381,1864.55
121447147964535328,2020-09,2845.68,2495.55,0,3998.58,-3648.45,-1783.9
121447147964535328,2020-10,994.61,2598.98,7380.37,1935.8,3840.2,2056.3
121447147964535328,2020-11,1817.07,1004.92,2258.98,1329.23,1741.9,3798.2
121447147964535328,2020-12,0,3052,0,4880.25,-7932.25,-4134.05
122077335612044656,2020-01,3819.59,59.16,779.89,0,4540.32,4540.32
122077335612044656,2020-03,2008.43,2783.37,0,1030.58,-1805.52,2734.8
122077335612044656,2020-04,3850.27,129.73,4085.14,1512.98,6292.7,9027.5
122077335612044656,2020-05,1195.96,4228.66,5371.61,0,2338.91,11366.41
122077335612044656,2020-06,1649.55,1605.15,2029.11,0,2073.51,13439.92
122077335612044656,2020-07,1669.85,0,0,2866.59,-1196.74,12243.18
122077335612044656,2020-08,4617.77,984.18,87.75,4051.44,-330.1,11913.08
122077335612044656,2020-09,4318.82,3401.61,5269.43,2798.96,3387.68,15300.76
122077335612044656,2020-10,145.28,1374.92,4220.47,4724.16,-1733.33,13567.43
122077335612044656,2020-11,1324.63,1404.99,1322.41,349.31,892.74,14460.17
122077335612044656,2020-12,1543.38,5458.44,1683.12,2720.72,-4952.66,9507.51
125102738137855808,2020-01,5436.26,654.3,3341.1,5007.28,3115.78,3115.78
125102738137855808,2020-02,8489.07,7666.3,3866.13,521.12,4167.78,7283.56
125102738137855808,2020-03,4242.79,4768.62,4739.37,2829.43,1384.11,8667.67
125102738137855808,2020-04,2492.54,10504.98,5579.31,3209.53,-5642.66,3025.01
125102738137855808,2020-05,5786.79,3614.77,903.66,8521.9,-5446.22,-2421.21
125102738137855808,2020-06,2356.84,9532.02,1207.51,12669.28,-18636.95,-21058.16
125102738137855808,2020-07,1779.29,2931.79,3075.44,1684.8,238.14,-20820.02
125102738137855808,2020-08,10316.58,4022.03,4522.67,2444.96,8372.26,-12447.76
125102738137855808,2020-09,4082.63,2982,5492.79,6432.17,161.25,-12286.51
125102738137855808,2020-10,2388.5,4191.89,2443.25,4521.68,-3881.82,-16168.33
125102738137855808,2020-11,4655.37,6735.77,6018.91,4687.62,-749.11,-16917.44
125102738137855808,2020-12,4126.52,800.47,6545.56,10137.88,-266.27,-17183.71
125737692260642688,2020-01,1683.14,1724.34,1699.81,0,1658.61,1658.61
125737692260642688,2020-02,0,1938.39,674.52,0,-1263.87,394.74
125737692260642688,2020-04,858.94,0,1590.44,1310.78,1138.6,1533.34
125737692260642688,2020-05,1223.18,2680.07,0,1131.01,-2587.9,-1054.56
125737692260642688,2020-06,833.43,0,862.07,0,1695.5,640.94
125737692260642688,2020-07,1924.6,104.88,0,0,1819.72,2460.66
125737692260642688,2020-08,1134.94,0,0,0,1134.94,3595.6
125737692260642688,2020-09,2204.95,83.04,0,1627.67,494.24,4089.84
125737692260642688,2020-10,2010.04,0,1001.31,0,3011.35,7101.19
125737692260642688,2020-11,0,1571.15,0,0,-1571.15,5530.04
125737692260642688,2020-12,0,243.7,704.58,1283.53,-822.65,4707.39
129426260996028448,2020-01,1681.09,2936.22,3790.11,0,2534.98,2534.98
129426260996028448,2020-02,1368.76,4606.81,5418.21,4189.19,-2009.03,525.95
129426260996028448,2020-03,3589.78,2886.54,4404.32,2964.43,2143.13,2669.08
129426260996028448,2020-04,1502.84,4390.45,3969.15,409.16,672.38,3341.46
129426260996028448,2020-05,2096.42,2777.85,1732.73,5444.63,-4393.33,-1051.87
129426260996028448,2020-06,0,2952.42,800.91,2628.7,-4780.21,-5832.08
129426260996028448,2020-07,2272.01,1740.85,8134.74,4399.99,4265.91,-1566.17
129426260996028448,2020-08,655.36,5303.12,2926.69,4765.47,-6486.54,-8052.71
129426260996028448,2020-09,539.78,3563.24,7501.96,6209.88,-1731.38,-9784.09
129426260996028448,2020-10,2272.38,1388.07,4125.6,749.92,4259.99,-5524.1
129426260996028448,2020-11,5810.11,2157.88,0,2842.53,809.7,-4714.4
129426260996028448,2020-12,3544.49,3045.6,4314.81,1112.14,3701.56,-1012.84
130313332445630048,2020-01,5410.73,570.68,524.82,4883.03,481.84,481.84
130313332445630048,2020-02,4530.84,4698.87,2647.85,1207.46,1272.36,1754.2
130313332445630048,2020-03,4080.52,2119.04,2682.06,2078.23,2565.31,4319.51
130313332445630048,2020-04,2737.92,3003.18,1090.94,3694.77,-2869.09,1450.42
130313332445630048,2020-05,2206.89,1763.25,1671.39,685.31,1429.72,2880.14
130313332445630048,2020-06,4831.81,99.73,928.04,439.08,5221.04,8101.18
130313332445630048,2020-07,3011.88,1209.66,7676.47,1981.61,7497.08,15598.26
130313332445630048,2020-08,3947.67,1337.38,840.29,313.47,3137.11,18735.37
130313332445630048,2020-09,2312.12,3435.84,0,4013.22,-5136.94,13598.43
130313332445630048,2020-10,11.72,4339.92,1304.58,2042.65,-5066.27,8532.16
130313332445630048,2020-11,3376.23,1492.39,3717.21,1512.64,4088.41,12620.57
130313332445630048,2020-12,2655.57,0,4323.47,514.05,6464.99,19085.56
131530041744091664,2020-01,4305.55,2787.37,3024.04,4270.25,271.97,271.97
131530041744091664,2020-02,2683.09,3009.61,422.77,3107.47,-3011.22,-2739.25
131530041744091664,2020-03,3951.87,7683.75,2136.03,4964.4,-6560.25,-9299.5
131530041744091664,2020-04,2210.86,5776.78,2485.34,2611.8,-3692.38,-12991.88
131530041744091664,2020-05,0,1179.56,1861.8,988.76,-306.52,-13298.4
131530041744091664,2020-06,2111.93,850.2,3224.92,4771.03,-284.38,-13582.78
131530041744091664,2020-07,4099.84,1897.39,5927.25,7101.27,1028.43,-12554.35
131530041744091664,2020-08,1158.02,2116.53,0,719.71,-1678.22,-14232.57
131530041744091664,2020-09,2487.11,5567.93,2295.04,2722.56,-3508.34,-17740.91
131530041744091664,2020-10,2851.94,3445.22,1630.76,4138.78,-3101.3,-20842.21
131530041744091664,2020-11,4304.82,4202.42,5359.24,6791.29,-1329.65,-22171.86
131530041744091664,2020-12,296.04,4937.95,3379.63,1384.87,-2647.15,-24819.01
131854226170914688,2020-01,2990.02,3601.05,3885,1075.6,2198.37,2198.37
131854226170914688,2020-02,7639.73,5657.7,5850.07,1680.49,6151.61,8349.98
131854226170914688,2020-03,8043.92,8530.31,4604.39,4721.18,-603.18,7746.8
131854226170914688,2020-04,6.6,8231.4,1884.35,4450.79,-10791.24,-3044.44
131854226170914688,2020-05,775.33,999.16,3107.81,1865.4,1018.58,-2025.86
131854226170914688,2020-06,2527.46,6019.53,3687.09,6007.32,-5812.3,-7838.16
131854226170914688,2020-07,5489.78,2936.85,3874,2916.06,3510.87,-4327.29
131854226170914688,2020-08,8536.16,5975.86,4464.32,2368.48,4656.14,328.85
131854226170914688,2020-09,2947.43,10944.96,4367.06,1646.99,-5277.46,-4948.61
131854226170914688,2020-10,4313.37,6622.03,1825.55,3249.96,-3733.07,-8681.68
131854226170914688,2020-11,5548.04,2963.02,2912.51,4798.08,699.45,-7982.23
131854226170914688,2020-12,3705.38,5261.82,2141.25,8312.68,-7727.87,-15710.1
132231690586607808,2020-01,1316.24,1938.58,2514.49,70.23,1821.92,1821.92
132231690586607808,2020-02,2956.39,3939.22,4111.68,5026.33,-1897.48,-75.56
132231690586607808,2020-03,4989.92,2002.59,4525.42,2817.73,4695.02,4619.46
132231690586607808,2020-04,4810.75,3139.14,5339.57,2359.5,4651.68,9271.14
132231690586607808,2020-05,3160.35,4562.25,7475.25,894.61,5178.74,14449.88
132231690586607808,2020-06,4981.44,5624.35,8226,4910.86,2672.23,17122.11
132231690586607808,2020-07,1581.36,9619.11,4268.96,5391.07,-9159.86,7962.25
132231690586607808,2020-08,3319.35,1800.2,4286.7,6477.87,-672.02,7290.23
132231690586607808,2020-09,3773.44,7017.09,9542.52,3082.49,3216.38,10506.61
132231690586607808,2020-10,3958.57,4975.48,7270.72,4926.13,1327.68,11834.29
132231690586607808,2020-11,3913.24,2450.91,618.48,1497.2,583.61,12417.9
132231690586607808,2020-12,7881.56,7704.28,3867.05,2648.99,1395.34,13813.24
132991518007720096,2020-01,516.76,0,1576.99,1226.93,866.82,866.82
132991518007720096,2020-02,1961.14,2845.28,1620.6,430.16,306.3,1173.12
132991518007720096,2020-03,1922.06,874.42,2198.12,2137.21,1108.55,2281.67
132991518007720096,2020-04,2125.02,991.23,1822.1,0,2955.89,5237.56
132991518007720096,2020-05,3697.5,639.84,0,0,3057.66,8295.22
132991518007720096,2020-06,1763.24,0,5254.15,2519.08,4498.31,12793.53
132991518007720096,2020-07,902.52,1103.2,1834.49,841.05,792.76,13586.29
132991518007720096,2020-08,412.56,0,1467.23,0,1879.79,15466.08
132991518007720096,2020-09,531.49,0,2668.65,0,3200.14,18666.22
132991518007720096,2020-10,1988.57,3406.56,2982.49,1606.94,-42.44,18623.78
132991518007720096,2020-11,1613.95,1982.98,1135.58,2594.4,-1827.85,16795.93
132991518007720096,2020-12,112.99,0,1663.63,0,1776.62,18572.55
133203379703062752,2020-01,6529.25,5507.25,4541.98,4136.99,1426.99,1426.99
133203379703062752,2020-02,5773.04,3974.89,5450.25,1758.43,5489.97,6916.96
133203379703062752,2020-03,3696.09,6474.36,3976.07,5949.22,-4751.42,2165.54
133203379703062752,2020-04,70.27,5462.87,672.18,4669.07,-9389.49,-7223.95
133203379703062752,2020-05,4940.18,3594.35,3374.32,4751.89,-31.74,-7255.69
133203379703062752,2020-06,1724.9,5829.15,5825.11,10199.36,-8478.5,-15734.19
133203379703062752,2020-07,7095.28,2193.74,4510.18,3404.05,6007.67,-9726.52
133203379703062752,2020-08,4812.27,5704.32,5408.52,2921.03,1595.44,-8131.08
133203379703062752,2020-09,4801.17,4637.15,7906.47,3894.24,4176.25,-3954.83
133203379703062752,2020-10,6285.01,6522.39,5931.75,11320.83,-5626.46,-9581.29
133203379703062752,2020-11,3719.68,2444.18,8395.93,1920.31,7751.12,-1830.17
133203379703062752,2020-12,3737.64,5592.13,6299.32,3724.93,719.9,-1110.27
133865680615216256,2020-01,1475.71,5509.33,6680.55,6088,-3441.07,-3441.07
133865680615216256,2020-02,8252.99,3930.66,4059.91,1668.77,6713.47,3272.4
133865680615216256,2020-03,2587.43,9532.38,4526.64,2576.9,-4995.21,-1722.81
133865680615216256,2020-04,3944.76,3387.23,3356.52,9592.31,-5678.26,-7401.07
133865680615216256,2020-05,7630.13,5206.59,3341.44,3625.82,2139.16,-5261.91
133865680615216256,2020-06,6566.3,5219.34,2726.64,577.71,3495.89,-1766.02
133865680615216256,2020-07,4369.46,3129.04,8974.1,4098.18,6116.34,4350.32
133865680615216256,2020-08,6632.59,13682.07,2235.9,6260.83,-11074.41,-6724.09
133865680615216256,2020-09,3488.49,1205.93,5908.82,2942.13,5249.25,-1474.84
133865680615216256,2020-10,562.18,5144.41,2672.4,8245.46,-10155.29,-11630.13
133865680615216256,2020-11,6790.9,6358.84,3306.01,2108.88,1629.19,-10000.94
133865680615216256,2020-12,3468.6,3125.47,6299.2,11031.7,-4389.37,-14390.31
134306922778102512,2020-01,4709.31,1241.49,527.83,2358.81,1636.84,1636.84
134306922778102512,2020-02,2786.7,0,846,999.67,2633.03,4269.87
134306922778102512,2020-03,3328.08,0,0,3516.85,-188.77,4081.1
134306922778102512,2020-04,1033.51,0,0,3451.39,-2417.88,1663.22
134306922778102512,2020-05,0,984.28,1752.51,1220.88,-452.65,1210.57
134306922778102512,2020-06,0,3819.23,1287.87,2788.11,-5319.47,-4108.9
134306922778102512,2020-07,2198.04,20.09,1919.03,3340.75,756.23,-3352.67
134306922778102512,2020-08,1059.72,0,591.25,1322.37,328.6,-3024.07
134306922778102512,2020-09,1448.78,2668.66,3207.98,3946.65,-1958.55,-4982.62
134306922778102512,2020-10,2778.94,1801.64,0,2216.9,-1239.6,-6222.22
134306922778102512,2020-11,1914.88,687.8,3523.29,1838.38,2911.99,-3310.23
134306922778102512,2020-12,2350.43,1918.5,949.5,0,1381.43,-1928.8
135994545284052512,2020-01,3814.89,965.62,2341.76,3750.81,1440.22,1440.22
135994545284052512,2020-02,4245.45,2740.38,886.1,371.25,2019.92,3460.14
135994545284052512,2020-03,4813.45,2980.5,624.53,3191.38,-733.9,2726.24
135994545284052512,2020-04,828.68,0,225.89,3314,-2259.43,466.81
135994545284052512,2020-05,8112.01,1473.36,2785.4,1291.11,8132.94,8599.75
135994545284052512,2020-06,2148.87,2548.93,1680.92,0,1280.86,9880.61
135994545284052512,2020-07,1732.36,1793.65,1185.28,3456.36,-2332.37,7548.24
135994545284052512,2020-08,3990.72,3124.55,2107.49,0,2973.66,10521.9
135994545284052512,2020-09,3171.79,3107.73,3014.42,0,3078.48,13600.38
135994545284052512,2020-10,3651.16,0,3855.94,1975.71,5531.39,19131.77
135994545284052512,2020-11,3491.01,3410.57,0,1118.2,-1037.76,18094.01
135994545284052512,2020-12,2026.22,2402.76,4484.63,2075.22,2032.87,20126.88
136189833806689712,2020-01,6030.76,4666.89,2506.45,2949.51,920.81,920.81
136189833806689712,2020-02,3168.49,2296.23,3600.51,1916.92,2555.85,3476.66
136189833806689712,2020-03,3190.16,3452.97,637.23,4214.07,-3839.65,-362.99
136189833806689712,2020-04,593.59,573.14,337.46,1495.72,-1137.81,-1500.8
136189833806689712,2020-05,496.86,2345.67,4732.83,2850.61,33.41,-1467.39
136189833806689712,2020-06,1829.09,1054.42,2174.84,0,2949.51,1482.12
136189833806689712,2020-07,2771.89,2908.12,3120.89,3284.87,-300.21,1181.91
136189833806689712,2020-08,767.56,1351.48,4120.35,0,3536.43,4718.34
136189833806689712,2020-09,3390.86,6420.13,3979.18,0,949.91,5668.25
136189833806689712,2020-10,3127.8,0,5929.82,6548.12,2509.5,8177.75
136189833806689712,2020-11,5306.9,4614.2,3937.13,2746.99,1882.84,10060.59
136189833806689712,2020-12,6592.71,2174.93,0,4734.05,-316.27,9744.32
136616631129961680,2020-02,0,4835.69,0,154.65,-4990.34,-4990.34
136616631129961680,2020-03,1028.63,2448.82,0,1363.08,-2783.27,-7773.61
136616631129961680,2020-04,977.64,0,0,1951.95,-974.31,-8747.92
136616631129961680,2020-05,1730.34,1044.29,212.81,0,898.86,-7849.06
136616631129961680,2020-06,1947.98,0,1618.57,0,3566.55,-4282.51
136616631129961680,2020-07,2007.2,943.64,0,3125.85,-2062.29,-6344.8
136616631129961680,2020-08,1660.39,1000.23,1394.84,267.86,1787.14,-4557.66
136616631129961680,2020-09,0,1117.08,1104.16,1644.52,-1657.44,-6215.1
136616631129961680,2020-10,974.24,1775.61,0,2234.38,-3035.75,-9250.85
136616631129961680,2020-11,1597.53,0,0,0,1597.53,-7653.32
136616631129961680,2020-12,2142.64,1720.13,0,0,422.51,-7230.81
136814598998399168,2020-01,3722.47,6029.9,300.98,0,-2006.45,-2006.45
136814598998399168,2020-02,1528.69,1723.77,120.68,780.48,-854.88,-2861.33
136814598998399168,2020-03,0,1530.27,1560.06,3752.08,-3722.29,-6583.62
136814598998399168,2020-04,285.32,5287.6,4281.16,1216.16,-1937.28,-8520.9
136814598998399168,2020-05,2833.18,2446.72,3319.47,1976.49,1729.44,-6791.46
136814598998399168,2020-06,2670.35,2659.64,0,21.75,-11.04,-6802.5
136814598998399168,2020-07,3460.18,0,1539.3,2738.81,2260.67,-4541.83
136814598998399168,2020-08,4301.1,127.25,2008.23,0,6182.08,1640.25
136814598998399168,2020-09,1264.91,1159.06,3985.43,0,4091.28,5731.53
136814598998399168,2020-10,2172.26,0,1653.57,1029.62,2796.21,8527.74
136814598998399168,2020-11,713.49,1361.4,963.91,242.44,73.56,8601.3
136814598998399168,2020-12,5098.59,542.29,219.46,1783.05,2992.71,11594.01
137829543234361008,2020-04,495.48,0,0,538.89,-43.41,-43.41
137829543234361008,2020-05,898.66,0,0,0,898.66,855.25
137829543234361008,2020-09,0,1753.7,753.51,0,-1000.19,-144.94
138449949579833776,2020-01,3885.08,5260.3,5769.56,5527.07,-1132.73,-1132.73
138449949579833776,2020-02,2624.4,2676.62,2422.52,4928.93,-2558.63,-3691.36
138449949579833776,2020-03,11906.46,6920.18,3576.01,5752.91,2809.38,-881.98
138449949579833776,2020-04,3661.72,2610.24,3982.21,69.59,4964.1,4082.12
138449949579833776,2020-05,1463.92,1132.22,3146.49,6485.63,-3007.44,1074.68
138449949579833776,2020-06,538.88,1977.15,1422.17,4172.79,-4188.89,-3114.21
138449949579833776,2020-07,4230.61,5481.83,5631.84,0,4380.62,1266.41
138449949579833776,2020-08,3469.85,3232.57,2944.47,5332.81,-2151.06,-884.65
138449949579833776,2020-09,6514,2679.8,4959.68,4766.58,4027.3,3142.65
138449949579833776,2020-10,9447.66,5603.02,2337.6,5092.07,1090.17,4232.82
138449949579833776,2020-11,3550.95,1838.4,2797.58,6058.2,-1548.07,2684.75
138449949579833776,2020-12,5890.26,3669.64,6483.64,620.83,8083.43,10768.18
138914554655046656,2020-01,1862.49,0,1708.18,2462.47,1108.2,1108.2
138914554655046656,2020-02,1758.05,4962.06,0,0,-3204.01,-2095.81
138914554655046656,2020-03,2018.5,3765.16,6865.33,3034.99,2083.68,-12.13
138914554655046656,2020-04,0,1248.38,4969.65,0,3721.27,3709.14
138914554655046656,2020-05,2115.78,713.41,2978.03,3318.11,1062.29,4771.43
138914554655046656,2020-06,2450.82,299.99,2830.5,2876.93,2104.4,6875.83
138914554655046656,2020-07,2646.82,3105.55,3502.5,2505.93,537.84,7413.67
138914554655046656,2020-08,4138.86,1447.64,1462.17,5673.36,-1519.97,5893.7
138914554655046656,2020-09,578.96,1330.27,1173.82,1542.31,-1119.8,4773.9
138914554655046656,2020-10,984.71,2706.83,3232.54,875.67,634.75,5408.65
138914554655046656,2020-11,1371.15,1087.95,1538.86,3831.94,-2009.88,3398.77
138914554655046656,2020-12,526.1,3356.78,4106,6312.97,-5037.65,-1638.88
139211761744912640,2020-01,1118.13,1539.8,0,843.6,-1265.27,-1265.27
139211761744912640,2020-02,1641.86,1485.22,2401.15,391.23,2166.56,901.29
139211761744912640,2020-03,2580.47,4384.8,526.19,0,-1278.14,-376.85
139211761744912640,2020-04,591.62,1450.53,2354.44,2062.7,-567.17,-944.02
139211761744912640,2020-05,1228.87,2475.1,1912.32,5130.22,-4464.13,-5408.15
139211761744912640,2020-06,2756.97,1079.72,1989.93,5978.43,-2311.25,-7719.4
139211761744912640,2020-07,5288.75,6903.57,3159.96,491.96,1053.18,-6666.22
139211761744912640,2020-08,3760.09,2494.76,2124.97,162.94,3227.36,-3438.86
139211761744912640,2020-09,1470.79,2376.64,3455.19,3253.64,-704.3,-4143.16
139211761744912640,2020-10,2758.68,2040.48,0,5330.23,-4612.03,-8755.19
139211761744912640,2020-11,5546.94,2104.7,1712.47,1587.16,3567.55,-5187.64
139211761744912640,2020-12,2088.86,7159.08,1788.06,1836.55,-5118.71,-10306.35
139659264818790800,2020-01,4532.25,1302.64,1475.18,3896.27,808.52,808.52
139659264818790800,2020-02,2427.13,1695.98,2591.84,0,3322.99,4131.51
139659264818790800,2020-03,3288.75,3168.68,1641.22,1987.6,-226.31,3905.2
139659264818790800,2020-04,2454.5,261.11,4753.63,554.36,6392.66,10297.86
139659264818790800,2020-05,1364.93,0,0,1788.44,-423.51,9874.35
139659264818790800,2020-06,0,1268.3,0,0,-1268.3,8606.05
139659264818790800,2020-07,4691.61,2324.04,3391.47,2975.17,2783.87,11389.92
139659264818790800,2020-08,5360.34,3109.87,1650.53,0,3901,15290.92
139659264818790800,2020-09,1254.91,1221.01,2311.13,1821.47,523.56,15814.48
139659264818790800,2020-10,0,3318.96,897.58,5429.54,-7850.92,7963.56
139659264818790800,2020-11,0,4684.23,0,1991.63,-6675.86,1287.7
139659264818790800,2020-12,2606.45,4553.29,39.67,0,-1907.17,-619.47
140816729931645584,2020-12,1411.67,0,0,0,1411.67,1411.67
141411854159038672,2020-01,1918.94,2749.22,2543.73,1651.08,62.37,62.37
141411854159038672,2020-02,3391.31,2684.45,4705.75,5543.59,-130.98,-68.61
141411854159038672,2020-03,949.51,0,860.8,5195.68,-3385.37,-3453.98
141411854159038672,2020-04,3454.16,1706.19,5794.89,2214.78,5328.08,1874.1
141411854159038672,2020-05,0,1437.02,1648.78,0,211.76,2085.86
141411854159038672,2020-06,1013.37,4475.4,392.77,3312.63,-6381.89,-4296.03
141411854159038672,2020-07,1959.17,2541.12,584.13,1414.11,-1411.93,-5707.96
141411854159038672,2020-08,1404.62,1760.76,1862.19,1847.74,-341.69,-6049.65
141411854159038672,2020-09,5479.23,1942.52,0,3868.12,-331.41,-6381.06
141411854159038672,2020-10,2004.86,2595.36,1640.11,654,395.61,-5985.45
141411854159038672,2020-11,4113.42,392.8,2137.01,213.75,5643.88,-341.57
141411854159038672,2020-12,1920.61,0,60.12,3401.43,-1420.7,-1762.27
141988657608792496,2020-01,683.17,1247.65,835.01,0,270.53,270.53
141988657608792496,2020-02,3551.29,195.08,0,3482.91,-126.7,143.83
141988657608792496,2020-03,1768.25,983.97,4439.07,3343.9,1879.45,2023.28
141988657608792496,2020-04,3442.73,0,3728.05,339.69,6831.09,8854.37
141988657608792496,2020-05,1730.15,3758.47,2166.31,1893.12,-1755.13,7099.24
141988657608792496,2020-06,938.89,1327.91,795.29,1068.1,-661.83,6437.41
141988657608792496,2020-07,8.1,1792.06,1570.06,124.66,-338.56,6098.85
141988657608792496,2020-08,1162.86,1142.36,2975.54,1783.26,1212.78,7311.63
141988657608792496,2020-09,1318.09,1131.81,1166.14,0,1352.42,8664.05
141988657608792496,2020-10,1274.44,904.67,634.5,4721.45,-3717.18,4946.87
141988657608792496,2020-11,782.17,2153,2293.94,4102.78,-3179.67,1767.2
141988657608792496,2020-12,1505.87,1336.73,142.11,1885.63,-1574.38,192.82
144629451756140608,2020-02,1864.02,4961.68,5731.62,4474.91,-1840.95,-1840.95
144629451756140608,2020-03,1534.78,1513.03,1578.5,0,1600.25,-240.7
144629451756140608,2020-04,1490.49,1697.15,3664.41,57.54,3400.21,3159.51
144629451756140608,2020-05,1879.47,3112.41,2450.87,1767.84,-549.91,2609.6
144629451756140608,2020-06,3709.02,1114.45,3607.36,5477.89,724.04,3333.64
144629451756140608,2020-07,3671.06,2881.29,3691.12,1471.62,3009.27,6342.91
144629451756140608,2020-08,1030.55,6504.51,1770.44,3483.43,-7186.95,-844.04
144629451756140608,2020-09,3954.96,3044.97,1160.67,3799.99,-1729.33,-2573.37
144629451756140608,2020-10,2846.92,852.51,4477.62,842.71,5629.32,3055.95
144629451756140608,2020-11,6016.68,2590.31,4027.01,2051.39,5401.99,8457.94
144629451756140608,2020-12,1300.29,3325.81,479.73,0,-1545.79,6912.15
146983024923494048,2020-01,2411.92,0,0,557.42,1854.5,1854.5
146983024923494048,2020-02,366.54,0,367.16,0,733.7,2588.2
146983024923494048,2020-03,1521.21,0,0,0,1521.21,4109.41
146983024923494048,2020-04,0,1556.88,0,0,-1556.88,2552.53
146983024923494048,2020-05,0,1228.4,2909.08,0,1680.68,4233.21
146983024923494048,2020-06,836.87,505.27,0,0,331.6,4564.81
146983024923494048,2020-07,1717.14,1273.28,1669.33,2775.08,-661.89,3902.92
146983024923494048,2020-08,0,1484.7,0,0,-1484.7,2418.22
146983024923494048,2020-09,0,382.52,0,0,-382.52,2035.7
146983024923494048,2020-10,0,197.44,0,0,-197.44,1838.26
146983024923494048,2020-11,1308.5,735.86,0,1318.59,-745.95,1092.31
146983024923494048,2020-12,0,1337.35,0,0,-1337.35,-245.04
147533201923466656,2020-01,441.2,822.16,1571.06,0,1190.1,1190.1
147533201923466656,2020-03,3215.68,1843.14,2980,575.9,3776.64,4966.74
147533201923466656,2020-04,346.99,0,0,0,346.99,5313.73
147533201923466656,2020-05,194.42,0,387.17,82.33,499.26,5812.99
147533201923466656,2020-06,1526.26,0,0,0,1526.26,7339.25
147533201923466656,2020-07,0,596.97,555.61,0,-41.36,7297.89
147533201923466656,2020-08,1599.4,855.23,1574.3,0,2318.47,9616.36
147533201923466656,2020-09,365.89,0,0,0,365.89,9982.25
147533201923466656,2020-11,2798.08,0,969.08,2089.58,1677.58,11659.83
147533201923466656,2020-12,2153.09,5745.18,957.21,0,-2634.88,9024.95
148212151499662208,2020-01,2401.59,0,3380.74,6575.63,-793.3,-793.3
148212151499662208,2020-02,3017.74,6217.57,4409.66,2653.37,-1443.54,-2236.84
148212151499662208,2020-03,1236.67,0,0,1816.26,-579.59,-2816.43
148212151499662208,2020-04,992.58,4355.37,3428.37,3950.94,-3885.36,-6701.79
148212151499662208,2020-05,5615.64,5221.35,572.08,106.21,860.16,-5841.63
148212151499662208,2020-06,3219.53,2743.13,2830.51,3681.44,-374.53,-6216.16
148212151499662208,2020-07,2384.63,0,1580.43,2483.84,1481.22,-4734.94
148212151499662208,2020-08,3055.75,517.49,2527.95,2456.19,2610.02,-2124.92
148212151499662208,2020-09,1946.75,3532.66,2820.55,206.46,1028.18,-1096.74
148212151499662208,2020-10,3350.91,6127.71,4572.94,2596.06,-799.92,-1896.66
148212151499662208,2020-11,5246.13,1468.22,4336.99,1733.76,6381.14,4484.48
148212151499662208,2020-12,5668.45,4074.35,8908.55,657.64,9845.01,14329.49
149110363386528096,2020-01,1965.27,3941.87,2952.15,1343.29,-367.74,-367.74
149110363386528096,2020-02,5784.06,4031.09,0,7908.75,-6155.78,-6523.52
149110363386528096,2020-03,4399.73,795.51,2342.5,4148.31,1798.41,-4725.11
149110363386528096,2020-04,4888.41,1447.81,3635.72,3885.22,3191.1,-1534.01
149110363386528096,2020-05,3282.14,6436.4,10314.54,2051.62,5108.66,3574.65
149110363386528096,2020-06,5115.67,0,5600.04,2308.59,8407.12,11981.77
149110363386528096,2020-07,3190.76,1029.62,1825.77,5658.52,-1671.61,10310.16
149110363386528096,2020-08,4193.23,3121.49,1956.02,1222.61,1805.15,12115.31
149110363386528096,2020-09,7533.06,2326.34,3666.64,2148.89,6724.47,18839.78
149110363386528096,2020-10,237.35,5895.91,1137.06,4027.83,-8549.33,10290.45
149110363386528096,2020-11,2380.72,6074.28,3350.75,3955.3,-4298.11,5992.34
149110363386528096,2020-12,1105.41,6929.29,4907.09,3295.61,-4212.4,1779.94
150374623233893696,2020-01,1918.82,4499.81,2738.85,2430.54,-2272.68,-2272.68
150374623233893696,2020-02,10791.49,1662.24,3218.51,2576.74,9771.02,7498.34
150374623233893696,2020-03,2989.48,2202.65,7670.25,5347.74,3109.34,10607.68
150374623233893696,2020-04,902.72,1585.05,6136.61,3859.63,1594.65,12202.33
150374623233893696,2020-05,9490.13,3905,5156.16,3615.34,7125.95,19328.28
150374623233893696,2020-06,2112.88,4806.23,3248.88,7654.78,-7099.25,12229.03
150374623233893696,2020-07,6324.36,3450.45,5170.24,2423.19,5620.96,17849.99
150374623233893696,2020-08,4687.96,3056.15,2670.92,6116.62,-1813.89,16036.1
150374623233893696,2020-09,5266.37,4409.25,3099.09,7455.18,-3498.97,12537.13
150374623233893696,2020-10,1474.3,6827.98,5921.84,787.13,-218.97,12318.16
150374623233893696,2020-11,4552.4,4684.01,4187.76,2719.08,1337.07,13655.23
150374623233893696,2020-12,3387.64,2705.35,3538.37,3924.98,295.68,13950.91
151261468430393088,2020-01,0,135.89,0,0,-135.89,-135.89
151261468430393088,2020-03,1772.36,905.77,0,0,866.59,730.7
151261468430393088,2020-04,0,1783.03,1252.24,1089.45,-1620.24,-889.54
151261468430393088,2020-05,0,1273.1,375.35,0,-897.75,-1787.29
151261468430393088,2020-06,616.49,134.63,1444.31,1558.37,367.8,-1419.49
151261468430393088,2020-07,1832.17,763.4,3406.17,726.84,3748.1,2328.61
151261468430393088,2020-08,143.64,0,0,412.23,-268.59,2060.02
151261468430393088,2020-09,1675.9,1707.02,0,320.67,-351.79,1708.23
151261468430393088,2020-10,0,1674.32,0,0,-1674.32,33.91
151261468430393088,2020-11,0,1591.24,95.76,146.13,-1641.61,-1607.7
151261468430393088,2020-12,1868.97,0,0,527.31,1341.66,-266.04
153995685631433664,2020-01,1053.01,2702.27,1696.76,2958.61,-2911.11,-2911.11
153995685631433664,2020-02,736.64,3818.02,4459.45,2349.37,-971.3,-3882.41
153995685631433664,2020-03,5463.32,4889.58,4851.57,1846.79,3578.52,-303.89
153995685631433664,2020-04,684.18,1800.61,1100.08,2757.13,-2773.48,-3077.37
153995685631433664,2020-05,3619.52,6496.65,4742.71,997.85,867.73,-2209.64
153995685631433664,2020-06,4517.71,1542.01,4522.28,0,7497.98,5288.34
153995685631433664,2020-07,1548.69,1979.21,4262.58,3957.35,-125.29,5163.05
153995685631433664,2020-08,3746.22,3363.29,3322.67,2049.28,1656.32,6819.37
153995685631433664,2020-09,4504.02,0,857.59,1031.94,4329.67,11149.04
153995685631433664,2020-10,3837.96,2532,0,3146.18,-1840.22,9308.82
153995685631433664,2020-11,1966.28,3205.45,1776.68,912.36,-374.85,8933.97
153995685631433664,2020-12,3493.87,3647.84,4618.51,1699.32,2765.22,11699.19
154482077363836576,2020-04,1966.94,471.51,0,0,1495.43,1495.43
154482077363836576,2020-07,1609.55,162.86,0,1142.28,304.41,1799.84
154482077363836576,2020-08,0,1068.95,0,1204.76,-2273.71,-473.87
154482077363836576,2020-09,3546.06,0,72.61,1429.83,2188.84,1714.97
154567951775666912,2020-01,4818.23,1001.07,3659.05,3873.38,3602.83,3602.83
154567951775666912,2020-02,3253.58,5696.43,3663.63,4907.24,-3686.46,-83.63
154567951775666912,2020-03,6097.89,3405.39,4421.16,6868.46,245.2,161.57
154567951775666912,2020-04,4071.64,4994.62,4312.25,3970.42,-581.15,-419.58
154567951775666912,2020-05,2526.49,6472.52,3690.91,5338.5,-5593.62,-6013.2
154567951775666912,2020-06,5747.66,6536.3,1083.91,7960.35,-7665.08,-13678.28
154567951775666912,2020-07,3069.93,4139.08,5132.23,4467.93,-404.85,-14083.13
154567951775666912,2020-08,2862.89,6365.12,4320.63,7706.22,-6887.82,-20970.95
154567951775666912,2020-09,4185.56,8868.57,2787.27,5269.12,-7164.86,-28135.81
154567951775666912,2020-10,7477.47,9181.32,2606.65,3548.26,-2645.46,-30781.27
154567951775666912,2020-11,7787.57,2599.55,3451.58,639.15,8000.45,-22780.82
154567951775666912,2020-12,4136.64,4933.93,4737.54,5127.13,-1186.88,-23967.7
156124614189629696,2020-02,0,1821.84,0,1023.92,-2845.76,-2845.76
156124614189629696,2020-03,57.56,0,0,0,57.56,-2788.2
156124614189629696,2020-04,0,1169.62,0,0,-1169.62,-3957.82
156124614189629696,2020-08,0,1906.24,0,887.11,-2793.35,-6751.17
156349090547455328,2020-01,1502.76,1048.29,4528.76,1406.79,3576.44,3576.44
156349090547455328,2020-02,1656,5265.37,4246.64,0,637.27,4213.71
156349090547455328,2020-03,2430.88,3189.97,2169.85,787.91,622.85,4836.56
156349090547455328,2020-04,4636.34,1460.23,0,2997.85,178.26,5014.82
156349090547455328,2020-05,2134.85,896.14,3169.23,2927.11,1480.83,6495.65
156349090547455328,2020-06,1779.96,2644.55,3108.55,3202.43,-958.47,5537.18
156349090547455328,2020-07,1520.47,1804.63,5143.3,1763.39,3095.75,8632.93
156349090547455328,2020-08,3167.42,447.82,874,5000.93,-1407.33,7225.6
156349090547455328,2020-09,0,5444.31,2654.62,4655.75,-7445.44,-219.84
156349090547455328,2020-10,0,1233.08,5593.15,4381.95,-21.88,-241.72
156349090547455328,2020-11,2368.81,1245.71,1628.72,2745.4,6.42,-235.3
156349090547455328,2020-12,5830.91,3055.78,4064.85,4175.52,2664.46,2429.16
158081596600537024,2020-02,2601.66,1133.59,0,95.34,1372.73,1372.73
158081596600537024,2020-03,814.15,0,580.51,0,1394.66,2767.39
158081596600537024,2020-05,1047.5,754.16,0,0,293.34,3060.73
158081596600537024,2020-07,0,1681.55,0,0,-1681.55,1379.18
158081596600537024,2020-08,1764.77,0,2612.36,1347.53,3029.6,4408.78
158081596600537024,2020-10,1640,0,0,2169.26,-529.26,3879.52
158081596600537024,2020-11,2289.07,0,0,0,2289.07,6168.59
159029138477976544,2020-01,704.66,3430.9,0,1092.73,-3818.97,-3818.97
159029138477976544,2020-02,3929.02,0,606.1,2901.77,1633.35,-2185.62
159029138477976544,2020-03,744.36,1367.51,2004.1,0,1380.95,-804.67
159029138477976544,2020-05,201.57,0,0,0,201.57,-603.1
159029138477976544,2020-06,1922.42,1682.49,0,174.13,65.8,-537.3
159029138477976544,2020-07,483.61,0,1963.16,0,2446.77,1909.47
159029138477976544,2020-08,967.67,1879.21,0,2544.23,-3455.77,-1546.3
159029138477976544,2020-10,398.98,0,0,787.44,-388.46,-1934.76
159029138477976544,2020-11,0,361.81,376.17,3275.86,-3261.5,-5196.26
159029138477976544,2020-12,1023.26,0,104.02,5707.39,-4580.11,-9776.37
159535050014766624,2020-01,8075.91,1249.45,5483.56,1606.83,10703.19,10703.19
159535050014766624,2020-02,7753.69,1740.89,2272.13,593.88,7691.05,18394.24
159535050014766624,2020-03,1953.74,2177.05,1649.74,5706.07,-4279.64,14114.6
159535050014766624,2020-04,2328.34,3182.74,2205.64,120.69,1230.55,15345.15
159535050014766624,2020-05,5295.61,2883.87,3757.48,2086.17,4083.05,19428.2
159535050014766624,2020-06,8008.19,6471.69,5132.51,5347.63,1321.38,20749.58
159535050014766624,2020-07,685.12,3649.23,2277.06,3986.09,-4673.14,16076.44
159535050014766624,2020-08,2727.21,5730.15,3361.22,4060.18,-3701.9,12374.54
159535050014766624,2020-09,574.73,114.5,7240.06,0,7700.29,20074.83
159535050014766624,2020-10,1488.9,7166.25,2830.16,3350.65,-6197.84,13876.99
159535050014766624,2020-11,0,1996.23,5829.12,1174.99,2657.9,16534.89
159535050014766624,2020-12,3628.59,4628.62,3891.22,3939.74,-1048.55,15486.34
160330498834619040,2020-01,9317.38,7460.92,785.54,4187.24,-1545.24,-1545.24
160330498834619040,2020-02,5026.53,5487.1,3512.79,5542.59,-2490.37,-4035.61
160330498834619040,2020-03,7686.23,5209.1,8522.73,7325.22,3674.64,-360.97
160330498834619040,2020-04,8572.26,1907.04,2161.89,9518.34,-691.23,-1052.2
160330498834619040,2020-05,102.95,7096.35,4811.5,7598.99,-9780.89,-10833.09
160330498834619040,2020-06,3212.78,6529.06,4771.03,2130.77,-676.02,-11509.11
160330498834619040,2020-07,4288.2,2290.84,3943.48,2296.52,3644.32,-7864.79
160330498834619040,2020-08,4856.59,5767.58,779.22,5065.03,-5196.8,-13061.59
160330498834619040,2020-09,2895.83,5254.5,4033.88,4950.87,-3275.66,-16337.25
160330498834619040,2020-10,1460.03,6702.22,3523.65,10643.84,-12362.38,-28699.63
160330498834619040,2020-11,6089.25,9613.49,7025.3,8713.18,-5212.12,-33911.75
160330498834619040,2020-12,4311.52,3972.5,2695.12,3184.25,-150.11,-34061.86
160821748564778688,2020-01,6521.95,4500.48,3069.01,4798.74,291.74,291.74
160821748564778688,2020-02,2604.87,1056.23,1591.8,4844.82,-1704.38,-1412.64
160821748564778688,2020-03,6093.21,6862.9,4436.61,7003.14,-3336.22,-4748.86
160821748564778688,2020-04,4668.01,2515.85,0,4081.43,-1929.27,-6678.13
160821748564778688,2020-05,5077.93,2179.31,1499.29,1032.59,3365.32,-3312.81
160821748564778688,2020-06,3141.12,4791.13,5407.72,3552.77,204.94,-3107.87
160821748564778688,2020-07,3421,3636.99,5848.6,3447.5,2185.11,-922.76
160821748564778688,2020-08,1528.52,0,4645.17,3521.77,2651.92,1729.16
160821748564778688,2020-09,1910.8,1515.14,6771.44,3296.82,3870.28,5599.44
160821748564778688,2020-10,2096.33,5574.94,1704.09,5926.22,-7700.74,-2101.3
160821748564778688,2020-11,0,4394.06,1431.87,1065.5,-4027.69,-6128.99
160821748564778688,2020-12,1095.93,2396.33,522.4,2019.84,-2797.84,-8926.83
160845833937341504,2020-01,8487.17,4279.76,4473.47,2228.85,6452.03,6452.03
160845833937341504,2020-02,8240.83,0,2568.78,3072.15,7737.46,14189.49
160845833937341504,2020-03,4680.9,7823.33,2491.43,6801.83,-7452.83,6736.66
160845833937341504,2020-04,1516.01,1629.85,3022.06,3996.15,-1087.93,5648.73
160845833937341504,2020-05,4913.2,3581.71,4628.74,2287.19,3673.04,9321.77
160845833937341504,2020-06,5198.33,5272.69,8673.01,8122.08,476.57,9798.34
160845833937341504,2020-07,1217.11,2480.39,8223.26,5417.47,1542.51,11340.85
160845833937341504,2020-08,3087.42,6048.61,4470.58,6505.55,-4996.16,6344.69
160845833937341504,2020-09,4386.44,1810.72,6778.12,5897.83,3456.01,9800.7
160845833937341504,2020-10,3634.23,4383.71,4836.6,5897.14,-1810.02,7990.68
160845833937341504,2020-11,4853.49,2368.61,1776.02,6410.37,-2149.47,5841.21
160845833937341504,2020-12,7948.29,6824.23,1920.79,3710.04,-665.19,5176.02
160899060515324256,2020-01,2495.86,1851.12,3205.61,2967.94,882.41,882.41
160899060515324256,2020-02,3494.26,568.59,5484.99,2775.26,5635.4,6517.81
160899060515324256,2020-03,218.46,1096.94,2383.9,2176.25,-670.83,5846.98
160899060515324256,2020-04,2536.3,314.17,2202.18,0,4424.31,10271.29
160899060515324256,2020-05,4012.99,0,1084.78,2699.47,2398.3,12669.59
160899060515324256,2020-06,539.26,3130.4,2768.87,5938.13,-5760.4,6909.19
160899060515324256,2020-07,0,2642.8,719.97,3531.95,-5454.78,1454.41
160899060515324256,2020-08,8839.65,607.45,1284.23,2960.25,6556.18,8010.59
160899060515324256,2020-09,6244.8,1281.38,135.42,1595.52,3503.32,11513.91
160899060515324256,2020-10,645.52,1972.95,2973.92,3251.16,-1604.67,9909.24
160899060515324256,2020-11,2164.08,0,3909.9,1458.89,4615.09,14524.33
160899060515324256,2020-12,5194.83,3237.08,1116.26,0,3074.01,17598.34
160932438394884064,2020-01,5375.87,882.27,1371.18,1383.17,4481.61,4481.61
160932438394884064,2020-02,248.08,2425.06,2756.74,1428.64,-848.88,3632.73
160932438394884064,2020-03,4183.13,427.07,1404.81,56.51,5104.36,8737.09
160932438394884064,2020-04,0,401.04,1746.4,1135.44,209.92,8947.01
160932438394884064,2020-05,1586.25,1349.99,3758.3,1783.82,2210.74,11157.75
160932438394884064,2020-06,6008.52,1633.56,1801.18,3319.69,2856.45,14014.2
160932438394884064,2020-07,3205.42,3988.04,4966.62,5566.32,-1382.32,12631.88
160932438394884064,2020-08,3506.47,579.14,3846.59,4528.42,2245.5,14877.38
160932438394884064,2020-09,1793.26,967.23,3716.1,1690.64,2851.49,17728.87
160932438394884064,2020-10,1943.29,4432.98,2172.26,1259.97,-1577.4,16151.47
160932438394884064,2020-11,2883.65,1706.18,4003.89,0,5181.36,21332.83
160932438394884064,2020-12,4208.85,2051.16,186.42,682.99,1661.12,22993.95
162622600770855616,2020-01,7507.65,96.27,7072.46,2034.96,12448.88,12448.88
162622600770855616,2020-02,2725.35,1259.7,1393.41,3039.22,-180.16,12268.72
162622600770855616,2020-03,3275.05,4320.08,1311.14,1685.97,-1419.86,10848.86
162622600770855616,2020-04,2585.36,5391.41,1912.29,4067.87,-4961.63,5887.23
162622600770855616,2020-05,4955.55,3612.97,229.19,2686.96,-1115.19,4772.04
162622600770855616,2020-06,1222.15,6475.7,3256.47,7617.33,-9614.41,-4842.37
162622600770855616,2020-07,1702.28,1753.71,2401.47,3712.82,-1362.78,-6205.15
162622600770855616,2020-08,8474.45,4798.08,0,1799.96,1876.41,-4328.74
162622600770855616,2020-09,1928.13,6378.06,5814.68,307.51,1057.24,-3271.5
162622600770855616,2020-10,4147.79,2249.25,1205.52,1986.58,1117.48,-2154.02
162622600770855616,2020-11,3330,98.3,3779.8,1559.51,5451.99,3297.97
162622600770855616,2020-12,6596.82,2273.71,5474.25,2357.38,7439.98,10737.95
162933258938612864,2020-03,918.05,488.67,0,0,429.38,429.38
162933258938612864,2020-04,191.97,0,656.13,1378.43,-530.33,-100.95
162933258938612864,2020-05,164.93,2269.48,0,1932.99,-4037.54,-4138.49
162933258938612864,2020-09,1131.34,1413.54,1633.85,0,1351.65,-2786.84
162933258938612864,2020-10,0,1231.56,234.76,1766.51,-2763.31,-5550.15
162933258938612864,2020-12,0,139.02,2176.32,0,2037.3,-3512.85
163277502836618848,2020-01,2125.48,2286.14,1743.33,651.76,930.91,930.91
163277502836618848,2020-02,3547.52,2238.17,3758.21,2503.2,2564.36,3495.27
163277502836618848,2020-03,0,2428.38,1790.82,4232.93,-4870.49,-1375.22
163277502836618848,2020-04,3440.44,343.74,1285.31,377.67,4004.34,2629.12
163277502836618848,2020-05,1928.59,2225.01,8229.77,1571.03,6362.32,8991.44
163277502836618848,2020-06,3478.4,638.03,6324.38,0,9164.75,18156.19
163277502836618848,2020-07,2584.04,3107.96,3055.43,0,2531.51,20687.7
163277502836618848,2020-08,801.94,2512.68,594.85,2409.25,-3525.14,17162.56
163277502836618848,2020-09,0,2076.6,1396.97,1725.04,-2404.67,14757.89
163277502836618848,2020-10,2174.89,7880.98,2056.89,0,-3649.2,11108.69
163277502836618848,2020-11,5033.18,1065.8,3128.31,267.75,6827.94,17936.63
163277502836618848,2020-12,3612.95,1461.18,146.3,3723.37,-1425.3,16511.33
163290819979202624,2020-01,1224.13,400.71,2081.95,3565.37,-660,-660
163290819979202624,2020-02,2512.94,668.74,2294.03,7337.17,-3198.94,-3858.94
163290819979202624,2020-03,4152.53,3283.79,6700.19,2342,5226.93,1367.99
163290819979202624,2020-04,2897.24,0,4726.11,4252.75,3370.6,4738.59
163290819979202624,2020-06,3290.37,2872.83,19.38,3251.06,-2814.14,1924.45
163290819979202624,2020-07,543.35,4042.18,2967.52,4558.09,-5089.4,-3164.95
163290819979202624,2020-08,3428.69,3641.02,4971.21,3616.25,1142.63,-2022.32
163290819979202624,2020-09,3303.74,1107.42,2336.15,2554.65,1977.82,-44.5
163290819979202624,2020-10,3301.14,5468.87,5392.04,4771.39,-1547.08,-1591.58
163290819979202624,2020-11,4057.66,5163.35,4267.03,36.63,3124.71,1533.13
163290819979202624,2020-12,759.91,4580.68,2384.42,2834.23,-4270.58,-2737.45
163895212718469664,2020-01,786.08,1162.99,0,1458.31,-1835.22,-1835.22
163895212718469664,2020-02,2011.85,0,0,1776.17,235.68,-1599.54
163895212718469664,2020-03,2740.65,1658.88,1357.56,1477.1,962.23,-637.31
163895212718469664,2020-04,794,432.18,0,2141.34,-1779.52,-2416.83
163895212718469664,2020-05,509.31,1198.98,3829.14,1803.62,1335.85,-1080.98
163895212718469664,2020-06,3826.67,0,88.75,1257.39,2658.03,1577.05
163895212718469664,2020-07,2119.95,0,379.83,0,2499.78,4076.83
163895212718469664,2020-08,1847.91,3299.61,276.37,0,-1175.33,2901.5
163895212718469664,2020-09,0,2220.1,1057.85,547.99,-1710.24,1191.26
163895212718469664,2020-10,0,1286.44,2768.72,5149.41,-3667.13,-2475.87
163895212718469664,2020-11,3514.83,1592.51,0,1822.81,99.51,-2376.36
163895212718469664,2020-12,1692.74,825.68,5161.37,2232.13,3796.3,1419.94
164155288488882784,2020-06,0,707.71,0,0,-707.71,-707.71
164155288488882784,2020-07,2542.87,1254.15,2813.49,0,4102.21,3394.5
164155288488882784,2020-10,0,924.31,0,0,-924.31,2470.19
164947079543327712,2020-01,4217.8,152.63,3232.03,4695.4,2601.8,2601.8
164947079543327712,2020-02,663.85,1377.46,1369.98,846.82,-190.45,2411.35
164947079543327712,2020-03,1036.46,6146.93,2483.85,3697.04,-6323.66,-3912.31
164947079543327712,2020-04,221.29,1068.03,4803.6,2884.53,1072.33,-2839.98
164947079543327712,2020-05,0,2264.23,4924.59,872.74,1787.62,-1052.36
164947079543327712,2020-06,1537.42,2707.86,1729.31,627.39,-68.52,-1120.88
164947079543327712,2020-07,2985.96,3836.84,1558.74,1254.51,-546.65,-1667.53
164947079543327712,2020-08,1218.04,3486.46,2171.55,3206.13,-3303,-4970.53
164947079543327712,2020-09,1980.41,2262.82,1475.45,1607.92,-414.88,-5385.41
164947079543327712,2020-10,1926.24,3048.46,165.03,4876.13,-5833.32,-11218.73
164947079543327712,2020-11,523.52,3248.64,2177.37,1920.95,-2468.7,-13687.43
164947079543327712,2020-12,1305.51,0,2597.25,2768.97,1133.79,-12553.64
165757848890810528,2020-01,1289.11,0,993.88,629.62,1653.37,1653.37
165757848890810528,2020-02,4318.18,1430.34,1298.11,0,4185.95,5839.32
165757848890810528,2020-03,3015.95,0,0,2389.4,626.55,6465.87
165757848890810528,2020-04,2171.12,2208.72,0,67.14,-104.74,6361.13
165757848890810528,2020-05,1135.88,3721.41,449.47,2478.25,-4614.31,1746.82
165757848890810528,2020-06,0,2392.15,4159.86,2019.07,-251.36,1495.46
165757848890810528,2020-07,4011.85,0,3294.36,3935.65,3370.56,4866.02
165757848890810528,2020-08,0,1788.37,166.6,1770.92,-3392.69,1473.33
165757848890810528,2020-09,4390.55,2002.8,0,1709.71,678.04,2151.37
165757848890810528,2020-10,2303.25,3071.4,4369.05,0,3600.9,5752.27
165757848890810528,2020-11,3132.04,3088.26,3089.35,29.21,3103.92,8856.19
165757848890810528,2020-12,5030.56,0,1710.06,1188.88,5551.74,14407.93
167391078470261280,2020-01,2723.58,5995.54,5169.21,1993.94,-96.69,-96.69
167391078470261280,2020-02,2469.14,1812.69,3708.33,3595.91,768.87,672.18
167391078470261280,2020-03,4108.54,335.91,4244.54,4263.56,3753.61,4425.79
167391078470261280,2020-04,3932.48,3513.54,2408.65,2837.91,-10.32,4415.47
167391078470261280,2020-05,4116.04,4564.74,5908.15,444.63,5014.82,9430.29
167391078470261280,2020-06,5817.06,6212.15,5094.37,1100.11,3599.17,13029.46
167391078470261280,2020-07,3233.37,2958.21,2305.46,3787.83,-1207.21,11822.25
167391078470261280,2020-08,1904.66,2791.41,2115.35,3815.67,-2587.07,9235.18
167391078470261280,2020-09,2351.24,4495.94,8081.72,2068.02,3869,13104.18
167391078470261280,2020-10,5896.16,5167.96,7186.46,4950.53,2964.13,16068.31
167391078470261280,2020-11,2327.85,3183.59,737.98,3787.95,-3905.71,12162.6
167391078470261280,2020-12,9758.96,2538.96,663.23,706.07,7177.16,19339.76
167464303134948480,2020-01,1194.21,0,0,0,1194.21,1194.21
167464303134948480,2020-02,4252.38,116.66,641.04,0,4776.76,5970.97
167464303134948480,2020-04,0,2511.85,0,0,-2511.85,3459.12
167464303134948480,2020-05,4227.26,579.29,350.48,0,3998.45,7457.57
167464303134948480,2020-06,1976.4,0,0,0,1976.4,9433.97
167464303134948480,2020-07,2965.04,0,1241.67,554.56,3652.15,13086.12
167464303134948480,2020-11,19.45,0,1413.06,21.27,1411.24,14497.36
167464303134948480,2020-12,0,1056.32,0,0,-1056.32,13441.04
169901856947080384,2020-01,1588.05,863.09,1538.42,517.43,1745.95,1745.95
169901856947080384,2020-03,3092.98,1453.77,1333.92,183.28,2789.85,4535.8
169901856947080384,2020-04,3201.74,1401.74,318.03,0,2118.03,6653.83
169901856947080384,2020-05,1816.89,0,2945.96,0,4762.85,11416.68
169901856947080384,2020-06,379.65,1331.42,71.15,1767.18,-2647.8,8768.88
169901856947080384,2020-07,0,677.65,0,688.91,-1366.56,7402.32
169901856947080384,2020-10,1433.51,0,0,4290.09,-2856.58,4545.74
169901856947080384,2020-11,2134.44,4248.94,0,2675.09,-4789.59,-243.85
169901856947080384,2020-12,3938.6,0,1563.52,1.92,5500.2,5256.35
172778847932175200,2020-01,3056.05,4406.2,3364.3,2166.38,-152.23,-152.23
172778847932175200,2020-02,1951.89,1356.52,1512.33,3949.08,-1841.38,-1993.61
172778847932175200,2020-03,898.21,5226.11,1086.07,267.24,-3509.07,-5502.68
172778847932175200,2020-04,1999.79,7424.49,3157,2549.18,-4816.88,-10319.56
172778847932175200,2020-05,2410.4,1313.38,1086.5,7477.37,-5293.85,-15613.41
172778847932175200,2020-06,3305.13,2400.08,1069.17,4333.4,-2359.18,-17972.59
172778847932175200,2020-07,516.67,7877.32,3179.13,2934.77,-7116.29,-25088.88
172778847932175200,2020-08,1263.45,1910.8,756.07,641.82,-533.1,-25621.98
172778847932175200,2020-09,1594.61,785.92,7214.18,4005.83,4017.04,-21604.94
172778847932175200,2020-10,1715.89,1563.14,1627.77,1683.37,97.15,-21507.79
172778847932175200,2020-11,143.56,1199.01,0,4509.67,-5565.12,-27072.91
172778847932175200,2020-12,2576.34,2075.11,1289.8,1557.42,233.61,-26839.3
173680719307034080,2020-01,215.43,5952.24,439.22,3795.45,-9093.04,-9093.04
173680719307034080,2020-02,4176.96,1063.38,1383.11,3759.58,737.11,-8355.93
173680719307034080,2020-03,3451.72,4100.29,3313.88,6845.97,-4180.66,-12536.59
173680719307034080,2020-04,0,2998.68,4416.08,2221.36,-803.96,-13340.55
173680719307034080,2020-05,1034.95,3167.25,278.56,4788.35,-6642.09,-19982.64
173680719307034080,2020-06,0,1671.77,1764,3666.69,-3574.46,-23557.1
173680719307034080,2020-07,4433.38,6971.94,3751.97,0,1213.41,-22343.69
173680719307034080,2020-08,6397.54,1284.02,4355.57,1583.51,7885.58,-14458.11
173680719307034080,2020-09,0,4739.47,2273.34,2920.34,-5386.47,-19844.58
173680719307034080,2020-10,4009.88,3593.96,607.17,1662.14,-639.05,-20483.63
173680719307034080,2020-11,1142.24,3513.21,4281.31,2164.7,-254.36,-20737.99
173680719307034080,2020-12,1608.18,1511.33,2564.67,1312.47,1349.05,-19388.94
174369027768353728,2020-01,3903.48,7107.67,4084.07,2451.85,-1571.97,-1571.97
174369027768353728,2020-02,1499.83,1926.1,4801.9,3737.93,637.7,-934.27
174369027768353728,2020-03,4025.85,459.63,2918.87,8020.9,-1535.81,-2470.08
174369027768353728,2020-04,5126.15,2700.7,2831.16,159.1,5097.51,2627.43
174369027768353728,2020-05,5585.44,3861.45,1702.36,1922.04,1504.31,4131.74
174369027768353728,2020-06,6229.58,9939.18,4026.09,3997.02,-3680.53,451.21
174369027768353728,2020-07,6058.29,4941.89,4226.63,3657.27,1685.76,2136.97
174369027768353728,2020-08,3239.38,3841.37,1142,8572.13,-8032.12,-5895.15
174369027768353728,2020-09,4499.78,1993.35,9316.46,6753.74,5069.15,-826
174369027768353728,2020-10,2388.65,1664.14,3957.85,9621.72,-4939.36,-5765.36
174369027768353728,2020-11,3851.52,673.9,6793.03,8618.16,1352.49,-4412.87
174369027768353728,2020-12,7175.35,2952.22,2269.77,6691.19,-198.29,-4611.16
174823207400998208,2020-01,4227.36,1698.8,2817.08,2690.38,2655.26,2655.26
174823207400998208,2020-02,3207.27,144.51,1956.09,3098.55,1920.3,4575.56
174823207400998208,2020-03,5493.56,2811.37,10409.09,4780.3,8310.98,12886.54
174823207400998208,2020-04,2551.26,3488.52,2900.29,1681.23,281.8,13168.34
174823207400998208,2020-05,1358.45,1002.14,1882.78,1617.69,621.4,13789.74
174823207400998208,2020-06,4648.03,1653.6,6677.79,4642.25,5029.97,18819.71
174823207400998208,2020-07,3051.74,4022.27,2313.47,1727.69,-384.75,18434.96
174823207400998208,2020-08,1857.51,3659.44,2970.26,2093.07,-924.74,17510.22
174823207400998208,2020-09,2774.75,3354.5,3975.77,128.13,3267.89,20778.11
174823207400998208,2020-10,989.28,2788.37,3667.65,0,1868.56,22646.67
174823207400998208,2020-11,1007.3,0,0,0,1007.3,23653.97
174823207400998208,2020-12,1913.44,0,5049.06,4181.36,2781.14,26435.11
175193282892667648,2020-01,0,1704.52,0,1694.56,-3399.08,-3399.08
175193282892667648,2020-02,1353.36,0,135.99,1421.62,67.73,-3331.35
175193282892667648,2020-04,2006.94,1789.56,1367.49,2329.66,-744.79,-4076.14
175193282892667648,2020-05,0,1372.88,0,1983.02,-3355.9,-7432.04
175193282892667648,2020-06,1968.95,1341.37,1322.81,0,1950.39,-5481.65
175193282892667648,2020-07,0,1648.4,125.03,2655.83,-4179.2,-9660.85
175193282892667648,2020-08,2105.95,0,1551.02,0,3656.97,-6003.88
175193282892667648,2020-09,0,1030.64,0,0,-1030.64,-7034.52
175193282892667648,2020-11,2147.58,385.89,257.95,0,2019.64,-5014.88
175193282892667648,2020-12,388.65,0,0,0,388.65,-4626.23
176399836325055008,2020-01,199.2,3034.09,662.58,3749.54,-5921.85,-5921.85
176399836325055008,2020-02,0,910.92,2033.45,2708.94,-1586.41,-7508.26
176399836325055008,2020-03,1498.27,2334.27,1921.9,1060.06,25.84,-7482.42
176399836325055008,2020-04,2062.11,631.83,0,2941.06,-1510.78,-8993.2
176399836325055008,2020-05,846.31,1573.41,2218.16,2074.52,-583.46,-9576.66
176399836325055008,2020-06,0,290.76,2851.63,6785.21,-4224.34,-13801
176399836325055008,2020-07,2574.96,891.87,962.59,2526.35,119.33,-13681.67
176399836325055008,2020-08,816.79,2443.34,0,1574.22,-3200.77,-16882.44
176399836325055008,2020-09,1141.05,2318.55,0,2596.03,-3773.53,-20655.97
176399836325055008,2020-10,775.46,0,1909.62,865.22,1819.86,-18836.11
176399836325055008,2020-11,2177.56,4938.55,971.26,1314.38,-3104.11,-21940.22
176399836325055008,2020-12,1053.51,3867.5,728.89,1518.23,-3603.33,-25543.55
177287887246077696,2020-01,2666.64,1419.62,0,233.98,1013.04,1013.04
177287887246077696,2020-02,0,430.4,4779.05,1579.81,2768.84,3781.88
177287887246077696,2020-03,2617.45,5794.98,4522.21,3538.32,-2193.64,1588.24
177287887246077696,2020-04,1802.97,873.69,484.63,4433.4,-3019.49,-1431.25
177287887246077696,2020-05,1958.39,1907.8,1682.53,775.84,957.28,-473.97
177287887246077696,2020-06,4393.62,0,2012.8,1288.46,5117.96,4643.99
177287887246077696,2020-07,1554.75,3334.78,377.05,2809.93,-4212.91,431.08
177287887246077696,2020-09,2109.33,2666.9,1128.02,4209.19,-3638.74,-3207.66
177287887246077696,2020-11,2735.82,1120.43,0,2822.39,-1207,-4414.66
177287887246077696,2020-12,2472.71,1044.27,1650.5,721.62,2357.32,-2057.34
178066533003927904,2020-01,5121.44,4723.04,1030.46,3149.4,-1720.54,-1720.54
178066533003927904,2020-02,6029.11,2133.32,4416.63,6044.39,2268.03,547.49
178066533003927904,2020-03,2591.5,8042.51,6372.33,4870.28,-3948.96,-3401.47
178066533003927904,2020-04,5182.49,6644.83,8933.02,947.59,6523.09,3121.62
178066533003927904,2020-05,2352.82,2495.22,3415.75,7047.56,-3774.21,-652.59
178066533003927904,2020-06,3615.67,3554.97,2400.51,6102.05,-3640.84,-4293.43
178066533003927904,2020-07,5716.23,5706.46,0,4035.77,-4026,-8319.43
178066533003927904,2020-08,585.91,9948.72,1842.21,3439.04,-10959.64,-19279.07
178066533003927904,2020-09,1761.7,4410.5,3741.97,4837.48,-3744.31,-23023.38
178066533003927904,2020-10,5756,2433.11,20.86,491.4,2852.35,-20171.03
178066533003927904,2020-11,5169.66,2547.36,1107.64,6544.87,-2814.93,-22985.96
178066533003927904,2020-12,8211.59,3776.42,5135.67,6866.84,2704,-20281.96
178099128706221440,2020-01,2980.27,2101.22,4123.44,4763.87,238.62,238.62
178099128706221440,2020-02,3800.13,1928.64,613.01,2901.35,-416.85,-178.23
178099128706221440,2020-03,0,3653.29,1910.81,1874.02,-3616.5,-3794.73
178099128706221440,2020-04,1170.67,3465.87,1017.11,4750.43,-6028.52,-9823.25
178099128706221440,2020-05,4470.89,1831.81,5356.98,0,7996.06,-1827.19
178099128706221440,2020-06,3448.05,0,3712.23,3897.81,3262.47,1435.28
178099128706221440,2020-07,2123.05,3136.14,5686.24,3780.26,892.89,2328.17
178099128706221440,2020-08,2478.81,998.83,2872.75,5937.11,-1584.38,743.79
178099128706221440,2020-09,5340.73,4426.27,1346.81,5753.15,-3491.88,-2748.09
178099128706221440,2020-10,3298.28,3025.06,3390.32,2034.03,1629.51,-1118.58
178099128706221440,2020-11,5258.17,929.2,6911.08,2559.32,8680.73,7562.15
178099128706221440,2020-12,964.54,3037.73,3132.99,863.69,196.11,7758.26
178254733220854432,2020-01,4592.26,4914.33,3153.41,5307.53,-2476.19,-2476.19
178254733220854432,2020-02,0,3716.12,3570.3,6286.67,-6432.49,-8908.68
178254733220854432,2020-03,7060.72,3056.18,7898.97,4299.07,7604.44,-1304.24
178254733220854432,2020-04,4231.47,5249.64,5564.71,5431.69,-885.15,-2189.39
178254733220854432,2020-05,4880.17,1713.59,6231.12,3415.42,5982.28,3792.89
178254733220854432,2020-06,3486.75,7167.5,3228.1,1279.35,-1732,2060.89
178254733220854432,2020-07,5578.43,4805.32,4373.93,5779.07,-632.03,1428.86
178254733220854432,2020-08,2534.23,3833.95,7736.09,8192.35,-1755.98,-327.12
178254733220854432,2020-09,6890.38,8301.45,5919.66,2919.96,1588.63,1261.51
178254733220854432,2020-10,1896.16,3393.75,7503.72,4551.73,1454.4,2715.91
178254733220854432,2020-11,2797.77,1973.59,6966.74,5341.73,2449.19,5165.1
178254733220854432,2020-12,3859.8,2006.54,1984.96,3609.71,228.51,5393.61
180172769926227552,2020-01,1157.44,2650.62,1151.92,358.57,-699.83,-699.83
180172769926227552,2020-03,2557.08,0,0,0,2557.08,1857.25
180172769926227552,2020-04,1745.2,1976.61,2134.36,2043.72,-140.77,1716.48
180172769926227552,2020-05,1232.38,1195.83,0,1249.44,-1212.89,503.59
180172769926227552,2020-06,2707.89,2073.8,3148.05,7.08,3775.06,4278.65
180172769926227552,2020-07,370.28,80.95,1889.62,1921.75,257.2,4535.85
180172769926227552,2020-08,1352.68,4171.16,3231.21,1296.56,-883.83,3652.02
180172769926227552,2020-09,1146.15,1805.46,514.31,0,-145,3507.02
180172769926227552,2020-10,0,3971.41,296.93,986.96,-4661.44,-1154.42
181251140315878272,2020-01,1171.91,4208.47,0,6255.97,-9292.53,-9292.53
181251140315878272,2020-02,1804.92,1728.3,513.41,955.58,-365.55,-9658.08
181251140315878272,2020-03,5325.24,2599.66,3416,1590.09,4551.49,-5106.59
181251140315878272,2020-04,1355.03,3465.83,1779.7,0,-331.1,-5437.69
181251140315878272,2020-05,1378.47,3338.7,950.66,0,-1009.57,-6447.26
181251140315878272,2020-06,703.22,4218.35,2377.21,2794.57,-3932.49,-10379.75
181251140315878272,2020-07,4825.35,2626.22,3089.77,6338.11,-1049.21,-11428.96
181251140315878272,2020-08,1826.58,4030.69,1371.04,1052.46,-1885.53,-13314.49
181251140315878272,2020-09,4039.85,2920.27,4182.07,0,5301.65,-8012.84
181251140315878272,2020-10,1779.01,443.01,3503.54,955.5,3884.04,-4128.8
181251140315878272,2020-11,2967.36,2381.74,2483.91,141.29,2928.24,-1200.56
181251140315878272,2020-12,2600.86,2709.87,2775.85,0,2666.84,1466.28
181441195457892448,2020-01,1185.3,1021.73,111.66,0,275.23,275.23
181441195457892448,2020-02,211.94,10.69,0,923.06,-721.81,-446.58
181441195457892448,2020-03,0,3723.05,2512.27,2455.79,-3666.57,-4113.15
181441195457892448,2020-04,1617.61,1033.81,3005.13,353.54,3235.39,-877.76
181441195457892448,2020-05,1700.88,0,3005.1,1200.58,3505.4,2627.64
181441195457892448,2020-07,827.87,4431.16,3389.6,0,-213.69,2413.95
181441195457892448,2020-08,1722.27,3943.34,0,979.33,-3200.4,-786.45
181441195457892448,2020-09,846.65,2869.67,822.26,0,-1200.76,-1987.21
181441195457892448,2020-10,3920.23,3605.04,115.93,0,431.12,-1556.09
181441195457892448,2020-11,1787.72,191.98,1719.89,173.53,3142.1,1586.01
181441195457892448,2020-12,1067.56,3033.16,1122.23,907.31,-1750.68,-164.67
181773858817361856,2020-01,1960.35,90.86,3127.01,2487.39,2509.11,2509.11
181773858817361856,2020-02,2921.64,922.39,1048.32,2317.74,729.83,3238.94
181773858817361856,2020-03,777.47,3849.75,3226.67,2388.95,-2234.56,1004.38
181773858817361856,2020-04,2707.5,1570.49,1733.29,4073.23,-1202.93,-198.55
181773858817361856,2020-05,2951.48,2800.47,622.45,16.97,756.49,557.94
181773858817361856,2020-06,2708.89,0,2399.89,3578.31,1530.47,2088.41
181773858817361856,2020-07,0,4158.88,1360.38,3634.2,-6432.7,-4344.29
181773858817361856,2020-08,3295.46,5878.87,1978.76,1589.22,-2193.87,-6538.16
181773858817361856,2020-09,1601.28,9459.28,4330.71,3632.19,-7159.48,-13697.64
181773858817361856,2020-10,1998.57,5655.08,1701.35,1735.88,-3691.04,-17388.68
181773858817361856,2020-11,2411.83,2558.56,5242.35,2410.21,2685.41,-14703.27
181773858817361856,2020-12,4829.08,3838.17,678.32,1010.58,658.65,-14044.62
183874788617101600,2020-01,4084.45,1420.52,2588.77,1458.95,3793.75,3793.75
183874788617101600,2020-02,2274.89,1204.36,2187.37,1845.08,1412.82,5206.57
183874788617101600,2020-03,5048.5,5665.7,3829.1,2051.57,1160.33,6366.9
183874788617101600,2020-04,0,5163.51,2195,1390.74,-4359.25,2007.65
183874788617101600,2020-05,2726.49,3717.21,2564.43,0,1573.71,3581.36
183874788617101600,2020-06,2297.46,678.14,1690.31,3150.33,159.3,3740.66
183874788617101600,2020-07,4959.92,1115.48,5676.91,4484.55,5036.8,8777.46
183874788617101600,2020-08,2673.48,7884.7,4548.15,3726.1,-4389.17,4388.29
183874788617101600,2020-09,2368.83,3031.9,2657.2,1852.69,141.44,4529.73
183874788617101600,2020-10,1343.24,3671.14,0,3102.12,-5430.02,-900.29
183874788617101600,2020-11,0,3692.88,1325.39,0,-2367.49,-3267.78
183874788617101600,2020-12,6269.84,4428.93,2036.59,631.69,3245.81,-21.97
184538082930537024,2020-01,4560.42,3818.1,0,526.06,216.26,216.26
184538082930537024,2020-02,3646.61,3919.16,4619.87,1566.3,2781.02,2997.28
184538082930537024,2020-03,4031.14,2784.81,2372.08,2764.27,854.14,3851.42
184538082930537024,2020-04,3839.73,3999.44,4535.99,3721.07,655.21,4506.63
184538082930537024,2020-05,7553.32,2181.63,5818.29,1371.56,9818.42,14325.05
184538082930537024,2020-06,5323.95,2570.14,1735.8,5251.66,-762.05,13563
184538082930537024,2020-07,648.15,3695.79,9341.22,3940.9,2352.68,15915.68
184538082930537024,2020-08,2739.68,4869.69,1405.03,4410.96,-5135.94,10779.74
184538082930537024,2020-09,2684.65,0,1774.23,1410.02,3048.86,13828.6
184538082930537024,2020-10,5152.18,3817.16,3796.07,1670.71,3460.38,17288.98
184538082930537024,2020-11,0,3793.08,2120.17,1935.94,-3608.85,13680.13
184538082930537024,2020-12,3574.92,0,3577.92,4243.57,2909.27,16589.4
185648988121536832,2020-01,3436.2,3197.25,1848.55,3168.11,-1080.61,-1080.61
185648988121536832,2020-02,1997.76,1971.63,1339.9,10066.08,-8700.05,-9780.66
185648988121536832,2020-03,1471.51,3463.97,1197.91,3499.5,-4294.05,-14074.71
185648988121536832,2020-04,2457.76,2408.01,4545.74,3418.37,1177.12,-12897.59
185648988121536832,2020-05,964.8,4619.67,4523.53,5789.6,-4920.94,-17818.53
185648988121536832,2020-06,1738.64,3658.69,0,4754.96,-6675.01,-24493.54
185648988121536832,2020-07,3068.65,3721.17,3751.75,3853.75,-754.52,-25248.06
185648988121536832,2020-08,4423.18,3764.29,2085.48,2311.87,432.5,-24815.56
185648988121536832,2020-09,3422.42,7977.03,3753.47,0,-801.14,-25616.7
185648988121536832,2020-10,5853.65,5000.78,10867.37,4276.38,7443.86,-18172.84
185648988121536832,2020-11,3361.26,3605.02,2728.46,5074.89,-2590.19,-20763.03
185648988121536832,2020-12,3222.05,1536.89,5348.95,1753.74,5280.37,-15482.66
186066020344372992,2020-01,1863.51,0,0,3607.21,-1743.7,-1743.7
186066020344372992,2020-02,1564.82,0,2798.12,3749.86,613.08,-1130.62
186066020344372992,2020-03,3716.79,1224.01,968.14,0,3460.92,2330.3
186066020344372992,2020-04,0,1958.33,2457.34,1136.34,-637.33,1692.97
186066020344372992,2020-05,0,4448.8,1233.42,3880.09,-7095.47,-5402.5
186066020344372992,2020-06,1181.92,3274.1,3072.06,2022.41,-1042.53,-6445.03
186066020344372992,2020-07,2629.23,0,122.2,6745.07,-3993.64,-10438.67
186066020344372992,2020-08,1770.72,3291.78,0,335.75,-1856.81,-12295.48
186066020344372992,2020-09,1987.05,1663.19,1038.8,1418.58,-55.92,-12351.4
186066020344372992,2020-11,61.88,0,0,966.41,-904.53,-13255.93
186066020344372992,2020-12,3015.99,737.4,4970.96,0,7249.55,-6006.38
186997530644804096,2020-01,1466.34,848.09,0,1091.43,-473.18,-473.18
186997530644804096,2020-02,532.01,0,3567.62,0,4099.63,3626.45
186997530644804096,2020-05,580.38,0,0,0,580.38,4206.83
186997530644804096,2020-06,0,884.95,0,0,-884.95,3321.88
186997530644804096,2020-07,0,68.96,0,347.93,-416.89,2904.99
186997530644804096,2020-08,1774.74,0,0,0,1774.74,4679.73
186997530644804096,2020-10,0,805.14,804.41,0,-0.73,4679
186997530644804096,2020-11,1023.59,0,0,0,1023.59,5702.59
186997530644804096,2020-12,1975.34,1295.29,0,0,680.05,6382.64
189107285063750336,2020-01,1999.9,1655.62,5327.61,3593.48,2078.41,2078.41
189107285063750336,2020-02,5106.58,2945.18,826.97,0,2988.37,5066.78
189107285063750336,2020-03,5092.39,1036.68,4364.71,2076.41,6344.01,11410.79
189107285063750336,2020-04,1555.74,2164.25,1899.48,4635.72,-3344.75,8066.04
189107285063750336,2020-05,961.82,3659.83,0,1288.93,-3986.94,4079.1
189107285063750336,2020-07,1578.06,6637.37,1341.43,1979.27,-5697.15,-1618.05
189107285063750336,2020-08,5242.62,3326.39,1826,260,3482.23,1864.18
189107285063750336,2020-09,1245.37,589.57,3286.75,1602.88,2339.67,4203.85
189107285063750336,2020-10,2415.27,2209.27,716.37,978.23,-55.86,4147.99
189107285063750336,2020-11,0,4977.32,1799.57,739.36,-3917.11,230.88
189107285063750336,2020-12,2633.1,2079.37,4423.72,2440.86,2536.59,2767.47
189909787472602368,2020-01,4981.99,2329.62,5152.27,5630.05,2174.59,2174.59
189909787472602368,2020-02,3523.96,3845.38,3215.73,5913.17,-3018.86,-844.27
189909787472602368,2020-03,4708.48,2123.2,4082.78,6353.8,314.26,-530.01
189909787472602368,2020-04,1994.81,5363.57,1932.38,2787.9,-4224.28,-4754.29
189909787472602368,2020-05,11249.48,1396.04,6942.78,3554.56,13241.66,8487.37
189909787472602368,2020-06,3139.34,1388.42,881.16,3454.23,-822.15,7665.22
189909787472602368,2020-07,5721.97,10349.51,3114.23,40.82,-1554.13,6111.09
189909787472602368,2020-08,1980.37,6853.81,3901.33,6293.95,-7266.06,-1154.97
189909787472602368,2020-09,7311.78,2253.47,5090.7,8647.33,1501.68,346.71
189909787472602368,2020-10,3710.84,5143,6440.88,9407.06,-4398.34,-4051.63
189909787472602368,2020-11,8028.5,3978.58,6859.67,8096.89,2812.7,-1238.93
189909787472602368,2020-12,3286.8,4796.35,2998.12,4332.34,-2843.77,-4082.7
192963180483984960,2020-01,939.11,3587.88,2679.59,0,30.82,30.82
192963180483984960,2020-02,3503.31,1559.8,3235.17,224.04,4954.64,4985.46
192963180483984960,2020-03,3029.52,86.28,1575.84,6204.88,-1685.8,3299.66
192963180483984960,2020-04,1068.03,2339.61,4183.94,1883.73,1028.63,4328.29
192963180483984960,2020-05,4574.12,2110.35,202.73,1929.03,737.47,5065.76
192963180483984960,2020-06,3986,3184.8,3826.34,1039.77,3587.77,8653.53
192963180483984960,2020-07,4479.79,1894.41,1841.09,0,4426.47,13080
192963180483984960,2020-08,2003.07,2969.25,982.47,0,16.29,13096.29
192963180483984960,2020-09,3775.86,1801.1,0,2908.42,-933.66,12162.63
192963180483984960,2020-10,6213.68,1871.15,1694.74,3222.77,2814.5,14977.13
192963180483984960,2020-11,4649.76,91.77,906.58,5503.69,-39.12,14938.01
192963180483984960,2020-12,3298.81,1017.07,2544.28,4533.16,292.86,15230.87
193967084425721440,2020-01,7834.26,7785.58,1697.26,7143.84,-5397.9,-5397.9
193967084425721440,2020-02,4135.72,2214.11,5717.99,205.24,7434.36,2036.46
193967084425721440,2020-03,2970.67,4281.08,1572.92,1363.02,-1100.51,935.95
193967084425721440,2020-04,2122.95,5571.23,3927.67,2495.44,-2016.05,-1080.1
193967084425721440,2020-05,4347.22,5790.43,5962.26,5812.43,-1293.38,-2373.48
193967084425721440,2020-06,2285.07,3188.3,5637.75,3283.89,1450.63,-922.85
193967084425721440,2020-07,0,294.22,6601.86,1867.8,4439.84,3516.99
193967084425721440,2020-08,3202.49,4818.47,5589.37,8230.66,-4257.27,-740.28
193967084425721440,2020-09,4021.31,6252.16,7259.73,6018.51,-989.63,-1729.91
193967084425721440,2020-10,3117.47,835.78,2466.49,1535.04,3213.14,1483.23
193967084425721440,2020-11,3599.49,3224.4,1661.95,2996.62,-959.58,523.65
193967084425721440,2020-12,2948.79,2917.91,5543.29,1846.56,3727.61,4251.26
194230705711642272,2020-01,4543.04,1462.18,3383.71,507.16,5957.41,5957.41
194230705711642272,2020-02,4850.45,3436.15,770.46,2730.02,-545.26,5412.15
194230705711642272,2020-03,3709.28,4776.43,3856.59,3026.65,-237.21,5174.94
194230705711642272,2020-04,4142.64,2421.24,0,1724.32,-2.92,5172.02
194230705711642272,2020-05,4022.88,9908.92,7724.47,6618.69,-4780.26,391.76
194230705711642272,2020-06,6064.73,0,2132.39,7218.47,978.65,1370.41
194230705711642272,2020-07,95.85,0,1106.63,1621.32,-418.84,951.57
194230705711642272,2020-08,1786.62,8177.56,0,5824.27,-12215.21,-11263.64
194230705711642272,2020-09,2818.04,4934.7,3117.42,2392.6,-1391.84,-12655.48
194230705711642272,2020-10,3000.38,3512.83,5267.53,7154.48,-2399.4,-15054.88
194230705711642272,2020-11,1255.94,3450.19,3458.82,1951.81,-687.24,-15742.12
194230705711642272,2020-12,1336.08,5388.77,6525.86,9498.03,-7024.86,-22766.98
195556552817977152,2020-01,0,2372.17,1025.3,2274.29,-3621.16,-3621.16
195556552817977152,2020-02,2848.77,1932.03,0,3261.26,-2344.52,-5965.68
195556552817977152,2020-03,1041,3133.11,2426.04,0,333.93,-5631.75
195556552817977152,2020-04,79.7,0,2297.47,4246.46,-1869.29,-7501.04
195556552817977152,2020-05,2458.57,1573.49,1814.8,2980.28,-280.4,-7781.44
195556552817977152,2020-06,1472.77,1866.25,1888.12,161.36,1333.28,-6448.16
195556552817977152,2020-07,1043.99,940.15,149.24,0,253.08,-6195.08
195556552817977152,2020-08,304.38,148.43,3298.96,2669.69,785.22,-5409.86
195556552817977152,2020-09,1125.27,696.35,5367.39,3215.07,2581.24,-2828.62
195556552817977152,2020-10,1122.08,1517.15,0,1968.58,-2363.65,-5192.27
195556552817977152,2020-11,2262.06,2870.13,1044.82,962.98,-526.23,-5718.5
195556552817977152,2020-12,776.45,0,0,3201.24,-2424.79,-8143.29
195659247558715680,2020-01,2352.91,6597.26,43.36,2587.01,-6788,-6788
195659247558715680,2020-02,3736.18,17.54,2393.65,0,6112.29,-675.71
195659247558715680,2020-03,5110.57,5283.3,3760.38,3996.58,-408.93,-1084.64
195659247558715680,2020-04,4639.29,5229.72,4666.92,5061.1,-984.61,-2069.25
195659247558715680,2020-05,2486.48,5739.1,4117.51,4757.44,-3892.55,-5961.8
195659247558715680,2020-06,181.95,4270.71,4556.37,7309.74,-6842.13,-12803.93
195659247558715680,2020-07,6720.32,4218.02,5969.97,2930.26,5542.01,-7261.92
195659247558715680,2020-08,6453.26,8234.56,7392.03,7741.75,-2131.02,-9392.94
195659247558715680,2020-09,7067.64,5065.35,3640.62,2519.12,3123.79,-6269.15
195659247558715680,2020-10,3493.52,7239.89,1544.37,7668.72,-9870.72,-16139.87
195659247558715680,2020-11,5582.38,3269.49,7666.7,7850.48,2129.11,-14010.76
195659247558715680,2020-12,7328.5,3380.82,9140.74,7511.01,5577.41,-8433.35
196356863719252576,2020-01,0,5714.5,7156.55,0,1442.05,1442.05
196356863719252576,2020-02,2943.44,53.65,535.49,0,3425.28,4867.33
196356863719252576,2020-03,2355.98,1392.94,1990.49,4224.65,-1271.12,3596.21
196356863719252576,2020-04,2326.34,5138.6,4892.95,3021.47,-940.78,2655.43
196356863719252576,2020-05,2667.95,0,824.45,2768.86,723.54,3378.97
196356863719252576,2020-06,2437.82,5607.97,330.58,3132.67,-5972.24,-2593.27
196356863719252576,2020-07,7021.48,6002.81,1334.83,7817.3,-5463.8,-8057.07
196356863719252576,2020-08,5897.65,2236.02,2280.76,3418.3,2524.09,-5532.98
196356863719252576,2020-09,3445.74,1092.3,652.27,4300.8,-1295.09,-6828.07
196356863719252576,2020-10,648.88,2639.14,208.71,2060.33,-3841.88,-10669.95
196356863719252576,2020-11,5090.1,3291.44,2103.31,4163.39,-261.42,-10931.37
196356863719252576,2020-12,169.64,641.49,3078.29,101.05,2505.39,-8425.98
196415932344191680,2020-01,3605.86,5151.3,5679.03,4831.17,-697.58,-697.58
196415932344191680,2020-02,2489.75,4395.46,7118.65,5250.2,-37.26,-734.84
196415932344191680,2020-03,3825.34,4029.26,4873,1724.13,2944.95,2210.11
196415932344191680,2020-04,4239.93,4753.42,2564.57,1593.26,457.82,2667.93
196415932344191680,2020-05,1854.48,1158.38,3255.4,3435.23,516.27,3184.2
196415932344191680,2020-06,3072.2,4380.31,1018.56,2825.99,-3115.54,68.66
196415932344191680,2020-07,2269.07,2166.34,55.07,2472.47,-2314.67,-2246.01
196415932344191680,2020-08,2827.19,967.29,1374.46,2138.73,1095.63,-1150.38
196415932344191680,2020-09,1816.99,5034.69,4667.82,7135.2,-5685.08,-6835.46
196415932344191680,2020-10,1801.54,7154.59,1765.43,6014.96,-9602.58,-16438.04
196415932344191680,2020-11,14024.17,5212.34,5429.63,3289.68,10951.78,-5486.26
196415932344191680,2020-12,1871.37,1779.56,2110.45,3907.18,-1704.92,-7191.18
196599969570778080,2020-01,4106.56,4529.17,4990.28,4891.57,-323.9,-323.9
196599969570778080,2020-02,1271.2,7961.68,0,3601.35,-10291.83,-10615.73
196599969570778080,2020-03,5608.57,10105.95,8054.32,3612.09,-55.15,-10670.88
196599969570778080,2020-04,5289.96,5211.38,2197.78,5928.89,-3652.53,-14323.41
196599969570778080,2020-05,5778.85,4647.95,5062.1,6445.59,-252.59,-14576
196599969570778080,2020-06,9405.11,9632.11,3221.17,6906.87,-3912.7,-18488.7
196599969570778080,2020-07,1326.56,4079.37,4688.44,4853.19,-2917.56,-21406.26
196599969570778080,2020-08,1840.32,5549.06,8346.35,2813.07,1824.54,-19581.72
196599969570778080,2020-09,5868.24,822.84,2126.57,9134.65,-1962.68,-21544.4
196599969570778080,2020-10,4537.58,3327.16,8631.24,1922.62,7919.04,-13625.36
196599969570778080,2020-11,3051.32,1278.97,3873.93,3870.24,1776.04,-11849.32
196599969570778080,2020-12,4026.76,3961.61,7717.43,6516.43,1266.15,-10583.17
198221860505019424,2020-01,6422.77,4662.51,4552.8,4229.58,2083.48,2083.48
198221860505019424,2020-02,6658.02,2899.26,2778.74,4717.17,1820.33,3903.81
198221860505019424,2020-03,5865.75,6424.83,1813.71,2694.91,-1440.28,2463.53
198221860505019424,2020-04,3236.31,6299.26,7873.76,2466.59,2344.22,4807.75
198221860505019424,2020-05,4110.17,5034.03,2901.49,6358.69,-4381.06,426.69
198221860505019424,2020-06,1750.85,1915.61,2170.68,1908.53,97.39,524.08
198221860505019424,2020-07,5977.71,1404.94,2823.26,3808.44,3587.59,4111.67
198221860505019424,2020-08,3760.93,1362.04,1657.84,1864.63,2192.1,6303.77
198221860505019424,2020-09,4139.31,3751.03,1893.23,2613.32,-331.81,5971.96
198221860505019424,2020-10,2418.43,2688.16,1682.66,3886.29,-2473.36,3498.6
198221860505019424,2020-11,2724.67,3265.1,1734.44,2109.95,-915.94,2582.66
198221860505019424,2020-12,2977.34,3082.67,8015.68,5045.94,2864.41,5447.07
199367610254079520,2020-01,3920.01,1303.25,0,935.85,1680.91,1680.91
199367610254079520,2020-02,1502.32,3136.12,992.61,2137.62,-2778.81,-1097.9
199367610254079520,2020-03,0,7889.51,952.29,995.21,-7932.43,-9030.33
199367610254079520,2020-04,2645.16,6488.82,5107.42,203.22,1060.54,-7969.79
199367610254079520,2020-05,0,1256.75,3992.78,5058.83,-2322.8,-10292.59
199367610254079520,2020-06,501.35,4547.95,2629.14,3207.18,-4624.64,-14917.23
199367610254079520,2020-07,1701.98,1540.26,4764.19,3698.83,1227.08,-13690.15
199367610254079520,2020-08,1317.7,0,816.33,5318.63,-3184.6,-16874.75
199367610254079520,2020-09,492.01,10359.88,4860.44,1063.06,-6070.49,-22945.24
199367610254079520,2020-10,7004.36,940.38,2750.58,3226.09,5588.47,-17356.77
199367610254079520,2020-11,1480.36,0,1984.34,4749.14,-1284.44,-18641.21
199367610254079520,2020-12,504.98,4260.27,1457.14,763.86,-3062.01,-21703.22
199812129682424256,2020-01,1773.75,2144.27,3942.99,4090.41,-517.94,-517.94
199812129682424256,2020-02,2975.01,1216.21,4160.14,2531.54,3387.4,2869.46
199812129682424256,2020-03,715.2,1230.64,2984.81,559.64,1909.73,4779.19
199812129682424256,2020-04,1020.94,1456.44,4787.97,0,4352.47,9131.66
199812129682424256,2020-05,572.27,3257.39,6081.15,4091.16,-695.13,8436.53
199812129682424256,2020-06,4172.39,885.03,2653.97,2242.93,3698.4,12134.93
199812129682424256,2020-07,4267.9,5933.12,2717.77,5838.97,-4786.42,7348.51
199812129682424256,2020-08,5035.11,7379.37,772.75,3637.13,-5208.64,2139.87
199812129682424256,2020-09,858.82,2774.12,2787.28,3733.05,-2861.07,-721.2
199812129682424256,2020-10,3472.89,4285.74,3932.52,956.45,2163.22,1442.02
199812129682424256,2020-11,1667.08,989.74,3526.84,1733.65,2470.53,3912.55
199812129682424256,2020-12,2333.52,0,2908.74,700.69,4541.57,8454.12
200250322810066816,2020-01,4184.43,4683.01,3424.05,6561.7,-3636.23,-3636.23
200250322810066816,2020-02,5352.02,7564.88,2916.29,4171.07,-3467.64,-7103.87
200250322810066816,2020-03,3446.18,1712.4,7580.65,3602.93,5711.5,-1392.37
200250322810066816,2020-04,2401.06,3983.97,2364.38,5238.31,-4456.84,-5849.21
200250322810066816,2020-05,942.75,2051.37,5573.34,5420.81,-956.09,-6805.3
200250322810066816,2020-06,6047.63,2173.31,5251.97,5563.06,3563.23,-3242.07
200250322810066816,2020-07,3440.13,9462.72,2485.79,3368.08,-6904.88,-10146.95
200250322810066816,2020-08,6016.97,1610.41,3307.9,1260.48,6453.98,-3692.97
200250322810066816,2020-09,3645.21,4353.76,7530.27,9409.98,-2588.26,-6281.23
200250322810066816,2020-10,7770.29,4574.35,8154.52,2646.98,8703.48,2422.25
200250322810066816,2020-11,2744.76,1413.62,4528.06,5558.41,300.79,2723.04
200250322810066816,2020-12,2939.52,6386.45,2593.36,4707.04,-5560.61,-2837.57
200422473371757280,2020-01,0,2603.95,2218.73,2133.79,-2519.01,-2519.01
200422473371757280,2020-02,584.02,918.38,2857.61,2275.85,247.4,-2271.61
200422473371757280,2020-03,3925.63,2936.08,1646.32,1050.72,1585.15,-686.46
200422473371757280,2020-04,502.28,1336.92,1282.9,0,448.26,-238.2
200422473371757280,2020-05,1443.59,2878.24,4189.2,4447.34,-1692.79,-1930.99
200422473371757280,2020-06,0,6200.74,1076.84,2890.11,-8014.01,-9945
200422473371757280,2020-07,5313.09,2994.11,1193.83,1651.69,1861.12,-8083.88
200422473371757280,2020-08,1915.16,313.85,79.59,0,1680.9,-6402.98
200422473371757280,2020-09,2314.87,2061.08,213.45,5742.45,-5275.21,-11678.19
200422473371757280,2020-10,3143.39,2914.47,1809.92,0,2038.84,-9639.35
200422473371757280,2020-11,2393.89,5565.3,3146.72,776.47,-801.16,-10440.51
200422473371757280,2020-12,1741.69,621.41,275.65,1496.65,-100.72,-10541.23
200858785663163648,2020-01,8423.18,8893.41,4686.94,3709.85,506.86,506.86
200858785663163648,2020-02,5995.17,3659.46,11346.99,5006.49,8676.21,9183.07
200858785663163648,2020-03,6823.14,2989.89,4708.05,5965.47,2575.83,11758.9
200858785663163648,2020-04,5682.11,4200.65,800.58,2840.19,-558.15,11200.75
200858785663163648,2020-05,5532.13,4619.39,2172.03,5259.21,-2174.44,9026.31
200858785663163648,2020-06,4196.01,8028.4,2902.72,6419.21,-7348.88,1677.43
200858785663163648,2020-07,1682.84,3553.32,2587.27,5333.26,-4616.47,-2939.04
200858785663163648,2020-08,2468.53,12742.35,1948.25,3236.14,-11561.71,-14500.75
200858785663163648,2020-09,4693.43,5419.92,3229.08,6781.03,-4278.44,-18779.19
200858785663163648,2020-10,3889.34,6004,6523.3,3975.78,432.86,-18346.33
200858785663163648,2020-11,3032.25,5279.3,3578.84,4855.31,-3523.52,-21869.85
200858785663163648,2020-12,5087.97,4927.35,3638.65,1704.99,2094.28,-19775.57
201203585492658848,2020-01,47.02,0,0,0,47.02,47.02
201203585492658848,2020-02,0,1387.61,0,0,-1387.61,-1340.59
201203585492658848,2020-04,0,118.28,0,0,-118.28,-1458.87
201203585492658848,2020-08,327.86,0,235.54,0,563.4,-895.47
201203585492658848,2020-10,0,536.62,3156.44,0,2619.82,1724.35
201203585492658848,2020-11,0,1169.76,916.12,1720.3,-1973.94,-249.59
201978581803671552,2020-01,3991.59,3839.86,3311.38,60.37,3402.74,3402.74
201978581803671552,2020-02,4020.93,735.76,1786.64,4390.28,681.53,4084.27
201978581803671552,2020-03,2743.93,7146.29,3575.23,5155.99,-5983.12,-1898.85
201978581803671552,2020-04,1809.55,3464.14,8740.41,6326.67,759.15,-1139.7
201978581803671552,2020-05,4675.09,6275.4,6330.65,6186.75,-1456.41,-2596.11
201978581803671552,2020-06,4512.15,4586.61,4093.38,1791.33,2227.59,-368.52
201978581803671552,2020-07,4408.56,3818.37,2653.42,2183.61,1060,691.48
201978581803671552,2020-08,4490.03,1643.74,4709.53,3413.44,4142.38,4833.86
201978581803671552,2020-09,4593.45,1692.73,6615.8,9658.21,-141.69,4692.17
201978581803671552,2020-10,6605.94,3109.31,972.28,3527.64,941.27,5633.44
201978581803671552,2020-11,1758.24,2157.08,4915.56,6009.03,-1492.31,4141.13
201978581803671552,2020-12,3650.33,4818.58,1575.31,6590.17,-6183.11,-2041.98
202286437787667456,2020-01,3453.31,5499.62,5623.02,0,3576.71,3576.71
202286437787667456,2020-02,1730.3,1916.34,2738.28,1255.67,1296.57,4873.28
202286437787667456,2020-03,316.58,4694.12,1272.23,795.36,-3900.67,972.61
202286437787667456,2020-04,4228.27,336.27,3343.19,5595.48,1639.71,2612.32
202286437787667456,2020-05,5260.66,832.53,6482.9,4957.15,5953.88,8566.2
202286437787667456,2020-06,2671.03,1489.98,1768.25,218.85,2730.45,11296.65
202286437787667456,2020-07,2767.66,882.52,2540.59,1736.28,2689.45,13986.1
202286437787667456,2020-08,3457.97,6613.1,3853.28,5853.17,-5155.02,8831.08
202286437787667456,2020-09,2969.79,1346.47,2179.7,814.94,2988.08,11819.16
202286437787667456,2020-10,4667.37,2785.44,161.17,3975.11,-1932.01,9887.15
202286437787667456,2020-11,4529.3,4594.34,4829.04,1903.04,2860.96,12748.11
202286437787667456,2020-12,3430.68,1313.89,7540.35,0,9657.14,22405.25
202575175337309408,2020-01,1775.22,4562.87,247.9,1918.63,-4458.38,-4458.38
202575175337309408,2020-02,1830.99,2324.21,1652.21,0,1158.99,-3299.39
202575175337309408,2020-03,1608.91,1460.25,0,0,148.66,-3150.73
202575175337309408,2020-04,2043.58,2239.22,0,3232.33,-3427.97,-6578.7
202575175337309408,2020-05,0,504.03,3473.79,0,2969.76,-3608.94
202575175337309408,2020-06,622.07,2011.92,2216.37,1605.8,-779.28,-4388.22
202575175337309408,2020-07,0,1861.59,313.97,193.94,-1741.56,-6129.78
202575175337309408,2020-08,706.59,1794.52,768.95,4731.62,-5050.6,-11180.38
202575175337309408,2020-10,457.33,1940.03,1073.18,3116.74,-3526.26,-14706.64
202575175337309408,2020-11,0,2333.98,2338.31,3721.92,-3717.59,-18424.23
202575175337309408,2020-12,3948.34,180.13,0,722.83,3045.38,-15378.85
202829683531391040,2020-01,667.62,2742.35,0,639.99,-2714.72,-2714.72
202829683531391040,2020-02,3228.18,4063.34,488.02,492.29,-839.43,-3554.15
202829683531391040,2020-03,0,5532.89,2631.79,1235.66,-4136.76,-7690.91
202829683531391040,2020-04,1820.63,0,1532.14,0,3352.77,-4338.14
202829683531391040,2020-05,2352.81,5221.11,2152.26,5158.85,-5874.89,-10213.03
202829683531391040,2020-06,4409.83,4467.98,4647.4,0,4589.25,-5623.78
202829683531391040,2020-07,9103.69,0,1589.96,834.79,9858.86,4235.08
202829683531391040,2020-08,2914.64,2945.9,873.99,6505.88,-5663.15,-1428.07
202829683531391040,2020-09,4826.92,1601.18,5262.2,1749.91,6738.03,5309.96
202829683531391040,2020-10,0,4213.32,446.48,2819.88,-6586.72,-1276.76
202829683531391040,2020-11,2659.52,4628.62,0,500.73,-2469.83,-3746.59
202829683531391040,2020-12,2472.7,6335.35,4477.62,0,614.97,-3131.62
202873121216153728,2020-01,4369.37,7092.27,4199.08,4200.93,-2724.75,-2724.75
202873121216153728,2020-02,5554.55,2178.63,5030.8,6817.91,1588.81,-1135.94
202873121216153728,2020-03,2477.22,1745.94,4439.5,1910.97,3259.81,2123.87
202873121216153728,2020-04,3375.25,2167.19,5402.9,3423.77,3187.19,5311.06
202873121216153728,2020-05,2484.71,7267,2465.08,2713.32,-5030.53,280.53
202873121216153728,2020-06,4722.95,7112.97,8132.95,906.11,4836.82,5117.35
202873121216153728,2020-07,3325.65,2424.84,3686.48,5355.66,-768.37,4348.98
202873121216153728,2020-08,2290.82,7179.78,4987.15,2981.37,-2883.18,1465.8
202873121216153728,2020-09,3695.61,2991,6974.87,4564.2,3115.28,4581.08
202873121216153728,2020-10,7381.67,3039.84,4417.96,8409.31,350.48,4931.56
202873121216153728,2020-11,1600.92,1724.52,3746.27,4392.82,-770.15,4161.41
202873121216153728,2020-12,4895.98,3796.46,4049.66,1317.66,3831.52,7992.93
203119523476309536,2020-01,7741.77,3513.19,2189.41,5614.6,803.39,803.39
203119523476309536,2020-02,3429.67,7782.14,1940.08,4331.43,-6743.82,-5940.43
203119523476309536,2020-03,1757.44,4010.1,5796.18,3869.42,-325.9,-6266.33
203119523476309536,2020-04,5256.39,4653.16,3476.35,2509.04,1570.54,-4695.79
203119523476309536,2020-05,4365.53,6444.64,5424.48,7287.53,-3942.16,-8637.95
203119523476309536,2020-06,6329.91,2247.13,2675.36,2764.45,3993.69,-4644.26
203119523476309536,2020-07,6361.31,2538.56,7708.77,6991.49,4540.03,-104.23
203119523476309536,2020-08,6206.12,4781.52,12739.17,2925.06,11238.71,11134.48
203119523476309536,2020-09,4901.53,3251.78,1794.03,2520,923.78,12058.26
203119523476309536,2020-10,6493.31,3636.77,809.81,5866.57,-2200.22,9858.04
203119523476309536,2020-11,5817.35,5777.43,6749.28,2872.18,3917.02,13775.06
203119523476309536,2020-12,2405.89,6227.66,5859.33,3516.86,-1479.3,12295.76
203240636663332800,2020-01,3776.06,5773.81,6780.63,5681.64,-898.76,-898.76
203240636663332800,2020-02,5536.08,3855.08,2312.45,3213.31,780.14,-118.62
203240636663332800,2020-03,5710.37,7953.73,6215.94,2351.79,1620.79,1502.17
203240636663332800,2020-04,1227.64,6305.77,6929.63,4621.76,-2770.26,-1268.09
203240636663332800,2020-05,2685.96,4399.94,4850.16,1991.4,1144.78,-123.31
203240636663332800,2020-06,5634.17,3109.79,1476.6,4812.96,-811.98,-935.29
203240636663332800,2020-07,1814.19,7597.71,9348.53,5444.05,-1879.04,-2814.33
203240636663332800,2020-08,2143.86,9520.65,3734.13,334.21,-3976.87,-6791.2
203240636663332800,2020-09,232.33,5410.8,7524.64,3445.27,-1099.1,-7890.3
203240636663332800,2020-10,5955.28,5581.53,5783.85,5073.3,1084.3,-6806
203240636663332800,2020-11,5305.57,2958.8,6061.67,7127.07,1281.37,-5524.63
203240636663332800,2020-12,7526.81,3011.86,4790.2,7772.62,1532.53,-3992.1
204702936577853984,2020-02,1785.37,0,0,0,1785.37,1785.37
204702936577853984,2020-03,580.28,0,0,0,580.28,2365.65
204702936577853984,2020-04,0,192.16,0,0,-192.16,2173.49
206127305156916512,2020-01,6729.76,682.3,1249.93,5046.7,2250.69,2250.69
206127305156916512,2020-02,12548.16,7760.64,4179.64,8853.74,113.42,2364.11
206127305156916512,2020-03,2972.63,5998.33,3027.01,1752.34,-1751.03,613.08
206127305156916512,2020-04,3546.97,1465.42,1206.65,1693.68,1594.52,2207.6
206127305156916512,2020-05,993.21,1437.76,6157.62,4198.81,1514.26,3721.86
206127305156916512,2020-06,2395.23,8425.82,8527.77,2970.34,-473.16,3248.7
206127305156916512,2020-07,2423.91,6771.9,8016.97,4299.74,-630.76,2617.94
206127305156916512,2020-08,7925.29,2633.95,5581.58,2666.15,8206.77,10824.71
206127305156916512,2020-09,3406.64,2492.67,3010.65,4786.21,-861.59,9963.12
206127305156916512,2020-10,4376.45,0,2595.04,4541.01,2430.48,12393.6
206127305156916512,2020-11,5693.87,7041.1,1981.52,4091.68,-3457.39,8936.21
206127305156916512,2020-12,6076.96,6319.9,3265.73,2203.08,819.71,9755.92
207214958808762976,2020-01,10640.73,7948.55,3024.79,3718.4,1998.57,1998.57
207214958808762976,2020-02,2507.86,6836.96,5860.99,4137.5,-2605.61,-607.04
207214958808762976,2020-03,7895.25,4981.33,2656.29,4786.09,784.12,177.08
207214958808762976,2020-04,2355.99,4208.5,1976,4479.87,-4356.38,-4179.3
207214958808762976,2020-05,6060,5180.36,3573.17,2876.99,1575.82,-2603.48
207214958808762976,2020-06,2610.92,5516.59,10859.2,2291.68,5661.85,3058.37
207214958808762976,2020-07,2220.76,2524.62,4424.22,5720.6,-1600.24,1458.13
207214958808762976,2020-08,4603.06,5264.57,6181.16,3673,1846.65,3304.78
207214958808762976,2020-09,6839.91,5450.22,5512.49,3488.06,3414.12,6718.9
207214958808762976,2020-10,4216.18,952.26,4462.45,8064.79,-338.42,6380.48
207214958808762976,2020-11,6425.88,3303.47,234.35,1335.26,2021.5,8401.98
207214958808762976,2020-12,2095.29,2847.66,6256.97,1656.03,3848.57,12250.55
209464810249267840,2020-01,0,740.85,1726.6,451.37,534.38,534.38
209464810249267840,2020-02,0,462.6,0,875.07,-1337.67,-803.29
209464810249267840,2020-04,1567.4,3440.13,1283.71,929.2,-1518.22,-2321.51
209464810249267840,2020-05,2282.17,2117.8,0,0,164.37,-2157.14
209464810249267840,2020-06,99.86,0,899.03,1472.11,-473.22,-2630.36
209464810249267840,2020-07,2079.37,2312.17,2916.66,737.11,1946.75,-683.61
209464810249267840,2020-09,709.14,2459.92,168.07,0,-1582.71,-2266.32
209464810249267840,2020-10,93.11,1807.33,0,0,-1714.22,-3980.54
209464810249267840,2020-11,0,3141.15,5.4,3406.68,-6542.43,-10522.97
209464810249267840,2020-12,2742.46,988.04,0,1913.95,-159.53,-10682.5
209650390266219264,2020-01,1378.65,1470.82,292.63,4671.03,-4470.57,-4470.57
209650390266219264,2020-02,2757.91,958.76,0,1126.14,673.01,-3797.56
209650390266219264,2020-03,3887.03,1569.41,2984.79,3521.72,1780.69,-2016.87
209650390266219264,2020-04,4377.26,739.11,3401.75,2907.52,4132.38,2115.51
209650390266219264,2020-05,1357.32,735.7,4707.71,2372.37,2956.96,5072.47
209650390266219264,2020-06,2656.3,2813.53,3939.8,1080.39,2702.18,7774.65
209650390266219264,2020-07,1644.85,906.5,2421.74,5640.23,-2480.14,5294.51
209650390266219264,2020-08,2486.19,5003.87,1762.93,2117.11,-2871.86,2422.65
209650390266219264,2020-09,2187.86,3134.52,762.75,4424.59,-4608.5,-2185.85
209650390266219264,2020-10,481.85,4578.75,1289.82,5055.69,-7862.77,-10048.62
209650390266219264,2020-11,7885.15,3496.16,2594.13,1201.08,5782.04,-4266.58
209650390266219264,2020-12,277.07,0,543.1,1703.64,-883.47,-5150.05
211577267597883232,2020-01,2198.55,1885.5,0,0,313.05,313.05
211577267597883232,2020-02,0,1856.58,0,0,-1856.58,-1543.53
211577267597883232,2020-05,1421.35,0,1559.98,1050.2,1931.13,387.6
211577267597883232,2020-07,0,1422.31,1138.28,0,-284.03,103.57
211577267597883232,2020-08,1011.45,0,1857.87,0,2869.32,2972.89
211577267597883232,2020-10,1208.55,304.06,110.09,0,1014.58,3987.47
211577267597883232,2020-11,317.52,0,1688.18,0,2005.7,5993.17
211577267597883232,2020-12,0,1782.08,0,16.18,-1798.26,4194.91
213427376287104544,2020-01,6915.31,1798.51,0,0,5116.8,5116.8
213427376287104544,2020-02,0,2188.35,1877.11,1105.49,-1416.73,3700.07
213427376287104544,2020-03,0,656.58,771.73,1333.27,-1218.12,2481.95
213427376287104544,2020-04,1498.2,0,31.17,7155.47,-5626.1,-3144.15
213427376287104544,2020-05,241.38,0,3890.66,2126.24,2005.8,-1138.35
213427376287104544,2020-06,478.16,1743.07,0,837.8,-2102.71,-3241.06
213427376287104544,2020-07,2748.77,3946.54,0,735.78,-1933.55,-5174.61
213427376287104544,2020-08,3457.85,1127.2,449.73,2912.94,-132.56,-5307.17
213427376287104544,2020-10,0,1307.67,888.08,1980.52,-2400.11,-7707.28
213427376287104544,2020-11,1105.46,0,1334.15,1416.14,1023.47,-6683.81
213427376287104544,2020-12,1127.57,3329.51,593.33,2636.31,-4244.92,-10928.73
214057815026765504,2020-01,5220.67,5838.52,5931.73,7091.47,-1777.59,-1777.59
214057815026765504,2020-02,8267.63,6996.31,3090.25,4998.9,-637.33,-2414.92
214057815026765504,2020-03,8546.32,3555.73,3513.6,6896.18,1608.01,-806.91
214057815026765504,2020-04,7262.63,5457.4,6220.83,3810.5,4215.56,3408.65
214057815026765504,2020-05,3984.53,5754.57,4159.78,10375.09,-7985.35,-4576.7
214057815026765504,2020-06,6771.37,1807.5,5429.07,6036.39,4356.55,-220.15
214057815026765504,2020-07,2058.4,7349.06,4836.2,7006.52,-7460.98,-7681.13
214057815026765504,2020-08,4490.06,4326.88,3834.74,4995.78,-997.86,-8678.99
214057815026765504,2020-09,1713.19,310.99,2532.61,5809.22,-1874.41,-10553.4
214057815026765504,2020-10,7711.25,6689,3390.26,3526.71,885.8,-9667.6
214057815026765504,2020-11,6562.49,2645.58,4853.67,4518.82,4251.76,-5415.84
214057815026765504,2020-12,1863.05,3425.93,994.31,5341.56,-5910.13,-11325.97
214223691782491808,2020-02,3975.41,768.97,1914.1,4110.16,1010.38,1010.38
214223691782491808,2020-03,2227.48,3727.65,2067.38,3630.44,-3063.23,-2052.85
214223691782491808,2020-04,2978.8,720.58,3995.46,9243.1,-2989.42,-5042.27
214223691782491808,2020-05,3069.68,3782.2,5584.37,4878.82,-6.97,-5049.24
214223691782491808,2020-06,1750.19,7565.34,2145.24,3015.75,-6685.66,-11734.9
214223691782491808,2020-07,3452.63,2102.61,1981.11,3919.8,-588.67,-12323.57
214223691782491808,2020-08,621.2,2084.3,1667.26,3303.29,-3099.13,-15422.7
214223691782491808,2020-09,0,6767.47,6107.98,3184.31,-3843.8,-19266.5
214223691782491808,2020-10,2677.83,685.76,3439.56,1389.94,4041.69,-15224.81
214223691782491808,2020-11,554.31,5579.53,2405.17,3402.53,-6022.58,-21247.39
214223691782491808,2020-12,1098.55,3078.24,2371.88,2755.3,-2363.11,-23610.5
214313874517335776,2020-01,2797.7,4626.09,805.01,0,-1023.38,-1023.38
214313874517335776,2020-02,1318.1,1890.66,0,4372.32,-4944.88,-5968.26
214313874517335776,2020-03,0,2564.58,2701.12,0,136.54,-5831.72
214313874517335776,2020-04,1990.37,4310.59,3056.41,2867.22,-2131.03,-7962.75
214313874517335776,2020-05,1446.51,2416,2962.63,1916.24,76.9,-7885.85
214313874517335776,2020-06,3985.12,1911.15,0,1087.18,986.79,-6899.06
214313874517335776,2020-07,4485.55,2073.64,2369.35,2602.66,2178.6,-4720.46
214313874517335776,2020-09,1380.35,0,1058.49,3306.99,-868.15,-5588.61
214313874517335776,2020-10,2349.86,567.27,0,1368.27,414.32,-5174.29
214313874517335776,2020-11,1184.45,242.01,3895.23,1570.83,3266.84,-1907.45
214313874517335776,2020-12,1910.44,3914.66,3271.08,3356.5,-2089.64,-3997.09
214998900300485696,2020-01,4275.85,1566.16,0,1876.62,833.07,833.07
214998900300485696,2020-02,1975.06,1257.18,1261.41,339.6,1639.69,2472.76
214998900300485696,2020-03,1039.21,1063.72,0,1223.71,-1248.22,1224.54
214998900300485696,2020-04,4698.91,471.35,869.7,1940.01,3157.25,4381.79
214998900300485696,2020-05,0,2291.69,0,1999.51,-4291.2,90.59
214998900300485696,2020-06,1043.88,2714.66,0,3147,-4817.78,-4727.19
214998900300485696,2020-07,0,676.28,2765.78,2486.72,-397.22,-5124.41
214998900300485696,2020-09,1443.8,0,869.94,0,2313.74,-2810.67
214998900300485696,2020-10,4716.42,1656.47,1912.67,962.22,4010.4,1199.73
214998900300485696,2020-11,3261.86,939.24,0,725.51,1597.11,2796.84
214998900300485696,2020-12,1803.89,4357.43,1695.18,398.67,-1257.03,1539.81
216470066142578624,2020-01,5025.61,5394.02,841.64,3160.26,-2687.03,-2687.03
216470066142578624,2020-02,4663.04,1895.06,0,8912.76,-6144.78,-8831.81
216470066142578624,2020-03,3088.71,1920.73,2142.74,5893.38,-2582.66,-11414.47
216470066142578624,2020-04,782.91,1417.05,1965.08,3016.87,-1685.93,-13100.4
216470066142578624,2020-05,4186.49,3471.61,1961.27,4455.82,-1779.67,-14880.07
216470066142578624,2020-06,15538.84,4673.42,3056.68,1711.76,12210.34,-2669.73
216470066142578624,2020-07,3006.52,6432.22,5459.73,5254.25,-3220.22,-5889.95
216470066142578624,2020-08,2214.39,2118.76,4360.66,4110.75,345.54,-5544.41
216470066142578624,2020-09,6421.65,7334.05,3800.29,1550.94,1336.95,-4207.46
216470066142578624,2020-10,6105.76,2900.07,2834.71,25.94,6014.46,1807
216470066142578624,2020-11,4054.01,6031.49,758.32,5851.77,-7070.93,-5263.93
216470066142578624,2020-12,1459.44,2736.19,4868.82,3437.87,154.2,-5109.73
216741987053558656,2020-01,117.22,1907.54,0,2522.81,-4313.13,-4313.13
216741987053558656,2020-02,0,1300,0,368.21,-1668.21,-5981.34
216741987053558656,2020-03,1104.96,1972.33,2609.08,0,1741.71,-4239.63
216741987053558656,2020-05,0,1449.54,1794.23,0,344.69,-3894.94
216741987053558656,2020-06,982.48,0,0,1563.86,-581.38,-4476.32
216741987053558656,2020-08,0,1504.4,434.92,0,-1069.48,-5545.8
216741987053558656,2020-09,364.83,0,0,122.84,241.99,-5303.81
216741987053558656,2020-10,0,1787.51,1112.57,0,-674.94,-5978.75
216741987053558656,2020-11,1389.07,0,1414.9,778.5,2025.47,-3953.28
216741987053558656,2020-12,0,1554.77,0,568.71,-2123.48,-6076.76
217445039957996384,2020-01,5151.69,3357.9,7126.46,1643.46,7276.79,7276.79
217445039957996384,2020-02,1120.48,8932.31,3716.92,3568.94,-7663.85,-387.06
217445039957996384,2020-03,5334.11,2092.81,1604.23,2188.15,2657.38,2270.32
217445039957996384,2020-04,2708.57,1407.17,8208.17,3783.01,5726.56,7996.88
217445039957996384,2020-05,8021.32,5553.38,3181.77,9173.67,-3523.96,4472.92
217445039957996384,2020-06,2449.28,3534.68,6759.21,5200.28,473.53,4946.45
217445039957996384,2020-07,3724.52,9750.36,3170.25,6232.42,-9088.01,-4141.56
217445039957996384,2020-08,1310.81,5142.3,4434.57,3363.75,-2760.67,-6902.23
217445039957996384,2020-09,2669.84,7398.78,1675.52,6681.04,-9734.46,-16636.69
217445039957996384,2020-10,10802.83,2076.22,4723.98,8405.19,5045.4,-11591.29
217445039957996384,2020-11,3523.33,3732.55,6092.71,1697.57,4185.92,-7405.37
217445039957996384,2020-12,482.69,6674.55,2865.33,3576.83,-6903.36,-14308.73
218577931722332640,2020-01,4780.87,4212.22,1972.11,2508.93,31.83,31.83
218577931722332640,2020-02,2248.74,2934.8,8980.01,3218.84,5075.11,5106.94
218577931722332640,2020-03,6386.83,3416.78,3386.55,5167.64,1188.96,6295.9
218577931722332640,2020-04,11084.22,819.51,7167.9,0,17432.61,23728.51
218577931722332640,2020-05,3542.34,4178.5,2465.91,6519.56,-4689.81,19038.7
218577931722332640,2020-06,1544.27,4196.63,2724.01,4224.22,-4152.57,14886.13
218577931722332640,2020-07,3987.7,2105.64,1999.83,4431.21,-549.32,14336.81
218577931722332640,2020-08,3629.32,3798.17,5676.6,6152.75,-645,13691.81
218577931722332640,2020-09,4177.12,871.03,1472.77,1217.3,3561.56,17253.37
218577931722332640,2020-10,1943.5,6737.16,4975.7,0,182.04,17435.41
218577931722332640,2020-11,4710.08,7726.33,2850.74,6633.77,-6799.28,10636.13
218577931722332640,2020-12,5825.73,4162.23,3507.47,2954.79,2216.18,12852.31
219268689427117536,2020-01,1539.67,1478.67,713.17,2525.71,-1751.54,-1751.54
219268689427117536,2020-02,6090.53,0,1802.23,4286.22,3606.54,1855
219268689427117536,2020-03,1572.76,6457.45,0,5023.86,-9908.55,-8053.55
219268689427117536,2020-04,1369,2758.84,1453.9,0,64.06,-7989.49
219268689427117536,2020-05,0,1875.87,1172.58,1506.84,-2210.13,-10199.62
219268689427117536,2020-06,0,842.93,0,3714.48,-4557.41,-14757.03
219268689427117536,2020-07,1512.7,0,3344.81,2603.63,2253.88,-12503.15
219268689427117536,2020-08,4909.73,148.09,2960.85,3421.91,4300.58,-8202.57
219268689427117536,2020-09,2188.16,0,2088.46,1826.44,2450.18,-5752.39
219268689427117536,2020-10,0,2662.42,3534.86,1667.87,-795.43,-6547.82
219268689427117536,2020-11,3038.18,0,3174.19,1441.33,4771.04,-1776.78
219268689427117536,2020-12,1879.9,1287.59,3899.01,1112.12,3379.2,1602.42
220444232987512352,2020-01,3509.67,2635.77,3647.03,2115.93,2405,2405
220444232987512352,2020-02,1782.87,386.26,1820.09,4178.8,-962.1,1442.9
220444232987512352,2020-03,2909.1,1677.53,1010.29,2918.34,-676.48,766.42
220444232987512352,2020-04,147.6,0,1667.05,1810.79,3.86,770.28
220444232987512352,2020-05,1844.2,4780.02,3691.07,1623.11,-867.86,-97.58
220444232987512352,2020-06,570.73,789.27,787.13,3130.45,-2561.86,-2659.44
220444232987512352,2020-07,3140.89,402.81,4038.53,5587.32,1189.29,-1470.15
220444232987512352,2020-08,531.15,1409.6,2654.03,5689.56,-3913.98,-5384.13
220444232987512352,2020-09,4729.84,624.14,1599.41,3293.91,2411.2,-2972.93
220444232987512352,2020-10,3308.52,2518.07,1527.24,7309.5,-4991.81,-7964.74
220444232987512352,2020-11,3392.27,839.45,577.4,1330.36,1799.86,-6164.88
220444232987512352,2020-12,510.26,1762.14,2264.18,3190.39,-2178.09,-8342.97
221139396845409280,2020-03,1000.22,0,0,0,1000.22,1000.22
221139396845409280,2020-04,0,1108.88,1764.46,0,655.58,1655.8
221139396845409280,2020-07,0,1439.2,1926.44,92.78,394.46,2050.26
221139396845409280,2020-08,1451.73,1328.47,0,0,123.26,2173.52
221139396845409280,2020-11,1785.26,0,876.32,36.67,2624.91,4798.43
222187109751174208,2020-01,0,302.91,1382.91,1690.67,-610.67,-610.67
222187109751174208,2020-02,0,1081.61,0,0,-1081.61,-1692.28
222187109751174208,2020-07,0,453.25,0,0,-453.25,-2145.53
222187109751174208,2020-10,0,1433.02,0,0,-1433.02,-3578.55
222187109751174208,2020-11,3019.56,380.49,0,0,2639.07,-939.48
222187109751174208,2020-12,1579.7,0,0,0,1579.7,640.22
223346700406302784,2020-01,1181.97,2510.03,1066.6,0,-261.46,-261.46
223346700406302784,2020-02,2427.69,1686.4,2983.92,734.84,2990.37,2728.91
223346700406302784,2020-03,2571.19,8193.28,1366.2,3306.75,-7562.64,-4833.73
223346700406302784,2020-04,3389.05,0,2788.14,1208.25,4968.94,135.21
223346700406302784,2020-05,7281.78,4433.01,4455.2,2021.08,5282.89,5418.1
223346700406302784,2020-06,1249.47,374.07,2472.13,2298.03,1049.5,6467.6
223346700406302784,2020-07,4322.61,3965.4,3584.57,3543.63,398.15,6865.75
223346700406302784,2020-08,68.85,3337.92,5825.83,1853.7,703.06,7568.81
223346700406302784,2020-09,6180.79,280.52,610.67,4265.55,2245.39,9814.2
223346700406302784,2020-10,805.42,2687.07,2591.52,6092.4,-5382.53,4431.67
223346700406302784,2020-11,9928.84,2058.96,2389.45,5116.46,5142.87,9574.54
223346700406302784,2020-12,0,2498.93,4505,3099.22,-1093.15,8481.39
224998961076740000,2020-01,3224.98,3210.69,4322.36,2079.58,2257.07,2257.07
224998961076740000,2020-02,7681.58,261.24,3006.01,6122.57,4303.78,6560.85
224998961076740000,2020-03,4888.69,1882.92,5212.04,3512.94,4704.87,11265.72
224998961076740000,2020-04,8418.23,3119.56,3803.44,4607.52,4494.59,15760.31
224998961076740000,2020-05,3815.41,5712.33,9039.44,7940.65,-798.13,14962.18
224998961076740000,2020-06,2843.55,1636.66,6592.26,3782.22,4016.93,18979.11
224998961076740000,2020-07,2595.61,5905.11,6043.08,280.01,2453.57,21432.68
224998961076740000,2020-08,2875.01,2330.83,2178.46,300.35,2422.29,23854.97
224998961076740000,2020-09,5295.61,3948.84,1313.58,3817.02,-1156.67,22698.3
224998961076740000,2020-10,1012.23,3285.34,0,6397.47,-8670.58,14027.72
224998961076740000,2020-11,5658.21,1971.63,3103.93,2791.97,3998.54,18026.26
224998961076740000,2020-12,3098.98,2722.74,3236.9,1162.62,2450.52,20476.78
225026510017061184,2020-03,1693.85,2862.21,802.68,0,-365.68,-365.68
225026510017061184,2020-04,0,1463.64,1747.95,0,284.31,-81.37
225026510017061184,2020-05,1013.73,0,0,2220.82,-1207.09,-1288.46
225026510017061184,2020-06,1218.54,0,1090.18,0,2308.72,1020.26
225026510017061184,2020-08,0,364.47,0,922.87,-1287.34,-267.08
225026510017061184,2020-09,53.94,788.22,621.64,0,-112.64,-379.72
225026510017061184,2020-12,1205.42,0,0,213.18,992.24,612.52
225952738792860992,2020-01,3623.87,3369.7,5880.33,4642.44,1492.06,1492.06
225952738792860992,2020-02,2883.82,3825.53,6660.11,2823.17,2895.23,4387.29
225952738792860992,2020-03,4157.46,5151.85,1960.6,5017.42,-4051.21,336.08
225952738792860992,2020-04,6163.78,2166.9,3661.64,4667.75,2990.77,3326.85
225952738792860992,2020-05,1725.15,2012.22,2118.1,2173.9,-342.87,2983.98
225952738792860992,2020-06,4324.8,3374.83,8420.25,7713.85,1656.37,4640.35
225952738792860992,2020-07,7797.56,6240.2,7286.65,5903.39,2940.62,7580.97
225952738792860992,2020-08,3864.5,3587.08,524.86,2516.86,-1714.58,5866.39
225952738792860992,2020-09,8669.1,3889.53,1698.13,2480.85,3996.85,9863.24
225952738792860992,2020-10,823.76,3984.84,4606.84,5771.13,-4325.37,5537.87
225952738792860992,2020-11,2549.66,786.24,1890.87,10437.47,-6783.18,-1245.31
225952738792860992,2020-12,637.76,5309.16,3438.98,2579.27,-3811.69,-5057
226289351272946176,2020-02,0,1233.92,0,0,-1233.92,-1233.92
226289351272946176,2020-03,0,993.37,0,0,-993.37,-2227.29
226289351272946176,2020-04,2035.3,439.45,1825.02,30.7,3390.17,1162.88
226289351272946176,2020-06,0,52.93,0,0,-52.93,1109.95
226289351272946176,2020-07,586.41,381.72,1858.14,1420.52,642.31,1752.26
226289351272946176,2020-08,0,1767.93,0,0,-1767.93,-15.67
226289351272946176,2020-10,2083.94,1737.9,0,9.09,336.95,321.28
226289351272946176,2020-11,1135.81,455.05,1933.99,0,2614.75,2936.03
226289351272946176,2020-12,0,1801.26,0,0,-1801.26,1134.77
227004700414053248,2020-01,2313.82,2476.87,3219.59,1483.42,1573.12,1573.12
227004700414053248,2020-02,2671.47,2585.98,0,3212.1,-3126.61,-1553.49
227004700414053248,2020-03,1943.45,3190.33,3610.25,3446.34,-1082.97,-2636.46
227004700414053248,2020-04,3981.31,4080.86,1664.51,2427.66,-862.7,-3499.16
227004700414053248,2020-05,3080.96,0,1054.94,5553.91,-1418.01,-4917.17
227004700414053248,2020-06,2739.49,3126.45,1783.32,5594.45,-4198.09,-9115.26
227004700414053248,2020-07,507.45,3019.97,4986.1,4762.02,-2288.44,-11403.7
227004700414053248,2020-08,3697.47,5319.81,2119.39,1854.19,-1357.14,-12760.84
227004700414053248,2020-09,2634.81,3027.18,3612.65,3387.16,-166.88,-12927.72
227004700414053248,2020-10,2671.93,0,3053.74,2250.01,3475.66,-9452.06
227004700414053248,2020-11,3313.84,7007.41,1509.17,1627.35,-3811.75,-13263.81
227004700414053248,2020-12,4322.44,444.59,0,4654.65,-776.8,-14040.61
228065570433614496,2020-01,7759.16,3934.8,4151.3,5273.43,2702.23,2702.23
228065570433614496,2020-02,2154.48,0,3149.47,4509.24,794.71,3496.94
228065570433614496,2020-03,3474.68,5816.66,3774.87,5519.29,-4086.4,-589.46
228065570433614496,2020-04,2053.99,3252.92,6649,1408.62,4041.45,3451.99
228065570433614496,2020-05,7797.7,3524.79,1344.99,4355.79,1262.11,4714.1
228065570433614496,2020-06,1871.93,2784.09,4616.3,1799.59,1904.55,6618.65
228065570433614496,2020-07,4590.5,3336.31,1904.26,0,3158.45,9777.1
228065570433614496,2020-08,2386.7,1569.47,2901.31,4502.17,-783.63,8993.47
228065570433614496,2020-09,4350.93,4931.88,2672.05,4633.55,-2542.45,6451.02
228065570433614496,2020-10,4140.3,2412.27,4869.53,1243.92,5353.64,11804.66
228065570433614496,2020-11,6446.89,0,3946.95,5719.66,4674.18,16478.84
228065570433614496,2020-12,3413.19,5134.86,2681.79,2852.54,-1892.42,14586.42
228480585457552768,2020-01,5085.57,5117.37,723.11,4084.18,-3392.87,-3392.87
228480585457552768,2020-02,6415.91,3443.35,5570.66,4972.5,3570.72,177.85
228480585457552768,2020-03,3329.25,4699.1,2399.71,2216.57,-1186.71,-1008.86
228480585457552768,2020-04,2798.92,3618.34,1586.56,7781.35,-7014.21,-8023.07
228480585457552768,2020-05,6346.34,10634,11684.69,2070.36,5326.67,-2696.4
228480585457552768,2020-06,1793.64,2957.88,3041.14,193.77,1683.13,-1013.27
228480585457552768,2020-07,4472.88,10606.36,8200.63,2362.71,-295.56,-1308.83
228480585457552768,2020-08,4587.52,2213.47,2538.13,1468.36,3443.82,2134.99
228480585457552768,2020-09,5874.13,4879.48,5674.5,3516.31,3152.84,5287.83
228480585457552768,2020-10,4209.88,2699.23,3316.71,3653.34,1174.02,6461.85
228480585457552768,2020-11,4860.99,1989.81,176.7,3778.99,-731.11,5730.74
228480585457552768,2020-12,5653.3,4201.04,7696.42,0,9148.68,14879.42
228511955072902112,2020-01,2754.49,2358.83,4308.3,1310.63,3393.33,3393.33
228511955072902112,2020-02,2997.41,339.73,1814,287.95,4183.73,7577.06
228511955072902112,2020-03,6289.45,3921.66,1343.51,2848.65,862.65,8439.71
228511955072902112,2020-04,2750.22,3871.63,2534.34,1756.07,-343.14,8096.57
228511955072902112,2020-05,1618.62,850.56,1802.96,2991.05,-420.03,7676.54
228511955072902112,2020-06,5130.53,2683.84,6500.93,869.23,8078.39,15754.93
228511955072902112,2020-07,3295.84,0,1411.01,0,4706.85,20461.78
228511955072902112,2020-08,2318.39,1597.6,886.73,999.45,608.07,21069.85
228511955072902112,2020-09,1014.59,0,0,1028.31,-13.72,21056.13
228511955072902112,2020-10,5545.28,3464,1451.05,1918.6,1613.73,22669.86
228511955072902112,2020-11,3446.93,1240.24,2615,4707.77,113.92,22783.78
228511955072902112,2020-12,1529.84,2558.95,3389.87,2225.75,135.01,22918.79
229439519458087456,2020-01,7938.79,2470.72,5471.17,3813.3,7125.94,7125.94
229439519458087456,2020-02,1276.19,9187.31,1482.06,6228.13,-12657.19,-5531.25
229439519458087456,2020-03,6569.12,3864.73,3916.32,4143.9,2476.81,-3054.44
229439519458087456,2020-04,3118.66,5957.47,6613.4,7896.02,-4121.43,-7175.87
229439519458087456,2020-05,3810.55,6456.23,3212.13,4204.8,-3638.35,-10814.22
229439519458087456,2020-06,6484.57,1753.65,3592.37,9232.09,-908.8,-11723.02
229439519458087456,2020-07,4120.55,785.28,13566.38,1145.8,15755.85,4032.83
229439519458087456,2020-08,1470.21,2819.36,8156.36,1851.97,4955.24,8988.07
229439519458087456,2020-09,8267.99,724.52,2726.69,7725.76,2544.4,11532.47
229439519458087456,2020-10,11311.33,3372.97,6783.66,1272.12,13449.9,24982.37
229439519458087456,2020-11,2722.97,2140.23,6083.16,8746.46,-2080.56,22901.81
229439519458087456,2020-12,3304.69,56.32,1745.06,6141.07,-1147.64,21754.17
229661046079442816,2020-01,5457.86,4922.22,1817.43,3759.39,-1406.32,-1406.32
229661046079442816,2020-02,7558.7,1767.75,2634.97,3279.02,5146.9,3740.58
229661046079442816,2020-03,5722.34,6963.36,3663.94,3639.94,-1217.02,2523.56
229661046079442816,2020-04,3573.04,2316.92,10303.14,1898.1,9661.16,12184.72
229661046079442816,2020-05,5015.99,6283.57,6785.39,3491.4,2026.41,14211.13
229661046079442816,2020-06,5325.21,1751.66,4163.79,3816.57,3920.77,18131.9
229661046079442816,2020-07,1056,4872.5,2516.54,1399.34,-2699.3,15432.6
229661046079442816,2020-08,4321.5,5056.85,7091.25,4291.4,2064.5,17497.1
229661046079442816,2020-09,7328.44,2331.14,4867.56,3405.15,6459.71,23956.81
229661046079442816,2020-10,8632.66,8811.51,2968.97,2506.65,283.47,24240.28
229661046079442816,2020-11,5560.42,3791.85,4095.3,8021.49,-2157.62,22082.66
229661046079442816,2020-12,4976.38,4378.38,8713.54,6706.22,2605.32,24687.98
229671953929727200,2020-01,2813.72,2840,253.01,826.32,-599.59,-599.59
229671953929727200,2020-02,3969.62,2359.46,833.3,1704.59,738.87,139.28
229671953929727200,2020-03,2479.64,363.02,1743.12,2978.19,881.55,1020.83
229671953929727200,2020-04,4278.16,1932.82,3442.48,0,5787.82,6808.65
229671953929727200,2020-05,6434.59,4119.54,5479.52,0,7794.57,14603.22
229671953929727200,2020-06,2305.83,1818.18,638.14,0,1125.79,15729.01
229671953929727200,2020-07,2468.86,3163.35,2018.95,1314.33,10.13,15739.14
229671953929727200,2020-08,1350.96,1918.62,1670.06,1558.53,-456.13,15283.01
229671953929727200,2020-09,948.02,2974.36,112.81,1228.18,-3141.71,12141.3
229671953929727200,2020-10,1122.26,1335.2,1407.11,990.9,203.27,12344.57
229671953929727200,2020-11,2927.98,0,1891.6,1360.13,3459.45,15804.02
229671953929727200,2020-12,0,2339.68,1175.28,3886.92,-5051.32,10752.7
230101691340016960,2020-01,4522.72,3698.52,7535.28,1831.03,6528.45,6528.45
230101691340016960,2020-02,3280.17,1267.3,1670.37,3348.38,334.86,6863.31
230101691340016960,2020-03,7132.27,3334.45,0,1863.24,1934.58,8797.89
230101691340016960,2020-04,1767.18,4124.98,1597.56,2062.91,-2823.15,5974.74
230101691340016960,2020-05,2828.53,5973.09,272.68,1955.41,-4827.29,1147.45
230101691340016960,2020-06,5748.6,3254.56,1637.65,801.65,3330.04,4477.49
230101691340016960,2020-07,3763,2725.86,3175.86,3937.97,275.03,4752.52
230101691340016960,2020-08,9920.84,2743.96,94.23,2441.49,4829.62,9582.14
230101691340016960,2020-09,4272.55,3821.95,7941.58,1913.48,6478.7,16060.84
230101691340016960,2020-10,3316.61,860.82,1097.79,5409.01,-1855.43,14205.41
230101691340016960,2020-11,6971.65,3827.25,3121.37,2633.44,3632.33,17837.74
230101691340016960,2020-12,5018.92,3311.84,3824.24,3903.57,1627.75,19465.49
230758908637388224,2020-01,0,3342.35,731.12,702.32,-3313.55,-3313.55
230758908637388224,2020-02,2334,2060.55,0,1404.64,-1131.19,-4444.74
230758908637388224,2020-03,403.81,1072.65,302.71,380.58,-746.71,-5191.45
230758908637388224,2020-04,0,2967.48,3718.58,554.49,196.61,-4994.84
230758908637388224,2020-05,1332.05,897.72,2209.64,712.84,1931.13,-3063.71
230758908637388224,2020-06,138.24,0,575.08,3489.31,-2775.99,-5839.7
230758908637388224,2020-07,56.03,1114.3,0,2380.3,-3438.57,-9278.27
230758908637388224,2020-08,0,1519.41,745.11,1420.89,-2195.19,-11473.46
230758908637388224,2020-09,1444.93,0,0,340.37,1104.56,-10368.9
230758908637388224,2020-10,761.24,2059.8,0,0,-1298.56,-11667.46
230758908637388224,2020-11,0,2055.9,1427.45,0,-628.45,-12295.91
230758908637388224,2020-12,658.27,0,1563.86,0,2222.13,-10073.78
231005937382814688,2020-01,2486.25,0,1511.63,1990.74,2007.14,2007.14
231005937382814688,2020-02,112.85,2963.43,1044.84,3596.21,-5401.95,-3394.81
231005937382814688,2020-03,1346.37,2955.45,1700.03,1836.63,-1745.68,-5140.49
231005937382814688,2020-04,3629.84,1471.51,1868.39,2091.75,1934.97,-3205.52
231005937382814688,2020-05,497.25,2809.5,2271.44,1301.16,-1341.97,-4547.49
231005937382814688,2020-06,0,3127.41,2899.62,4691.37,-4919.16,-9466.65
231005937382814688,2020-07,0,1964.34,7388.98,1406.03,4018.61,-5448.04
231005937382814688,2020-08,5750.71,2879.56,2739.63,3584.11,2026.67,-3421.37
231005937382814688,2020-09,4494.94,8012.25,2150.01,5161.25,-6528.55,-9949.92
231005937382814688,2020-10,1180.32,2694.48,3493.46,1823.7,155.6,-9794.32
231005937382814688,2020-11,1498.09,2567.36,1676.72,3009.27,-2401.82,-12196.14
231005937382814688,2020-12,0,4942.75,1643.54,3109.74,-6408.95,-18605.09
231366689818330016,2020-01,0,1670.36,1314.04,221,-577.32,-577.32
231366689818330016,2020-02,2682.23,282.31,0,646.84,1753.08,1175.76
231366689818330016,2020-03,2808.48,1543.13,74.75,0,1340.1,2515.86
231366689818330016,2020-04,1255.47,0,176.13,2627.87,-1196.27,1319.59
231366689818330016,2020-05,1651.59,0,0,3018.49,-1366.9,-47.31
231366689818330016,2020-06,0,276.17,1357.33,0,1081.16,1033.85
231366689818330016,2020-07,1.21,24.78,0,1040.07,-1063.64,-29.79
231366689818330016,2020-08,0,2350.48,477.31,0,-1873.17,-1902.96
231366689818330016,2020-09,1825.6,3404.62,1523.49,0,-55.53,-1958.49
231366689818330016,2020-10,0,1666.04,2317.84,0,651.8,-1306.69
231366689818330016,2020-11,1409.42,2309.74,0,0,-900.32,-2207.01
231366689818330016,2020-12,0,1038.38,147.79,815.92,-1706.51,-3913.52
234913061149708448,2020-03,0,4588.52,141.65,1527.89,-5974.76,-5974.76
234913061149708448,2020-04,1203.81,1954.46,1788.82,2198.91,-1160.74,-7135.5
234913061149708448,2020-05,486.98,0,1273.95,0,1760.93,-5374.57
234913061149708448,2020-06,370.57,850.5,2686.32,1749.73,456.66,-4917.91
234913061149708448,2020-07,1360.15,0,1534.08,1304.42,1589.81,-3328.1
234913061149708448,2020-08,3302.08,2099.12,68.83,1252.23,19.56,-3308.54
234913061149708448,2020-09,0,4165.32,1981.88,0,-2183.44,-5491.98
234913061149708448,2020-10,0,474.64,1475.13,1975.02,-974.53,-6466.51
234913061149708448,2020-11,261.4,938.52,0,0,-677.12,-7143.63
234913061149708448,2020-12,3607.15,1618.87,0,4068.35,-2080.07,-9223.7
235799480909338624,2020-01,1794.8,7231.34,2582.55,8367.85,-11221.84,-11221.84
235799480909338624,2020-02,584.65,624.3,5226.79,367.18,4819.96,-6401.88
235799480909338624,2020-03,6137.54,7360.41,4989.16,4788.67,-1022.38,-7424.26
235799480909338624,2020-04,672.33,4997.22,4359.03,6457.25,-6423.11,-13847.37
235799480909338624,2020-05,150.53,4222.01,4718.84,7807.82,-7160.46,-21007.83
235799480909338624,2020-06,8122.66,4498.43,1.57,6122.94,-2497.14,-23504.97
235799480909338624,2020-07,4417.86,4263.99,5748.24,5688.71,213.4,-23291.57
235799480909338624,2020-08,6444.02,3437.09,2955.98,10551.76,-4588.85,-27880.42
235799480909338624,2020-09,2787.96,4928.39,7029.03,19.5,4869.1,-23011.32
235799480909338624,2020-10,3116.78,1490.44,4062.53,1782.77,3906.1,-19105.22
235799480909338624,2020-11,2179.15,390.67,800.77,2251.99,337.26,-18767.96
235799480909338624,2020-12,2231.54,4494.79,6581.61,2217.44,2100.92,-16667.04
236087614141118112,2020-01,1603.73,4941.61,1923.04,2934.71,-4349.55,-4349.55
236087614141118112,2020-02,6336.65,7632.21,3166.5,2817.3,-946.36,-5295.91
236087614141118112,2020-03,2274.34,3560.06,3166.3,1908.78,-28.2,-5324.11
236087614141118112,2020-04,1073.22,4657.58,4922.42,3670.53,-2332.47,-7656.58
236087614141118112,2020-05,6116.44,3934.44,8174.86,2002.84,8354.02,697.44
236087614141118112,2020-06,3713.43,6627.63,1259.46,723.22,-2377.96,-1680.52
236087614141118112,2020-07,5541.81,5386.78,2097.93,814.67,1438.29,-242.23
236087614141118112,2020-08,4865.99,11810.93,2048.69,2480.59,-7376.84,-7619.07
236087614141118112,2020-09,221.37,5319.32,2593.46,6600.98,-9105.47,-16724.54
236087614141118112,2020-10,3313.51,1996.87,2488.46,3005.28,799.82,-15924.72
236087614141118112,2020-11,7224.42,3431.27,4883.17,5981.48,2694.84,-13229.88
236087614141118112,2020-12,6227.74,4752.65,6026.41,2385.89,5115.61,-8114.27
236851404232655232,2020-01,1837.59,164.21,1385.97,1631.12,1428.23,1428.23
236851404232655232,2020-02,2159.58,4979.11,4966.28,4081.74,-1934.99,-506.76
236851404232655232,2020-03,6196,4454.13,3471.49,1658.87,3554.49,3047.73
236851404232655232,2020-04,0,2074.08,4539.83,804.34,1661.41,4709.14
236851404232655232,2020-05,5610.5,4567.31,1660.66,4561.94,-1858.09,2851.05
236851404232655232,2020-06,1759.34,4740.73,2180.6,3417.23,-4218.02,-1366.97
236851404232655232,2020-07,2959.72,1228.42,3116.64,4018.81,829.13,-537.84
236851404232655232,2020-08,3089.91,2778.18,2167.16,2615.77,-136.88,-674.72
236851404232655232,2020-09,424.87,1250.59,0,3877.27,-4702.99,-5377.71
236851404232655232,2020-10,1866.56,3574.35,1713.06,4099.26,-4093.99,-9471.7
236851404232655232,2020-11,1320.35,2859.32,3542.21,2567.9,-564.66,-10036.36
236851404232655232,2020-12,2876.83,1124.66,1775.44,1632.48,1895.13,-8141.23
237705123451545984,2020-01,3259.61,0,626.1,1220.79,2664.92,2664.92
237705123451545984,2020-02,1873.7,1994.59,2786.18,1805.72,859.57,3524.49
237705123451545984,2020-03,265.83,1728.81,1114.28,0,-348.7,3175.79
237705123451545984,2020-04,0,1056.41,0,0,-1056.41,2119.38
237705123451545984,2020-05,3811.11,2165.44,0,87.14,1558.53,3677.91
237705123451545984,2020-07,1940.68,733.06,0,0,1207.62,4885.53
237705123451545984,2020-08,1245.81,2974.77,0,1832.71,-3561.67,1323.86
237705123451545984,2020-09,0,2619.13,1268.4,198.69,-1549.42,-225.56
237705123451545984,2020-11,2380.14,0,2026.2,1451.32,2955.02,2729.46
237705123451545984,2020-12,1044.87,0,0,0,1044.87,3774.33
238109535343645056,2020-01,4588.4,0,7160.84,5345.13,6404.11,6404.11
238109535343645056,2020-02,4336.53,3975.22,2605.57,2653.35,313.53,6717.64
238109535343645056,2020-03,1182.86,6666.82,3134.29,5159.94,-7509.61,-791.97
238109535343645056,2020-04,5540.16,3387.38,2317.62,4344.13,126.27,-665.7
238109535343645056,2020-05,7758.78,6810,3731.68,5748.09,-1067.63,-1733.33
238109535343645056,2020-06,4875.06,4012.61,417.83,2490.49,-1210.21,-2943.54
238109535343645056,2020-07,3074.87,3884.08,4331.54,6028.88,-2506.55,-5450.09
238109535343645056,2020-08,3227.68,9044.8,7939.22,3110.42,-988.32,-6438.41
238109535343645056,2020-09,6307.62,6515.87,976.33,1734.9,-966.82,-7405.23
238109535343645056,2020-10,0,4609.39,2665.12,9451.65,-11395.92,-18801.15
238109535343645056,2020-11,3397.03,2705.53,2362.14,3806.11,-752.47,-19553.62
238109535343645056,2020-12,6971.35,7241.57,3894.13,2472.79,1151.12,-18402.5
238935372242917888,2020-01,260.55,0,3634.32,3756.19,138.68,138.68
238935372242917888,2020-02,1869.22,221.53,3219.42,173.04,4694.07,4832.75
238935372242917888,2020-03,1799.78,2669.94,4236.42,1808.42,1557.84,6390.59
238935372242917888,2020-04,562.36,0,501.61,0,1063.97,7454.56
238935372242917888,2020-05,923.45,6009.23,3072.89,1856.42,-3869.31,3585.25
238935372242917888,2020-06,554.46,2008.21,4386.1,3035.44,-103.09,3482.16
238935372242917888,2020-07,1469.7,1614.08,3521.91,2414.48,963.05,4445.21
238935372242917888,2020-08,0,1245.43,253.63,3000.16,-3991.96,453.25
238935372242917888,2020-09,3064.33,4875.7,882.74,2388.97,-3317.6,-2864.35
238935372242917888,2020-10,5171.8,3101.17,2199.33,2559.85,1710.11,-1154.24
238935372242917888,2020-11,777.56,1925.25,1261.65,2495.39,-2381.43,-3535.67
238935372242917888,2020-12,835.8,772.59,0,94.72,-31.51,-3567.18
240344571053975936,2020-01,10115.4,584.71,8967.29,3133,15364.98,15364.98
240344571053975936,2020-02,2881.44,0,3195.17,3121.51,2955.1,18320.08
240344571053975936,2020-03,3294.79,4274.06,1494.12,5670.8,-5155.95,13164.13
240344571053975936,2020-04,3627.74,1730.13,3452.19,3176.66,2173.14,15337.27
240344571053975936,2020-05,4679.62,2255.75,954.14,6586.3,-3208.29,12128.98
240344571053975936,2020-06,1835.56,3006.06,5899.58,4638.23,90.85,12219.83
240344571053975936,2020-07,2858.54,7029.46,4632.81,5156.38,-4694.49,7525.34
240344571053975936,2020-08,883.25,5770.95,3786.37,2497.45,-3598.78,3926.56
240344571053975936,2020-09,2952.91,8004.33,1691.59,2277.86,-5637.69,-1711.13
240344571053975936,2020-10,4662.14,2722.84,3379.13,4204.39,1114.04,-597.09
240344571053975936,2020-11,7911.41,465.66,63.7,4142.87,3366.58,2769.49
240344571053975936,2020-12,5602.01,2759.52,6335.4,4950.74,4227.15,6996.64
240821034611075040,2020-01,3065.6,1729.12,2258.62,3343.32,251.78,251.78
240821034611075040,2020-02,1011.67,5381.84,1133.94,2325.09,-5561.32,-5309.54
240821034611075040,2020-03,5212.27,965.66,2406.25,4634.86,2018,-3291.54
240821034611075040,2020-04,6972.26,2195.49,637.05,6127.52,-713.7,-4005.24
240821034611075040,2020-05,1182.2,1994.05,2544.89,1681.07,51.97,-3953.27
240821034611075040,2020-06,4322.4,3141.28,3929.33,6341.1,-1230.65,-5183.92
240821034611075040,2020-07,5420.54,2171.69,760.84,3746.35,263.34,-4920.58
240821034611075040,2020-08,5713.41,71.92,1439.13,2932.79,4147.83,-772.75
240821034611075040,2020-09,0,4484.17,3653.16,1978.28,-2809.29,-3582.04
240821034611075040,2020-10,6665.13,3262.04,4463.54,111.17,7755.46,4173.42
240821034611075040,2020-11,2730.05,1009.24,609.26,6350.99,-4020.92,152.5
240821034611075040,2020-12,4480.93,2297.83,2736.9,1463.24,3456.76,3609.26
242996732329793568,2020-01,2082.19,2870.35,175.33,123.73,-736.56,-736.56
242996732329793568,2020-02,1086.33,3164.32,175.28,3859.19,-5761.9,-6498.46
242996732329793568,2020-03,2375.09,0,1299.84,0,3674.93,-2823.53
242996732329793568,2020-04,1569.61,2674.18,2934.19,2690.95,-861.33,-3684.86
242996732329793568,2020-05,1937.26,454.98,504.21,2048.83,-62.34,-3747.2
242996732329793568,2020-07,0,1557.7,0,2241.41,-3799.11,-7546.31
242996732329793568,2020-08,0,2131.36,0,0,-2131.36,-9677.67
242996732329793568,2020-09,1339.45,0,1293.68,1946.9,686.23,-8991.44
242996732329793568,2020-10,1287.6,2073.03,1410.92,184.93,440.56,-8550.88
242996732329793568,2020-11,436.7,125.88,2190.86,2191.36,310.32,-8240.56
242996732329793568,2020-12,3328.22,1990.24,0,2569.08,-1231.1,-9471.66
244052804909135264,2020-01,5650.45,8372.45,4668.21,2012.52,-66.31,-66.31
244052804909135264,2020-02,0,6964.75,4100.64,5412.22,-8276.33,-8342.64
244052804909135264,2020-03,3170.27,8332.69,6690.5,6234.49,-4706.41,-13049.05
244052804909135264,2020-04,4552.34,4605.83,1453.91,6085.72,-4685.3,-17734.35
244052804909135264,2020-05,8874.89,5946.75,4520.92,4622.18,2826.88,-14907.47
244052804909135264,2020-06,6444.05,1898.23,8316.02,8900.3,3961.54,-10945.93
244052804909135264,2020-07,2612.31,2363.73,0,11898.07,-11649.49,-22595.42
244052804909135264,2020-08,3782.27,900.64,3296.54,4684.97,1493.2,-21102.22
244052804909135264,2020-09,6758.59,2811.54,7993.36,1669.17,10271.24,-10830.98
244052804909135264,2020-10,8252.32,2829.35,1288.59,2488.73,4222.83,-6608.15
244052804909135264,2020-11,13005.21,4947.34,1950.92,1425.19,8583.6,1975.45
244052804909135264,2020-12,3051.05,6819.93,3169,5692.37,-6292.25,-4316.8
244215509342831328,2020-02,0,432.15,0,0,-432.15,-432.15
244215509342831328,2020-03,0,1904.92,0,1716.82,-3621.74,-4053.89
244215509342831328,2020-04,4259.5,497.95,0,0,3761.55,-292.34
244215509342831328,2020-05,1738.59,0,965.83,697.78,2006.64,1714.3
244215509342831328,2020-06,0,2768.27,6052.78,0,3284.51,4998.81
244215509342831328,2020-07,0,784.3,0,5.19,-789.49,4209.32
244215509342831328,2020-08,0,1811.31,3114.21,374.07,928.83,5138.15
244215509342831328,2020-09,0,1988.25,0,0,-1988.25,3149.9
244215509342831328,2020-10,2362.01,0,611.41,2656.83,316.59,3466.49
244215509342831328,2020-11,717.9,2377.27,0,0,-1659.37,1807.12
244215509342831328,2020-12,1897.94,1608.46,195.24,0,484.72,2291.84
244418242287710496,2020-01,1841.27,879.48,1943.8,817.74,2087.85,2087.85
244418242287710496,2020-02,2629.69,5587.4,2585.52,1234.79,-1606.98,480.87
244418242287710496,2020-03,1189.74,1712.44,0,389.02,-911.72,-430.85
244418242287710496,2020-04,1666.34,1577.17,661.85,1741.48,-990.46,-1421.31
244418242287710496,2020-05,1570.74,4136.61,4300.92,1280,455.05,-966.26
244418242287710496,2020-06,6943.79,194.76,0,6067.56,681.47,-284.79
244418242287710496,2020-07,958.4,2334.61,3278.13,4864.63,-2962.71,-3247.5
244418242287710496,2020-08,4309.59,3590.54,611.77,1758.52,-427.7,-3675.2
244418242287710496,2020-09,2963.01,963.28,496.85,3310.24,-813.66,-4488.86
244418242287710496,2020-10,1485.91,1291.96,5404.26,3781.38,1816.83,-2672.03
244418242287710496,2020-11,0,454.39,0,1171.69,-1626.08,-4298.11
244418242287710496,2020-12,2730.88,6608.25,1461.3,2976.22,-5392.29,-9690.4
246428778563527456,2020-01,2476.87,885.34,0,1629.53,-38,-38
246428778563527456,2020-02,1383.37,354.57,3150.98,2555.23,1624.55,1586.55
246428778563527456,2020-03,2302.53,1940.3,3055.49,0,3417.72,5004.27
246428778563527456,2020-04,0,2957.84,0,1404.67,-4362.51,641.76
246428778563527456,2020-05,927.77,5091.97,1315.44,796.72,-3645.48,-3003.72
246428778563527456,2020-06,3305.87,0,5203.96,751.65,7758.18,4754.46
246428778563527456,2020-07,1968.01,0,2191.43,4241.58,-82.14,4672.32
246428778563527456,2020-08,1562.21,2923.3,925.74,3373.16,-3808.51,863.81
246428778563527456,2020-09,1287.87,5521.87,803.55,2943.34,-6373.79,-5509.98
246428778563527456,2020-10,3422.07,1282.16,4415.13,1722.21,4832.83,-677.15
246428778563527456,2020-11,1791.63,111.33,1880.46,505.41,3055.35,2378.2
246428778563527456,2020-12,0,1567.41,1806.49,3446.42,-3207.34,-829.14
246454645583650144,2020-01,1121.42,3826.2,653.37,6854.04,-8905.45,-8905.45
246454645583650144,2020-02,6649.64,1967.18,424.62,3928.2,1178.88,-7726.57
246454645583650144,2020-03,9629.09,4157.86,6913.14,3405.18,8979.19,1252.62
246454645583650144,2020-04,8314.57,1965.43,9263.22,6388.86,9223.5,10476.12
246454645583650144,2020-05,4613.62,2688.07,5860.57,7081.52,704.6,11180.72
246454645583650144,2020-06,4015.36,1814.06,3569.76,1296.27,4474.79,15655.51
246454645583650144,2020-07,1310.65,4639.07,2726.57,2148.97,-2750.82,12904.69
246454645583650144,2020-08,1955.82,773.29,1953.32,3123.23,12.62,12917.31
246454645583650144,2020-09,1408.18,4899.09,4247.97,10555.56,-9798.5,3118.81
246454645583650144,2020-10,3083.85,82.91,2612.08,5966.42,-353.4,2765.41
246454645583650144,2020-11,10323.53,5241.5,2976.38,4339.68,3718.73,6484.14
246454645583650144,2020-12,4111.24,892.61,2211,1363.82,4065.81,10549.95
246814085100035776,2020-01,2128.96,141.25,1607.43,1410.32,2184.82,2184.82
246814085100035776,2020-02,2899.73,1768.3,0,3486.85,-2355.42,-170.6
246814085100035776,2020-03,0,1285.62,4876.8,0,3591.18,3420.58
246814085100035776,2020-04,0,1985.43,0,0,-1985.43,1435.15
246814085100035776,2020-05,260.69,2212.98,150.24,2442.37,-4244.42,-2809.27
246814085100035776,2020-06,3120.31,1581.62,408.59,851.75,1095.53,-1713.74
246814085100035776,2020-07,1889.91,430.39,1234.25,659.73,2034.04,320.3
246814085100035776,2020-08,1887.31,0,1473.06,1051.88,2308.49,2628.79
246814085100035776,2020-09,0,2484.7,1169.16,1965.26,-3280.8,-652.01
246814085100035776,2020-10,964.83,2730.85,420.84,1488.96,-2834.14,-3486.15
246814085100035776,2020-11,609.88,2343.55,2348.48,2289.58,-1674.77,-5160.92
246814085100035776,2020-12,0,734.69,2295.05,4.17,1556.19,-3604.73
247224003417008416,2020-01,2502.67,3092.5,5251.1,7223.91,-2562.64,-2562.64
247224003417008416,2020-02,6725.99,1703.67,4315.02,158.71,9178.63,6615.99
247224003417008416,2020-03,1766.18,2921.32,5618.62,5001.39,-537.91,6078.08
247224003417008416,2020-04,4969.65,3165.43,4312.32,229.99,5886.55,11964.63
247224003417008416,2020-05,3147.38,3412.41,3002.59,5211.96,-2474.4,9490.23
247224003417008416,2020-06,1721.16,1661.85,5414.08,5036.35,437.04,9927.27
247224003417008416,2020-07,2149.72,1599.43,975.79,2215.96,-689.88,9237.39
247224003417008416,2020-08,3854.4,7954.04,3651.82,8392.39,-8840.21,397.18
247224003417008416,2020-09,7376.45,1646.4,5511.98,0,11242.03,11639.21
247224003417008416,2020-10,10373.58,9355.25,6940.13,2052.23,5906.23,17545.44
247224003417008416,2020-11,4687.06,3143.25,1783.89,1985.21,1342.49,18887.93
247224003417008416,2020-12,2915.12,869.91,5468.84,3772.45,3741.6,22629.53
247465181245577664,2020-01,3846.24,844.78,1218.19,4029.98,189.67,189.67
247465181245577664,2020-02,3473.8,2620.26,3408.26,3409.45,852.35,1042.02
247465181245577664,2020-03,5067.72,3021.34,1709.66,2881.93,874.11,1916.13
247465181245577664,2020-04,3001.45,2671.01,3569.67,3005.21,894.9,2811.03
247465181245577664,2020-05,3806.45,1268.96,1998.38,1685.04,2850.83,5661.86
247465181245577664,2020-06,2268.2,3559.24,1424.01,1890.94,-1757.97,3903.89
247465181245577664,2020-07,2609.68,2354.35,4629.48,4126.73,758.08,4661.97
247465181245577664,2020-08,557.84,710.32,1934.35,4136.74,-2354.87,2307.1
247465181245577664,2020-09,1075.42,284.53,2808.21,0,3599.1,5906.2
247465181245577664,2020-10,0,1504.85,2720.18,2092.4,-877.07,5029.13
247465181245577664,2020-11,1753.95,2085.64,1993.8,4216.73,-2554.62,2474.51
247465181245577664,2020-12,1920.57,2141.09,1273.16,1449.78,-397.14,2077.37
247482271263894688,2020-01,7420.14,2607.36,3506.96,2535.76,5783.98,5783.98
247482271263894688,2020-02,3769.64,7225.37,4371.97,5211.95,-4295.71,1488.27
247482271263894688,2020-03,6152.11,2631.2,1253.24,12757.88,-7983.73,-6495.46
247482271263894688,2020-04,3582.6,861.3,4623.61,12869.89,-5524.98,-12020.44
247482271263894688,2020-05,4133.46,1766.15,5392.02,6219.52,1539.81,-10480.63
247482271263894688,2020-06,9403.51,4514.79,5539.11,4072.05,6355.78,-4124.85
247482271263894688,2020-07,3663.23,3053.2,3069.12,2170.72,1508.43,-2616.42
247482271263894688,2020-08,3647.16,9500.64,3973.56,4337.25,-6217.17,-8833.59
247482271263894688,2020-09,1535.7,2088.37,2802.27,7694.22,-5444.62,-14278.21
247482271263894688,2020-10,1663.4,8495.56,4425.61,2613.87,-5020.42,-19298.63
247482271263894688,2020-11,5944.89,4069.62,4551.9,5639.45,787.72,-18510.91
247482271263894688,2020-12,10064.47,3397.56,4527.19,1928.86,9265.24,-9245.67
248747515350902368,2020-01,6511.9,2054.03,1745.97,0,6203.84,6203.84
248747515350902368,2020-02,363.69,3716.13,3928.52,2577.58,-2001.5,4202.34
248747515350902368,2020-03,2904.04,2196.78,142.69,1917.89,-1067.94,3134.4
248747515350902368,2020-04,1980.27,2256.02,0,893.95,-1169.7,1964.7
248747515350902368,2020-05,2995.36,585.32,3235.28,1257.76,4387.56,6352.26
248747515350902368,2020-06,3297.32,621.21,299.49,2118.6,857,7209.26
248747515350902368,2020-07,1670.95,6133.98,0,2680.38,-7143.41,65.85
248747515350902368,2020-08,1623.49,2771.18,989.48,1950.18,-2108.39,-2042.54
248747515350902368,2020-09,1604.48,2502.48,0,2090.53,-2988.53,-5031.07
248747515350902368,2020-10,1355.82,4830.69,991.37,3292.23,-5775.73,-10806.8
248747515350902368,2020-11,0,4505.58,2065.64,1988.9,-4428.84,-15235.64
248747515350902368,2020-12,2820.97,1484,2414.91,101.94,3649.94,-11585.7
249195818884389568,2020-01,0,3091,5658.29,0,2567.29,2567.29
249195818884389568,2020-02,708.03,1668.16,1800.56,5240.3,-4399.87,-1832.58
249195818884389568,2020-03,0,2022.16,4237.5,0,2215.34,382.76
249195818884389568,2020-04,1433.9,2051.65,2171.48,2622.95,-1069.22,-686.46
249195818884389568,2020-05,0,1009.08,1746.19,4391.52,-3654.41,-4340.87
249195818884389568,2020-06,1468.22,817.86,725.73,598.55,777.54,-3563.33
249195818884389568,2020-07,0,2946.98,0,0,-2946.98,-6510.31
249195818884389568,2020-08,6099.53,2622.72,2815.51,1765.21,4527.11,-1983.2
249195818884389568,2020-09,0,4526.45,4942.68,1640.4,-1224.17,-3207.37
249195818884389568,2020-10,2603.5,4129.65,915,319.17,-930.32,-4137.69
249195818884389568,2020-11,1339.82,993.6,3352.62,1811.7,1887.14,-2250.55
249195818884389568,2020-12,2923.74,1190.05,2124.24,4180.28,-322.35,-2572.9
249383402739336896,2020-01,1084.75,0,207.97,0,1292.72,1292.72
249383402739336896,2020-02,4975.09,404.46,5953.95,1440.66,9083.92,10376.64
249383402739336896,2020-03,1094.62,2126.01,5251.87,2412.09,1808.39,12185.03
249383402739336896,2020-04,3352.62,4420.44,4314.3,0,3246.48,15431.51
249383402739336896,2020-05,268.52,5756.78,1778.71,5219.75,-8929.3,6502.21
249383402739336896,2020-06,0,5549.27,1684.62,2455.68,-6320.33,181.88
249383402739336896,2020-07,2637.13,252.56,4135.59,701.23,5818.93,6000.81
249383402739336896,2020-08,1462.48,2321.85,2664.83,4364.04,-2558.58,3442.23
249383402739336896,2020-09,1852.22,2472.25,2764.56,2906.94,-762.41,2679.82
249383402739336896,2020-10,1874.88,4583.56,2460.2,3355.42,-3603.9,-924.08
249383402739336896,2020-11,0,2480.44,4029.53,3528.29,-1979.2,-2903.28
249383402739336896,2020-12,1224.65,0,211.25,3014.91,-1579.01,-4482.29
249682909731872992,2020-01,0,160.92,3053.36,1791.81,1100.63,1100.63
249682909731872992,2020-02,1286.78,2937.31,1007.81,0,-642.72,457.91
249682909731872992,2020-03,2286.01,899.85,0,1543.17,-157.01,300.9
249682909731872992,2020-04,0,3318.1,1368.21,80.41,-2030.3,-1729.4
249682909731872992,2020-05,1117.47,54.93,0,2499.18,-1436.64,-3166.04
249682909731872992,2020-06,530.21,1756.11,0,209.57,-1435.47,-4601.51
249682909731872992,2020-07,4885.76,2069.73,0,0,2816.03,-1785.48
249682909731872992,2020-08,1858.82,791.86,1220.28,551.96,1735.28,-50.2
249682909731872992,2020-10,959,2167.58,0,2821.11,-4029.69,-4079.89
249682909731872992,2020-11,3288.97,0,1961.01,1382.96,3867.02,-212.87
249682909731872992,2020-12,260.58,0,0,1299.98,-1039.4,-1252.27
252895083400328288,2020-01,0,1438.05,2589.73,411.38,740.3,740.3
252895083400328288,2020-04,0,81.41,0,0,-81.41,658.89
252895083400328288,2020-05,1882.65,1554.06,1617.88,2211.63,-265.16,393.73
252895083400328288,2020-06,0,1453.84,420.27,0,-1033.57,-639.84
252895083400328288,2020-08,577.23,0,0,0,577.23,-62.61
252895083400328288,2020-09,0,1180.07,0,0,-1180.07,-1242.68
252895083400328288,2020-10,1133.99,0,0,0,1133.99,-108.69
252895083400328288,2020-12,0,443.01,0,0,-443.01,-551.7
253279358514960512,2020-01,2764.93,1852.85,3997.8,2793.15,2116.73,2116.73
253279358514960512,2020-02,7071.21,4422.62,3452.15,3328.04,2772.7,4889.43
253279358514960512,2020-03,4644.25,3654.3,6766.33,5048.54,2707.74,7597.17
253279358514960512,2020-04,0,15883.03,6596.98,4282.43,-13568.48,-5971.31
253279358514960512,2020-05,4691.58,2408.48,8003.5,677.12,9609.48,3638.17
253279358514960512,2020-06,1981.62,665.85,4776.1,2012.52,4079.35,7717.52
253279358514960512,2020-07,5531.93,4543.12,3666.74,1800.45,2855.1,10572.62
253279358514960512,2020-08,2734.26,5926.24,6127.48,1528.68,1406.82,11979.44
253279358514960512,2020-09,3803.47,6505.06,2634.25,2812.84,-2880.18,9099.26
253279358514960512,2020-10,4237.69,2507.75,5131.32,273.6,6587.66,15686.92
253279358514960512,2020-11,5085.85,2033.17,8334.89,1983.59,9403.98,25090.9
253279358514960512,2020-12,1021.25,4686.75,1570.54,3469.21,-5564.17,19526.73
253443492219014048,2020-03,798.52,1069.06,1041.03,0,770.49,770.49
253443492219014048,2020-04,5415.02,0,0,521.04,4893.98,5664.47
253443492219014048,2020-07,1080.55,444.8,0,1971.36,-1335.61,4328.86
253443492219014048,2020-08,1316.93,391.07,2471.2,0,3397.06,7725.92
253443492219014048,2020-09,0,68.7,0,2019.62,-2088.32,5637.6
253443492219014048,2020-10,1581.02,970.21,0,1926.21,-1315.4,4322.2
253694561230882592,2020-02,588.58,0,0,0,588.58,588.58
253694561230882592,2020-10,1249.4,0,0,0,1249.4,1837.98
253694561230882592,2020-11,942.55,0,0,0,942.55,2780.53
254296325101355072,2020-06,0,64.72,0,885.77,-950.49,-950.49
254296325101355072,2020-09,1477.8,0,2030.19,0,3507.99,2557.5
254296325101355072,2020-10,0,673.65,0,2281.93,-2955.58,-398.08
254296325101355072,2020-11,0,1644.19,0,0,-1644.19,-2042.27
254296325101355072,2020-12,0,124.16,0,685.91,-810.07,-2852.34
256071406907151104,2020-01,5535.36,4474.76,3864.46,1977.61,2947.45,2947.45
256071406907151104,2020-02,5298.02,1741.27,671.21,179.33,4048.63,6996.08
256071406907151104,2020-03,4163.26,223.69,1509.49,4350.24,1098.82,8094.9
256071406907151104,2020-04,5458.67,6580.01,5035.38,6480.79,-2566.75,5528.15
256071406907151104,2020-05,3708.42,1786.12,1758.71,2343.3,1337.71,6865.86
256071406907151104,2020-06,4857.11,6101.46,5589.73,2416.49,1928.89,8794.75
256071406907151104,2020-07,7673.29,1575.93,2181.49,5074.89,3203.96,11998.71
256071406907151104,2020-08,2161.38,3857.84,4213.07,3413.63,-897.02,11101.69
256071406907151104,2020-09,3073.13,0,1336.19,1886.51,2522.81,13624.5
256071406907151104,2020-10,2162.37,1177.64,2767.03,3438.06,313.7,13938.2
256071406907151104,2020-11,7129.62,2707.68,6544.72,803.86,10162.8,24101
256071406907151104,2020-12,4226.87,1851.65,5674.67,5291.41,2758.48,26859.48
256138946050576608,2020-01,1289.48,2681.4,183.74,3162.65,-4370.83,-4370.83
256138946050576608,2020-02,0,1986.79,17.87,0,-1968.92,-6339.75
256138946050576608,2020-03,4711.21,1089.82,0,0,3621.39,-2718.36
256138946050576608,2020-04,0,1849.2,3758.38,7.62,1901.56,-816.8
256138946050576608,2020-05,0,1948.97,2143.52,0,194.55,-622.25
256138946050576608,2020-06,0,3289.47,1571.9,1805.46,-3523.03,-4145.28
256138946050576608,2020-07,1140.8,0,2785.37,7.57,3918.6,-226.68
256138946050576608,2020-08,216.55,1532.71,2383.72,0,1067.56,840.88
256138946050576608,2020-09,0,550.06,0,0,-550.06,290.82
256138946050576608,2020-10,1023.77,0,194.33,580.59,637.51,928.33
256138946050576608,2020-11,658.53,0,2707.97,0,3366.5,4294.83
256138946050576608,2020-12,898.71,1765.59,0,0,-866.88,3427.95
256676415234214144,2020-01,218.26,0,0,0,218.26,218.26
256676415234214144,2020-03,1062.51,0,1366.25,0,2428.76,2647.02
256676415234214144,2020-04,0,200.33,0,0,-200.33,2446.69
256676415234214144,2020-07,0,144.44,670.31,0,525.87,2972.56
256676415234214144,2020-08,1711.66,0,3246.84,0,4958.5,7931.06
256676415234214144,2020-11,0,178.02,2303.69,0,2125.67,10056.73
256676415234214144,2020-12,0,41.57,0,3065.65,-3107.22,6949.51
257156172637830752,2020-01,5344.6,3386.65,5202.68,6178.55,982.08,982.08
257156172637830752,2020-02,6781.01,1155.49,4066.88,5976.2,3716.2,4698.28
257156172637830752,2020-03,6938.09,1121.77,1291.38,3261.14,3846.56,8544.84
257156172637830752,2020-04,4804.49,5308.89,4917.41,4042.85,370.16,8915
257156172637830752,2020-05,3340.91,8829.65,10966.79,4042.47,1435.58,10350.58
257156172637830752,2020-06,6997.25,2861.83,6505.58,2591.53,8049.47,18400.05
257156172637830752,2020-07,3164.67,2057.55,5276.91,2790.02,3594.01,21994.06
257156172637830752,2020-08,4631.07,4754.4,4424.21,3104.01,1196.87,23190.93
257156172637830752,2020-09,3385.07,3885.29,6063.34,6516.79,-953.67,22237.26
257156172637830752,2020-10,2712.34,6580.68,7670.6,3716.82,85.44,22322.7
257156172637830752,2020-11,3672.19,905.61,1588.72,2911.81,1443.49,23766.19
257156172637830752,2020-12,1710.39,3555.47,3362.99,4983.45,-3465.54,20300.65
257422111230735104,2020-01,6529.7,4586.29,3915.72,3215.04,2644.09,2644.09
257422111230735104,2020-02,7462.46,2269.87,4103.98,2667.39,6629.18,9273.27
257422111230735104,2020-03,8066.24,4455.31,4691.73,3342.86,4959.8,14233.07
257422111230735104,2020-04,5224.92,5998.82,2161.41,1967.93,-580.42,13652.65
257422111230735104,2020-05,8502.64,3042.36,3532.65,2121.76,6871.17,20523.82
257422111230735104,2020-06,2831.52,3369.15,6434.09,1921.36,3975.1,24498.92
257422111230735104,2020-07,6477,130.46,5920.63,893.22,11373.95,35872.87
257422111230735104,2020-08,4977.52,3009.58,1917.13,0,3885.07,39757.94
257422111230735104,2020-09,4279.12,978.29,3495.85,2321.57,4475.11,44233.05
257422111230735104,2020-10,3532.98,1868.92,3958.83,3893.13,1729.76,45962.81
257422111230735104,2020-11,1430.2,4046.11,3185.92,3813.3,-3243.29,42719.52
257422111230735104,2020-12,1886.99,4931.18,2624.77,499.03,-918.45,41801.07
258052331167854624,2020-01,0,3788.27,6767.18,0,2978.91,2978.91
258052331167854624,2020-02,872.48,871.91,1697.19,805.41,892.35,3871.26
258052331167854624,2020-03,0,347.9,5661.47,1043.63,4269.94,8141.2
258052331167854624,2020-04,2102.78,0,0,765.89,1336.89,9478.09
258052331167854624,2020-06,4217.36,445.59,402.96,1819.34,2355.39,11833.48
258052331167854624,2020-07,0,493.66,5347.91,497.87,4356.38,16189.86
258052331167854624,2020-08,1274.56,1050.98,3055.16,1514.72,1764.02,17953.88
258052331167854624,2020-09,3816.35,1559.69,55.69,0,2312.35,20266.23
258052331167854624,2020-10,509.97,0,1721.41,815.68,1415.7,21681.93
258052331167854624,2020-11,1752.08,2750.82,3112.62,2497.76,-383.88,21298.05
258052331167854624,2020-12,0,1729.6,2278.71,2387.53,-1838.42,19459.63
258143738296482496,2020-01,3838.35,1967.49,7119.58,5361.53,3628.91,3628.91
258143738296482496,2020-02,5965.06,3432.79,8173.63,3251.64,7454.26,11083.17
258143738296482496,2020-03,1658.85,2705.16,4683.69,2929.73,707.65,11790.82
258143738296482496,2020-04,6053.8,2157.44,2025.05,1225.91,4695.5,16486.32
258143738296482496,2020-05,3182.64,2483.93,0,6770.44,-6071.73,10414.59
258143738296482496,2020-06,3887.19,1410.41,7235.72,3982.82,5729.68,16144.27
258143738296482496,2020-07,3507.42,7372.1,2800.18,6058.01,-7122.51,9021.76
258143738296482496,2020-08,1719.28,2264.48,1525.15,2023.63,-1043.68,7978.08
258143738296482496,2020-09,5434.86,2225.21,7608.03,938.53,9879.15,17857.23
258143738296482496,2020-10,5679.53,4758.67,1304.02,3582.91,-1358.03,16499.2
258143738296482496,2020-11,4138.17,1844.6,3216.27,1861.43,3648.41,20147.61
258143738296482496,2020-12,5584.29,2933.6,1757.48,9644.02,-5235.85,14911.76
258250010206456960,2020-01,4102.03,1200.44,3458.87,1088.28,5272.18,5272.18
258250010206456960,2020-02,2878.28,3221.65,0,1768.22,-2111.59,3160.59
258250010206456960,2020-03,3093.65,3679.56,0,4376.38,-4962.29,-1801.7
258250010206456960,2020-04,5818.66,4326.09,6668.13,1459.18,6701.52,4899.82
258250010206456960,2020-05,2093.65,842.3,2888.91,1550.32,2589.94,7489.76
258250010206456960,2020-06,6638.53,3127.72,2979.59,1779.91,4710.49,12200.25
258250010206456960,2020-07,4486.87,2754.81,463.03,1066.67,1128.42,13328.67
258250010206456960,2020-08,885,0,4352.87,1797.81,3440.06,16768.73
258250010206456960,2020-09,195.02,3757.83,543.66,7230.48,-10249.63,6519.1
258250010206456960,2020-10,0,885.43,0,0,-885.43,5633.67
258250010206456960,2020-11,4238.24,2447.2,639.86,0,2430.9,8064.57
258250010206456960,2020-12,1146.97,1299.88,2404.45,3706.48,-1454.94,6609.63
258392000025497024,2020-01,1629.21,0,0,0,1629.21,1629.21
258392000025497024,2020-02,579.74,0,0,748.73,-168.99,1460.22
258392000025497024,2020-03,1761.27,756.44,1541.18,252.44,2293.57,3753.79
258392000025497024,2020-04,778.94,1315.48,1576.81,1955.14,-914.87,2838.92
258392000025497024,2020-05,1908.04,0,2986.18,1099.83,3794.39,6633.31
258392000025497024,2020-06,876.57,400.3,1529.13,0,2005.4,8638.71
258392000025497024,2020-07,1982.47,787.06,3460.35,1835.76,2820,11458.71
258392000025497024,2020-08,613.73,3824.61,0,1276.01,-4486.89,6971.82
258392000025497024,2020-09,0,1576.17,5355.79,1845.47,1934.15,8905.97
258392000025497024,2020-10,0,1189.96,761.15,1834,-2262.81,6643.16
258392000025497024,2020-11,614.33,0,2072.77,1929.7,757.4,7400.56
258392000025497024,2020-12,0,48.6,790.41,0,741.81,8142.37
260877016253556064,2020-01,3983.09,0,1901.8,0,5884.89,5884.89
260877016253556064,2020-02,1443.47,0,1736.98,300.63,2879.82,8764.71
260877016253556064,2020-03,63.03,1683.95,580.14,0,-1040.78,7723.93
260877016253556064,2020-05,0,1562.29,168.53,0,-1393.76,6330.17
260877016253556064,2020-06,1508.55,0,0,0,1508.55,7838.72
260877016253556064,2020-07,0,1483.94,1856.94,0,373,8211.72
260877016253556064,2020-08,1846.87,0,0,0,1846.87,10058.59
260877016253556064,2020-09,53.65,1272.74,597.61,278.59,-900.07,9158.52
260877016253556064,2020-11,117.58,418.09,0,0,-300.51,8858.01
260877016253556064,2020-12,0,1974.15,683.34,0,-1290.81,7567.2
260997781830618784,2020-01,4057.75,2934.05,3717.39,2660.22,2180.87,2180.87
260997781830618784,2020-02,3112.8,1005.28,299.88,1737.37,670.03,2850.9
260997781830618784,2020-03,270.29,3305.74,3051.08,1473.63,-1458,1392.9
260997781830618784,2020-04,1529.79,0,3120.44,1809.9,2840.33,4233.23
260997781830618784,2020-05,3664.23,2627.12,1351.76,2006.52,382.35,4615.58
260997781830618784,2020-06,5015.89,2093.89,940.5,8687.88,-4825.38,-209.8
260997781830618784,2020-07,4873.04,5111.34,0,0,-238.3,-448.1
260997781830618784,2020-08,2150.59,1222.78,2861.65,2643.78,1145.68,697.58
260997781830618784,2020-09,3122.29,2646.58,1893.55,5662.65,-3293.39,-2595.81
260997781830618784,2020-10,1116.82,2651.83,2887.65,963.56,389.08,-2206.73
260997781830618784,2020-11,0,4213.17,0,0,-4213.17,-6419.9
260997781830618784,2020-12,3649.81,3049.17,1336.54,1781.57,155.61,-6264.29
261709767291100192,2020-01,3483.47,3072.57,6456.5,2338.03,4529.37,4529.37
261709767291100192,2020-02,3068.74,4122.44,6537.4,1639.33,3844.37,8373.74
261709767291100192,2020-03,2448.79,8069.23,8416.11,6498.36,-3702.69,4671.05
261709767291100192,2020-04,4423.38,7475.71,4651.97,4192.48,-2592.84,2078.21
261709767291100192,2020-05,3343.96,4110.58,3945.34,4377.26,-1198.54,879.67
261709767291100192,2020-06,2585.79,2517.18,3837.96,2239.33,1667.24,2546.91
261709767291100192,2020-07,3358.35,2748.38,2934.71,1720.93,1823.75,4370.66
261709767291100192,2020-08,3963.92,2579.84,5148.76,8251.5,-1718.66,2652
261709767291100192,2020-09,6904.31,1249.08,1979.41,2392.3,5242.34,7894.34
261709767291100192,2020-10,8477.25,4927.83,7348.37,5582.67,5315.12,13209.46
261709767291100192,2020-11,10070.81,4551.28,6472.07,5179.18,6812.42,20021.88
261709767291100192,2020-12,5215.14,2298.61,7588.6,3702.37,6802.76,26824.64
261728610212602112,2020-01,1760.84,2319.26,1072.72,2008.54,-1494.24,-1494.24
261728610212602112,2020-02,3381.68,4101.31,2729.53,0,2009.9,515.66
261728610212602112,2020-03,2040.91,2996.49,1808.66,488.84,364.24,879.9
261728610212602112,2020-04,916.9,2262.32,71.38,643.87,-1917.91,-1038.01
261728610212602112,2020-05,1011.17,1958.41,1450.03,29.17,473.62,-564.39
261728610212602112,2020-06,5333.27,0,1648.95,4994.47,1987.75,1423.36
261728610212602112,2020-07,2750.39,294.26,0,3677.31,-1221.18,202.18
261728610212602112,2020-08,0,2560.38,3549.4,3332.07,-2343.05,-2140.87
261728610212602112,2020-09,4659.41,4617.24,5445.42,2362.24,3125.35,984.48
261728610212602112,2020-10,0,1625.73,4780.93,2543.76,611.44,1595.92
261728610212602112,2020-11,409.13,2360.1,3916.38,617.77,1347.64,2943.56
261728610212602112,2020-12,3466.13,4043.43,405.21,2540.48,-2712.57,230.99
263006445679535584,2020-01,1761.57,0,0,0,1761.57,1761.57
263006445679535584,2020-04,96.52,0,0,0,96.52,1858.09
263006445679535584,2020-10,39.88,0,0,741.16,-701.28,1156.81
263006445679535584,2020-11,960.59,0,0,891.95,68.64,1225.45
263021740143510976,2020-01,3343.7,4683.96,1492.58,2033.16,-1880.84,-1880.84
263021740143510976,2020-02,802.81,934.57,2385.31,3213.43,-959.88,-2840.72
263021740143510976,2020-03,5490.44,1285.61,1852.08,3182.77,2874.14,33.42
263021740143510976,2020-04,0,3333.48,4494.28,0,1160.8,1194.22
263021740143510976,2020-05,4235.62,1775.4,3264.33,165.6,5558.95,6753.17
263021740143510976,2020-06,5223.65,9.33,2859.58,0,8073.9,14827.07
263021740143510976,2020-07,1390,637.25,7366.52,5188.23,2931.04,17758.11
263021740143510976,2020-08,1886.76,1881.8,1197.56,0,1202.52,18960.63
263021740143510976,2020-09,949.17,4537.77,3551.72,2200.89,-2237.77,16722.86
263021740143510976,2020-10,5646.67,1336.84,993.52,1401.47,3901.88,20624.74
263021740143510976,2020-11,5479.64,7140.3,3115.42,8667.37,-7212.61,13412.13
263021740143510976,2020-12,1540.81,1371.78,1559.62,3237.54,-1508.89,11903.24
264228822322236320,2020-01,3779.01,2622.13,6189.25,3194.47,4151.66,4151.66
264228822322236320,2020-02,3737.91,5953.75,4035.97,3571.08,-1750.95,2400.71
264228822322236320,2020-03,4094.53,128.98,1935.4,2003.56,3897.39,6298.1
264228822322236320,2020-04,364.75,373.65,2512.43,376.07,2127.46,8425.56
264228822322236320,2020-05,3744.69,4550.53,6886.46,9508.48,-3427.86,4997.7
264228822322236320,2020-06,3450.05,1915.47,0,3135.44,-1600.86,3396.84
264228822322236320,2020-07,2612.38,8330.04,223.29,3703.57,-9197.94,-5801.1
264228822322236320,2020-08,3158.4,6029.92,3331.49,3145.62,-2685.65,-8486.75
264228822322236320,2020-09,3120.85,5167.35,3145.26,3484.9,-2386.14,-10872.89
264228822322236320,2020-10,1709.87,9697.66,1018.42,1622,-8591.37,-19464.26
264228822322236320,2020-11,5583.75,6227.59,2003.4,4968.15,-3608.59,-23072.85
264228822322236320,2020-12,133.75,3355.06,765.55,1066.86,-3522.62,-26595.47
264452182167155744,2020-01,601.1,690.14,1474.94,0,1385.9,1385.9
264452182167155744,2020-02,76.66,463.26,0,2150.79,-2537.39,-1151.49
264452182167155744,2020-03,2786.3,69.88,0,3299.92,-583.5,-1734.99
264452182167155744,2020-04,2003.98,0,0,1521.12,482.86,-1252.13
264452182167155744,2020-06,185.35,900.28,2078.87,918.03,445.91,-806.22
264452182167155744,2020-07,554.51,3382.46,0,1784.95,-4612.9,-5419.12
264452182167155744,2020-08,2725.18,2206.69,1839.23,1636.22,721.5,-4697.62
264452182167155744,2020-09,0,460.87,1388.31,1845.54,-918.1,-5615.72
264452182167155744,2020-10,3149.56,1885.53,1980.68,1330.81,1913.9,-3701.82
264452182167155744,2020-11,1772.51,15.36,0,1748.55,8.6,-3693.22
264452182167155744,2020-12,2930.98,867.68,4952.4,2237.94,4777.76,1084.54
264680777419559392,2020-01,0,7011.56,2466.66,579.39,-5124.29,-5124.29
264680777419559392,2020-02,6236.59,2773.07,4474.09,4195.6,3742.01,-1382.28
264680777419559392,2020-03,4890.37,4360.85,1464.96,4681.07,-2686.59,-4068.87
264680777419559392,2020-04,4502.46,1296.6,1254.65,4084.62,375.89,-3692.98
264680777419559392,2020-05,4741.34,3869.94,2557.84,1755.06,1674.18,-2018.8
264680777419559392,2020-06,349.84,1989.15,3790.21,2029.2,121.7,-1897.1
264680777419559392,2020-07,2995.93,2511.75,3122.03,6132.07,-2525.86,-4422.96
264680777419559392,2020-08,3426.23,3613.76,2327,5342.93,-3203.46,-7626.42
264680777419559392,2020-09,2557.43,3218.19,9648.44,2838.88,6148.8,-1477.62
264680777419559392,2020-10,380.55,3036.84,606.36,9736.44,-11786.37,-13263.99
264680777419559392,2020-11,5020.86,2907.55,2809.79,2112.37,2810.73,-10453.26
264680777419559392,2020-12,1193.63,2806.81,0,1594.26,-3207.44,-13660.7
266452739389299488,2020-01,0,1866.49,0,0,-1866.49,-1866.49
266452739389299488,2020-05,0,1729.04,0,0,-1729.04,-3595.53
268158553332792224,2020-01,3442.62,4824.05,2278.97,4507.71,-3610.17,-3610.17
268158553332792224,2020-02,2374.99,4522.13,6653.14,2752.06,1753.94,-1856.23
268158553332792224,2020-03,2392.76,5158.28,1838.31,5045.65,-5972.86,-7829.09
268158553332792224,2020-04,5352.83,9298.65,4012.88,1548.78,-1481.72,-9310.81
268158553332792224,2020-05,4183.87,4431.79,2077.69,2957.73,-1127.96,-10438.77
268158553332792224,2020-06,564.74,3450.54,2472.55,6511.82,-6925.07,-17363.84
268158553332792224,2020-07,3614.95,5143.67,5986.93,292.33,4165.88,-13197.96
268158553332792224,2020-08,4311.63,1994.17,4495.88,4314,2499.34,-10698.62
268158553332792224,2020-09,2311.12,4072.77,5047.01,1360.2,1925.16,-8773.46
268158553332792224,2020-10,5398.39,5083.03,3850.21,4276.52,-110.95,-8884.41
268158553332792224,2020-11,1890.96,769.87,4402.36,2973.06,2550.39,-6334.02
268158553332792224,2020-12,2427.08,247.62,2505.49,1637.5,3047.45,-3286.57
270593414138866976,2020-01,1452.22,0,0,0,1452.22,1452.22
270593414138866976,2020-02,823.49,0,0,928.67,-105.18,1347.04
270593414138866976,2020-03,0,3930.92,6790.96,3249.46,-389.42,957.62
270593414138866976,2020-04,0,3074.54,0,0,-3074.54,-2116.92
270593414138866976,2020-05,1905.7,253.39,0,2287.08,-634.77,-2751.69
270593414138866976,2020-06,3188.05,1551.67,1515.39,884.69,2267.08,-484.61
270593414138866976,2020-07,3655.78,0,1544.76,1514.64,3685.9,3201.29
270593414138866976,2020-08,1590.8,2537.12,3593.34,948.59,1698.43,4899.72
270593414138866976,2020-09,975.95,3175.89,2205.13,0,5.19,4904.91
270593414138866976,2020-10,2230.45,1741.96,2386.34,2463.2,411.63,5316.54
270593414138866976,2020-11,2705.09,2580.12,1341.87,1531.3,-64.46,5252.08
270593414138866976,2020-12,1779.6,3922.94,0,377.5,-2520.84,2731.24
270698372006450496,2020-01,2183.83,1976.07,2718.56,0,2926.32,2926.32
270698372006450496,2020-02,5960.44,1618.45,325.38,2216.36,2451.01,5377.33
270698372006450496,2020-03,2654.3,90.17,3944.12,0,6508.25,11885.58
270698372006450496,2020-04,0,3835.58,0,4872.33,-8707.91,3177.67
270698372006450496,2020-05,3380.74,1887.68,1611.28,1478.49,1625.85,4803.52
270698372006450496,2020-06,4062.63,566.41,2366.12,0,5862.34,10665.86
270698372006450496,2020-07,1038.47,2335.8,5889.76,2034.88,2557.55,13223.41
270698372006450496,2020-08,2685.42,1945.35,1645.6,3337.14,-951.47,12271.94
270698372006450496,2020-09,4550.53,942.86,0,3090.74,516.93,12788.87
270698372006450496,2020-10,6808.26,0,1974.41,1507.48,7275.19,20064.06
270698372006450496,2020-11,1480.36,1725.44,0,3159.19,-3404.27,16659.79
270698372006450496,2020-12,4418.39,2704.28,1168.66,0,2882.77,19542.56
272282735743283008,2020-01,2858.5,2592.34,1336.44,2663.08,-1060.48,-1060.48
272282735743283008,2020-02,6366.36,1391.73,3639.92,2001.95,6612.6,5552.12
272282735743283008,2020-03,3409.91,1904.33,1052.75,3441.35,-883.02,4669.1
272282735743283008,2020-04,1458.64,3626.63,1980.77,866.17,-1053.39,3615.71
272282735743283008,2020-05,1576.01,3982.97,860.97,2696.97,-4242.96,-627.25
272282735743283008,2020-06,2556.52,1656.3,3776.45,837.87,3838.8,3211.55
272282735743283008,2020-07,2060.27,4813.81,4147.02,6606.74,-5213.26,-2001.71
272282735743283008,2020-08,7430.19,3137.95,3388.82,3319.33,4361.73,2360.02
272282735743283008,2020-09,7721.54,6216.45,2785.07,4456.83,-166.67,2193.35
272282735743283008,2020-10,6256.68,2125.38,4224.44,2222.1,6133.64,8326.99
272282735743283008,2020-11,7230.77,2873.78,3357.85,3804.41,3910.43,12237.42
272282735743283008,2020-12,5470.13,0,3353.71,4283.25,4540.59,16778.01
274201659409845376,2020-01,4221.41,2444.42,1366.8,4982.24,-1838.45,-1838.45
274201659409845376,2020-02,3660.28,5184.74,4811.61,796.97,2490.18,651.73
274201659409845376,2020-03,1515.37,1611.78,2634.07,1807.26,730.4,1382.13
274201659409845376,2020-04,2014.69,0,195.71,2508.33,-297.93,1084.2
274201659409845376,2020-05,3996.49,2291.55,764.08,5160.87,-2691.85,-1607.65
274201659409845376,2020-06,5813.02,4949.8,3702.24,1158.53,3406.93,1799.28
274201659409845376,2020-07,3760.64,0,3988.24,3133.61,4615.27,6414.55
274201659409845376,2020-08,1652.1,1429.26,558.21,660.98,120.07,6534.62
274201659409845376,2020-09,0,2603.33,3651.05,1776.47,-728.75,5805.87
274201659409845376,2020-10,2849,892.36,3720.26,1785.43,3891.47,9697.34
274201659409845376,2020-11,0,2821.77,3925.46,1309.37,-205.68,9491.66
274201659409845376,2020-12,1889.7,846.67,666.25,2434.78,-725.5,8766.16
274494146908837376,2020-01,5611.59,9172.45,4349.46,971.65,-183.05,-183.05
274494146908837376,2020-02,3553.31,3538.2,3363.65,7558.7,-4179.94,-4362.99
274494146908837376,2020-03,4160.71,3366.11,2512.75,2780.4,526.95,-3836.04
274494146908837376,2020-04,4506.38,4446.24,0,5244.45,-5184.31,-9020.35
274494146908837376,2020-05,3977.43,3732.05,6571.76,4575.63,2241.51,-6778.84
274494146908837376,2020-06,9740.32,3598.71,2461.38,2705.49,5897.5,-881.34
274494146908837376,2020-07,1843.29,711.82,1771.57,4260.49,-1357.45,-2238.79
274494146908837376,2020-08,4207.34,931.76,0,2533.82,741.76,-1497.03
274494146908837376,2020-09,4309.31,4227.38,2577.1,3209.71,-550.68,-2047.71
274494146908837376,2020-10,3894.23,7825.33,2176.1,708.71,-2463.71,-4511.42
274494146908837376,2020-11,950.19,1881.37,890.97,272.98,-313.19,-4824.61
274494146908837376,2020-12,6392.62,2663.52,4093.62,1632.74,6189.98,1365.37
275991141994273600,2020-01,2139.75,707.75,2420.07,0,3852.07,3852.07
275991141994273600,2020-02,2256.89,6806.5,3293.59,2519.42,-3775.44,76.63
275991141994273600,2020-03,1721.64,1994.95,2384.69,99.72,2011.66,2088.29
275991141994273600,2020-05,635.66,954.51,439.29,1202.8,-1082.36,1005.93
275991141994273600,2020-06,237.22,1424.97,482.48,3992.33,-4697.6,-3691.67
275991141994273600,2020-07,0,930.31,54.19,4228.18,-5104.3,-8795.97
275991141994273600,2020-08,3829.95,519.82,0,938.8,2371.33,-6424.64
275991141994273600,2020-09,688.03,769.48,0,3003.28,-3084.73,-9509.37
275991141994273600,2020-10,5052.03,0,1117.6,1378.83,4790.8,-4718.57
275991141994273600,2020-11,84.24,3718.75,0,1857.68,-5492.19,-10210.76
275991141994273600,2020-12,1036.29,1470.83,1360.75,1570.18,-643.97,-10854.73
276738588952286176,2020-01,7043.53,3651.09,3780.69,3722.2,3450.93,3450.93
276738588952286176,2020-02,286.88,4888.99,1693.59,2205.13,-5113.65,-1662.72
276738588952286176,2020-03,2254.56,2181.42,0,3457.12,-3383.98,-5046.7
276738588952286176,2020-04,5504.78,5647.07,1778.3,2178.69,-542.68,-5589.38
276738588952286176,2020-05,1247.41,7261.24,2041.96,4362.66,-8334.53,-13923.91
276738588952286176,2020-06,4365.49,3017.78,1352.21,3540.27,-840.35,-14764.26
276738588952286176,2020-07,3847.24,4484.02,8366.69,3632.18,4097.73,-10666.53
276738588952286176,2020-08,1472.09,3067.87,6476,4324.07,556.15,-10110.38
276738588952286176,2020-09,1830.59,7739.39,881.17,4552.24,-9579.87,-19690.25
276738588952286176,2020-10,1997.82,3616.23,1873.37,6675.91,-6420.95,-26111.2
276738588952286176,2020-11,164.05,5062.3,5466.45,8572.6,-8004.4,-34115.6
276738588952286176,2020-12,1498.61,7104.07,2293.99,1907.74,-5219.21,-39334.81
279233363005368320,2020-01,7080.63,3237.33,3857.25,7692.83,7.72,7.72
279233363005368320,2020-02,512.74,2978.57,1187.51,3083.16,-4361.48,-4353.76
279233363005368320,2020-03,362.2,2614.88,4345.32,10.66,2081.98,-2271.78
279233363005368320,2020-04,1031.6,59.44,3894.53,1964.35,2902.34,630.56
279233363005368320,2020-05,4071.06,543.56,2608.79,4374.51,1761.78,2392.34
279233363005368320,2020-06,0,3460.73,2320.29,0,-1140.44,1251.9
279233363005368320,2020-07,1085.29,1043.05,3583.97,3287.71,338.5,1590.4
279233363005368320,2020-08,2170.56,816.81,597.62,2980.19,-1028.82,561.58
279233363005368320,2020-09,3261.02,2186.82,7285.82,2623.8,5736.22,6297.8
279233363005368320,2020-10,2551.28,1200.98,2128.98,1357.87,2121.41,8419.21
279233363005368320,2020-11,3459.1,1257.55,2495.07,1357.39,3339.23,11758.44
279233363005368320,2020-12,1389.19,0,2652.78,4511.93,-469.96,11288.48
280820183091394464,2020-01,703.76,3424.99,1747.81,1319.5,-2292.92,-2292.92
280820183091394464,2020-02,0,94.2,2721.94,811.15,1816.59,-476.33
280820183091394464,2020-03,2511.55,2167.45,623.67,1822.5,-854.73,-1331.06
280820183091394464,2020-04,2490.54,4896.06,2730.48,3673.28,-3348.32,-4679.38
280820183091394464,2020-05,1908.69,5933.35,2028.14,1966.89,-3963.41,-8642.79
280820183091394464,2020-06,337.39,6186.72,3646.01,6948.72,-9152.04,-17794.83
280820183091394464,2020-07,4244.79,537.55,5280.84,3975.29,5012.79,-12782.04
280820183091394464,2020-08,1428.2,0,2491.42,3173.58,746.04,-12036
280820183091394464,2020-09,2938.44,3250.58,500.63,4167.05,-3978.56,-16014.56
280820183091394464,2020-10,0,3176.7,2818.29,5429.76,-5788.17,-21802.73
280820183091394464,2020-11,3853.53,3779.88,378.34,1492.59,-1040.6,-22843.33
280820183091394464,2020-12,4115.64,5499.43,710.24,3571.37,-4244.92,-27088.25
281026973294784032,2020-01,0,252.56,2857.15,0,2604.59,2604.59
281026973294784032,2020-02,0,1919.58,0,1807.35,-3726.93,-1122.34
281026973294784032,2020-03,0,57.61,1677.35,415.97,1203.77,81.43
281026973294784032,2020-04,1149.2,0,0,31.55,1117.65,1199.08
281026973294784032,2020-05,0,1069.85,0,919.98,-1989.83,-790.75
281026973294784032,2020-06,0,1979.6,180.71,0,-1798.89,-2589.64
281026973294784032,2020-07,0,1320.89,0,0,-1320.89,-3910.53
281026973294784032,2020-08,480.51,0,654.27,2309.78,-1175,-5085.53
281026973294784032,2020-09,1727.91,479.22,0,2642.15,-1393.46,-6478.99
281026973294784032,2020-10,2413.75,272.27,441.85,491.17,2092.16,-4386.83
281026973294784032,2020-12,0,916.11,1221.6,258.86,46.63,-4340.2
281077540295334304,2020-01,2202.77,0,151.33,0,2354.1,2354.1
281077540295334304,2020-02,0,1887.01,0,186.36,-2073.37,280.73
281077540295334304,2020-03,0,169.78,0,0,-169.78,110.95
281077540295334304,2020-04,982.24,0,0,778.21,204.03,314.98
281077540295334304,2020-05,132.5,1493.29,0,0,-1360.79,-1045.81
281077540295334304,2020-06,0,2802.37,0,1532.59,-4334.96,-5380.77
281077540295334304,2020-07,3460.22,0,1368.75,1918.63,2910.34,-2470.43
281077540295334304,2020-08,0,2464.94,1637.89,1419.93,-2246.98,-4717.41
281077540295334304,2020-09,287.54,0,0,1522.14,-1234.6,-5952.01
281077540295334304,2020-10,89.01,1705.24,0,0,-1616.23,-7568.24
281077540295334304,2020-12,0,1278.46,1332.35,1898.1,-1844.21,-9412.45
281109758200862496,2020-01,6020.85,11188.12,9687.9,2011.69,2508.94,2508.94
281109758200862496,2020-02,6378.97,6729.25,8316.89,4737.71,3228.9,5737.84
281109758200862496,2020-03,4117.14,900.06,5195.73,3695.94,4716.87,10454.71
281109758200862496,2020-04,6528.62,7026.18,4285.98,9705.81,-5917.39,4537.32
281109758200862496,2020-05,5691.04,2151.69,2692.64,5670.79,561.2,5098.52
281109758200862496,2020-06,4269.19,4581.12,4831.95,9640.26,-5120.24,-21.72
281109758200862496,2020-07,5191.87,2330.89,292.59,7384.02,-4230.45,-4252.17
281109758200862496,2020-08,3159.97,7435.47,1790.34,9344.86,-11830.02,-16082.19
281109758200862496,2020-09,7262.82,5131.17,7909.59,5857.1,4184.14,-11898.05
281109758200862496,2020-10,2665.31,5768.85,2969.65,8047.06,-8180.95,-20079
281109758200862496,2020-11,3302.52,3455.54,5098.18,1799.31,3145.85,-16933.15
281109758200862496,2020-12,4041.58,4109.36,1811.79,2722.54,-978.53,-17911.68
281271940656016832,2020-02,2681.8,0,0,1959.16,722.64,722.64
281271940656016832,2020-03,2106.58,0,1901.59,0,4008.17,4730.81
281271940656016832,2020-04,847.03,0,0,0,847.03,5577.84
281271940656016832,2020-05,0,61.87,1666.98,1813.84,-208.73,5369.11
281271940656016832,2020-06,1751.73,526.39,0,0,1225.34,6594.45
281271940656016832,2020-07,1879.36,1796.56,933.77,0,1016.57,7611.02
281271940656016832,2020-08,1610.6,3679.78,0,0,-2069.18,5541.84
281271940656016832,2020-09,1094.06,0,378.32,1557.95,-85.57,5456.27
281271940656016832,2020-10,1795.44,2244.73,1505.18,0,1055.89,6512.16
281271940656016832,2020-11,1647.16,0,2040.81,1375.84,2312.13,8824.29
281777638972504992,2020-01,3243.33,381.66,1483.16,0,4344.83,4344.83
281777638972504992,2020-02,0,1915.68,2868.49,829.61,123.2,4468.03
281777638972504992,2020-03,10277.16,1299.94,1740.64,2419.48,8298.38,12766.41
281777638972504992,2020-04,2085.9,992.49,4433.73,2224.08,3303.06,16069.47
281777638972504992,2020-05,1481.21,3957.21,2822.55,1493.18,-1146.63,14922.84
281777638972504992,2020-06,1407.63,1061.92,3949.61,2261.68,2033.64,16956.48
281777638972504992,2020-07,7216.41,1356,3414.6,2680.77,6594.24,23550.72
281777638972504992,2020-08,4474.58,3036.55,4056.34,5277.02,217.35,23768.07
281777638972504992,2020-09,3722.12,0,4682.2,1551.72,6852.6,30620.67
281777638972504992,2020-10,3682.13,2493.33,1745.34,1926.87,1007.27,31627.94
281777638972504992,2020-11,3406.37,0,3361.43,2495.98,4271.82,35899.76
281777638972504992,2020-12,5626.99,5204.93,1431.55,1069.62,783.99,36683.75
281850747470688608,2020-01,1427.94,7497.13,455.55,8955.93,-14569.57,-14569.57
281850747470688608,2020-02,4762.12,7793.09,1067.76,958.96,-2922.17,-17491.74
281850747470688608,2020-03,7919.48,3700.97,2692.7,22.53,6888.68,-10603.06
281850747470688608,2020-04,611.43,5908.1,613.07,6408.19,-11091.79,-21694.85
281850747470688608,2020-05,1596.4,2889.22,6437.8,2753.2,2391.78,-19303.07
281850747470688608,2020-06,3346.19,5029.38,6989.62,3559.33,1747.1,-17555.97
281850747470688608,2020-07,3371.21,3155.25,2879,2186.01,908.95,-16647.02
281850747470688608,2020-08,2389.07,6180.01,2122.55,3436.18,-5104.57,-21751.59
281850747470688608,2020-09,3591.85,2947.43,7458.39,302.9,7799.91,-13951.68
281850747470688608,2020-10,0,4250.65,2465.49,3868.07,-5653.23,-19604.91
281850747470688608,2020-11,3738.49,6236.19,5288.54,836.29,1954.55,-17650.36
281850747470688608,2020-12,3188.05,1078.7,6742.98,1883.26,6969.07,-10681.29
282741193551172448,2020-01,2160.72,5330.94,3627.04,6487.49,-6030.67,-6030.67
282741193551172448,2020-02,4719.82,7254.3,431.49,4615.48,-6718.47,-12749.14
282741193551172448,2020-03,245.01,4927.71,10336.13,4314.14,1339.29,-11409.85
282741193551172448,2020-04,11683.92,2722.62,4638.36,4701.04,8898.62,-2511.23
282741193551172448,2020-05,5239.7,1100.29,2679.77,5618.3,1200.88,-1310.35
282741193551172448,2020-06,5373.16,3060.97,3447.43,1325.44,4434.18,3123.83
282741193551172448,2020-07,4326.84,1463.42,7592.63,3420,7036.05,10159.88
282741193551172448,2020-08,4850.76,7482.84,2884.39,3840.29,-3587.98,6571.9
282741193551172448,2020-09,6248.42,6389.71,3453.27,683.16,2628.82,9200.72
282741193551172448,2020-10,2900.75,5285.17,3358.78,2463.06,-1488.7,7712.02
282741193551172448,2020-11,2598.14,6885.54,4559.07,0,271.67,7983.69
282741193551172448,2020-12,3299.52,10830.02,48.34,1014.4,-8496.56,-512.87
283980082325918976,2020-01,404.48,3079.8,2854.87,4182.42,-4002.87,-4002.87
283980082325918976,2020-02,43.24,606.05,1154.94,4082.41,-3490.28,-7493.15
283980082325918976,2020-03,3342.35,5405.99,1498.01,78.48,-644.11,-8137.26
283980082325918976,2020-04,1041.18,1588.92,4028.2,262.67,3217.79,-4919.47
283980082325918976,2020-05,1569.77,1949.03,4271.47,3766.74,125.47,-4794
283980082325918976,2020-06,974.41,2914.81,4111.16,5166.6,-2995.84,-7789.84
283980082325918976,2020-07,2446.73,814.99,1564.51,2159.81,1036.44,-6753.4
283980082325918976,2020-08,2146.17,1153.2,4379.56,4105.16,1267.37,-5486.03
283980082325918976,2020-09,2035.47,2138.17,1894.53,3435.35,-1643.52,-7129.55
283980082325918976,2020-10,3817.11,256.45,4001.7,3110.68,4451.68,-2677.87
283980082325918976,2020-11,1644.18,1381.19,1942.13,6446.23,-4241.11,-6918.98
284422241350488960,2020-01,179.38,3638.14,2963.62,2322.88,-2818.02,-2818.02
284422241350488960,2020-02,2676.22,409.24,1824.49,1034.1,3057.37,239.35
284422241350488960,2020-03,0,1140.22,0,163.21,-1303.43,-1064.08
284422241350488960,2020-04,22.46,2509.47,4583.4,0,2096.39,1032.31
284422241350488960,2020-05,619.43,2595.42,3281.45,1688.99,-383.53,648.78
284422241350488960,2020-06,310.08,0,928.93,2609.77,-1370.76,-721.98
284422241350488960,2020-07,549.15,584.81,1237.76,230.98,971.12,249.14
284422241350488960,2020-08,1689.48,1027.75,1891.5,3357.05,-803.82,-554.68
284422241350488960,2020-10,1190.8,628.12,759.69,0,1322.37,767.69
284422241350488960,2020-11,180.63,0,335.51,1795.66,-1279.52,-511.83
284422241350488960,2020-12,4262.58,0,939.01,3717.82,1483.77,971.94
285256955396758976,2020-01,8243.37,1523.46,7538.55,5630.24,8628.22,8628.22
285256955396758976,2020-02,4948.03,2405.05,2395.01,799.59,4138.4,12766.62
285256955396758976,2020-03,223.8,215.2,798.66,2930.35,-2123.09,10643.53
285256955396758976,2020-04,2483.91,4168.51,5542.93,6951.88,-3093.55,7549.98
285256955396758976,2020-05,5068.98,7833.65,6959.56,1401.68,2793.21,10343.19
285256955396758976,2020-06,6319.35,5623.34,3416.87,7669.71,-3556.83,6786.36
285256955396758976,2020-07,1450.31,4581.04,4772.04,1600.43,40.88,6827.24
285256955396758976,2020-08,3075.98,0,390.26,1087.01,2379.23,9206.47
285256955396758976,2020-09,8605.39,33.79,1615.33,4561.32,5625.61,14832.08
285256955396758976,2020-10,6829.2,1541.56,3100.22,2964.1,5423.76,20255.84
285256955396758976,2020-11,0,2744.19,6094.6,6209.78,-2859.37,17396.47
285256955396758976,2020-12,4187.65,1786.48,3094.6,3791.36,1704.41,19100.88
285954202652059168,2020-01,4155.48,2031.73,485.79,3764.3,-1154.76,-1154.76
285954202652059168,2020-02,4739.18,6670.54,1468.54,781.52,-1244.34,-2399.1
285954202652059168,2020-03,0,1863.7,3344.08,5428.2,-3947.82,-6346.92
285954202652059168,2020-04,4525.8,3413.97,1817.12,3783.76,-854.81,-7201.73
285954202652059168,2020-05,2424.29,4688.59,2383.66,4762.31,-4642.95,-11844.68
285954202652059168,2020-06,4551.08,1815.39,4511.65,9930.98,-2683.64,-14528.32
285954202652059168,2020-07,2894,7307.66,2734.95,2579.22,-4257.93,-18786.25
285954202652059168,2020-08,1814.13,5200.83,6866.67,4724.59,-1244.62,-20030.87
285954202652059168,2020-09,2013.49,7275.38,7123.41,3068.72,-1207.2,-21238.07
285954202652059168,2020-10,3663.57,1922.24,0,5606.72,-3865.39,-25103.46
285954202652059168,2020-11,4611,2406.44,5716.81,1435.14,6486.23,-18617.23
285954202652059168,2020-12,6347.99,6179.62,4376.24,1578.71,2965.9,-15651.33
286834239720255168,2020-01,1116.28,0,0,0,1116.28,1116.28
286834239720255168,2020-03,0,801.21,0,0,-801.21,315.07
286834239720255168,2020-07,614.46,0,0,0,614.46,929.53
286834239720255168,2020-08,1111,0,1743.2,0,2854.2,3783.73
286834239720255168,2020-11,0,157.73,1728.6,0,1570.87,5354.6
286834239720255168,2020-12,0,1332.43,775.63,1042.97,-1599.77,3754.83
286971064071035232,2020-01,4212.06,3675.21,3312.74,3203.24,646.35,646.35
286971064071035232,2020-02,1817.55,2970.73,347.7,2149.86,-2955.34,-2308.99
286971064071035232,2020-03,1195.4,2475.58,2461.19,1767.63,-586.62,-2895.61
286971064071035232,2020-04,1842.77,4597.09,2037.03,1245.16,-1962.45,-4858.06
286971064071035232,2020-05,1817.68,2638.08,3110.02,1469.05,820.57,-4037.49
286971064071035232,2020-06,5492.02,1519.63,1054.24,3586.03,1440.6,-2596.89
286971064071035232,2020-07,3184.67,4489.25,2268.23,4395.06,-3431.41,-6028.3
286971064071035232,2020-08,2091.17,6990.53,3511.42,3254.3,-4642.24,-10670.54
286971064071035232,2020-09,6464.11,129.24,1405.29,3259.1,4481.06,-6189.48
286971064071035232,2020-10,2463.18,6181.84,3941.1,6054.35,-5831.91,-12021.39
286971064071035232,2020-11,4589.55,3369.16,3044.54,2804.08,1460.85,-10560.54
286971064071035232,2020-12,2401.1,4770.07,1497.21,1783.26,-2655.02,-13215.56
287917711213129888,2020-02,0,132.09,0,2923.26,-3055.35,-3055.35
287917711213129888,2020-03,1595.36,1661.9,0,0,-66.54,-3121.89
287917711213129888,2020-04,0,2091.23,0,0,-2091.23,-5213.12
287917711213129888,2020-08,0,1226.1,0,0,-1226.1,-6439.22
287917711213129888,2020-09,226.14,1671.56,0,2439.82,-3885.24,-10324.46
287917711213129888,2020-10,1040.29,529.22,0,0,511.07,-9813.39
287917711213129888,2020-12,0,628.99,2636.47,0,2007.48,-7805.91
288018669968888032,2020-01,4307.83,2610.34,0,3643.16,-1945.67,-1945.67
288018669968888032,2020-02,2605.21,1246,1948.03,7463.13,-4155.89,-6101.56
288018669968888032,2020-03,6787.92,2542.4,0,3180.47,1065.05,-5036.51
288018669968888032,2020-04,1720.91,2228.19,3078.73,2746.79,-175.34,-5211.85
288018669968888032,2020-05,3590.34,0,1570.79,1785.57,3375.56,-1836.29
288018669968888032,2020-06,6953.54,4864.71,3479.33,2884.67,2683.49,847.2
288018669968888032,2020-07,4483.57,8630,1603.46,3493.15,-6036.12,-5188.92
288018669968888032,2020-08,4493.54,2262.7,3449.2,7330.73,-1650.69,-6839.61
288018669968888032,2020-09,0,1067.99,4214.23,1268.83,1877.41,-4962.2
288018669968888032,2020-10,2411.12,5294.29,8273.56,662.22,4728.17,-234.03
288018669968888032,2020-11,6611.47,4841,1308.69,3108.66,-29.5,-263.53
288018669968888032,2020-12,4514.31,328.86,3274.11,796.27,6663.29,6399.76
289421542209532352,2020-01,3034.23,4066.69,1392.65,2431.84,-2071.65,-2071.65
289421542209532352,2020-02,1422.69,4085.4,1959.32,4514.26,-5217.65,-7289.3
289421542209532352,2020-03,6964.33,3387.4,2552.7,3241.15,2888.48,-4400.82
289421542209532352,2020-04,994.28,4962.01,2066.63,3310.15,-5211.25,-9612.07
289421542209532352,2020-05,4754.48,3243.56,2807.22,1021.56,3296.58,-6315.49
289421542209532352,2020-06,0,4063.74,2783.45,2505.45,-3785.74,-10101.23
289421542209532352,2020-07,2707.36,3491.85,2075.7,5481.65,-4190.44,-14291.67
289421542209532352,2020-08,5994.61,2969.74,6514.5,4666.16,4873.21,-9418.46
289421542209532352,2020-09,6217.74,2016.85,3693.44,292.9,7601.43,-1817.03
289421542209532352,2020-10,1490.05,1431.62,3196.37,0,3254.8,1437.77
289421542209532352,2020-11,7603.36,647.13,2944.26,3671.56,6228.93,7666.7
289421542209532352,2020-12,2850.98,4599.07,1257.58,5980.67,-6471.18,1195.52
289844685976538560,2020-01,0,109.69,1227.51,0,1117.82,1117.82
289844685976538560,2020-03,2722.65,1316.38,1805.16,0,3211.43,4329.25
289844685976538560,2020-04,683.66,1716,166.97,3307.08,-4172.45,156.8
289844685976538560,2020-05,3450.33,1336.12,1610.74,2372.16,1352.79,1509.59
289844685976538560,2020-06,2621.79,162.12,0,1855.52,604.15,2113.74
289844685976538560,2020-07,539.69,0,2917.35,1291.54,2165.5,4279.24
289844685976538560,2020-08,0,1580.44,1613.44,0,33,4312.24
289844685976538560,2020-09,17.51,0,1147.8,0,1165.31,5477.55
289844685976538560,2020-10,0,412.21,0,3623.21,-4035.42,1442.13
289844685976538560,2020-11,1984.11,1677.54,3192.34,1078.18,2420.73,3862.86
289844685976538560,2020-12,0,3177.14,0,2854.41,-6031.55,-2168.69
290249309974067648,2020-01,1427.72,1209.2,1755.24,7519.93,-5546.17,-5546.17
290249309974067648,2020-02,0,1507.14,1635.29,2008.41,-1880.26,-7426.43
290249309974067648,2020-03,1806.3,1956.45,1737.24,1970.94,-383.85,-7810.28
290249309974067648,2020-04,2345.73,618.88,2478.85,0,4205.7,-3604.58
290249309974067648,2020-05,3749.21,1580.14,974.67,422.36,2721.38,-883.2
290249309974067648,2020-06,2119.73,1713.74,1137.5,0,1543.49,660.29
290249309974067648,2020-07,720.33,5257.53,2170.22,0,-2366.98,-1706.69
290249309974067648,2020-08,4988.51,3036.77,2419.26,0,4371,2664.31
290249309974067648,2020-09,2845.54,662.17,2543.13,0,4726.5,7390.81
290249309974067648,2020-10,0,1518.36,1714.58,0,196.22,7587.03
290249309974067648,2020-11,2947.3,1728.37,809.18,3508.61,-1480.5,6106.53
290249309974067648,2020-12,712.46,2364.34,4047.1,0,2395.22,8501.75
291621834982585472,2020-01,1788.54,1631.71,3547.61,1175.41,2529.03,2529.03
291621834982585472,2020-02,653.26,734.27,172.43,2731.08,-2639.66,-110.63
291621834982585472,2020-03,2777.72,2371.15,0,0,406.57,295.94
291621834982585472,2020-04,1463.56,0,2618.34,0,4081.9,4377.84
291621834982585472,2020-05,0,1428.95,0,1121.99,-2550.94,1826.9
291621834982585472,2020-06,2207.38,1470.83,816.62,530.77,1022.4,2849.3
291621834982585472,2020-07,72.61,2811.71,2223.46,531.03,-1046.67,1802.63
291621834982585472,2020-09,2850.46,721.1,858.05,1862.05,1125.36,2927.99
291621834982585472,2020-11,0,701.02,0,851.02,-1552.04,1375.95
291621834982585472,2020-12,2557.26,1531.5,3062.92,0,4088.68,5464.63
291883582326531712,2020-01,6357.2,8316.54,4156.14,5082.19,-2885.39,-2885.39
291883582326531712,2020-02,2728.56,3374.95,0,3627.79,-4274.18,-7159.57
291883582326531712,2020-03,7123.52,9868.68,7781.66,8289.4,-3252.9,-10412.47
291883582326531712,2020-04,5449.04,1099.12,6680.28,4481.58,6548.62,-3863.85
291883582326531712,2020-05,2040.3,1517.7,1348.52,4767.94,-2896.82,-6760.67
291883582326531712,2020-06,2924.94,705.85,1175.32,5532.6,-2138.19,-8898.86
291883582326531712,2020-07,4471.91,5252.49,1604.27,4156.36,-3332.67,-12231.53
291883582326531712,2020-08,10047.4,6511.05,3131.28,4059.14,2608.49,-9623.04
291883582326531712,2020-09,695.38,1991.09,0,1136.75,-2432.46,-12055.5
291883582326531712,2020-10,4015.31,3268.87,9241.91,4720.47,5267.88,-6787.62
291883582326531712,2020-11,6454.61,1966.46,42.04,8219.32,-3689.13,-10476.75
291883582326531712,2020-12,1984.12,4740.21,4051.93,5458.23,-4162.39,-14639.14
291922322831040576,2020-01,4832.7,2146.87,6437.92,6368.87,2754.88,2754.88
291922322831040576,2020-02,639.21,2284.62,3605.39,3225.04,-1265.06,1489.82
291922322831040576,2020-03,3101.66,2272.28,0,2429.88,-1600.5,-110.68
291922322831040576,2020-04,464.32,1853.49,1581.38,3224.57,-3032.36,-3143.04
291922322831040576,2020-05,1869.38,4628.15,1048.17,3734.22,-5444.82,-8587.86
291922322831040576,2020-06,1299.8,1306.71,7237.84,818.44,6412.49,-2175.37
291922322831040576,2020-07,2577.81,571.87,0,8441.81,-6435.87,-8611.24
291922322831040576,2020-08,1753.7,706.57,6060.26,512.96,6594.43,-2016.81
291922322831040576,2020-09,1088.67,1617.08,3181.31,1863.09,789.81,-1227
291922322831040576,2020-10,0,4153.68,1392.6,6643.76,-9404.84,-10631.84
291922322831040576,2020-11,1853.22,3526.94,2347.43,2482.48,-1808.77,-12440.61
291922322831040576,2020-12,2430.22,5514.86,4985.53,6812.78,-4911.89,-17352.5
292668755240831168,2020-01,322.21,2351.72,3330.01,0,1300.5,1300.5
292668755240831168,2020-03,343.77,2378.46,0,0,-2034.69,-734.19
292668755240831168,2020-04,825.64,0,853.44,1364.52,314.56,-419.63
292668755240831168,2020-05,3144.22,1875.43,274.66,754.79,788.66,369.03
292668755240831168,2020-06,2425.86,688.75,0,1956.62,-219.51,149.52
292668755240831168,2020-07,0,243.21,0,0,-243.21,-93.69
292668755240831168,2020-08,0,1005.91,0,0,-1005.91,-1099.6
292668755240831168,2020-10,1866.56,1770.18,0,0,96.38,-1003.22
292668755240831168,2020-11,1569.05,2185.23,1347.89,1677.68,-945.97,-1949.19
293370289343593856,2020-01,3789.58,0,4341.85,0,8131.43,8131.43
293370289343593856,2020-02,3473.81,4833.16,3286.57,1969.52,-42.3,8089.13
293370289343593856,2020-03,3932.39,0,0,835.83,3096.56,11185.69
293370289343593856,2020-04,3170.9,1914.07,543.25,3797.72,-1997.64,9188.05
293370289343593856,2020-05,5574.81,2055.23,1483.6,4982.58,20.6,9208.65
293370289343593856,2020-07,1835,0,0,0,1835,11043.65
293370289343593856,2020-08,1588.14,3832.53,3283.84,2523.86,-1484.41,9559.24
293370289343593856,2020-09,1464.36,1138.48,2374.39,2545.16,155.11,9714.35
293370289343593856,2020-10,1278.09,4415.27,225.18,641.03,-3553.03,6161.32
293370289343593856,2020-11,858.13,1876.01,0,6527.89,-7545.77,-1384.45
293370289343593856,2020-12,2652.88,437.21,1069.51,2414.23,870.95,-513.5
293753999060979584,2020-01,660.43,4611.18,5482.26,3484.39,-1952.88,-1952.88
293753999060979584,2020-02,4369.32,4538.29,1237.28,7215.92,-6147.61,-8100.49
293753999060979584,2020-03,3341.68,3124.06,1796.03,4395.17,-2381.52,-10482.01
293753999060979584,2020-04,3218.84,3818.91,3834.09,4029.4,-795.38,-11277.39
293753999060979584,2020-05,2026.65,9257.11,6828.08,3576.9,-3979.28,-15256.67
293753999060979584,2020-06,2271.63,2868.45,2692.49,0,2095.67,-13161
293753999060979584,2020-07,4354.16,1043.44,1363.66,3252.45,1421.93,-11739.07
293753999060979584,2020-08,2637.16,6840.62,6180.27,2474.23,-497.42,-12236.49
293753999060979584,2020-09,3081.25,5977,320.49,5949.04,-8524.3,-20760.79
293753999060979584,2020-10,323.93,1590,2708.89,4200.84,-2758.02,-23518.81
293753999060979584,2020-11,7604.74,2440.8,0,5005.03,158.91,-23359.9
293753999060979584,2020-12,2693.47,1992.29,10872.17,3032.99,8540.36,-14819.54
294088249766139200,2020-01,0,304.31,0,0,-304.31,-304.31
294088249766139200,2020-08,1805.12,0,0,1782.46,22.66,-281.65
294088249766139200,2020-09,802.58,0,0,0,802.58,520.93
297869603965745408,2020-01,1746.25,4419.55,2335.34,1338.9,-1676.86,-1676.86
297869603965745408,2020-02,1651.81,1689.8,3072.49,2281.07,753.43,-923.43
297869603965745408,2020-03,527.83,2263.85,3069.02,8932.7,-7599.7,-8523.13
297869603965745408,2020-04,414.37,1601.25,715.23,3504.63,-3976.28,-12499.41
297869603965745408,2020-05,1176.01,1085.06,4670.34,1403.32,3357.97,-9141.44
297869603965745408,2020-06,0,2611.12,6198.92,2963.81,623.99,-8517.45
297869603965745408,2020-07,3370.9,1840.68,2403.57,1844.92,2088.87,-6428.58
297869603965745408,2020-08,2383.75,0,2280.47,2667.1,1997.12,-4431.46
297869603965745408,2020-09,2612.53,2397.41,1134.69,126.27,1223.54,-3207.92
297869603965745408,2020-10,1932.07,2138.82,914.79,1923.22,-1215.18,-4423.1
297869603965745408,2020-11,4213.61,2129.78,256.87,2321.36,19.34,-4403.76
297869603965745408,2020-12,1169.11,3839.88,18.37,1852.64,-4505.04,-8908.8
297961530275182272,2020-01,1504.34,2228.58,2222.18,2903.44,-1405.5,-1405.5
297961530275182272,2020-02,2393.2,1972.77,3513.64,0,3934.07,2528.57
297961530275182272,2020-03,3479.03,0,826.04,2466.99,1838.08,4366.65
297961530275182272,2020-05,2389.08,825.9,260.86,230.07,1593.97,5960.62
297961530275182272,2020-06,2068.41,545.68,1755.18,2794.96,482.95,6443.57
297961530275182272,2020-07,3393.52,2571.52,1173.46,0,1995.46,8439.03
297961530275182272,2020-08,5560.63,0,1376.88,2685.52,4251.99,12691.02
297961530275182272,2020-09,4183.58,1810.68,2243.07,1330.7,3285.27,15976.29
297961530275182272,2020-10,1032.76,0,1478.92,2511.94,-0.26,15976.03
297961530275182272,2020-11,1624.88,764.8,0,0,860.08,16836.11
297961530275182272,2020-12,4135.03,4178.53,1950.49,1232.79,674.2,17510.31
298398631645732800,2020-01,79.33,1683.81,1938.1,2497.7,-2164.08,-2164.08
298398631645732800,2020-02,8744.69,1984.23,2205.29,476.13,8489.62,6325.54
298398631645732800,2020-03,2158.53,2153.53,1963.39,791.05,1177.34,7502.88
298398631645732800,2020-04,1619.78,757.36,0,2588.54,-1726.12,5776.76
298398631645732800,2020-05,1143.74,3814.23,5451.53,2159.9,621.14,6397.9
298398631645732800,2020-06,1752.96,2166.9,2135.26,814.33,906.99,7304.89
298398631645732800,2020-07,3713.41,2088.43,0,3192.43,-1567.45,5737.44
298398631645732800,2020-08,6815.98,4690.86,4563.66,280.69,6408.09,12145.53
298398631645732800,2020-09,931.79,0,2485.09,2988.1,428.78,12574.31
298398631645732800,2020-10,0,121.71,10972.85,1392.31,9458.83,22033.14
298398631645732800,2020-11,1729.95,3417.54,1665.9,3775.24,-3796.93,18236.21
298398631645732800,2020-12,2753.99,3425.47,2132.75,438.03,1023.24,19259.45
298412662426283392,2020-01,4063.33,5303.29,1756.5,15207.83,-14691.29,-14691.29
298412662426283392,2020-02,3886.95,5012.24,7164.57,7121.01,-1081.73,-15773.02
298412662426283392,2020-03,3925.75,6034.15,1273.45,1402.99,-2237.94,-18010.96
298412662426283392,2020-04,3505.09,5129.15,8571.25,5802.73,1144.46,-16866.5
298412662426283392,2020-05,1742.63,3442.84,8140.59,3985.81,2454.57,-14411.93
298412662426283392,2020-06,3375.97,3742.25,4045.75,4524.99,-845.52,-15257.45
298412662426283392,2020-07,3185.42,2340.64,6175.32,3196.32,3823.78,-11433.67
298412662426283392,2020-08,5993.68,4974.35,8354.07,2778.55,6594.85,-4838.82
298412662426283392,2020-09,2889.56,2650.97,7282.72,6016.19,1505.12,-3333.7
298412662426283392,2020-10,4021.26,8215.42,6909.9,1589.68,1126.06,-2207.64
298412662426283392,2020-11,2587.45,2374.61,60.77,5105.97,-4832.36,-7040
298412662426283392,2020-12,707.89,1848.57,7065.03,4239.66,1684.69,-5355.31
299688611537980160,2020-01,4728.88,454.6,1395.61,1486.44,4183.45,4183.45
299688611537980160,2020-02,3583.85,1084.19,6556.25,0,9055.91,13239.36
299688611537980160,2020-03,1645.72,3699.95,0,2914.78,-4969.01,8270.35
299688611537980160,2020-04,4622.86,4348.59,2132.18,3817.03,-1410.58,6859.77
299688611537980160,2020-05,888.22,2832.11,0,3908.63,-5852.52,1007.25
299688611537980160,2020-06,1931.36,1632.21,2858.99,2950.21,207.93,1215.18
299688611537980160,2020-07,2455.66,1638.6,1926.98,2472.96,271.08,1486.26
299688611537980160,2020-08,0,2438.87,2268.66,1903.72,-2073.93,-587.67
299688611537980160,2020-09,1967.79,1606.16,1999.4,1502,859.03,271.36
299688611537980160,2020-10,770.08,3957.25,0,5675.79,-8862.96,-8591.6
299688611537980160,2020-11,2193.87,1646.45,1854.17,2577.76,-176.17,-8767.77
299688611537980160,2020-12,2288.18,2962.28,0,1031.66,-1705.76,-10473.53
300684444494252992,2020-01,6954.67,1850.76,3698.15,6060.09,2741.97,2741.97
300684444494252992,2020-02,1222.66,4569.11,1768.5,4169.36,-5747.31,-3005.34
300684444494252992,2020-03,4713.53,6581.27,2550.82,6133.75,-5450.67,-8456.01
300684444494252992,2020-04,7692.12,2393.54,8327.11,7696.88,5928.81,-2527.2
300684444494252992,2020-05,801.39,3941.12,780.61,2606.34,-4965.46,-7492.66
300684444494252992,2020-06,5267.46,4505.83,7964.22,2633.28,6092.57,-1400.09
300684444494252992,2020-07,3955.54,1768.53,7133.27,7323.32,1996.96,596.87
300684444494252992,2020-08,3002.69,2700.36,5404.41,5140.46,566.28,1163.15
300684444494252992,2020-09,3566.39,6693.1,4883.34,3431.92,-1675.29,-512.14
300684444494252992,2020-10,6107.03,5866.55,7376.12,7274.26,342.34,-169.8
300684444494252992,2020-11,3331.36,2537.64,7549.6,6333.49,2009.83,1840.03
300684444494252992,2020-12,1776.34,3553.74,4947.14,718.56,2451.18,4291.21
300730991551359040,2020-04,0,672.45,0,0,-672.45,-672.45
300730991551359040,2020-06,1845.12,0,0,1564.58,280.54,-391.91
302627976616225216,2020-01,2433.99,3210.37,3112.07,2654.15,-318.46,-318.46
302627976616225216,2020-02,2315.89,0,0,3347.17,-1031.28,-1349.74
302627976616225216,2020-03,3082.2,2624.87,1599.63,182.14,1874.82,525.08
302627976616225216,2020-04,5107.75,2820.52,1331.87,1968.72,1650.38,2175.46
302627976616225216,2020-05,2048.12,9002.66,7366.36,2291.4,-1879.58,295.88
302627976616225216,2020-06,1795.07,3159.35,2082.14,5064.75,-4346.89,-4051.01
302627976616225216,2020-07,1809.37,4228.59,0,1760.23,-4179.45,-8230.46
302627976616225216,2020-08,992.8,2419.47,530.42,0,-896.25,-9126.71
302627976616225216,2020-09,1249.39,1634.5,3049.12,0,2664.01,-6462.7
302627976616225216,2020-10,209.18,531.05,3214.39,4879.4,-1986.88,-8449.58
302627976616225216,2020-11,4727.99,2879.94,666.73,1717.3,797.48,-7652.1
302627976616225216,2020-12,654.17,2226.7,1672.89,0,100.36,-7551.74
304160244893763904,2020-02,18.33,0,230.05,1606.32,-1357.94,-1357.94
304160244893763904,2020-03,1120.27,0,0,0,1120.27,-237.67
304160244893763904,2020-04,1284.24,646.28,167.82,0,805.78,568.11
304160244893763904,2020-05,0,327.99,4093.98,1377.09,2388.9,2957.01
304160244893763904,2020-06,1880.7,1842.41,1891.45,1125.32,804.42,3761.43
304160244893763904,2020-07,1017.49,0,0,2435.73,-1418.24,2343.19
304160244893763904,2020-08,1273.57,4246.35,305.5,0,-2667.28,-324.09
304160244893763904,2020-09,0,2990.68,0,2731.2,-5721.88,-6045.97
304160244893763904,2020-10,2340.3,0,989.27,0,3329.57,-2716.4
304160244893763904,2020-11,0,1768.2,229.51,1585.18,-3123.87,-5840.27
304160244893763904,2020-12,0,6152.19,0,932.39,-7084.58,-12924.85
305097794860386752,2020-01,0,692.87,2428.31,1015.27,720.17,720.17
305097794860386752,2020-02,0,1422.96,0,1280.01,-2702.97,-1982.8
305097794860386752,2020-03,429.91,455.27,0,2582.09,-2607.45,-4590.25
305097794860386752,2020-04,0,2203.64,0,0,-2203.64,-6793.89
305097794860386752,2020-06,3158.97,510.94,1014.47,1536.89,2125.61,-4668.28
305097794860386752,2020-07,0,1170.16,0,0,-1170.16,-5838.44
305097794860386752,2020-08,1761.4,0,568.24,7.64,2322,-3516.44
305097794860386752,2020-09,0,996.97,0,0,-996.97,-4513.41
305097794860386752,2020-10,0,2895.54,0,638.9,-3534.44,-8047.85
305097794860386752,2020-11,1317.5,0,0,2012.57,-695.07,-8742.92
305097794860386752,2020-12,0,4194.36,5611.1,0,1416.74,-7326.18
305222673030779648,2020-01,1692.46,1397.83,225.13,3263.57,-2743.81,-2743.81
305222673030779648,2020-02,1852.04,2122.28,0,948.15,-1218.39,-3962.2
305222673030779648,2020-03,3979.36,2381.78,1968.41,6542.81,-2976.82,-6939.02
305222673030779648,2020-04,121.46,1679.71,6.04,1455.71,-3007.92,-9946.94
305222673030779648,2020-05,3308.27,6779.93,5801.41,2749.52,-419.77,-10366.71
305222673030779648,2020-06,3413.18,283.02,2205.72,4037.27,1298.61,-9068.1
305222673030779648,2020-07,3027.9,6528.76,2172.59,2267.31,-3595.58,-12663.68
305222673030779648,2020-08,4702.83,1235.89,0,583.31,2883.63,-9780.05
305222673030779648,2020-09,2503.93,0,4563.2,1532.52,5534.61,-4245.44
305222673030779648,2020-10,4902.4,345.51,3466.73,1078.15,6945.47,2700.03
305222673030779648,2020-11,3092.39,1285.98,0,1996.08,-189.67,2510.36
305222673030779648,2020-12,1384.96,1681.41,0,2420.16,-2716.61,-206.25
305536970600348352,2020-02,1978.75,2542.99,0,1949.19,-2513.43,-2513.43
305536970600348352,2020-04,0,1210.15,1683.09,954.34,-481.4,-2994.83
305536970600348352,2020-05,1442.59,0,0,0,1442.59,-1552.24
305536970600348352,2020-06,0,4399.85,2452.82,1002.3,-2949.33,-4501.57
305536970600348352,2020-07,0,1099.86,0,698.01,-1797.87,-6299.44
305536970600348352,2020-08,455.15,0,641.49,1805.81,-709.17,-7008.61
305536970600348352,2020-09,90.16,999.23,0,1308.29,-2217.36,-9225.97
305536970600348352,2020-11,0,908.8,1544.33,0,635.53,-8590.44
305536970600348352,2020-12,11.13,956.33,1376.04,0,430.84,-8159.6
309286578343157184,2020-01,2428.18,1169.3,556.14,1905.7,-90.68,-90.68
309286578343157184,2020-02,1521.06,4911.76,4095.93,0,705.23,614.55
309286578343157184,2020-03,7039.08,2265.72,2905.68,3169.24,4509.8,5124.35
309286578343157184,2020-04,6373.33,4511.68,0,5878.96,-4017.31,1107.04
309286578343157184,2020-05,1739.92,412.61,0,2864.4,-1537.09,-430.05
309286578343157184,2020-06,3846.2,2610.5,2032.35,1141.46,2126.59,1696.54
309286578343157184,2020-07,1199.22,4317.13,1143.52,1710.21,-3684.6,-1988.06
309286578343157184,2020-08,2506.92,5949.46,1332.36,270.61,-2380.79,-4368.85
309286578343157184,2020-09,3331.82,4979.74,3327.26,1844.28,-164.94,-4533.79
309286578343157184,2020-10,2274.76,4329,6946.39,2170.79,2721.36,-1812.43
309286578343157184,2020-11,3111.3,3171.6,0,5639.61,-5699.91,-7512.34
309286578343157184,2020-12,823.33,1881.12,1946.55,630.38,258.38,-7253.96
309822523118847296,2020-01,5296.25,299.16,2943.52,1927.66,6012.95,6012.95
309822523118847296,2020-02,4352.33,5883.13,5940.13,2085.31,2324.02,8336.97
309822523118847296,2020-03,4557.43,2791.61,2938.85,2727.68,1976.99,10313.96
309822523118847296,2020-04,1206.62,1954.11,1041.71,5188.26,-4894.04,5419.92
309822523118847296,2020-05,2232.37,421.57,6662.74,1206.41,7267.13,12687.05
309822523118847296,2020-06,5435.23,832.24,96.81,3605.82,1093.98,13781.03
309822523118847296,2020-07,1361.94,2976.93,5142.07,0,3527.08,17308.11
309822523118847296,2020-08,4030.3,2267.09,2693.63,4744.25,-287.41,17020.7
309822523118847296,2020-09,1667.41,4082.91,2773.67,2051.91,-1693.74,15326.96
309822523118847296,2020-10,1963.34,100.43,932.97,4917.38,-2121.5,13205.46
309822523118847296,2020-11,2893.99,2456.09,2761.58,4855.68,-1656.2,11549.26
309822523118847296,2020-12,2200.83,5090.53,1656.15,2975.18,-4208.73,7340.53
311105490901004288,2020-01,1489.14,988.08,1681.62,1950.76,231.92,231.92
311105490901004288,2020-02,4497.54,29.35,6966.45,4322.63,7112.01,7343.93
311105490901004288,2020-03,2458.59,2909.01,1263.78,1889.08,-1075.72,6268.21
311105490901004288,2020-04,0,1110.42,3179.06,1928.9,139.74,6407.95
311105490901004288,2020-05,666.98,3034.94,138.85,3625.72,-5854.83,553.12
311105490901004288,2020-06,1300.9,1140.97,0,0,159.93,713.05
311105490901004288,2020-07,1438.29,1316.95,1869.16,0,1990.5,2703.55
311105490901004288,2020-08,5346.11,0,1630.37,0,6976.48,9680.03
311105490901004288,2020-10,2479.13,2416.83,4016.96,0,4079.26,13759.29
311105490901004288,2020-11,0,3882.9,1884.03,1843.67,-3842.54,9916.75
311105490901004288,2020-12,1591.94,1703.07,2623.61,0,2512.48,12429.23
311349369727500416,2020-01,2593.9,1170.46,2368.02,954.81,2836.65,2836.65
311349369727500416,2020-02,3049.61,317.42,231.56,2004.18,959.57,3796.22
311349369727500416,2020-03,1170.47,0,2584.07,0,3754.54,7550.76
311349369727500416,2020-04,1061.66,843.23,1687.32,0,1905.75,9456.51
311349369727500416,2020-05,2252.28,3724.91,3394.42,1368.18,553.61,10010.12
311349369727500416,2020-06,2867.93,1899.98,1563.19,1656.4,874.74,10884.86
311349369727500416,2020-07,777.51,0,0,3389.1,-2611.59,8273.27
311349369727500416,2020-08,1877.16,4698.6,286.11,3202.15,-5737.48,2535.79
311349369727500416,2020-09,894.91,900.81,4108.58,193.97,3908.71,6444.5
311349369727500416,2020-10,1108.56,417.96,889.58,0,1580.18,8024.68
311349369727500416,2020-11,0,398.48,1958.35,1970.82,-410.95,7613.73
311349369727500416,2020-12,1104.49,0,0,1429.45,-324.96,7288.77
311389245479336832,2020-01,709.78,4509.86,8866.83,5411.05,-344.3,-344.3
311389245479336832,2020-02,4170.49,8392.71,3117.06,1652.12,-2757.28,-3101.58
311389245479336832,2020-03,2957.73,6017.17,3666,4610.93,-4004.37,-7105.95
311389245479336832,2020-04,8370.76,6020.86,867.34,7801.48,-4584.24,-11690.19
311389245479336832,2020-05,7271.32,2245.71,10566.63,5798.86,9793.38,-1896.81
311389245479336832,2020-06,10047.09,4844.82,6778.07,5170.31,6810.03,4913.22
311389245479336832,2020-07,4583.83,3646.99,2176.96,3552,-438.2,4475.02
311389245479336832,2020-08,5302.73,6317.47,3352.91,2044.19,293.98,4769
311389245479336832,2020-09,2433.09,5522.89,2997.6,2511.2,-2603.4,2165.6
311389245479336832,2020-10,3713.79,1857.26,4116.76,2819.65,3153.64,5319.24
311389245479336832,2020-11,2651.78,6073.09,1266.69,5167.79,-7322.41,-2003.17
311389245479336832,2020-12,1316.69,4986.24,11554.9,12491.8,-4606.45,-6609.62
311406230147928448,2020-01,5070.3,2378.3,1263.08,1052.93,2902.15,2902.15
311406230147928448,2020-02,1973.89,1803.64,4341.2,564.45,3947,6849.15
311406230147928448,2020-03,5261.95,4135.05,6257.48,3580.56,3803.82,10652.97
311406230147928448,2020-04,3292.06,2675.15,1858.11,3093.55,-618.53,10034.44
311406230147928448,2020-05,2831.57,2480.51,4520.29,3398.19,1473.16,11507.6
311406230147928448,2020-06,4917.61,4852.07,2920.65,6904.03,-3917.84,7589.76
311406230147928448,2020-07,3722.18,8571.22,4420.67,2074.69,-2503.06,5086.7
311406230147928448,2020-08,6116.58,1286.76,3301.94,7174.37,957.39,6044.09
311406230147928448,2020-09,5531.19,2286.51,799.25,2817.02,1226.91,7271
311406230147928448,2020-10,4782.33,2278.21,0,5014.25,-2510.13,4760.87
311406230147928448,2020-11,3826.09,2135.07,1434.26,6744.7,-3619.42,1141.45
311406230147928448,2020-12,985.98,4735.16,7091.99,5071.75,-1728.94,-587.49
311446622495190208,2020-01,6017.63,3077.42,3328.8,2789.49,3479.52,3479.52
311446622495190208,2020-02,271.81,77.84,0,1247.46,-1053.49,2426.03
311446622495190208,2020-03,519.81,5378.72,2941.01,763.37,-2681.27,-255.24
311446622495190208,2020-04,2755.6,1406.51,3322.85,3407.33,1264.61,1009.37
311446622495190208,2020-05,6509.96,3011.72,1936.27,2122.22,3312.29,4321.66
311446622495190208,2020-06,4150.81,5234.36,4232.59,338.75,2810.29,7131.95
311446622495190208,2020-07,1775.26,2190.14,4897.29,1604.7,2877.71,10009.66
311446622495190208,2020-08,4545.99,1264.21,1009.44,1861.37,2429.85,12439.51
311446622495190208,2020-09,21.98,2160.02,2726.24,3468.36,-2880.16,9559.35
311446622495190208,2020-10,828.39,0,1356.73,2679.65,-494.53,9064.82
311446622495190208,2020-11,975.67,1792.23,718.94,2078.19,-2175.81,6889.01
311446622495190208,2020-12,2701.36,0,1436.81,0,4138.17,11027.18
312930831799927872,2020-01,0,3724.25,5508.74,3639.63,-1855.14,-1855.14
312930831799927872,2020-02,1761.96,5022.54,4000,7789.69,-7050.27,-8905.41
312930831799927872,2020-03,3762.67,2222.2,1456.67,6206.94,-3209.8,-12115.21
312930831799927872,2020-04,1467.8,0,1400.17,6984.12,-4116.15,-16231.36
312930831799927872,2020-05,2080.78,1318.63,3678.7,942.88,3497.97,-12733.39
312930831799927872,2020-06,4328.42,1117.58,1740.87,3102.94,1848.77,-10884.62
312930831799927872,2020-07,2165.71,3069.27,5127.66,6263.22,-2039.12,-12923.74
312930831799927872,2020-08,4100.06,4916.11,9087,5022.5,3248.45,-9675.29
312930831799927872,2020-09,1011.82,4301.63,3404.31,0,114.5,-9560.79
312930831799927872,2020-10,1235.09,6198.95,4301.94,3649.85,-4311.77,-13872.56
312930831799927872,2020-11,1359.91,2184.22,3684.65,1836.85,1023.49,-12849.07
312930831799927872,2020-12,2657.41,1721.38,3774.84,0,4710.87,-8138.2
313105817823153472,2020-01,0,1228.77,232.57,1517.53,-2513.73,-2513.73
313105817823153472,2020-02,1343.79,0,0,0,1343.79,-1169.94
313105817823153472,2020-04,0,926.75,0,0,-926.75,-2096.69
313105817823153472,2020-07,0,1832.16,733.46,0,-1098.7,-3195.39
313105817823153472,2020-08,2307.29,0,0,0,2307.29,-888.1
313105817823153472,2020-09,0,1763.7,0,974.08,-2737.78,-3625.88
313105817823153472,2020-10,297.93,0,699.25,0,997.18,-2628.7
313105817823153472,2020-11,2983.97,0,0,0,2983.97,355.27
313105817823153472,2020-12,551.93,0,231.44,0,783.37,1138.64
314267451431446208,2020-03,0,3157.95,0,0,-3157.95,-3157.95
314267451431446208,2020-04,0,1197.91,0,0,-1197.91,-4355.86
314267451431446208,2020-05,0,10.23,1242.91,0,1232.68,-3123.18
314267451431446208,2020-07,3259.38,1821.74,0,1156.03,281.61,-2841.57
314267451431446208,2020-08,0,1515.71,0,0,-1515.71,-4357.28
314267451431446208,2020-10,0,407.15,1983.4,0,1576.25,-2781.03
314267451431446208,2020-11,1339.88,255,0,0,1084.88,-1696.15
315490371926050304,2020-01,1320.4,3097.31,3072.82,278.04,1017.87,1017.87
315490371926050304,2020-02,6113.65,2912.54,1860.47,967.7,4093.88,5111.75
315490371926050304,2020-03,3576.24,1604.44,3448.35,584.68,4835.47,9947.22
315490371926050304,2020-04,2370.2,1112.5,1739.9,723.57,2274.03,12221.25
315490371926050304,2020-05,1672.27,3004.23,1684.19,1346.58,-994.35,11226.9
315490371926050304,2020-06,2597.11,3466.61,1134.11,1939.91,-1675.3,9551.6
315490371926050304,2020-07,0,2060.48,1894.65,1328.69,-1494.52,8057.08
315490371926050304,2020-08,1699.51,1027.86,1672.09,5097.41,-2753.67,5303.41
315490371926050304,2020-09,143.92,1521.15,4369.38,1322.26,1669.89,6973.3
315490371926050304,2020-10,2995.36,3769.12,5368.5,3792.48,802.26,7775.56
315490371926050304,2020-11,1504.29,408.44,3208.91,1783.49,2521.27,10296.83
315490371926050304,2020-12,4278.17,2249.81,4260.28,1545.91,4742.73,15039.56
316229134888692544,2020-11,0,1036.21,0,0,-1036.21,-1036.21
318763421927734400,2020-01,815.44,1609.65,0,4684.61,-5478.82,-5478.82
318763421927734400,2020-02,729.99,725.16,2039.83,2037.66,7,-5471.82
318763421927734400,2020-03,1497.72,1591.16,343.86,1726.92,-1476.5,-6948.32
318763421927734400,2020-04,1237.16,1505.01,1197,1147.15,-218,-7166.32
318763421927734400,2020-05,0,4122.04,0,0,-4122.04,-11288.36
318763421927734400,2020-06,1965.83,5144.33,0,1286.81,-4465.31,-15753.67
318763421927734400,2020-07,0,1647.11,0,2577.28,-4224.39,-19978.06
318763421927734400,2020-08,543.76,1279.66,3458.88,996.46,1726.52,-18251.54
318763421927734400,2020-09,1991.76,3626.42,2467.96,1667.8,-834.5,-19086.04
318763421927734400,2020-10,618.17,2236.28,1660.24,0,42.13,-19043.91
318763421927734400,2020-11,620.97,632.27,2862.87,1171.81,1679.76,-17364.15
318763421927734400,2020-12,1620.59,203.91,2216.74,3531.93,101.49,-17262.66
318786553866128256,2020-01,3696.04,7005.74,3220.89,14231.5,-14320.31,-14320.31
318786553866128256,2020-02,2611.75,3892.41,3366.89,8011.53,-5925.3,-20245.61
318786553866128256,2020-03,7692.89,5870.68,3511.16,4179.12,1154.25,-19091.36
318786553866128256,2020-04,2749.42,1942.14,6874.93,7762.3,-80.09,-19171.45
318786553866128256,2020-05,1288.41,6015.71,3721.14,4622.45,-5628.61,-24800.06
318786553866128256,2020-06,5738.92,1868.12,4021.4,2392.24,5499.96,-19300.1
318786553866128256,2020-07,4904.12,1894.08,6779.25,2013.73,7775.56,-11524.54
318786553866128256,2020-08,1677.71,1130.6,3751.87,4776.74,-477.76,-12002.3
318786553866128256,2020-09,2846.85,5446.32,2868.32,3730.34,-3461.49,-15463.79
318786553866128256,2020-10,3668.3,4550.86,2429.53,3125.63,-1578.66,-17042.45
318786553866128256,2020-11,3939.91,4698.05,5959.94,4944.6,257.2,-16785.25
318786553866128256,2020-12,1080.72,45.35,4605.38,7626.05,-1985.3,-18770.55
320049611818291136,2020-01,3062.66,0,505.68,1288.78,2279.56,2279.56
320049611818291136,2020-02,1667.25,586.17,3451.87,3638.39,894.56,3174.12
320049611818291136,2020-03,2520.88,0,1358.74,0,3879.62,7053.74
320049611818291136,2020-04,0,411.69,1367.39,114.56,841.14,7894.88
320049611818291136,2020-05,120.71,1552.68,0,2555.79,-3987.76,3907.12
320049611818291136,2020-06,1207.64,0,1688.37,0,2896.01,6803.13
320049611818291136,2020-07,315.09,1676.92,1029.84,684.73,-1016.72,5786.41
320049611818291136,2020-08,2322.2,52.28,456.81,301.72,2425.01,8211.42
320049611818291136,2020-09,985.67,0,0,1015.14,-29.47,8181.95
320049611818291136,2020-10,1667.34,1141.48,2599.7,1827.28,1298.28,9480.23
320049611818291136,2020-11,1573.69,2920.52,1986.19,1805.96,-1166.6,8313.63
320049611818291136,2020-12,1752.18,0,2831.5,0,4583.68,12897.31
320154701698458368,2020-01,4787.71,1588.95,0,1832.78,1365.98,1365.98
320154701698458368,2020-02,3311.48,1144.26,446.41,0,2613.63,3979.61
320154701698458368,2020-03,5015.61,2245.92,882.07,0,3651.76,7631.37
320154701698458368,2020-04,0,2763.61,353.3,2866.79,-5277.1,2354.27
320154701698458368,2020-05,1568.58,1483.16,0,1629.53,-1544.11,810.16
320154701698458368,2020-06,1284.5,0,1990.81,0,3275.31,4085.47
320154701698458368,2020-07,2926.51,1079.51,2349.62,73.5,4123.12,8208.59
320154701698458368,2020-08,3062.32,2895.16,1567.78,623.92,1111.02,9319.61
320154701698458368,2020-09,662.3,0,4008.2,1137.24,3533.26,12852.87
320154701698458368,2020-10,2269.29,2833.13,4328.11,3627.13,137.14,12990.01
320154701698458368,2020-11,1852.14,206.63,0,1447.74,197.77,13187.78
320154701698458368,2020-12,0,1491.59,69.69,0,-1421.9,11765.88
320160228529057408,2020-01,5363.31,3251.57,4052.19,6213.71,-49.78,-49.78
320160228529057408,2020-02,3778.58,2279.98,3761.6,1629.6,3630.6,3580.82
320160228529057408,2020-03,2691.89,2692.09,667.78,5782.91,-5115.33,-1534.51
320160228529057408,2020-04,1550.14,9447.64,2076.75,720.35,-6541.1,-8075.61
320160228529057408,2020-05,1500.25,2730.13,3045.28,2321.31,-505.91,-8581.52
320160228529057408,2020-06,3171.49,2026.42,2408.49,961.56,2592,-5989.52
320160228529057408,2020-07,1863.66,1034.03,4380.61,2209.32,3000.92,-2988.6
320160228529057408,2020-08,4199.98,920.16,989,1031.5,3237.32,248.72
320160228529057408,2020-09,523.76,1038.15,186.79,2594.57,-2922.17,-2673.45
320160228529057408,2020-10,909.66,0,812.61,0,1722.27,-951.18
320160228529057408,2020-11,1064.21,2866.3,3350.24,3312.38,-1764.23,-2715.41
320160228529057408,2020-12,1469.41,5590.02,1565.73,2496.5,-5051.38,-7766.79
322088365866182528,2020-01,381.13,0,1871.23,0,2252.36,2252.36
322088365866182528,2020-02,2468.12,0,0,1871.01,597.11,2849.47
322088365866182528,2020-03,0,1408.64,0,0,-1408.64,1440.83
322088365866182528,2020-04,1572.11,1158.04,2710.57,4306.23,-1181.59,259.24
322088365866182528,2020-05,0,254.35,655.92,403.69,-2.12,257.12
322088365866182528,2020-06,0,595.97,0,1426.01,-2021.98,-1764.86
322088365866182528,2020-08,1506.64,880.39,0,1338.8,-712.55,-2477.41
322088365866182528,2020-09,2564.71,0,0,0,2564.71,87.3
322088365866182528,2020-11,0,1399.31,0,304.15,-1703.46,-1616.16
322127017140166912,2020-01,103.78,0,1071.02,1127.92,46.88,46.88
322127017140166912,2020-02,5686.27,2774.11,2815.42,1618.82,4108.76,4155.64
322127017140166912,2020-03,36.28,4238.51,1400.59,885.04,-3686.68,468.96
322127017140166912,2020-04,649.42,3417.53,2552.54,5604.88,-5820.45,-5351.49
322127017140166912,2020-05,1318.27,0,0,1258.25,60.02,-5291.47
322127017140166912,2020-06,0,1582.73,478.6,2042.57,-3146.7,-8438.17
322127017140166912,2020-07,2404.26,1138.35,2451.97,1344.5,2373.38,-6064.79
322127017140166912,2020-08,1092.68,525.47,2841.35,2907.82,500.74,-5564.05
322127017140166912,2020-09,531.9,1130.75,1959.71,600.03,760.83,-4803.22
322127017140166912,2020-10,1816.66,2839.71,0,7720.17,-8743.22,-13546.44
322127017140166912,2020-11,657.76,769.13,2188.59,1637.99,439.23,-13107.21
322127017140166912,2020-12,3003.8,2367.05,2570.8,1250.7,1956.85,-11150.36
323381413899802880,2020-02,1591.6,0,0,1505.36,86.24,86.24
323381413899802880,2020-03,1739.96,0,0,0,1739.96,1826.2
323381413899802880,2020-05,1387.36,1360.51,1263.75,1552.43,-261.83,1564.37
323381413899802880,2020-06,1639.51,0,1969.31,1675.9,1932.92,3497.29
323381413899802880,2020-07,0,708.08,1101.98,913.87,-519.97,2977.32
323381413899802880,2020-08,1302.86,0,77.01,942.14,437.73,3415.05
323381413899802880,2020-09,2742.78,0,1272.93,194.82,3820.89,7235.94
323381413899802880,2020-10,1847.28,0,465.71,1063.67,1249.32,8485.26
323381413899802880,2020-11,1519.62,0,821.54,2751.17,-410.01,8075.25
323381413899802880,2020-12,0,1234.28,4292.52,0,3058.24,11133.49
325525863981236416,2020-01,0,5863.09,2486.88,0,-3376.21,-3376.21
325525863981236416,2020-02,2662.52,6342.33,5159.4,0,1479.59,-1896.62
325525863981236416,2020-03,1763.16,2336.2,1997.26,3700.41,-2276.19,-4172.81
325525863981236416,2020-04,5916.85,2964.59,782.76,2367.42,1367.6,-2805.21
325525863981236416,2020-05,1399.28,376.76,1719.34,832.4,1909.46,-895.75
325525863981236416,2020-06,2626.12,0,3680.66,2261.37,4045.41,3149.66
325525863981236416,2020-07,639.28,1034.29,5498.93,2501.01,2602.91,5752.57
325525863981236416,2020-08,899.45,1721.52,22.86,3280.72,-4079.93,1672.64
325525863981236416,2020-09,2727.43,3614.99,3978.16,1238.02,1852.58,3525.22
325525863981236416,2020-10,4246.41,3843,1228.57,3159.6,-1527.62,1997.6
325525863981236416,2020-11,1207.89,3516.08,2060.29,158.2,-406.1,1591.5
325525863981236416,2020-12,1470.45,1632.06,179.99,0,18.38,1609.88
326313646152664128,2020-02,1017.27,794.42,0,759.79,-536.94,-536.94
326313646152664128,2020-03,1623.64,5305.37,2688.49,216.03,-1209.27,-1746.21
326313646152664128,2020-04,6816.78,2614.02,0,2839.1,1363.66,-382.55
326313646152664128,2020-05,994.83,279.33,2801.28,4362.74,-845.96,-1228.51
326313646152664128,2020-06,4265.08,939.5,3090.72,0,6416.3,5187.79
326313646152664128,2020-08,4091.44,1595.45,353.17,4801.04,-1951.88,3235.91
326313646152664128,2020-09,1775.65,101.75,0,1805.69,-131.79,3104.12
326313646152664128,2020-10,329.13,2449.76,1445.42,1416.92,-2092.13,1011.99
326313646152664128,2020-11,5471.02,3368.26,0,3106.89,-1004.13,7.86
326313646152664128,2020-12,5955.26,1484.89,265.62,0,4735.99,4743.85
327641571066486528,2020-02,0,124.57,256.48,0,131.91,131.91
327641571066486528,2020-04,1985.57,0,0,1968.59,16.98,148.89
327641571066486528,2020-05,0,1693.61,1650.94,0,-42.67,106.22
327641571066486528,2020-06,1692,1456.53,107.55,0,343.02,449.24
327641571066486528,2020-07,842.22,1228.47,0,91.84,-478.09,-28.85
327641571066486528,2020-08,0,321.42,0,0,-321.42,-350.27
327641571066486528,2020-09,0,1513.62,0,534.4,-2048.02,-2398.29
327641571066486528,2020-11,1518.48,0,0,0,1518.48,-879.81
330039793142276800,2020-01,3318.57,4914.53,175.83,1117.7,-2537.83,-2537.83
330039793142276800,2020-02,1992.16,7584.86,2787.68,3682.64,-6487.66,-9025.49
330039793142276800,2020-03,1269.04,2435.73,3610.16,7236.07,-4792.6,-13818.09
330039793142276800,2020-04,8079.4,2620.78,2152.98,3425.02,4186.58,-9631.51
330039793142276800,2020-05,2291.18,0,2939.04,2608.27,2621.95,-7009.56
330039793142276800,2020-06,7106.66,3007.89,6422.3,4220.06,6301.01,-708.55
330039793142276800,2020-07,2373.41,1170.56,7954.04,3112.9,6043.99,5335.44
330039793142276800,2020-08,1883.39,2482.93,4978.57,3430.67,948.36,6283.8
330039793142276800,2020-09,10647.13,7409.57,4704.24,2858.92,5082.88,11366.68
330039793142276800,2020-10,7285.77,2898.71,3281.38,3540.87,4127.57,15494.25
330039793142276800,2020-11,4000.61,486.99,4288.49,5950.15,1851.96,17346.21
330039793142276800,2020-12,720.93,4071.26,6242.44,6479.14,-3587.03,13759.18
330376069172600320,2020-01,2522.95,1378.14,6933.42,4970.38,3107.85,3107.85
330376069172600320,2020-03,3570.6,2014.81,4617.28,2947,3226.07,6333.92
330376069172600320,2020-04,3241.09,4602.57,3287.85,2771.44,-845.07,5488.85
330376069172600320,2020-05,3510.85,5972.2,5192.17,4602.56,-1871.74,3617.11
330376069172600320,2020-06,2770.43,5521.27,3726.23,2652.73,-1677.34,1939.77
330376069172600320,2020-07,1867.77,5061.15,501.21,2211.28,-4903.45,-2963.68
330376069172600320,2020-08,4208.54,2608.6,1457.14,2408.78,648.3,-2315.38
330376069172600320,2020-09,10690.13,1812.31,4881.96,4508.06,9251.72,6936.34
330376069172600320,2020-10,5084.31,8312.86,1124.51,389.43,-2493.47,4442.87
330376069172600320,2020-11,4111.37,7040.77,1440.56,7076.32,-8565.16,-4122.29
330376069172600320,2020-12,3609.8,1306.6,9255.1,1356.96,10201.34,6079.05
330550456335996608,2020-01,7054.57,4572.17,3313.5,3249.16,2546.74,2546.74
330550456335996608,2020-02,1915.43,784.12,1034.99,4869.65,-2703.35,-156.61
330550456335996608,2020-03,4773.03,5117.55,1325.06,1419.21,-438.67,-595.28
330550456335996608,2020-04,0,6918.74,1450.75,1077.59,-6545.58,-7140.86
330550456335996608,2020-05,3397.66,1051.4,2672.75,1485.91,3533.1,-3607.76
330550456335996608,2020-06,293.68,5486.11,5839.42,6274.84,-5627.85,-9235.61
330550456335996608,2020-07,2582.7,2687.17,2164.44,2557.81,-497.84,-9733.45
330550456335996608,2020-08,3365.18,147.94,1312.05,4161.87,367.42,-9366.03
330550456335996608,2020-09,1301.43,1970.22,495.83,589.1,-762.06,-10128.09
330550456335996608,2020-10,5435.05,4411.58,3050.28,2524.33,1549.42,-8578.67
330550456335996608,2020-11,747.51,466.81,3649.25,3729.01,200.94,-8377.73
330550456335996608,2020-12,1119.81,2393.53,1473.91,1986.24,-1786.05,-10163.78
330597025477579200,2020-01,1905.67,0,2079.22,2593.41,1391.48,1391.48
330597025477579200,2020-02,4127.04,3336.1,4960.48,1797.12,3954.3,5345.78
330597025477579200,2020-03,1220.57,3877.97,4017.5,1488.52,-128.42,5217.36
330597025477579200,2020-05,2082.9,2159.34,3907.35,3630.79,200.12,5417.48
330597025477579200,2020-06,2474.45,3084.69,1995.93,1924.74,-539.05,4878.43
330597025477579200,2020-07,627.3,6.56,5116.55,1225.66,4511.63,9390.06
330597025477579200,2020-08,2194.03,0,1420.39,3901.11,-286.69,9103.37
330597025477579200,2020-09,3198.84,0,2963.22,885.87,5276.19,14379.56
330597025477579200,2020-10,3175.5,3163.38,944.61,317.97,638.76,15018.32
330597025477579200,2020-11,2158.41,2647.66,2022.32,103.71,1429.36,16447.68
330597025477579200,2020-12,4935.02,139.31,4591.19,4190.57,5196.33,21644.01
331365408251358336,2020-02,0,1746.58,0,1657.96,-3404.54,-3404.54
331365408251358336,2020-04,0,1822.01,627.71,0,-1194.3,-4598.84
331365408251358336,2020-06,1381.88,126.3,1882.88,1643.78,1494.68,-3104.16
331365408251358336,2020-08,2180.95,0,0,0,2180.95,-923.21
331365408251358336,2020-10,0,1353.16,0,0,-1353.16,-2276.37
331365408251358336,2020-12,1276.02,327.7,475.47,0,1423.79,-852.58
331605930879694592,2020-01,4900.38,4603.3,3390.16,3328.81,358.43,358.43
331605930879694592,2020-02,2243.54,3580.6,4141.44,114.24,2690.14,3048.57
331605930879694592,2020-03,2927.32,1076.84,1894.05,8959.48,-5214.95,-2166.38
331605930879694592,2020-04,1787.01,2153.2,3153.76,2756.87,30.7,-2135.68
331605930879694592,2020-05,1934.04,9221.71,1155.53,3415.38,-9547.52,-11683.2
331605930879694592,2020-06,2182.11,3033.44,7332.15,3781.37,2699.45,-8983.75
331605930879694592,2020-07,1768.58,2283.49,0,4857.21,-5372.12,-14355.87
331605930879694592,2020-08,3037.06,894.2,1883.45,6322.37,-2296.06,-16651.93
331605930879694592,2020-09,6113.9,1713.72,0,0,4400.18,-12251.75
331605930879694592,2020-10,1942.54,1524.69,4234.38,4040.91,611.32,-11640.43
331605930879694592,2020-11,4207.63,0,5954.74,1347.83,8814.54,-2825.89
331605930879694592,2020-12,3283,787.74,1050.18,1447.78,2097.66,-728.23
331833163372402432,2020-01,1311.58,0,0,0,1311.58,1311.58
331833163372402432,2020-02,0,12.31,907.72,1014.66,-119.25,1192.33
331833163372402432,2020-03,0,2306.84,1225.13,0,-1081.71,110.62
331833163372402432,2020-04,1481.85,0,0,685.01,796.84,907.46
331833163372402432,2020-05,1107.58,0,85.97,1271.31,-77.76,829.7
331833163372402432,2020-06,1667.83,0,89.11,0,1756.94,2586.64
331833163372402432,2020-07,246.08,0,0,0,246.08,2832.72
331833163372402432,2020-09,1994.31,1366.75,0,0,627.56,3460.28
331833163372402432,2020-10,360.79,1679.8,0,0,-1319.01,2141.27
331833163372402432,2020-11,363.59,0,0,639.87,-276.28,1864.99
332613877850014080,2020-01,3031.83,2424.36,1962.73,2973.52,-403.32,-403.32
332613877850014080,2020-02,3025.79,2157.34,0,4292.29,-3423.84,-3827.16
332613877850014080,2020-03,5068.95,3086.44,1791.88,2216.24,1558.15,-2269.01
332613877850014080,2020-04,4045.16,2627.09,3001.56,2842.12,1577.51,-691.5
332613877850014080,2020-05,1921.15,2831.95,9712.25,1896.32,6905.13,6213.63
332613877850014080,2020-06,2248,1955.76,4794.87,1101.99,3985.12,10198.75
332613877850014080,2020-07,1037.07,2706.87,4991.45,4765.78,-1444.13,8754.62
332613877850014080,2020-08,4542.54,0,0,1229.21,3313.33,12067.95
332613877850014080,2020-10,0,3581.94,2753.27,0,-828.67,11239.28
332613877850014080,2020-11,4099.11,3293.49,3352.76,246.75,3911.63,15150.91
332613877850014080,2020-12,1795.5,1013.99,2511.74,2158.48,1134.77,16285.68
333808083333132352,2020-01,5771.82,3886.58,1441.25,1118.91,2207.58,2207.58
333808083333132352,2020-02,2333.06,2748.98,3549.81,0,3133.89,5341.47
333808083333132352,2020-03,3434.86,3900.53,6082.32,2294.88,3321.77,8663.24
333808083333132352,2020-04,4152.25,5040.77,2649.35,3401.71,-1640.88,7022.36
333808083333132352,2020-05,2294.36,772.25,2714.63,3222.86,1013.88,8036.24
333808083333132352,2020-06,5681.18,2303.84,8771.97,3061.17,9088.14,17124.38
333808083333132352,2020-07,5126.99,2235.4,8472,5085.62,6277.97,23402.35
333808083333132352,2020-08,4049.56,2406.41,6555.21,5675.61,2522.75,25925.1
333808083333132352,2020-09,2730.45,3500.37,992.88,6464.86,-6241.9,19683.2
333808083333132352,2020-10,3554.1,2208.52,7101.48,4145.83,4301.23,23984.43
333808083333132352,2020-11,7112.95,5205.16,5466.21,4940.91,2433.09,26417.52
333808083333132352,2020-12,5513.28,2674.77,4542.46,2333.43,5047.54,31465.06
334500144744259136,2020-01,0,700.84,0,1482.27,-2183.11,-2183.11
334500144744259136,2020-02,0,1633.84,0,453.27,-2087.11,-4270.22
334500144744259136,2020-03,1278.05,0,3074.88,0,4352.93,82.71
334500144744259136,2020-04,493.45,12.31,1711.83,2418.82,-225.85,-143.14
334500144744259136,2020-05,0,1054.88,0,0,-1054.88,-1198.02
334500144744259136,2020-06,0,1106.4,0,0,-1106.4,-2304.42
334500144744259136,2020-07,758.6,0,1715.46,0,2474.06,169.64
334500144744259136,2020-09,1784.01,1732.05,0,0,51.96,221.6
334500144744259136,2020-10,0,693.07,0,1257.57,-1950.64,-1729.04
334500144744259136,2020-11,0,1793.08,1162.92,0,-630.16,-2359.2
334500144744259136,2020-12,0,1779.35,6754.28,1633.64,3341.29,982.09
335167530101873216,2020-01,9006.93,1811.03,4709.75,4657.82,7247.83,7247.83
335167530101873216,2020-02,3668.22,588.13,2325.93,83.9,5322.12,12569.95
335167530101873216,2020-03,4896.39,6676.18,903.7,1886.62,-2762.71,9807.24
335167530101873216,2020-04,4061.49,2219.01,1319.77,3373.05,-210.8,9596.44
335167530101873216,2020-05,1491.92,5128.4,6066.3,4834,-2404.18,7192.26
335167530101873216,2020-06,1038.51,3520.04,1650.6,3447.08,-4278.01,2914.25
335167530101873216,2020-07,2504.53,908.12,4750.16,3082.67,3263.9,6178.15
335167530101873216,2020-08,2244.16,0,4362.38,4113.61,2492.93,8671.08
335167530101873216,2020-09,4193.88,3191.38,2689.3,1421.19,2270.61,10941.69
335167530101873216,2020-10,4162.84,3796.3,1549.06,224.92,1690.68,12632.37
335167530101873216,2020-11,0,2255.27,5005.6,3359.53,-609.2,12023.17
335167530101873216,2020-12,4963.4,980.06,356.86,4509.05,-168.85,11854.32
336007236430381440,2020-04,0,1932.54,1650.31,0,-282.23,-282.23
336007236430381440,2020-07,1212.01,0,1228.2,0,2440.21,2157.98
336007236430381440,2020-08,0,1779.49,0,1278.9,-3058.39,-900.41
336007236430381440,2020-09,0,1504.81,0,0,-1504.81,-2405.22
336007236430381440,2020-10,2436.54,1018.14,0,2445.21,-1026.81,-3432.03
336007236430381440,2020-12,396.21,762.7,769.68,966.02,-562.83,-3994.86
336735448735056896,2020-01,1908.48,2687.31,4330.45,4373.18,-821.56,-821.56
336735448735056896,2020-02,4508.02,4387.03,6217.9,4779.79,1559.1,737.54
336735448735056896,2020-03,4789.92,1883.06,7864.82,3988.33,6783.35,7520.89
336735448735056896,2020-04,4092.74,1995.87,9131.26,3920.89,7307.24,14828.13
336735448735056896,2020-05,10199.93,4099.35,2326.44,3148.79,5278.23,20106.36
336735448735056896,2020-06,973.67,5307.09,7473.52,2562.3,577.8,20684.16
336735448735056896,2020-07,837.23,997.77,6308.29,7409.16,-1261.41,19422.75
336735448735056896,2020-08,5565.91,2312.71,3964.17,4619.69,2597.68,22020.43
336735448735056896,2020-09,3069.13,1019.9,7424.26,4697.96,4775.53,26795.96
336735448735056896,2020-10,2078.38,6650.2,4932.57,5805.73,-5444.98,21350.98
336735448735056896,2020-11,3678.07,4329.86,3036.83,7967.59,-5582.55,15768.43
336735448735056896,2020-12,1145.02,4564.49,3527.43,3440.66,-3332.7,12435.73
336958475156602624,2020-01,2433.53,114.86,0,4137.78,-1819.11,-1819.11
336958475156602624,2020-02,439.22,778.69,5944.17,3604.7,2000,180.89
336958475156602624,2020-03,5284.6,3715.94,1860.85,5237.4,-1807.89,-1627
336958475156602624,2020-04,3357.92,5061.08,9750.86,6744.06,1303.64,-323.36
336958475156602624,2020-05,5464.52,202.44,6354.9,2124.05,9492.93,9169.57
336958475156602624,2020-06,529.85,3858.6,0,1871.01,-5199.76,3969.81
336958475156602624,2020-07,2876,1686.13,6418.02,2774.04,4833.85,8803.66
336958475156602624,2020-08,497.52,2914.5,1925.51,2931.84,-3423.31,5380.35
336958475156602624,2020-09,4159.69,0,7867.08,1085.42,10941.35,16321.7
336958475156602624,2020-10,4653.76,2593.97,0,5167.48,-3107.69,13214.01
336958475156602624,2020-11,1687.9,0,1386.09,3121.06,-47.07,13166.94
336958475156602624,2020-12,1622.58,7878.74,4411.55,4495.79,-6340.4,6826.54
337557693962360256,2020-01,0,1682.5,1294.23,1821.25,-2209.52,-2209.52
337557693962360256,2020-02,1068.59,39.66,4486.28,1545.32,3969.89,1760.37
337557693962360256,2020-03,0,1068.08,2059.89,1594.71,-602.9,1157.47
337557693962360256,2020-04,2075.26,0,764.1,0,2839.36,3996.83
337557693962360256,2020-05,1793.55,3384.6,726.38,724.09,-1588.76,2408.07
337557693962360256,2020-06,452.94,2938.01,1574.79,1071.84,-1982.12,425.95
337557693962360256,2020-07,1602.19,150.57,925.52,2208.96,168.18,594.13
337557693962360256,2020-08,1846.68,790.13,0,464.18,592.37,1186.5
337557693962360256,2020-09,1138.8,0,0,1088.84,49.96,1236.46
337557693962360256,2020-10,1001.53,4535.62,0,0,-3534.09,-2297.63
337557693962360256,2020-11,1459.44,305.51,1931.08,349.73,2735.28,437.65
337557693962360256,2020-12,1492.48,2297.5,953.04,0,148.02,585.67
337901585520676672,2020-01,1243.42,0,2493.5,1869.63,1867.29,1867.29
337901585520676672,2020-03,884.68,0,0,0,884.68,2751.97
337901585520676672,2020-05,2088.72,609.86,126.77,782.84,822.79,3574.76
337901585520676672,2020-06,1855.59,0,0,3424.18,-1568.59,2006.17
337901585520676672,2020-07,193.04,1405.2,1675.09,1306.45,-843.52,1162.65
337901585520676672,2020-08,287.04,1797.51,0,3866.97,-5377.44,-4214.79
337901585520676672,2020-09,1043.78,1434.16,0,745.2,-1135.58,-5350.37
337901585520676672,2020-10,1207.31,1155.94,227.87,0,279.24,-5071.13
337901585520676672,2020-11,1086.06,0,1575.21,2225.7,435.57,-4635.56
337901585520676672,2020-12,5525.33,1187.63,2802.6,0,7140.3,2504.74
338161820951347072,2020-01,914.76,0,752.79,0,1667.55,1667.55
338161820951347072,2020-02,1231.83,2514.42,2243.78,812.37,148.82,1816.37
338161820951347072,2020-03,664.4,1163.81,2935.34,3221.91,-785.98,1030.39
338161820951347072,2020-04,0,2907.81,0,2562.21,-5470.02,-4439.63
338161820951347072,2020-05,0,436.15,1703.02,1407.24,-140.37,-4580
338161820951347072,2020-06,2169.42,987.18,0,2284.04,-1101.8,-5681.8
338161820951347072,2020-07,2079.13,1355.81,0,1226.89,-503.57,-6185.37
338161820951347072,2020-08,2352.32,2616.9,1315.03,1915.83,-865.38,-7050.75
338161820951347072,2020-09,690.88,0,1534.75,1284.7,940.93,-6109.82
338161820951347072,2020-10,1800.73,0,0,2556.02,-755.29,-6865.11
338161820951347072,2020-11,1150.5,1079.53,887.31,0,958.28,-5906.83
338161820951347072,2020-12,1862.73,634.54,0,1263.82,-35.63,-5942.46
339423483125970752,2020-01,3913.52,0,1600.58,933.48,4580.62,4580.62
339423483125970752,2020-03,2008.95,1617.01,0,0,391.94,4972.56
339423483125970752,2020-04,0,1349.66,1914.18,0,564.52,5537.08
339423483125970752,2020-07,772.42,0,278.64,0,1051.06,6588.14
339423483125970752,2020-09,0,594.63,2973.37,0,2378.74,8966.88
339423483125970752,2020-11,0,2099.57,1633.67,904.01,-1369.91,7596.97
339423483125970752,2020-12,18.8,731.72,881.64,225.63,-56.91,7540.06
339447091655224896,2020-01,2974.94,2409.31,2205.51,3008.45,-237.31,-237.31
339447091655224896,2020-02,5215.28,2987.71,3105.78,2550.2,2783.15,2545.84
339447091655224896,2020-03,2754.84,4221.86,4193.27,5091.76,-2365.51,180.33
339447091655224896,2020-04,2906.07,4784.91,4741.13,4091.85,-1229.56,-1049.23
339447091655224896,2020-05,4351.12,2465.27,6039.6,6603.8,1321.65,272.42
339447091655224896,2020-06,6364.43,9283.55,4977.49,2437.06,-378.69,-106.27
339447091655224896,2020-07,2750.18,5646.55,3358.64,5686.97,-5224.7,-5330.97
339447091655224896,2020-08,1559.13,3086.23,4137.64,9577.6,-6967.06,-12298.03
339447091655224896,2020-09,5100.35,1488.87,11042.04,5157.66,9495.86,-2802.17
339447091655224896,2020-10,1102.54,3531.24,4698.76,3782.85,-1512.79,-4314.96
339447091655224896,2020-11,1936.5,2960.96,5455.34,4875.81,-444.93,-4759.89
339447091655224896,2020-12,7221.87,5178.79,2888.38,4350.55,580.91,-4178.98
340126008310351488,2020-01,2849.89,6285.45,1963.4,163.4,-1635.56,-1635.56
340126008310351488,2020-02,2827.62,1434.15,1930.99,2341.21,983.25,-652.31
340126008310351488,2020-03,3101.64,0,2891.42,3463.3,2529.76,1877.45
340126008310351488,2020-04,930.38,2272.35,380.88,1669.1,-2630.19,-752.74
340126008310351488,2020-05,1492.86,3604.96,371.08,0,-1741.02,-2493.76
340126008310351488,2020-06,0,98.37,0,1410,-1508.37,-4002.13
340126008310351488,2020-07,3502.49,0,2063.34,3120.07,2445.76,-1556.37
340126008310351488,2020-08,0,2800.95,4173.45,2741.48,-1368.98,-2925.35
340126008310351488,2020-09,1953.44,0,1495.19,557.16,2891.47,-33.88
340126008310351488,2020-10,0,1071.32,2090.25,2122.96,-1104.03,-1137.91
340126008310351488,2020-11,1908.19,4527.71,1664.89,793.07,-1747.7,-2885.61
340126008310351488,2020-12,496.89,1361.17,0,863.41,-1727.69,-4613.3
343573136843501632,2020-01,2891.63,2717.21,8317.39,4364.58,4127.23,4127.23
343573136843501632,2020-02,9045.64,0,5249.6,4026.7,10268.54,14395.77
343573136843501632,2020-03,4839.32,2230.06,5128.92,6054.07,1684.11,16079.88
343573136843501632,2020-04,5925.22,9090.2,1874.37,5245.59,-6536.2,9543.68
343573136843501632,2020-05,2740.3,2966.14,2060.99,1981.86,-146.71,9396.97
343573136843501632,2020-06,9514.41,3792.98,4411.71,4252.25,5880.89,15277.86
343573136843501632,2020-07,4664.89,4370.11,7059.48,3452.38,3901.88,19179.74
343573136843501632,2020-08,3170.65,4278.33,5414.73,3995.91,311.14,19490.88
343573136843501632,2020-09,2190.38,7122.73,4785.73,5601.35,-5747.97,13742.91
343573136843501632,2020-10,3057.35,556.38,3217.46,5784.82,-66.39,13676.52
343573136843501632,2020-11,4634.16,2468.07,3894.77,4692.3,1368.56,15045.08
343573136843501632,2020-12,1046.73,5643.88,9522.14,4583.48,341.51,15386.59
348105534425728320,2020-01,1908.97,1028.21,0,190.53,690.23,690.23
348105534425728320,2020-02,387.33,1715.03,1354.59,451.81,-424.92,265.31
348105534425728320,2020-03,2586.63,1517.34,0,3377.81,-2308.52,-2043.21
348105534425728320,2020-04,1988.25,1527.34,1914.78,999.12,1376.57,-666.64
348105534425728320,2020-05,2585.73,2557.04,0,0,28.69,-637.95
348105534425728320,2020-06,249.79,768.2,2979.86,1674.25,787.2,149.25
348105534425728320,2020-07,0,898.13,0,0,-898.13,-748.88
348105534425728320,2020-08,1918.42,0,3011.21,3442.63,1487,738.12
348105534425728320,2020-09,0,1638.84,2484.08,0,845.24,1583.36
348105534425728320,2020-10,618.51,570.97,538.42,0,585.96,2169.32
348105534425728320,2020-12,1661.79,1885.96,1250.15,2020.32,-994.34,1174.98
348683043896683520,2020-01,2415.43,1327.15,1915.18,5014.29,-2010.83,-2010.83
348683043896683520,2020-02,1152.45,2338.95,743.97,0,-442.53,-2453.36
348683043896683520,2020-03,1625.33,4540.49,0,1664.56,-4579.72,-7033.08
348683043896683520,2020-04,673.53,0,1723.96,0,2397.49,-4635.59
348683043896683520,2020-05,857.45,3788.3,983.94,2642.44,-4589.35,-9224.94
348683043896683520,2020-06,46.89,1225.5,4594.3,0,3415.69,-5809.25
348683043896683520,2020-07,2532.96,0,3348.78,792,5089.74,-719.51
348683043896683520,2020-08,0,494.78,0,0,-494.78,-1214.29
348683043896683520,2020-09,695.03,1386.25,1937.71,1080.73,165.76,-1048.53
348683043896683520,2020-10,0,2024.48,2129.85,0,105.37,-943.16
348683043896683520,2020-11,702.56,973.67,1477.33,1275.37,-69.15,-1012.31
348683043896683520,2020-12,1133.78,2160.11,3236.48,0,2210.15,1197.84
350794635095767552,2020-01,4116.77,6571.26,2486.1,5985.55,-5953.94,-5953.94
350794635095767552,2020-02,5936.04,6795.51,7484.08,550.09,6074.52,120.58
350794635095767552,2020-03,1616.54,10095.68,2868.61,5810.49,-11421.02,-11300.44
350794635095767552,2020-04,2755.93,2097.2,1273.36,5828.2,-3896.11,-15196.55
350794635095767552,2020-05,8124.58,2591.94,3266.5,4419.61,4379.53,-10817.02
350794635095767552,2020-06,9564.69,4172.7,2169.86,2621.38,4940.47,-5876.55
350794635095767552,2020-07,5611.4,2855.43,2214.42,3713.53,1256.86,-4619.69
350794635095767552,2020-08,0,4851.75,2469.88,206.84,-2588.71,-7208.4
350794635095767552,2020-09,5628,6234.19,5227.38,4221.62,399.57,-6808.83
350794635095767552,2020-10,4958.36,3883.44,3978.24,5324.03,-270.87,-7079.7
350794635095767552,2020-11,2325.96,3392.99,3937.82,3591.49,-720.7,-7800.4
350794635095767552,2020-12,2124.45,8742.71,11844.42,4059.06,1167.1,-6633.3
350938169589381312,2020-01,7750.49,7586.18,569.03,4288.43,-3555.09,-3555.09
350938169589381312,2020-02,3356.13,5649.26,6474.37,5612.97,-1431.73,-4986.82
350938169589381312,2020-03,4925.76,1582.69,2872.85,822.29,5393.63,406.81
350938169589381312,2020-04,1201,5515.92,4224.32,2047.05,-2137.65,-1730.84
350938169589381312,2020-05,1477.28,3394.02,4872.75,1790.61,1165.4,-565.44
350938169589381312,2020-06,3564.82,2375.26,1033.55,6704.12,-4481.01,-5046.45
350938169589381312,2020-07,7626.95,2630.77,4911.39,768.5,9139.07,4092.62
350938169589381312,2020-08,2457.93,6694.79,9123.37,6918.21,-2031.7,2060.92
350938169589381312,2020-09,6978.32,2071.5,6957.91,5089.03,6775.7,8836.62
350938169589381312,2020-10,5891.01,4127.64,2011.34,5674.48,-1899.77,6936.85
350938169589381312,2020-11,9933.27,7182.36,7106.11,4970.74,4886.28,11823.13
350938169589381312,2020-12,3356.33,4256.85,7745.71,2537.51,4307.68,16130.81
353258440400004480,2020-01,1596.51,356.85,358.66,2124.42,-526.1,-526.1
353258440400004480,2020-02,1585.89,0,0,0,1585.89,1059.79
353258440400004480,2020-03,0,2432.26,1752.65,3787.8,-4467.41,-3407.62
353258440400004480,2020-04,3481.26,1180.69,2081.19,705.36,3676.4,268.78
353258440400004480,2020-05,1528.43,2773.83,0,7457.89,-8703.29,-8434.51
353258440400004480,2020-06,1794.11,1788.58,0,1122.88,-1117.35,-9551.86
353258440400004480,2020-07,1090.82,822.88,698.43,1424.33,-457.96,-10009.82
353258440400004480,2020-09,0,1918.49,2620.29,854.07,-152.27,-10162.09
353258440400004480,2020-10,1560.75,0,0,1271.42,289.33,-9872.76
353258440400004480,2020-11,0,1964.1,0,0,-1964.1,-11836.86
353258440400004480,2020-12,1484.63,0,535.44,1396.32,623.75,-11213.11
353968482962785408,2020-01,0,897.83,285.99,595.49,-1207.33,-1207.33
353968482962785408,2020-02,0,1351.32,661.25,1011.12,-1701.19,-2908.52
353968482962785408,2020-03,1400.71,180.43,1326,1485.06,1061.22,-1847.3
353968482962785408,2020-04,0,1173.43,0,0,-1173.43,-3020.73
353968482962785408,2020-05,271.95,1059.91,0,0,-787.96,-3808.69
353968482962785408,2020-06,0,1067.77,0,1811.26,-2879.03,-6687.72
353968482962785408,2020-08,421.12,1807.49,0,0,-1386.37,-8074.09
354512048238236224,2020-01,1389.06,4127.03,1636.49,2775.86,-3877.34,-3877.34
354512048238236224,2020-02,1880.18,2023.45,2978.96,3708.58,-872.89,-4750.23
354512048238236224,2020-03,284.16,1385.38,5632.83,4250.84,280.77,-4469.46
354512048238236224,2020-04,3918.3,3755.99,4164.3,6019.19,-1692.58,-6162.04
354512048238236224,2020-05,4614.46,3926.65,1230.26,8599.72,-6681.65,-12843.69
354512048238236224,2020-06,1534.11,5762.28,5086.61,2187.35,-1328.91,-14172.6
354512048238236224,2020-07,1368.2,1547.32,5940.33,4484.43,1276.78,-12895.82
354512048238236224,2020-08,5992.84,4015.76,1992.59,3786.33,183.34,-12712.48
354512048238236224,2020-09,0,2764.56,3021.97,1587.17,-1329.76,-14042.24
354512048238236224,2020-10,3615.04,5752.49,5406.8,3338.06,-68.71,-14110.95
354512048238236224,2020-11,3345.18,4318.44,3952.01,3598.45,-619.7,-14730.65
354512048238236224,2020-12,4958.75,2837.73,2093.57,2692.17,1522.42,-13208.23
355403862342381120,2020-01,1848.66,1019.63,0,3543.35,-2714.32,-2714.32
355403862342381120,2020-02,0,5567.7,6881.8,5350.21,-4036.11,-6750.43
355403862342381120,2020-03,0,358.9,3143.89,4972.23,-2187.24,-8937.67
355403862342381120,2020-04,1387.58,1248.54,1758.36,2966.38,-1068.98,-10006.65
355403862342381120,2020-05,2553.82,530.53,1860.43,2488.78,1394.94,-8611.71
355403862342381120,2020-06,1596.63,2551.89,2577.28,1833.69,-211.67,-8823.38
355403862342381120,2020-07,161.16,2646.48,1247.77,5941.13,-7178.68,-16002.06
355403862342381120,2020-08,556.78,2160.86,3092.08,1118.99,369.01,-15633.05
355403862342381120,2020-09,1514.7,6732.97,994.25,1082.52,-5306.54,-20939.59
355403862342381120,2020-10,1074.79,6293.76,1228.94,1747.51,-5737.54,-26677.13
355403862342381120,2020-11,4643.32,0,161.57,0,4804.89,-21872.24
355403862342381120,2020-12,1862.02,227.01,0,5860.15,-4225.14,-26097.38
356431126825028480,2020-01,2217.15,9614.05,9693.86,3397.58,-1100.62,-1100.62
356431126825028480,2020-02,3189.33,1093.87,3730.46,2547.96,3277.96,2177.34
356431126825028480,2020-03,4464.46,4138.94,5930.42,5761.85,494.09,2671.43
356431126825028480,2020-04,1909.8,5515.25,7684.85,2467.7,1611.7,4283.13
356431126825028480,2020-05,5591.34,3140.38,4572.05,2392.22,4630.79,8913.92
356431126825028480,2020-06,5172.42,2523.95,4810.04,5727.31,1731.2,10645.12
356431126825028480,2020-07,3108.02,6261.51,4442.98,888.96,400.53,11045.65
356431126825028480,2020-08,7045.11,5008.18,3082.66,2932.73,2186.86,13232.51
356431126825028480,2020-09,3188.3,5564.66,266.42,4320.76,-6430.7,6801.81
356431126825028480,2020-10,5745.02,6594.43,10191.68,3101.28,6240.99,13042.8
356431126825028480,2020-11,3641.03,1883.44,6804.66,3975.2,4587.05,17629.85
356431126825028480,2020-12,6112.41,4960.98,4007.36,4590.93,567.86,18197.71
356665593032815360,2020-01,3977.78,6507.25,4380.9,4345.17,-2493.74,-2493.74
356665593032815360,2020-02,1571.87,3420.15,2035.77,1802.27,-1614.78,-4108.52
356665593032815360,2020-03,3760.49,4391.53,794.33,6093.21,-5929.92,-10038.44
356665593032815360,2020-04,0,7601.33,8733.53,756.67,375.53,-9662.91
356665593032815360,2020-05,7696.73,2623.51,3935.06,4807.23,4201.05,-5461.86
356665593032815360,2020-06,5654.16,3700.74,5898.25,3969.43,3882.24,-1579.62
356665593032815360,2020-07,2685.97,1189.92,7712.43,9172.4,36.08,-1543.54
356665593032815360,2020-08,4224.92,5765.18,2087.73,5875.89,-5328.42,-6871.96
356665593032815360,2020-09,7260.37,2208.15,0,9344.27,-4292.05,-11164.01
356665593032815360,2020-10,2168.08,2639.99,7173.26,4361.62,2339.73,-8824.28
356665593032815360,2020-11,3971.88,3948.67,0,6638.89,-6615.68,-15439.96
356665593032815360,2020-12,4244.97,1473.55,536.93,5622.66,-2314.31,-17754.27
357531052441408000,2020-01,3850.54,3398.15,4095.47,1478.97,3068.89,3068.89
357531052441408000,2020-02,4100.52,6696.21,502.85,3414.4,-5507.24,-2438.35
357531052441408000,2020-03,1986.69,5717.08,7259.61,7260.52,-3731.3,-6169.65
357531052441408000,2020-04,4523.26,4466.69,1139.86,1480.68,-284.25,-6453.9
357531052441408000,2020-05,3822.21,3266.31,31.62,0,587.52,-5866.38
357531052441408000,2020-06,7740.15,0,3031.44,3363.64,7407.95,1541.57
357531052441408000,2020-07,3033.54,3483.76,3240.35,1399.54,1390.59,2932.16
357531052441408000,2020-08,4650.91,3546.94,4530.84,7960.82,-2326.01,606.15
357531052441408000,2020-09,6260.62,6731.01,4816.04,3402.24,943.41,1549.56
357531052441408000,2020-10,1754.17,0,6316.77,2719.08,5351.86,6901.42
357531052441408000,2020-11,3393.87,2097.1,1891.88,4331.36,-1142.71,5758.71
357531052441408000,2020-12,4176.65,3309.75,4442.74,4047.04,1262.6,7021.31
358103633370811776,2020-01,1976.12,0,627.78,536.05,2067.85,2067.85
358103633370811776,2020-03,1504.16,2088.77,0,0,-584.61,1483.24
358103633370811776,2020-04,1793.24,164.87,0,670.68,957.69,2440.93
358103633370811776,2020-05,0,2059.31,1509.52,0,-549.79,1891.14
358103633370811776,2020-06,737.61,4770.74,846.8,1287.93,-4474.26,-2583.12
358103633370811776,2020-07,157.36,1843.37,0,2142.91,-3828.92,-6412.04
358103633370811776,2020-08,1820.94,2413.61,0,1245.1,-1837.77,-8249.81
358103633370811776,2020-10,4121.4,1689.65,2065.56,2209.46,2287.85,-5961.96
358103633370811776,2020-11,1722.13,0,462.71,1707.7,477.14,-5484.82
358103633370811776,2020-12,182.17,3386.38,1319.92,1703.35,-3587.64,-9072.46
359432744376383616,2020-01,0,1156.9,0,0,-1156.9,-1156.9
359432744376383616,2020-08,551.73,0,0,0,551.73,-605.17
359432744376383616,2020-09,1102.52,0,0,0,1102.52,497.35
359432744376383616,2020-10,0,3292.22,0,0,-3292.22,-2794.87
359432744376383616,2020-12,0,729.57,1205.37,0,475.8,-2319.07
360944201335621632,2020-01,174.83,1447.89,0,0,-1273.06,-1273.06
360944201335621632,2020-02,2009.32,3272.84,1347.17,0,83.65,-1189.41
360944201335621632,2020-04,640.12,0,2567.99,0,3208.11,2018.7
360944201335621632,2020-05,1968.27,1051.78,596.58,0,1513.07,3531.77
360944201335621632,2020-06,1109.85,0,1950.43,562.16,2498.12,6029.89
360944201335621632,2020-07,0,679.06,0,1687.57,-2366.63,3663.26
360944201335621632,2020-08,2477.61,0,1675.22,586.52,3566.31,7229.57
360944201335621632,2020-11,1914.24,2537.26,4.96,1481.61,-2099.67,5129.9
360944201335621632,2020-12,2726.3,1549.08,1741.34,285.84,2632.72,7762.62
361604643182903424,2020-01,1560.11,6214.29,3149.89,32.77,-1537.06,-1537.06
361604643182903424,2020-02,6654.03,1855.78,6646.4,9183.73,2260.92,723.86
361604643182903424,2020-03,9264.37,7548.48,2041.55,9256.82,-5499.38,-4775.52
361604643182903424,2020-04,5491.57,3661.84,5883.56,2111.01,5602.28,826.76
361604643182903424,2020-05,5083.07,4270.86,2573.83,5.86,3380.18,4206.94
361604643182903424,2020-06,5397.27,5019.58,5317.45,3944.81,1750.33,5957.27
361604643182903424,2020-07,5933.25,7925.71,6087.9,4927.9,-832.46,5124.81
361604643182903424,2020-08,2546.72,6096.2,502.66,3913.01,-6959.83,-1835.02
361604643182903424,2020-09,10348.02,2671.86,5765.13,3614.08,9827.21,7992.19
361604643182903424,2020-10,7187.55,10867.11,4300.62,3632.59,-3011.53,4980.66
361604643182903424,2020-11,10009.35,4826.57,1693.43,8244.95,-1368.74,3611.92
361604643182903424,2020-12,4469.44,2910.21,6183.1,1694.43,6047.9,9659.82
362552780560336832,2020-01,2351.35,1730.75,2468.28,12604.82,-9515.94,-9515.94
362552780560336832,2020-02,7197.75,7768.67,1617.25,2690.44,-1644.11,-11160.05
362552780560336832,2020-03,7879.52,8995.91,3433.73,2238.85,78.49,-11081.56
362552780560336832,2020-04,5945.99,2780.8,6294.87,4520.2,4939.86,-6141.7
362552780560336832,2020-05,3932.01,10829.64,12063.85,7600.19,-2433.97,-8575.67
362552780560336832,2020-06,3872.04,4387.88,3725.43,4398.46,-1188.87,-9764.54
362552780560336832,2020-07,7764.96,1943.23,2303.91,796.36,7329.28,-2435.26
362552780560336832,2020-08,5404.79,3256.46,4161.53,8990.07,-2680.21,-5115.47
362552780560336832,2020-09,6637.04,6814.26,3110.62,3456.2,-522.8,-5638.27
362552780560336832,2020-10,1914.13,5542.66,3765.65,3395.12,-3258,-8896.27
362552780560336832,2020-11,785.12,3390.79,5691.93,1733.19,1353.07,-7543.2
362552780560336832,2020-12,2570.57,4799.37,2361.64,2146.23,-2013.39,-9556.59
363084361693740096,2020-01,4247.66,491.66,2426.37,3998.54,2183.83,2183.83
363084361693740096,2020-02,1730.41,5273.26,8136.39,3617.7,975.84,3159.67
363084361693740096,2020-03,5781.82,3294.54,1492.33,4511.39,-531.78,2627.89
363084361693740096,2020-04,1671.13,3034.03,456.72,1216.72,-2122.9,504.99
363084361693740096,2020-05,5041.51,8672.89,2978.72,3790.97,-4443.63,-3938.64
363084361693740096,2020-06,3520.33,1243.2,1836.61,3284.63,829.11,-3109.53
363084361693740096,2020-07,4349.41,4480.83,6701.18,3564.73,3005.03,-104.5
363084361693740096,2020-08,2577.42,4388.97,9145.48,0,7333.93,7229.43
363084361693740096,2020-09,5292.93,6324.87,1466.52,3086.25,-2651.67,4577.76
363084361693740096,2020-10,6817.82,6161.11,3846.83,1931.67,2571.87,7149.63
363084361693740096,2020-11,5581.47,5729.31,6353.07,3054.95,3150.28,10299.91
363084361693740096,2020-12,1259.65,5002.56,3344.75,1346.58,-1744.74,8555.17
363678894478075840,2020-01,890.58,0,820.07,1678.11,32.54,32.54
363678894478075840,2020-02,0,3518.12,835.77,0,-2682.35,-2649.81
363678894478075840,2020-04,0,2833.8,0,461.43,-3295.23,-5945.04
363678894478075840,2020-05,1087.95,2404.63,0,681.02,-1997.7,-7942.74
363678894478075840,2020-06,1572.47,943.75,1500.89,393.08,1736.53,-6206.21
363678894478075840,2020-07,99.37,4890.44,481.58,664.05,-4973.54,-11179.75
363678894478075840,2020-08,769.25,0,0,0,769.25,-10410.5
363678894478075840,2020-09,0,1491.31,506.43,1838.51,-2823.39,-13233.89
363678894478075840,2020-10,4677.33,785.53,0,1781.37,2110.43,-11123.46
363678894478075840,2020-11,3087.28,0,43.41,0,3130.69,-7992.77
363678894478075840,2020-12,1969.18,201.71,1271.11,3033.75,4.83,-7987.94
363782435497340928,2020-01,1609.73,4756.4,431.87,1323.8,-4038.6,-4038.6
363782435497340928,2020-02,3209.32,0,1960.26,3090.82,2078.76,-1959.84
363782435497340928,2020-03,742.9,767.12,813.46,6359.46,-5570.22,-7530.06
363782435497340928,2020-04,0,743.63,2306.23,962.51,600.09,-6929.97
363782435497340928,2020-05,766.94,359.5,1699.42,0,2106.86,-4823.11
363782435497340928,2020-06,522.89,2877.3,3189.33,875.98,-41.06,-4864.17
363782435497340928,2020-07,0,966.14,0,1702.49,-2668.63,-7532.8
363782435497340928,2020-08,2284.68,3879.92,0,0,-1595.24,-9128.04
363782435497340928,2020-09,456.19,1617.52,0,3140.11,-4301.44,-13429.48
363782435497340928,2020-10,1051.25,462.11,0,525.12,64.02,-13365.46
363782435497340928,2020-11,0,2143.01,1558.81,2464.32,-3048.52,-16413.98
363782435497340928,2020-12,44.66,2846.09,40.06,0,-2761.37,-19175.35
364339143463862272,2020-01,17.1,4642.59,1599.5,271.06,-3297.05,-3297.05
364339143463862272,2020-02,6334.22,5644.01,2269.2,2890.54,68.87,-3228.18
364339143463862272,2020-03,637.08,1597.02,5039.31,6811.76,-2732.39,-5960.57
364339143463862272,2020-04,2316.22,2331.25,5138.12,2611.05,2512.04,-3448.53
364339143463862272,2020-05,3677.48,1113.7,2102.34,5705.7,-1039.58,-4488.11
364339143463862272,2020-06,3500.77,197.18,1915.24,4905.76,313.07,-4175.04
364339143463862272,2020-07,6775.15,767.61,1955.3,4419.85,3542.99,-632.05
364339143463862272,2020-08,2919.29,1617.71,1404.41,5252.31,-2546.32,-3178.37
364339143463862272,2020-09,5010.43,4124.92,6702,3304.59,4282.92,1104.55
364339143463862272,2020-10,5723.73,2313.05,1110.03,1321.72,3198.99,4303.54
364339143463862272,2020-11,6630.17,3171.91,753.96,7215.29,-3003.07,1300.47
364339143463862272,2020-12,4461.71,1536.99,6936.12,5669.96,4190.88,5491.35
366164701292132608,2020-01,4446.31,9326.34,5003.24,4099.86,-3976.65,-3976.65
366164701292132608,2020-02,6072.91,8287.97,5024.59,2916.59,-107.06,-4083.71
366164701292132608,2020-03,1722.88,2791.97,2775.22,2195.33,-489.2,-4572.91
366164701292132608,2020-04,2214.79,3981.2,4206.61,3677.21,-1237.01,-5809.92
366164701292132608,2020-05,7737.19,5121.72,1758.19,5899.6,-1525.94,-7335.86
366164701292132608,2020-06,4498.38,5076.09,2699.86,4161.63,-2039.48,-9375.34
366164701292132608,2020-07,10085.24,2936.2,2510.74,2297.99,7361.79,-2013.55
366164701292132608,2020-08,7631.15,5392.66,1776.97,6422.12,-2406.66,-4420.21
366164701292132608,2020-09,4376.13,2068.78,5891.08,4315.88,3882.55,-537.66
366164701292132608,2020-10,2574.71,3340.19,3059.05,3578.92,-1285.35,-1823.01
366164701292132608,2020-11,9164.06,5992.89,5348.23,5569.96,2949.44,1126.43
366164701292132608,2020-12,2991.65,10542.36,0,2128.01,-9678.72,-8552.29
366398489645734592,2020-01,7132.61,2408.21,952.85,5691.49,-14.24,-14.24
366398489645734592,2020-02,1819.02,2191.4,4044.17,4174.77,-502.98,-517.22
366398489645734592,2020-03,1589.38,2597.8,1886.79,7381.6,-6503.23,-7020.45
366398489645734592,2020-04,602.65,1348.48,4555.87,2247.82,1562.22,-5458.23
366398489645734592,2020-05,1039.65,2453.96,4281.82,6598.19,-3730.68,-9188.91
366398489645734592,2020-06,1703.94,2103.69,5183.9,1016.46,3767.69,-5421.22
366398489645734592,2020-07,1041.38,4073.84,3416.03,1786.48,-1402.91,-6824.13
366398489645734592,2020-08,4422.74,0,4284.61,2812.36,5894.99,-929.14
366398489645734592,2020-09,1912.58,3393.78,0,258.93,-1740.13,-2669.27
366398489645734592,2020-10,4824.06,3401.92,1637.91,0,3060.05,390.78
366398489645734592,2020-11,2108.64,5957.15,2052.36,4116.96,-5913.11,-5522.33
366398489645734592,2020-12,7121.86,2208.82,3962.95,4940.97,3935.02,-1587.31
366443523909551680,2020-01,1168.72,0,1213.24,1921.96,460,460
366443523909551680,2020-02,0,3210.71,0,1024.86,-4235.57,-3775.57
366443523909551680,2020-03,1752.11,1340.67,2126.29,232.33,2305.4,-1470.17
366443523909551680,2020-04,1053.09,0,0,0,1053.09,-417.08
366443523909551680,2020-06,0,1834.63,0,12.01,-1846.64,-2263.72
366443523909551680,2020-07,0,4199.38,429.05,0,-3770.33,-6034.05
366443523909551680,2020-08,2191.89,0,3178.1,0,5369.99,-664.06
366443523909551680,2020-10,2970.26,928.76,0,2011.47,30.03,-634.03
366443523909551680,2020-11,0,526.67,3769.1,2444.27,798.16,164.13
366443523909551680,2020-12,427.53,699.42,354.02,106.33,-24.2,139.93
366811203511484608,2020-01,255.55,1544.59,4151.55,6849.17,-3986.66,-3986.66
366811203511484608,2020-02,5870.96,1810.84,4494.37,2174.82,6379.67,2393.01
366811203511484608,2020-03,3672.32,4810.74,6816.01,5555.92,121.67,2514.68
366811203511484608,2020-04,4779.83,8289.93,2449.42,8347.78,-9408.46,-6893.78
366811203511484608,2020-05,5564,4353.65,3896.5,1914.78,3192.07,-3701.71
366811203511484608,2020-06,13222.06,4878.15,4137.44,1515.62,10965.73,7264.02
366811203511484608,2020-07,6144.35,6136.14,7285.58,3646,3647.79,10911.81
366811203511484608,2020-08,4693.47,5011.63,3858.59,2802.72,737.71,11649.52
366811203511484608,2020-09,8796.3,6106.38,2053.5,2531.02,2212.4,13861.92
366811203511484608,2020-10,4071.01,1689.7,5600.83,2481.33,5500.81,19362.73
366811203511484608,2020-11,2283.77,324.63,1947.44,6767.63,-2861.05,16501.68
366811203511484608,2020-12,10222.35,9468.02,3777.02,4696.97,-165.62,16336.06
367845782754400064,2020-02,0,1536.04,933.56,1150.32,-1752.8,-1752.8
367845782754400064,2020-03,1214.04,2099.3,0,820.28,-1705.54,-3458.34
367845782754400064,2020-04,1337.81,1793.54,0,0,-455.73,-3914.07
367845782754400064,2020-07,0,368.38,0,174.28,-542.66,-4456.73
367845782754400064,2020-08,2325.15,0,73.62,0,2398.77,-2057.96
367845782754400064,2020-09,491.69,0,1417.14,0,1908.83,-149.13
367845782754400064,2020-10,789.97,1225.75,1278.86,0,843.08,693.95
367906725705329152,2020-01,1867.1,0,0,0,1867.1,1867.1
367906725705329152,2020-03,0,2737.83,2342.05,0,-395.78,1471.32
367906725705329152,2020-04,1923.27,371.92,0,1784.84,-233.49,1237.83
367906725705329152,2020-06,313.72,880.39,0,1527.24,-2093.91,-856.08
367906725705329152,2020-09,845.13,1201.71,0,0,-356.58,-1212.66
367906725705329152,2020-10,324.52,0,0,875.62,-551.1,-1763.76
367906725705329152,2020-11,1359.91,0,830.52,1750.9,439.53,-1324.23
369185699212474880,2020-01,3016.69,874.64,0,0,2142.05,2142.05
369185699212474880,2020-02,5081.93,0,0,169.44,4912.49,7054.54
369185699212474880,2020-03,2120.79,466.11,1424.86,1071.29,2008.25,9062.79
369185699212474880,2020-04,2485.04,1816.47,1956.78,2202.9,422.45,9485.24
369185699212474880,2020-05,0,1873.04,2827.64,1055.35,-100.75,9384.49
369185699212474880,2020-06,3317.64,1540.68,0,1913.05,-136.09,9248.4
369185699212474880,2020-08,3409.45,16.47,2457.9,748.79,5102.09,14350.49
369185699212474880,2020-11,1669.33,0,590.17,965.08,1294.42,15644.91
369185699212474880,2020-12,0,1630.51,705.69,3118.94,-4043.76,11601.15
369356431862414784,2020-01,4112.41,2012.66,9498.65,4655.3,6943.1,6943.1
369356431862414784,2020-02,2716.66,6451.18,10429.16,2770.31,3924.33,10867.43
369356431862414784,2020-03,2651.58,3692.02,9208.45,4135.96,4032.05,14899.48
369356431862414784,2020-04,8960.13,4379.27,10899.71,6746.06,8734.51,23633.99
369356431862414784,2020-05,2823.84,4383.96,5969.24,4610.15,-201.03,23432.96
369356431862414784,2020-06,4604.01,1217.52,7825.94,0,11212.43,34645.39
369356431862414784,2020-07,1511,1624.03,9272.09,2280.95,6878.11,41523.5
369356431862414784,2020-08,2551.13,6584.87,3050.57,2193.33,-3176.5,38347
369356431862414784,2020-09,515,3096.77,3642.09,343.94,716.38,39063.38
369356431862414784,2020-10,2879.51,3087.34,1708.17,2870.92,-1370.58,37692.8
369356431862414784,2020-11,3076.84,4298.87,5147.43,5997.93,-2072.53,35620.27
369356431862414784,2020-12,5407.14,7740.45,7661.59,4346.44,981.84,36602.11
369551887773695104,2020-09,0,1369.68,0,0,-1369.68,-1369.68
370217377221170304,2020-01,1803.44,2567.13,6319.09,1146.17,4409.23,4409.23
370217377221170304,2020-02,2194.94,4897.06,1842.94,460.91,-1320.09,3089.14
370217377221170304,2020-03,765.19,1851.62,5629.46,6921.82,-2378.79,710.35
370217377221170304,2020-04,225.62,667.84,241.72,4112.88,-4313.38,-3603.03
370217377221170304,2020-05,0,1216.85,3500.41,1425.31,858.25,-2744.78
370217377221170304,2020-06,1067.44,3437.33,0,2400.92,-4770.81,-7515.59
370217377221170304,2020-07,3217.69,4908.98,1061.02,5680.95,-6311.22,-13826.81
370217377221170304,2020-08,2950.6,3004.35,1354.8,5726.1,-4425.05,-18251.86
370217377221170304,2020-09,7568.5,1223.15,3437.58,2607.26,7175.67,-11076.19
370217377221170304,2020-10,427.2,787.06,5202.09,5024.04,-181.81,-11258
370217377221170304,2020-11,3417.21,3062.88,1594.57,4303.8,-2354.9,-13612.9
370217377221170304,2020-12,2290.94,2255.55,39.71,1069.57,-994.47,-14607.37
370393696393726528,2020-01,3725.5,936.15,3983.37,5879.57,893.15,893.15
370393696393726528,2020-02,4791.91,6266.7,2245.58,1076,-305.21,587.94
370393696393726528,2020-03,3356.43,830.13,4079.92,4705.96,1900.26,2488.2
370393696393726528,2020-04,385.42,1128.46,209.09,3590.54,-4124.49,-1636.29
370393696393726528,2020-05,1284.67,4443.54,4313.97,669.03,486.07,-1150.22
370393696393726528,2020-06,543.68,756.66,3193.75,1355.51,1625.26,475.04
370393696393726528,2020-07,6356.77,3591.88,796.39,2978.19,583.09,1058.13
370393696393726528,2020-08,3387.37,4629.9,682.57,3396.61,-3956.57,-2898.44
370393696393726528,2020-09,8984.27,2570.33,1529.96,4581.81,3362.09,463.65
370393696393726528,2020-10,2611.38,102.26,2003.46,1574.78,2937.8,3401.45
370393696393726528,2020-11,1026.71,1128.7,3359.21,7888.11,-4630.89,-1229.44
370393696393726528,2020-12,1786.85,2682.95,3021.22,3560.35,-1435.23,-2664.67
371317895800782976,2020-01,5038.28,239.14,3443.9,4759.98,3483.06,3483.06
371317895800782976,2020-02,0,620.8,5989.9,1514.73,3854.37,7337.43
371317895800782976,2020-03,2455.93,2712.21,2528.83,2098.24,174.31,7511.74
371317895800782976,2020-04,0,1221.85,1570.85,1432.77,-1083.77,6427.97
371317895800782976,2020-05,4791.18,4314.35,1528.07,2216.22,-211.32,6216.65
371317895800782976,2020-06,2563.02,0,3271.65,2165.18,3669.49,9886.14
371317895800782976,2020-07,3134.95,1744.83,1628.2,1948.01,1070.31,10956.45
371317895800782976,2020-08,846.78,3276.89,3479.05,3045.8,-1996.86,8959.59
371317895800782976,2020-09,3216.14,596.76,1801.28,4168.01,252.65,9212.24
371317895800782976,2020-10,4398.7,2536.12,1646.58,2992.49,516.67,9728.91
371317895800782976,2020-11,172.02,2615.21,3691.59,267.95,980.45,10709.36
371317895800782976,2020-12,0,1672.3,3683.72,1681.51,329.91,11039.27
372644638956552576,2020-01,5351.28,311.66,3137.45,5514.34,2662.73,2662.73
372644638956552576,2020-02,8220.63,3768.76,2293.46,9620.14,-2874.81,-212.08
372644638956552576,2020-03,4131.14,7454.15,2406.68,8513.9,-9430.23,-9642.31
372644638956552576,2020-04,3038.92,4383.82,6478.8,5913.61,-779.71,-10422.02
372644638956552576,2020-05,5379.95,6033.31,2278.6,9202.19,-7576.95,-17998.97
372644638956552576,2020-06,6990.11,2403.95,1047.53,5556.74,76.95,-17922.02
372644638956552576,2020-07,6751.65,4352.56,4736.92,1089.98,6046.03,-11875.99
372644638956552576,2020-08,1933.85,4748.96,7245.7,8054.79,-3624.2,-15500.19
372644638956552576,2020-09,5946.05,3165.06,1863.46,6248.92,-1604.47,-17104.66
372644638956552576,2020-10,966.87,7044.86,2565.29,8573.96,-12086.66,-29191.32
372644638956552576,2020-11,3844.94,1850.34,2722.76,3463.59,1253.77,-27937.55
372644638956552576,2020-12,4266.93,7004.17,4181.38,5275.33,-3831.19,-31768.74
373385952725122560,2020-01,3068.27,5647.82,4141.49,5541.72,-3979.78,-3979.78
373385952725122560,2020-02,3372,5674.76,82.77,4751.36,-6971.35,-10951.13
373385952725122560,2020-03,3053.58,5612.75,2712.15,4530.76,-4377.78,-15328.91
373385952725122560,2020-04,4003.2,627.58,2711.63,2602,3485.25,-11843.66
373385952725122560,2020-05,1136.39,3468.9,3491.06,4694.38,-3535.83,-15379.49
373385952725122560,2020-06,3067.84,3569.68,5179.74,2214.53,2463.37,-12916.12
373385952725122560,2020-07,4303.34,3780.05,4492.01,4905.31,109.99,-12806.13
373385952725122560,2020-08,6490.46,1503.73,4189.47,4644.02,4532.18,-8273.95
373385952725122560,2020-09,6682.98,473.21,5263.62,2606.79,8866.6,592.65
373385952725122560,2020-10,9004.65,4822.43,6559.06,173.62,10567.66,11160.31
373385952725122560,2020-11,3453.56,1918.03,848.26,2489.77,-105.98,11054.33
373385952725122560,2020-12,3541.87,7707.65,4016.6,4377.73,-4526.91,6527.42
373958578591604672,2020-01,0,2409.76,249.15,834.94,-2995.55,-2995.55
373958578591604672,2020-02,2915.78,0,2785.05,0,5700.83,2705.28
373958578591604672,2020-03,1149.73,649.09,3124.69,1541.74,2083.59,4788.87
373958578591604672,2020-04,1133.88,0,2621.79,2878.73,876.94,5665.81
373958578591604672,2020-05,158.56,920.32,0,1591.68,-2353.44,3312.37
373958578591604672,2020-06,2649.36,258.87,1983.52,2207.45,2166.56,5478.93
373958578591604672,2020-07,4236.96,1926.31,2581.23,0,4891.88,10370.81
373958578591604672,2020-08,4311.07,0,27.17,0,4338.24,14709.05
373958578591604672,2020-10,597.87,1645.23,1187.38,0,140.02,14849.07
373958578591604672,2020-11,1121.93,1110.99,1975.77,2434.81,-448.1,14400.97
373958578591604672,2020-12,2912.86,712.18,2858.71,936.41,4122.98,18523.95
375314640681186048,2020-01,1186.15,6578.77,6332.73,1926.43,-986.32,-986.32
375314640681186048,2020-02,3397.14,1574.54,1842.16,4186.52,-521.76,-1508.08
375314640681186048,2020-03,2134.52,5723.29,6522.54,8759.48,-5825.71,-7333.79
375314640681186048,2020-04,1365.53,2766.34,9180.05,1202.21,6577.03,-756.76
375314640681186048,2020-05,665.2,4151.22,839.28,5624.45,-8271.19,-9027.95
375314640681186048,2020-06,6893.14,3733.94,5018.42,2906.89,5270.73,-3757.22
375314640681186048,2020-07,4854.38,4641.77,3202.7,3695.81,-280.5,-4037.72
375314640681186048,2020-08,5071.35,142.97,4209.28,2695.45,6442.21,2404.49
375314640681186048,2020-09,3247.62,2908.59,10906.17,2389.93,8855.27,11259.76
375314640681186048,2020-10,2988.37,2898.63,3679.44,3377.08,392.1,11651.86
375314640681186048,2020-11,4107.53,4380.79,1204.58,5532.75,-4601.43,7050.43
375314640681186048,2020-12,1644.31,2949.79,2305.39,1361.15,-361.24,6689.19
378528259597755520,2020-01,3255.65,2758.8,0,3262.8,-2765.95,-2765.95
378528259597755520,2020-02,0,3716.79,0,1173.57,-4890.36,-7656.31
378528259597755520,2020-03,1950.89,0,0,3467.05,-1516.16,-9172.47
378528259597755520,2020-05,2649.8,4148.95,1219.39,1962.15,-2241.91,-11414.38
378528259597755520,2020-06,1013.24,741.48,970.33,0,1242.09,-10172.29
378528259597755520,2020-07,1523.25,772.84,2181.55,2118.8,813.16,-9359.13
378528259597755520,2020-08,0,1290.13,2285.45,2059.69,-1064.37,-10423.5
378528259597755520,2020-09,1620.52,1171.84,2224.45,994.17,1678.96,-8744.54
378528259597755520,2020-10,1940.93,964.95,1906.6,1738.94,1143.64,-7600.9
378528259597755520,2020-11,820.26,2539.18,105.3,3311.61,-4925.23,-12526.13
378528259597755520,2020-12,974.6,2435.9,1546.52,3557.47,-3472.25,-15998.38
379244927040480384,2020-01,0,3451.23,0,5533.27,-8984.5,-8984.5
379244927040480384,2020-02,3105.38,1316.57,1875.54,3541.11,123.24,-8861.26
379244927040480384,2020-03,4285.17,1544.13,3175.87,1548.31,4368.6,-4492.66
379244927040480384,2020-04,4343.34,0,4323.77,3573.46,5093.65,600.99
379244927040480384,2020-05,4188.06,4168.8,3133.89,5360.62,-2207.47,-1606.48
379244927040480384,2020-06,847.61,1988.33,4142.7,3070.77,-68.79,-1675.27
379244927040480384,2020-07,8964.08,1657.32,0,2548.47,4758.29,3083.02
379244927040480384,2020-08,2845.28,1855.24,2352.79,3116.6,226.23,3309.25
379244927040480384,2020-09,3518.46,2767.18,2953.63,2756.23,948.68,4257.93
379244927040480384,2020-10,1848.87,0,2622.19,1341.51,3129.55,7387.48
379244927040480384,2020-11,1483.61,0,4223.41,1465.79,4241.23,11628.71
379244927040480384,2020-12,242.53,4306.08,4712.93,1918.46,-1269.08,10359.63
379565177514077056,2020-01,10173.19,11289.34,1882.24,1116.38,-350.29,-350.29
379565177514077056,2020-02,4432.3,1994.35,3343.18,4091.63,1689.5,1339.21
379565177514077056,2020-03,1664.55,2398.33,3117.86,1239.47,1144.61,2483.82
379565177514077056,2020-04,3181.37,1614.82,5777.41,1060.68,6283.28,8767.1
379565177514077056,2020-05,6176.8,4582.92,2884.4,4185.04,293.24,9060.34
379565177514077056,2020-06,6092.64,4767.12,470.78,1626.18,170.12,9230.46
379565177514077056,2020-07,1308.78,0,63.52,0,1372.3,10602.76
379565177514077056,2020-08,6036.96,3472.14,3782.08,616.36,5730.54,16333.3
379565177514077056,2020-09,6645.93,2685.42,1465.2,885.62,4540.09,20873.39
379565177514077056,2020-10,2890.71,5729.07,4571.65,3684.84,-1951.55,18921.84
379565177514077056,2020-11,2200.4,3196.43,4610.38,556.65,3057.7,21979.54
379565177514077056,2020-12,936.65,4654.42,3180.5,513.56,-1050.83,20928.71
380909063891985280,2020-01,0,1049.18,460.38,298.25,-887.05,-887.05
380909063891985280,2020-02,0,652.42,1731.06,0,1078.64,191.59
380909063891985280,2020-04,348.93,0,1141.05,1222.88,267.1,458.69
380909063891985280,2020-05,1817.78,1495.7,2073.46,2258.97,136.57,595.26
380909063891985280,2020-07,0,21.18,424.91,948,-544.27,50.99
380909063891985280,2020-08,0,834.28,1361.74,0,527.46,578.45
380909063891985280,2020-09,0,1063.63,0,0,-1063.63,-485.18
380909063891985280,2020-10,1309.25,644.32,2662.13,0,3327.06,2841.88
380909063891985280,2020-11,0,1110.8,0,0,-1110.8,1731.08
380909063891985280,2020-12,1171.66,0,0,1741.8,-570.14,1160.94
381283911578976896,2020-01,2838.44,8400.8,4631.91,3965.32,-4895.77,-4895.77
381283911578976896,2020-02,6458.8,1532.36,2295.74,1840.63,5381.55,485.78
381283911578976896,2020-03,5189.77,7400.82,1145.85,9511.82,-10577.02,-10091.24
381283911578976896,2020-04,0,1577.38,5045.01,2855.68,611.95,-9479.29
381283911578976896,2020-05,1915.07,4440.94,5131.91,2045.77,560.27,-8919.02
381283911578976896,2020-06,2856.97,3771.25,2939.83,4493.59,-2468.04,-11387.06
381283911578976896,2020-07,4984.87,2068.49,3273.55,1858.07,4331.86,-7055.2
381283911578976896,2020-08,1510.54,1608.58,2774.44,2877.29,-200.89,-7256.09
381283911578976896,2020-09,3262.23,898.58,6607.18,9546.14,-575.31,-7831.4
381283911578976896,2020-10,1666.68,1628.94,3548.87,2768.61,818,-7013.4
381283911578976896,2020-11,2755.46,2441.06,5455.59,3637.91,2132.08,-4881.32
381283911578976896,2020-12,4901.66,3169.59,3121.04,1810.54,3042.57,-1838.75
381318006776968896,2020-03,0,1455.79,0,111.53,-1567.32,-1567.32
381318006776968896,2020-05,392.11,984.02,0,0,-591.91,-2159.23
381318006776968896,2020-07,1850.36,0,0,0,1850.36,-308.87
381318006776968896,2020-09,0,2535.83,0,0,-2535.83,-2844.7
381318006776968896,2020-10,0,2307.51,3611.31,2352.61,-1048.81,-3893.51
381318006776968896,2020-11,0,1831.61,0,1214.22,-3045.83,-6939.34
381318006776968896,2020-12,0,693.6,1717.03,210.74,812.69,-6126.65
383541973118844736,2020-01,6556.01,3037.55,742.85,4940.3,-678.99,-678.99
383541973118844736,2020-02,2675.45,6070.37,0,3019.47,-6414.39,-7093.38
383541973118844736,2020-03,2716.36,1383.1,1892.89,3526.41,-300.26,-7393.64
383541973118844736,2020-04,1933.16,3647.48,1487.14,6243.93,-6471.11,-13864.75
383541973118844736,2020-05,1610.64,3081.12,5066.77,3373.82,222.47,-13642.28
383541973118844736,2020-06,751.12,0,4235.69,960.4,4026.41,-9615.87
383541973118844736,2020-07,3304.02,1782.79,4405.21,5673.71,252.73,-9363.14
383541973118844736,2020-08,5477.12,3445.3,2092.85,3272.36,852.31,-8510.83
383541973118844736,2020-09,1813.43,2208.39,2639.16,385.82,1858.38,-6652.45
383541973118844736,2020-10,4454.45,5587.2,2113.38,2246.72,-1266.09,-7918.54
383541973118844736,2020-11,2129.94,5522.84,0,3352.24,-6745.14,-14663.68
383541973118844736,2020-12,872.04,5200.65,416.11,7162.04,-11074.54,-25738.22
383773306591662976,2020-01,3386.22,2164.54,0,1717.35,-495.67,-495.67
383773306591662976,2020-02,7615.62,4041.17,6186.26,3100.21,6660.5,6164.83
383773306591662976,2020-03,783.93,2877.11,6734.69,241.39,4400.12,10564.95
383773306591662976,2020-04,3665.13,4978.03,763.56,3306.88,-3856.22,6708.73
383773306591662976,2020-05,4882.07,0,3105.36,828.37,7159.06,13867.79
383773306591662976,2020-06,52.36,4377.46,2844.63,3239.97,-4720.44,9147.35
383773306591662976,2020-07,1442.23,2937.83,6938.96,4146.17,1297.19,10444.54
383773306591662976,2020-08,2313.61,3589.15,0,2217.56,-3493.1,6951.44
383773306591662976,2020-09,6550.1,2402.93,2251.96,9313.56,-2914.43,4037.01
383773306591662976,2020-10,5388.43,5214.04,5125.66,4839.6,460.45,4497.46
383773306591662976,2020-11,560.3,3430.99,3260.87,3801.63,-3411.45,1086.01
383773306591662976,2020-12,702.4,3987.14,864.68,0,-2420.06,-1334.05
384668062822863808,2020-01,4770.22,4924.29,4046.21,1673.02,2219.12,2219.12
384668062822863808,2020-02,492.67,4839.84,3128.37,2351.63,-3570.43,-1351.31
384668062822863808,2020-03,3257.31,6598.65,2221.6,1712.15,-2831.89,-4183.2
384668062822863808,2020-04,2699.47,9080.05,1509.58,8340.58,-13211.58,-17394.78
384668062822863808,2020-05,2326.57,7167.1,10634.19,3162.49,2631.17,-14763.61
384668062822863808,2020-06,4932.2,2827,1833.49,7785.52,-3846.83,-18610.44
384668062822863808,2020-07,2784.94,7554.3,1852.19,2983.61,-5900.78,-24511.22
384668062822863808,2020-08,3130.08,0,9644.83,8481.13,4293.78,-20217.44
384668062822863808,2020-09,5666.61,7979.14,785.06,9660.03,-11187.5,-31404.94
384668062822863808,2020-10,129.47,6701.17,0,2045.64,-8617.34,-40022.28
384668062822863808,2020-11,6870.97,7566.97,1939.3,3955.47,-2712.17,-42734.45
384668062822863808,2020-12,2741.64,4963.4,2751.51,2234.17,-1704.42,-44438.87
385799180483035200,2020-01,1842.83,1090.55,305.6,1699.78,-641.9,-641.9
385799180483035200,2020-02,3011.7,821.93,0,0,2189.77,1547.87
385799180483035200,2020-03,836.65,1203.45,799.27,0,432.47,1980.34
385799180483035200,2020-04,1481.3,2957.9,0,4348.07,-5824.67,-3844.33
385799180483035200,2020-05,2745.3,875.98,0,0,1869.32,-1975.01
385799180483035200,2020-06,0,617.68,0,2465.77,-3083.45,-5058.46
385799180483035200,2020-07,3103.74,5449.74,0,0,-2346,-7404.46
385799180483035200,2020-08,2617.14,1875.07,1448.86,0,2190.93,-5213.53
385799180483035200,2020-09,407.03,359.55,1381.31,142.26,1286.53,-3927
385799180483035200,2020-10,1509.44,605.86,1582.26,499.73,1986.11,-1940.89
385799180483035200,2020-11,910.9,0,2377.67,1098.96,2189.61,248.72
385799180483035200,2020-12,2781.99,1991.2,2941.72,820.72,2911.79,3160.51
386179698669043072,2020-01,3349.88,3240.9,911.53,1748.48,-727.97,-727.97
386179698669043072,2020-02,4441.99,4726.91,7656.23,1000.66,6370.65,5642.68
386179698669043072,2020-03,2225.28,4937.13,5368.97,559.42,2097.7,7740.38
386179698669043072,2020-04,4222.51,157.2,4286.32,256.27,8095.36,15835.74
386179698669043072,2020-05,2821.11,1822.32,3481.84,3082.27,1398.36,17234.1
386179698669043072,2020-06,0,1393.4,2272.44,3780.52,-2901.48,14332.62
386179698669043072,2020-07,4003.57,5871.45,2805.88,6459.36,-5521.36,8811.26
386179698669043072,2020-08,1873.58,399.31,1484.35,120.18,2838.44,11649.7
386179698669043072,2020-09,2101.44,3135.33,4062.66,4384.9,-1356.13,10293.57
386179698669043072,2020-10,1818.18,4168.48,7359.91,5116.14,-106.53,10187.04
386179698669043072,2020-11,991.52,2253.81,2997.6,2017.8,-282.49,9904.55
386179698669043072,2020-12,3337.72,4195.6,792.45,2297.79,-2363.22,7541.33
387046261448225856,2020-01,10124.68,4100.32,1535.08,1388.53,6170.91,6170.91
387046261448225856,2020-02,3156.8,4221.8,1012.1,0,-52.9,6118.01
387046261448225856,2020-03,7584.18,5355.96,3240.95,1864.61,3604.56,9722.57
387046261448225856,2020-04,7266.56,2533.05,3417.94,340.17,7811.28,17533.85
387046261448225856,2020-05,8077.39,4237.12,2551.8,5809.76,582.31,18116.16
387046261448225856,2020-06,2025.85,4207.16,1553.51,7657.17,-8284.97,9831.19
387046261448225856,2020-07,8639.15,4735.1,5047.8,5995,2956.85,12788.04
387046261448225856,2020-08,8530.15,0,8239.56,3907.69,12862.02,25650.06
387046261448225856,2020-09,0,7497.73,6101.3,3036.24,-4432.67,21217.39
387046261448225856,2020-10,4947.23,2840.74,1521.55,3012.63,615.41,21832.8
387046261448225856,2020-11,5151.5,3428.7,6420.61,3897.98,4245.43,26078.23
387046261448225856,2020-12,6591.11,7386.2,9067.87,3742.47,4530.31,30608.54
387949696053654848,2020-01,342.13,0,3173.12,0,3515.25,3515.25
387949696053654848,2020-02,0,386.63,494.07,459.17,-351.73,3163.52
387949696053654848,2020-03,1334.55,0,2785.13,1953.75,2165.93,5329.45
387949696053654848,2020-04,2757.27,1876.92,0,2832.37,-1952.02,3377.43
387949696053654848,2020-06,2385.87,742.88,2097.28,1237.33,2502.94,5880.37
387949696053654848,2020-07,1569.26,35.02,4343.73,505.33,5372.64,11253.01
387949696053654848,2020-08,3382.73,0,469.41,77.01,3775.13,15028.14
387949696053654848,2020-09,4923.06,402.73,0,2259.62,2260.71,17288.85
387949696053654848,2020-10,3612.38,2331.4,1218.63,2176.14,323.47,17612.32
387949696053654848,2020-11,1284.98,573.75,703.47,0,1414.7,19027.02
388200785586446080,2020-01,7553.35,1805.23,1638.8,1661.54,5725.38,5725.38
388200785586446080,2020-02,5502.54,1617.94,3302.38,1852.37,5334.61,11059.99
388200785586446080,2020-03,3665.72,6501.81,2730.81,2198.65,-2303.93,8756.06
388200785586446080,2020-04,3594.71,2377,3878.39,7622.5,-2526.4,6229.66
388200785586446080,2020-05,10991.14,3149.47,477.22,2446.97,5871.92,12101.58
388200785586446080,2020-06,4812.44,4380.7,447.82,6175.05,-5295.49,6806.09
388200785586446080,2020-07,894.29,3006.06,2317.45,4817.44,-4611.76,2194.33
388200785586446080,2020-08,4550.78,1876.01,5352.15,2416.07,5610.85,7805.18
388200785586446080,2020-09,4857.66,3426.47,5388.67,6365.88,453.98,8259.16
388200785586446080,2020-10,4116.79,1113.29,3718.16,499.64,6222.02,14481.18
388200785586446080,2020-11,2007.65,1955.58,3793.38,6241.74,-2396.29,12084.89
388200785586446080,2020-12,5231.39,4619.18,3244.92,3998.68,-141.55,11943.34
390555007529522752,2020-01,7190.09,6445.96,2748.53,8858.89,-5366.23,-5366.23
390555007529522752,2020-02,192.18,2674.92,7535.21,1919.22,3133.25,-2232.98
390555007529522752,2020-03,1213.38,5436.65,4861.54,3464.04,-2825.77,-5058.75
390555007529522752,2020-04,4021.57,7519.74,962.11,5981.3,-8517.36,-13576.11
390555007529522752,2020-05,3209.62,1556.09,6628.69,5543.96,2738.26,-10837.85
390555007529522752,2020-06,2522.79,4162.49,4759.25,1125.72,1993.83,-8844.02
390555007529522752,2020-07,2921.76,3819.55,7183.67,2299.34,3986.54,-4857.48
390555007529522752,2020-08,2276.54,5994.56,5187.66,1939.32,-469.68,-5327.16
390555007529522752,2020-09,4372.21,5611.79,4045.57,4772.83,-1966.84,-7294
390555007529522752,2020-10,2161.88,4904.57,362.13,5176.13,-7556.69,-14850.69
390555007529522752,2020-11,3419.5,4404.85,4694.35,1972.01,1736.99,-13113.7
390555007529522752,2020-12,4069.34,5266.41,7520.03,2980.82,3342.14,-9771.56
390619132085653696,2020-01,4335.91,4013.53,0,7326.4,-7004.02,-7004.02
390619132085653696,2020-02,3850.66,6664.3,3203.44,4287,-3897.2,-10901.22
390619132085653696,2020-03,4233.15,4530.18,1489.49,4319.18,-3126.72,-14027.94
390619132085653696,2020-04,6031.28,5095.76,1558.59,5179.47,-2685.36,-16713.3
390619132085653696,2020-05,5784.02,4087.32,4014.36,3846.34,1864.72,-14848.58
390619132085653696,2020-06,932.29,2227.11,5043.16,9901.41,-6153.07,-21001.65
390619132085653696,2020-07,2921.7,6183.71,5436.16,3254.52,-1080.37,-22082.02
390619132085653696,2020-08,5198.47,3831.46,363.46,5717.15,-3986.68,-26068.7
390619132085653696,2020-09,7755.9,7714.06,6895.35,5228.21,1708.98,-24359.72
390619132085653696,2020-10,5242.66,4465.66,6154.55,5984.33,947.22,-23412.5
390619132085653696,2020-11,2633.21,734.09,3655.59,6632.04,-1077.33,-24489.83
390619132085653696,2020-12,4607.64,0,2612.41,5287.18,1932.87,-22556.96
392242169181139264,2020-01,2052.21,3432.76,111.2,4010.37,-5279.72,-5279.72
392242169181139264,2020-02,1960.26,169.13,2519.61,924.33,3386.41,-1893.31
392242169181139264,2020-03,0,2300.8,380.05,980.7,-2901.45,-4794.76
392242169181139264,2020-04,1997.96,0,1781.39,61.87,3717.48,-1077.28
392242169181139264,2020-05,1356.49,1198.36,0,2879.02,-2720.89,-3798.17
392242169181139264,2020-06,1520.08,0,0,97.13,1422.95,-2375.22
392242169181139264,2020-07,1888.38,464.5,0,0,1423.88,-951.34
392242169181139264,2020-08,1849.12,513.29,860.46,1398.03,798.26,-153.08
392242169181139264,2020-09,1936.96,1080.36,3144.29,479.57,3521.32,3368.24
392242169181139264,2020-10,0,891.27,0,1232.38,-2123.65,1244.59
392242169181139264,2020-11,1314.65,0,1332.86,3183.28,-535.77,708.82
392242169181139264,2020-12,2333,460.19,400.16,0,2272.97,2981.79
392623054795947136,2020-01,4600.83,6211.67,1880.33,2858.11,-2588.62,-2588.62
392623054795947136,2020-02,989.8,5861.42,4555.47,5297.67,-5613.82,-8202.44
392623054795947136,2020-03,1490.54,5044.08,6718.78,4197.78,-1032.54,-9234.98
392623054795947136,2020-04,5764.4,3996.11,1967.17,11414.41,-7678.95,-16913.93
392623054795947136,2020-05,5112.16,1435.69,6209.44,4355.47,5530.44,-11383.49
392623054795947136,2020-06,3667.96,142.26,7052.91,3739.38,6839.23,-4544.26
392623054795947136,2020-07,6170.4,6764.73,3033.9,3419.21,-979.64,-5523.9
392623054795947136,2020-08,1989.35,7463.97,2451.55,5704.19,-8727.26,-14251.16
392623054795947136,2020-09,5418.52,3998.68,2449.05,1250.95,2617.94,-11633.22
392623054795947136,2020-10,2765.61,3046.31,6648.45,4515.7,1852.05,-9781.17
392623054795947136,2020-11,8313.26,5695.92,1908.25,3149.45,1376.14,-8405.03
392623054795947136,2020-12,13146.63,1701.71,3141.31,6278.63,8307.6,-97.43
392771088176991296,2020-01,1057.76,2015.56,3345.54,221.75,2165.99,2165.99
392771088176991296,2020-02,1245.91,3761.88,4424.77,6446.54,-4537.74,-2371.75
392771088176991296,2020-03,1145.83,3239.29,3117.93,4326.31,-3301.84,-5673.59
392771088176991296,2020-04,5223.43,2230.35,3255.33,2336.61,3911.8,-1761.79
392771088176991296,2020-05,6706.42,4323.33,2768.07,4532.31,618.85,-1142.94
392771088176991296,2020-06,950.36,9260.28,4471.61,2082.05,-5920.36,-7063.3
392771088176991296,2020-07,5158.2,2945.55,0,3417.75,-1205.1,-8268.4
392771088176991296,2020-08,2474.85,2191.27,7942.27,1542.69,6683.16,-1585.24
392771088176991296,2020-09,1888.92,6052.26,7557.99,8240.82,-4846.17,-6431.41
392771088176991296,2020-10,5085.53,1915.81,4286.01,5136.95,2318.78,-4112.63
392771088176991296,2020-11,3861.09,3823.3,3792.74,8921.13,-5090.6,-9203.23
392771088176991296,2020-12,12178.9,2358.92,9040.34,2819.34,16040.98,6837.75
394786190154085568,2020-01,4426.9,0,911.86,52.22,5286.54,5286.54
394786190154085568,2020-02,2005.97,1270.61,1395.93,4385.9,-2254.61,3031.93
394786190154085568,2020-03,4574.25,3415.43,2536.3,0,3695.12,6727.05
394786190154085568,2020-04,1945.06,2150.81,2368.64,2513.62,-350.73,6376.32
394786190154085568,2020-05,3644.44,2436.53,0,3676.32,-2468.41,3907.91
394786190154085568,2020-06,88.94,1756.9,2782.11,3940.33,-2826.18,1081.73
394786190154085568,2020-07,2509.84,1829.33,2584.66,2324.13,941.04,2022.77
394786190154085568,2020-08,1480.42,3234.48,3519.06,268.15,1496.85,3519.62
394786190154085568,2020-09,430.4,4098.63,1109.34,2469.88,-5028.77,-1509.15
394786190154085568,2020-10,3332.82,3193.36,1892.76,1226.12,806.1,-703.05
394786190154085568,2020-11,4824.96,0,0,1826.6,2998.36,2295.31
394786190154085568,2020-12,2118.63,2042.99,5051.16,2031.57,3095.23,5390.54
394967025458044544,2020-01,2874.7,3275.34,5526.17,6284.98,-1159.45,-1159.45
394967025458044544,2020-02,6197.41,4482.07,4723.62,407.98,6030.98,4871.53
394967025458044544,2020-03,6211.21,5304.27,2413.29,7795.2,-4474.97,396.56
394967025458044544,2020-04,3146.77,7363.87,1896.78,9260.17,-11580.49,-11183.93
394967025458044544,2020-05,846.97,1537.04,0,3087.84,-3777.91,-14961.84
394967025458044544,2020-06,4515.31,2675.09,4511.18,3201.65,3149.75,-11812.09
394967025458044544,2020-07,8680.43,0,6723.59,4966.28,10437.74,-1374.35
394967025458044544,2020-08,6472.21,2635.44,4298.4,62,8073.17,6698.82
394967025458044544,2020-09,182.05,1177.79,2647.76,1781.57,-129.55,6569.27
394967025458044544,2020-10,3531.38,3228.68,4238.82,6513.54,-1972.02,4597.25
394967025458044544,2020-11,3539.06,4841.47,3748.29,776.51,1669.37,6266.62
394967025458044544,2020-12,3166.32,4632.55,7641.47,226.34,5948.9,12215.52
400419481087438336,2020-01,4625.81,2006.85,2558.46,8624.43,-3447.01,-3447.01
400419481087438336,2020-02,5793.45,6156.91,1409.29,3316.44,-2270.61,-5717.62
400419481087438336,2020-03,4800.21,3264.28,8063.84,2340.1,7259.67,1542.05
400419481087438336,2020-04,5887.95,1383.17,5999.65,4112.08,6392.35,7934.4
400419481087438336,2020-05,3248.67,4913.23,2391.39,4382.75,-3655.92,4278.48
400419481087438336,2020-06,2368.96,2071.75,4297.25,3262.97,1331.49,5609.97
400419481087438336,2020-07,5317.61,2558.87,2327.22,4203.29,882.67,6492.64
400419481087438336,2020-08,3779.68,1036.84,7031.54,1175.13,8599.25,15091.89
400419481087438336,2020-09,4171.81,4143.64,0,2762.31,-2734.14,12357.75
400419481087438336,2020-10,1922.29,5496.82,7852.91,5526,-1247.62,11110.13
400419481087438336,2020-11,971.58,1389.74,1618.23,748.47,451.6,11561.73
400419481087438336,2020-12,6839.93,5321.11,2495.53,2861.59,1152.76,12714.49
400500465805423168,2020-01,7738.41,2040.34,3477.54,1129.51,8046.1,8046.1
400500465805423168,2020-02,1649.65,359.2,1491.26,4757.72,-1976.01,6070.09
400500465805423168,2020-03,3472.9,0,2534.02,1494.26,4512.66,10582.75
400500465805423168,2020-04,408.4,1778.46,3183.8,6459.73,-4645.99,5936.76
400500465805423168,2020-05,2572.74,2876.1,1352.9,1710.68,-661.14,5275.62
400500465805423168,2020-06,0,4031.03,3645.45,1410.72,-1796.3,3479.32
400500465805423168,2020-07,4368.98,1492.96,1751.68,2419.7,2208,5687.32
400500465805423168,2020-08,1199.71,1179.34,1990.85,4370.63,-2359.41,3327.91
400500465805423168,2020-09,1484.42,2585.94,0,2201.61,-3303.13,24.78
400500465805423168,2020-10,4061.71,1458.92,3173.17,0,5775.96,5800.74
400500465805423168,2020-11,4657.06,1262.78,1396.47,0,4790.75,10591.49
400500465805423168,2020-12,3783.61,3936.35,1458.4,2684.84,-1379.18,9212.31
400545390962560448,2020-01,5709.23,4629.52,1606.39,3736.11,-1050.01,-1050.01
400545390962560448,2020-02,1461.5,5642.29,1584.04,5456.74,-8053.49,-9103.5
400545390962560448,2020-03,4519.53,3472.6,2412.78,6479.29,-3019.58,-12123.08
400545390962560448,2020-04,2045.84,3700.92,3992.55,1445.68,891.79,-11231.29
400545390962560448,2020-05,8635.49,522.15,9243.38,3035.54,14321.18,3089.89
400545390962560448,2020-06,0,3883.42,499.64,3254.12,-6637.9,-3548.01
400545390962560448,2020-07,386.09,1224.44,3113.03,1474.46,800.22,-2747.79
400545390962560448,2020-08,7715.1,2009.21,1915.76,6325.76,1295.89,-1451.9
400545390962560448,2020-09,0,5513.13,2672.73,5308.19,-8148.59,-9600.49
400545390962560448,2020-10,4565.56,7528.95,4728.1,1264.83,499.88,-9100.61
400545390962560448,2020-11,5106.55,4698.78,2737.37,1998.36,1146.78,-7953.83
400545390962560448,2020-12,6322.84,1964.39,0,760.21,3598.24,-4355.59
402796263538252608,2020-01,4862.21,3100.63,1293.81,2493.96,561.43,561.43
402796263538252608,2020-02,936.16,500.4,3178.32,414.75,3199.33,3760.76
402796263538252608,2020-03,1923.51,0,2316.46,129.97,4110,7870.76
402796263538252608,2020-04,5480.73,1766.9,0,2369.07,1344.76,9215.52
402796263538252608,2020-05,210.1,0,2828.86,2823.49,215.47,9430.99
402796263538252608,2020-06,2762.22,758.27,1660.94,852.46,2812.43,12243.42
402796263538252608,2020-07,3561.42,978.59,2505.39,2205.96,2882.26,15125.68
402796263538252608,2020-08,3367.21,0,1757.86,3013.59,2111.48,17237.16
402796263538252608,2020-09,2039.3,1323.52,579.86,1807.47,-511.83,16725.33
402796263538252608,2020-10,3625.42,0,1021.43,1781.62,2865.23,19590.56
402796263538252608,2020-11,0,2469.77,3312.64,2637.16,-1794.29,17796.27
402796263538252608,2020-12,4386.83,4985.85,1611.65,4355.84,-3343.21,14453.06
403187652398892416,2020-01,3143.38,3236.28,0,1651.85,-1744.75,-1744.75
403187652398892416,2020-02,429.04,4543.32,1410.83,3651.67,-6355.12,-8099.87
403187652398892416,2020-03,1892.67,0,2901.54,0,4794.21,-3305.66
403187652398892416,2020-04,3239.55,1672.18,0,3459.97,-1892.6,-5198.26
403187652398892416,2020-05,3036.8,1719.44,473.33,2345.23,-554.54,-5752.8
403187652398892416,2020-06,1608.87,1520.73,2154.71,4254.97,-2012.12,-7764.92
403187652398892416,2020-07,569.9,2290.78,1469.47,3282.29,-3533.7,-11298.62
403187652398892416,2020-08,717.37,4156.25,0,6865.79,-10304.67,-21603.29
403187652398892416,2020-09,1273.09,0,4709.51,2088.54,3894.06,-17709.23
403187652398892416,2020-10,1032.24,2309.26,1327.93,2023.34,-1972.43,-19681.66
403187652398892416,2020-11,1281.67,2958.97,1550.8,0,-126.5,-19808.16
403187652398892416,2020-12,210.19,4836.79,0,0,-4626.6,-24434.76
404235009899832576,2020-01,2267.16,2006.11,0,0,261.05,261.05
404235009899832576,2020-02,0,1262.32,0,0,-1262.32,-1001.27
404235009899832576,2020-05,0,1966.33,0,1599.56,-3565.89,-4567.16
404235009899832576,2020-06,0,1954.99,1834.72,0,-120.27,-4687.43
404235009899832576,2020-07,0,1887.78,1943.72,0,55.94,-4631.49
404235009899832576,2020-08,0,1329.18,574.02,0,-755.16,-5386.65
404235009899832576,2020-09,0,497.91,0,0,-497.91,-5884.56
404677690320992256,2020-01,5782.42,2551.65,986.03,4667.04,-450.24,-450.24
404677690320992256,2020-02,1547.03,3503.25,1935.68,4540.84,-4561.38,-5011.62
404677690320992256,2020-03,4659.31,10195.75,3093.84,5693.03,-8135.63,-13147.25
404677690320992256,2020-04,3848.71,5345.96,4829.73,2954.85,377.63,-12769.62
404677690320992256,2020-05,6358.95,5449.99,6124.69,3584.35,3449.3,-9320.32
404677690320992256,2020-06,6757.23,4788,7783.31,5250.35,4502.19,-4818.13
404677690320992256,2020-07,4127.28,1433.03,5312.61,7546.47,460.39,-4357.74
404677690320992256,2020-08,4229.43,6011.5,6607.53,7191.12,-2365.66,-6723.4
404677690320992256,2020-09,4436.07,3210.97,0,4254.09,-3028.99,-9752.39
404677690320992256,2020-10,6140.9,6660.23,3730.59,6031.24,-2819.98,-12572.37
404677690320992256,2020-11,2623.38,2489.36,6806.67,2637.84,4302.85,-8269.52
404677690320992256,2020-12,3635.66,5549.65,4950.3,4703.7,-1667.39,-9936.91
407330868980180416,2020-01,4509.81,4207.65,2143.3,6999.62,-4554.16,-4554.16
407330868980180416,2020-02,3785.38,3772.82,2464.25,4282.85,-1806.04,-6360.2
407330868980180416,2020-03,3034.32,428.29,1997.05,0,4603.08,-1757.12
407330868980180416,2020-04,2086.54,5161.59,3498.9,2091.86,-1668.01,-3425.13
407330868980180416,2020-05,2244.11,6052.43,1695.69,1840.04,-3952.67,-7377.8
407330868980180416,2020-06,3872.41,433.93,5293.07,5373.77,3357.78,-4020.02
407330868980180416,2020-07,7886.49,4367.77,816.15,2428.02,1906.85,-2113.17
407330868980180416,2020-08,4139.67,932.14,1326.65,3695.08,839.1,-1274.07
407330868980180416,2020-09,9890.15,11907.99,1589.79,3451.96,-3880.01,-5154.08
407330868980180416,2020-10,3494.59,4159.39,2453.29,879.3,909.19,-4244.89
407330868980180416,2020-11,6060.73,1960.41,7025.56,449.59,10676.29,6431.4
407330868980180416,2020-12,3527.24,6859.59,7767.43,4844.08,-409,6022.4
407514318012190336,2020-01,84.2,0,1816.55,1497.46,403.29,403.29
407514318012190336,2020-02,2059.79,0,0,1581.25,478.54,881.83
407514318012190336,2020-03,1118.88,0,0,1857.91,-739.03,142.8
407514318012190336,2020-04,0,1260.63,939.85,1898.18,-2218.96,-2076.16
407514318012190336,2020-05,0,1654.83,43.87,1128.81,-2739.77,-4815.93
407514318012190336,2020-06,1759.88,0,136.6,100.56,1795.92,-3020.01
407514318012190336,2020-08,1333.61,0,672.94,0,2006.55,-1013.46
407514318012190336,2020-09,723.33,0,0,1592.14,-868.81,-1882.27
407514318012190336,2020-10,3710.54,0,596.9,0,4307.44,2425.17
407514318012190336,2020-12,1854.79,1820.6,38.68,0,72.87,2498.04
407866482855816000,2020-01,2052.64,1377.27,1224.2,2887.45,-987.88,-987.88
407866482855816000,2020-02,126.31,2897.05,883.83,1051.09,-2938,-3925.88
407866482855816000,2020-05,2333.61,0,0,993.84,1339.77,-2586.11
407866482855816000,2020-06,0,433.77,3119.98,3857.5,-1171.29,-3757.4
407866482855816000,2020-07,0,1568.14,267.58,199.32,-1499.88,-5257.28
407866482855816000,2020-08,122.08,3290.74,0,2078.64,-5247.3,-10504.58
407866482855816000,2020-09,1577.42,1263.9,376.21,2852.72,-2162.99,-12667.57
407866482855816000,2020-10,1916.47,1605.63,1276.47,426.25,1161.06,-11506.51
407866482855816000,2020-12,4222.47,840.2,0,0,3382.27,-8124.24
408908263317497856,2020-02,1298.34,1240.84,0,807.36,-749.86,-749.86
408908263317497856,2020-03,0,1627.05,0,0,-1627.05,-2376.91
408908263317497856,2020-04,0,1127.97,0,0,-1127.97,-3504.88
408908263317497856,2020-05,1742.32,0,0,0,1742.32,-1762.56
408908263317497856,2020-06,0,5.16,0,0,-5.16,-1767.72
408908263317497856,2020-10,0,326.1,0,0,-326.1,-2093.82
408908263317497856,2020-12,0,1907.26,0,0,-1907.26,-4001.08
409574045218418688,2020-01,1725.58,4785.32,6231.56,2637.02,534.8,534.8
409574045218418688,2020-02,6810.98,5252.65,5136.51,3359.15,3335.69,3870.49
409574045218418688,2020-03,7392.88,7585.43,2292.6,1793.37,306.68,4177.17
409574045218418688,2020-04,3176.21,0,5996.99,12468.2,-3295,882.17
409574045218418688,2020-05,3929.87,4074.11,3218.58,738.76,2335.58,3217.75
409574045218418688,2020-06,5482.59,2522.01,1648.72,2150.25,2459.05,5676.8
409574045218418688,2020-07,2818.24,37.76,5982.74,3638.88,5124.34,10801.14
409574045218418688,2020-08,4868.83,7207.47,4850.06,2534.67,-23.25,10777.89
409574045218418688,2020-09,3041.33,3649.67,3749.26,5397.77,-2256.85,8521.04
409574045218418688,2020-10,8027.72,5766.16,4208.02,1778.58,4691,13212.04
409574045218418688,2020-11,3290.7,2531.39,3095.37,6267.6,-2412.92,10799.12
409574045218418688,2020-12,1468.07,5286.76,1462.44,589.88,-2946.13,7852.99
410679952743047552,2020-01,438.88,2567.67,1024.02,1331.94,-2436.71,-2436.71
410679952743047552,2020-02,1557.75,1912,3013.74,2555.08,104.41,-2332.3
410679952743047552,2020-03,3189.17,1385.48,2919.53,2032.19,2691.03,358.73
410679952743047552,2020-04,0,3086.28,0,2208.7,-5294.98,-4936.25
410679952743047552,2020-05,5138.01,0,0,4004.76,1133.25,-3803
410679952743047552,2020-06,0,3196.51,3378.49,2885.65,-2703.67,-6506.67
410679952743047552,2020-07,28.53,5068.64,1230.6,1747.69,-5557.2,-12063.87
410679952743047552,2020-08,0,2588.5,0,2042.94,-4631.44,-16695.31
410679952743047552,2020-09,0,1882.95,3078.56,0,1195.61,-15499.7
410679952743047552,2020-11,0,1877.54,617.83,2095.52,-3355.23,-18854.93
410679952743047552,2020-12,5323.96,1749.98,0,1705.47,1868.51,-16986.42
410680885485375616,2020-01,8867.92,8934.44,4090.4,7399.03,-3375.15,-3375.15
410680885485375616,2020-02,1730.34,2481.44,4183.7,4941.4,-1508.8,-4883.95
410680885485375616,2020-03,9485.12,3084.31,3649.55,4838.08,5212.28,328.33
410680885485375616,2020-04,4136.63,4751.44,7779.57,5164.49,2000.27,2328.6
410680885485375616,2020-05,2158.48,2992.59,4759.63,4179.5,-253.98,2074.62
410680885485375616,2020-06,5725.32,5400.28,2222.54,962.38,1585.2,3659.82
410680885485375616,2020-07,2919.96,5603.79,2481.2,4879.55,-5082.18,-1422.36
410680885485375616,2020-08,3335.58,1474.18,5604.72,2499.6,4966.52,3544.16
410680885485375616,2020-09,4155.37,2351.23,654.8,3184.94,-726,2818.16
410680885485375616,2020-10,7703.11,2868.18,6192.58,5469.16,5558.35,8376.51
410680885485375616,2020-11,6691.86,7636.28,5279.47,6077.46,-1742.41,6634.1
410680885485375616,2020-12,4806.82,0,4802.3,6551.53,3057.59,9691.69
411147575008959424,2020-01,3803.92,3758.54,9649.87,1669.77,8025.48,8025.48
411147575008959424,2020-02,4186.58,2127.4,2866.19,8748.25,-3822.88,4202.6
411147575008959424,2020-03,3333.92,2300.51,3041.87,1782.46,2292.82,6495.42
411147575008959424,2020-04,2897.32,3418.49,2191.65,7265.77,-5595.29,900.13
411147575008959424,2020-05,2970.65,6614.05,4130.45,4651.18,-4164.13,-3264
411147575008959424,2020-06,6636.02,8765.97,4148.71,3906.25,-1887.49,-5151.49
411147575008959424,2020-07,1519.17,2299.87,5456.19,10011.45,-5335.96,-10487.45
411147575008959424,2020-08,5934.59,967.24,920.16,7110.56,-1223.05,-11710.5
411147575008959424,2020-09,3717.88,3679.12,3905.52,6042.29,-2098.01,-13808.51
411147575008959424,2020-10,2180.7,4363.85,1637.6,6632.96,-7178.51,-20987.02
411147575008959424,2020-11,2584.43,6503.37,6380.26,5205.03,-2743.71,-23730.73
411147575008959424,2020-12,2984.33,2370.76,1929.75,1240.83,1302.49,-22428.24
412996602659981504,2020-01,1322.25,6245.49,1519.57,3234.51,-6638.18,-6638.18
412996602659981504,2020-02,1714.44,3149.37,2277.19,1966.9,-1124.64,-7762.82
412996602659981504,2020-03,2357.44,2916.48,1528.95,2480.01,-1510.1,-9272.92
412996602659981504,2020-04,3010.06,5735.85,1445.62,788.54,-2068.71,-11341.63
412996602659981504,2020-05,340.04,404.9,2077.47,3035.96,-1023.35,-12364.98
412996602659981504,2020-06,604.11,3535.28,1746.29,709.66,-1894.54,-14259.52
412996602659981504,2020-07,4447.12,1771.39,2731.24,1646.61,3760.36,-10499.16
412996602659981504,2020-08,7375.62,1969.2,0,2354.84,3051.58,-7447.58
412996602659981504,2020-09,0,1740.61,1492.6,4164.35,-4412.36,-11859.94
412996602659981504,2020-10,5369.23,3375.55,2461.81,4559.79,-104.3,-11964.24
412996602659981504,2020-11,10669.93,409.67,4755.39,1901.98,13113.67,1149.43
412996602659981504,2020-12,828.62,4908.45,2975.29,0,-1104.54,44.89
413282146570314176,2020-01,3752.09,4929.04,462.78,3112.19,-3826.36,-3826.36
413282146570314176,2020-02,7483.49,3431.84,5283.18,7998.93,1335.9,-2490.46
413282146570314176,2020-03,3693.41,2556.9,2619.91,2462.73,1293.69,-1196.77
413282146570314176,2020-04,3389.65,2024.07,2268.39,2657.11,976.86,-219.91
413282146570314176,2020-05,2774.97,3401.87,3957.52,1463.5,1867.12,1647.21
413282146570314176,2020-06,8237.72,4240.85,5657.19,6319.79,3334.27,4981.48
413282146570314176,2020-07,2108,1073.25,3341.28,2087.44,2288.59,7270.07
413282146570314176,2020-08,3090.29,1957.69,5999.43,7356.62,-224.59,7045.48
413282146570314176,2020-09,3177.47,1480.99,3937.45,7970.41,-2336.48,4709
413282146570314176,2020-10,3851.4,5842.17,5377.76,3992.98,-605.99,4103.01
413282146570314176,2020-11,6997.23,6699.59,380.03,11891.2,-11213.53,-7110.52
413282146570314176,2020-12,6331.49,2845.8,2689.18,1811.79,4363.08,-2747.44
413472486955993984,2020-01,1067.7,142.48,3413.42,139.01,4199.63,4199.63
413472486955993984,2020-02,1016.32,1296.06,0,2753.09,-3032.83,1166.8
413472486955993984,2020-03,2845.63,1128.45,1876.96,402.17,3191.97,4358.77
413472486955993984,2020-04,3196.71,1272.24,0,0,1924.47,6283.24
413472486955993984,2020-05,5130.94,859.75,1684,2993.56,2961.63,9244.87
413472486955993984,2020-06,2734.18,1612.72,1470.21,211.54,2380.13,11625
413472486955993984,2020-07,1793.04,3464.63,869.68,0,-801.91,10823.09
413472486955993984,2020-08,2052.28,1548.2,205.69,3684.98,-2975.21,7847.88
413472486955993984,2020-09,1452.82,2862.28,360.46,0,-1049,6798.88
413472486955993984,2020-10,2181.88,3476.31,3846.11,4287.2,-1735.52,5063.36
413472486955993984,2020-11,410.09,1990.44,1935.1,340.29,14.46,5077.82
413472486955993984,2020-12,1902.88,0,1275.63,2955.95,222.56,5300.38
414105220864039104,2020-01,5071.13,3405.85,0,2253.13,-587.85,-587.85
414105220864039104,2020-02,1539.05,2208.64,1826.55,1390.7,-233.74,-821.59
414105220864039104,2020-03,3038.48,3263.77,1230.13,4127.76,-3122.92,-3944.51
414105220864039104,2020-04,2286.23,2688.7,0,2248.11,-2650.58,-6595.09
414105220864039104,2020-05,0,1764.14,6491.9,2509.03,2218.73,-4376.36
414105220864039104,2020-06,1609.72,1415.14,2509.32,3594.38,-890.48,-5266.84
414105220864039104,2020-07,504.51,4667.57,6452.63,1927.85,361.72,-4905.12
414105220864039104,2020-08,1425.18,1418.04,2765.74,1639.7,1133.18,-3771.94
414105220864039104,2020-09,1467.6,2474.14,19,3042.41,-4029.95,-7801.89
414105220864039104,2020-10,5027.17,1230.78,1410.68,1865.04,3342.03,-4459.86
414105220864039104,2020-11,1682.27,1758.89,3167.73,1646.05,1445.06,-3014.8
414105220864039104,2020-12,1387.2,2833.22,1722.91,0,276.89,-2737.91
415426529295164864,2020-01,3164.19,1580.93,1677.57,2560.82,700.01,700.01
415426529295164864,2020-02,4948.51,1296.01,1364.78,1192.68,3824.6,4524.61
415426529295164864,2020-03,96.44,9057.92,2039.01,1121.19,-8043.66,-3519.05
415426529295164864,2020-04,2665.7,3480.78,0,2443.31,-3258.39,-6777.44
415426529295164864,2020-05,2955.82,4842.66,2593.67,1443.96,-737.13,-7514.57
415426529295164864,2020-06,7153.45,2255.02,3443.19,2644.43,5697.19,-1817.38
415426529295164864,2020-07,388.32,7264.76,1821.29,2706.64,-7761.79,-9579.17
415426529295164864,2020-08,982.35,4855.35,0,3673.53,-7546.53,-17125.7
415426529295164864,2020-09,0,4292.8,3101.03,3384.53,-4576.3,-21702
415426529295164864,2020-10,10750.22,6687.22,2220.54,3022.12,3261.42,-18440.58
415426529295164864,2020-11,1973.12,1457.93,4829.7,927.52,4417.37,-14023.21
415426529295164864,2020-12,7413.34,886.01,5825.33,153.83,12198.83,-1824.38
415575203974362880,2020-01,3703.52,2037.04,0,5355.29,-3688.81,-3688.81
415575203974362880,2020-02,871.6,5800.39,0,4121.96,-9050.75,-12739.56
415575203974362880,2020-03,5403.2,3496.13,3186.11,701.97,4391.21,-8348.35
415575203974362880,2020-04,4670.67,3353.57,628.34,5017.51,-3072.07,-11420.42
415575203974362880,2020-05,2056.72,4258.55,5995.11,6.63,3786.65,-7633.77
415575203974362880,2020-06,763.5,4643.04,4427.4,1085.99,-538.13,-8171.9
415575203974362880,2020-07,1680.65,1160.93,6104.38,781.76,5842.34,-2329.56
415575203974362880,2020-08,1693.43,0,0,2557.43,-864,-3193.56
415575203974362880,2020-09,2439.2,550.83,2252.61,1998.89,2142.09,-1051.47
415575203974362880,2020-10,1457.88,1109.06,3186.88,4107.26,-571.56,-1623.03
415575203974362880,2020-11,1810.91,1062.59,4517.18,1804.78,3460.72,1837.69
415575203974362880,2020-12,4821.02,4749,2134.61,1465.09,741.54,2579.23
415760475173559616,2020-01,0,1798.07,0,1788.08,-3586.15,-3586.15
415760475173559616,2020-02,0,1737.61,1846.03,5056.87,-4948.45,-8534.6
415760475173559616,2020-03,2385.73,279.34,1572.6,891.79,2787.2,-5747.4
415760475173559616,2020-04,4603.51,1898.87,1256.82,2960.13,1001.33,-4746.07
415760475173559616,2020-05,5102.43,2287.07,1031.78,945.74,2901.4,-1844.67
415760475173559616,2020-06,224.69,757,468.7,2096.13,-2159.74,-4004.41
415760475173559616,2020-07,21.03,832.79,2143.09,1699.58,-368.25,-4372.66
415760475173559616,2020-08,1710.88,4044.83,1974.38,4820.21,-5179.78,-9552.44
415760475173559616,2020-09,0,1685.03,1178.47,2060.03,-2566.59,-12119.03
415760475173559616,2020-10,0,2431.1,1368.65,855.22,-1917.67,-14036.7
415760475173559616,2020-11,2396.05,839.59,1134.77,2764.9,-73.67,-14110.37
415760475173559616,2020-12,0,1992.95,0,0,-1992.95,-16103.32
415879294451173440,2020-01,6353.82,1322.81,3493.02,3254.63,5269.4,5269.4
415879294451173440,2020-02,4650.57,993.91,4356.32,5095.93,2917.05,8186.45
415879294451173440,2020-03,3439.71,8041.56,0,8924.78,-13526.63,-5340.18
415879294451173440,2020-04,5569.6,2885.15,5615.23,3407.71,4891.97,-448.21
415879294451173440,2020-05,2146.06,2586.63,701.69,4306.25,-4045.13,-4493.34
415879294451173440,2020-06,1724.05,5272.62,348.71,7874.35,-11074.21,-15567.55
415879294451173440,2020-07,2567.68,914.81,6824.13,10607.89,-2130.89,-17698.44
415879294451173440,2020-08,1929.5,1926.46,3646.81,2323.27,1326.58,-16371.86
415879294451173440,2020-09,5180.17,1064.29,3718.01,1726.34,6107.55,-10264.31
415879294451173440,2020-10,7753.22,4266.71,8307.14,3847.5,7946.15,-2318.16
415879294451173440,2020-11,8268.32,6834.41,3816.02,3891.98,1357.95,-960.21
415879294451173440,2020-12,8362.62,4011.48,8690.81,7335.5,5706.45,4746.24
416408915126889984,2020-01,553.92,0,1138.44,842.86,849.5,849.5
416408915126889984,2020-02,6114,1991.99,79.59,5484.91,-1283.31,-433.81
416408915126889984,2020-03,6528.42,2034.01,3307.13,4312.26,3489.28,3055.47
416408915126889984,2020-04,4949.06,2501.76,2591.91,823.54,4215.67,7271.14
416408915126889984,2020-05,1060.36,1158.18,7145.66,5299.71,1748.13,9019.27
416408915126889984,2020-06,2248.33,4246.01,3015.22,789.31,228.23,9247.5
416408915126889984,2020-07,806.5,2264.77,2433.98,4196.18,-3220.47,6027.03
416408915126889984,2020-08,2476.28,2249.32,5200.97,145.97,5281.96,11308.99
416408915126889984,2020-09,3395.57,4890.28,3931.75,2750.99,-313.95,10995.04
416408915126889984,2020-10,756.84,1101.48,5784.52,867.37,4572.51,15567.55
416408915126889984,2020-11,344.9,3240.53,3909.1,6717.97,-5704.5,9863.05
416408915126889984,2020-12,2136.72,7553.53,3052.07,1045.13,-3409.87,6453.18
416637332398514880,2020-01,523.12,3217.53,876.96,3404.96,-5222.41,-5222.41
416637332398514880,2020-02,10891.75,4782.06,196.86,1383.34,4923.21,-299.2
416637332398514880,2020-03,0,4028.31,0,1896.82,-5925.13,-6224.33
416637332398514880,2020-04,2049.22,1937.61,3508.48,2132.25,1487.84,-4736.49
416637332398514880,2020-05,3587.82,3345.89,646.42,2899.98,-2011.63,-6748.12
416637332398514880,2020-06,613.81,2526.48,19.36,0,-1893.31,-8641.43
416637332398514880,2020-07,138.97,860.18,3142.6,0,2421.39,-6220.04
416637332398514880,2020-08,1268.38,631.24,0,3685.39,-3048.25,-9268.29
416637332398514880,2020-09,2727.44,0,3905.99,0,6633.43,-2634.86
416637332398514880,2020-10,494.39,3132.1,1150.6,1082.12,-2569.23,-5204.09
416637332398514880,2020-11,2950.1,1951.84,1621.17,0,2619.43,-2584.66
416637332398514880,2020-12,2178.4,0,5556.64,936.6,6798.44,4213.78
419405365099104064,2020-01,1794.33,4224.52,4681.37,3796.69,-1545.51,-1545.51
419405365099104064,2020-02,1571.33,567.39,4163.66,8604.58,-3436.98,-4982.49
419405365099104064,2020-03,1677.73,1133.01,2584.33,1951.16,1177.89,-3804.6
419405365099104064,2020-04,327.45,4599.54,5168.93,3371.27,-2474.43,-6279.03
419405365099104064,2020-05,1497.08,1890.72,1862.23,5933.19,-4464.6,-10743.63
419405365099104064,2020-06,2817.71,2902.03,233.33,2674.98,-2525.97,-13269.6
419405365099104064,2020-07,2091.87,1936.81,316.22,2450.45,-1979.17,-15248.77
419405365099104064,2020-08,941.57,0,5269.31,4331.33,1879.55,-13369.22
419405365099104064,2020-09,4494.33,0,3258.62,6595.35,1157.6,-12211.62
419405365099104064,2020-10,1170.92,725.55,424.31,1986.79,-1117.11,-13328.73
419405365099104064,2020-11,3483.75,709.02,779.72,2523.5,1030.95,-12297.78
419405365099104064,2020-12,29.85,128.21,2861.96,3619.65,-856.05,-13153.83
419613626378195200,2020-01,2578.63,2017.17,3523.96,7505.92,-3420.5,-3420.5
419613626378195200,2020-02,4308.6,748.32,2609.74,246.1,5923.92,2503.42
419613626378195200,2020-03,3328.07,1786.91,3365.75,1734.51,3172.4,5675.82
419613626378195200,2020-04,2377.69,6796.17,2454.04,3782.65,-5747.09,-71.27
419613626378195200,2020-05,5935.21,5943.57,0,3214,-3222.36,-3293.63
419613626378195200,2020-06,2814.43,1710,0,983.36,121.07,-3172.56
419613626378195200,2020-07,4544.7,9256.71,1068.67,3817.74,-7461.08,-10633.64
419613626378195200,2020-08,0,532.09,2266.14,9854.16,-8120.11,-18753.75
419613626378195200,2020-09,1523.95,0,2507.89,4164.63,-132.79,-18886.54
419613626378195200,2020-10,3636.33,3169.63,5881.28,1401.33,4946.65,-13939.89
419613626378195200,2020-11,0,318.19,3904.27,768.35,2817.73,-11122.16
419613626378195200,2020-12,1508.43,1784.49,3371.4,1417.28,1678.06,-9444.1
420685843884275776,2020-01,1134.5,0,0,0,1134.5,1134.5
420685843884275776,2020-02,1838.77,0,1983.42,763.76,3058.43,4192.93
420685843884275776,2020-04,1872.76,0,290.85,0,2163.61,6356.54
420685843884275776,2020-05,0,152.12,4322.88,2293.47,1877.29,8233.83
420685843884275776,2020-06,728.49,1488.71,2109.99,2017.27,-667.5,7566.33
420685843884275776,2020-07,0,1669.61,0,2208.84,-3878.45,3687.88
420685843884275776,2020-08,47.72,0,1466.16,682.46,831.42,4519.3
420685843884275776,2020-09,751.55,2708.66,0,0,-1957.11,2562.19
420685843884275776,2020-10,0,1773.1,0,1994.93,-3768.03,-1205.84
420685843884275776,2020-11,274.5,2749.2,3209.97,2538.47,-1803.2,-3009.04
420685843884275776,2020-12,244,2852.34,905.34,2084.71,-3787.71,-6796.75
424055309582882496,2020-01,124.5,0,0,0,124.5,124.5
424055309582882496,2020-02,1195.86,0,0,0,1195.86,1320.36
424055309582882496,2020-07,0,1868.87,0,0,-1868.87,-548.51
424055309582882496,2020-11,711.82,0,0,0,711.82,163.31
424055309582882496,2020-12,2513.73,0,0,0,2513.73,2677.04
424123839978554304,2020-01,4229.57,3446.16,334.65,3332.28,-2214.22,-2214.22
424123839978554304,2020-02,667.62,1365.18,5505.82,2125.33,2682.93,468.71
424123839978554304,2020-03,5422.06,4230.77,3709.96,969.37,3931.88,4400.59
424123839978554304,2020-04,1548.77,8050.21,993.87,3834.45,-9342.02,-4941.43
424123839978554304,2020-05,6950.29,1143.47,854.68,4054.72,2606.78,-2334.65
424123839978554304,2020-06,50.9,6998.81,2441.13,1176.03,-5682.81,-8017.46
424123839978554304,2020-07,4428.97,6822.71,4480.92,4610.97,-2523.79,-10541.25
424123839978554304,2020-08,2586.05,3717.63,0,2796.26,-3927.84,-14469.09
424123839978554304,2020-09,2180.54,3467.67,2278.76,3051,-2059.37,-16528.46
424123839978554304,2020-10,1857.56,5378.79,4247.36,1475.51,-749.38,-17277.84
424123839978554304,2020-11,6835.54,0,5842.04,1042.07,11635.51,-5642.33
424123839978554304,2020-12,1737.09,4362.81,3797.83,2361,-1188.89,-6831.22
424351189316723328,2020-01,5015.93,6416.7,4493.75,10816.54,-7723.56,-7723.56
424351189316723328,2020-02,4540.25,4375.34,5424.9,5931.38,-341.57,-8065.13
424351189316723328,2020-03,6831.08,3512.96,2592.48,5079.66,830.94,-7234.19
424351189316723328,2020-04,6043.7,4151.94,5556.3,6098.71,1349.35,-5884.84
424351189316723328,2020-05,1906.27,14733.26,4820.6,3539.09,-11545.48,-17430.32
424351189316723328,2020-06,6213.12,5631.5,1833.29,3387.07,-972.16,-18402.48
424351189316723328,2020-07,5922.68,10317.35,2318.12,2317.02,-4393.57,-22796.05
424351189316723328,2020-08,9130.13,7657.15,2621.15,5213.84,-1119.71,-23915.76
424351189316723328,2020-09,3263.21,7426.7,4813.22,2263.39,-1613.66,-25529.42
424351189316723328,2020-10,5968.05,3990.04,6018.58,1590.52,6406.07,-19123.35
424351189316723328,2020-11,3983.81,2753.12,1393.54,1219.89,1404.34,-17719.01
424351189316723328,2020-12,6250.69,2081.64,207.08,3744.61,631.52,-17087.49
425353278362828544,2020-02,0,397.37,0,0,-397.37,-397.37
425353278362828544,2020-08,1113,0,0,0,1113,715.63
425353278362828544,2020-09,1533.38,0,0,0,1533.38,2249.01
425737514827690816,2020-01,970.97,1845.63,3404.38,3426.5,-896.78,-896.78
425737514827690816,2020-02,6212.82,6138.22,1545.49,4819.41,-3199.32,-4096.1
425737514827690816,2020-03,3687.84,5033.37,5519.5,4675.58,-501.61,-4597.71
425737514827690816,2020-04,2896,3665.16,9091.69,3835.45,4487.08,-110.63
425737514827690816,2020-05,1867.19,1493.18,8310.06,8796.44,-112.37,-223
425737514827690816,2020-06,608.97,3871.36,3137.01,664.67,-790.05,-1013.05
425737514827690816,2020-07,1483.75,4546.71,2901.83,2994.11,-3155.24,-4168.29
425737514827690816,2020-08,2107.18,1457.49,5929.05,4782.49,1796.25,-2372.04
425737514827690816,2020-09,7774.86,1935.88,7628.5,2485.66,10981.82,8609.78
425737514827690816,2020-10,6294.64,4610.41,4577.88,8980.64,-2718.53,5891.25
425737514827690816,2020-11,5316.79,7873.59,3372.95,4069.4,-3253.25,2638
425737514827690816,2020-12,6553.63,5676.6,5240.76,4439.17,1678.62,4316.62
426846944565154816,2020-01,6115.6,1952.47,1842.82,3015.35,2990.6,2990.6
426846944565154816,2020-02,1030.97,6544.83,1423.8,4644.66,-8734.72,-5744.12
426846944565154816,2020-03,533.46,2994.96,0,5165.63,-7627.13,-13371.25
426846944565154816,2020-04,1967.67,1070.65,1731.97,5241.93,-2612.94,-15984.19
426846944565154816,2020-05,3296.81,2861.69,3713.66,1354.18,2794.6,-13189.59
426846944565154816,2020-06,5213.67,4376.47,2753.17,5026.4,-1436.03,-14625.62
426846944565154816,2020-07,6711.83,2781.06,6570.63,2069.88,8431.52,-6194.1
426846944565154816,2020-08,0,2831.28,951.6,2719.35,-4599.03,-10793.13
426846944565154816,2020-09,0,3349.34,2611.03,4363.2,-5101.51,-15894.64
426846944565154816,2020-10,1949.69,1949.59,3227.29,1358.92,1868.47,-14026.17
426846944565154816,2020-11,7683.41,5109.25,0,3855.7,-1281.54,-15307.71
426846944565154816,2020-12,0,2571.23,4675.57,0,2104.34,-13203.37
426865777950081216,2020-01,5225.87,3652.17,2819.99,8389.04,-3995.35,-3995.35
426865777950081216,2020-02,4647.15,750.4,1492.98,3395.86,1993.87,-2001.48
426865777950081216,2020-03,2701.94,1802.94,5347.87,3403.3,2843.57,842.09
426865777950081216,2020-04,14980.83,6201.68,5167.48,5194.49,8752.14,9594.23
426865777950081216,2020-05,3000.49,4467.49,3495.03,2223.63,-195.6,9398.63
426865777950081216,2020-06,2926.05,2856.53,3422.51,1824.2,1667.83,11066.46
426865777950081216,2020-07,5292.33,5928.63,8568.68,2911.27,5021.11,16087.57
426865777950081216,2020-08,4706.12,11446.86,8964.93,2848.5,-624.31,15463.26
426865777950081216,2020-09,1467.69,9290.2,1950.91,11161.71,-17033.31,-1570.05
426865777950081216,2020-10,2249.64,8427.22,6017.54,3600.61,-3760.65,-5330.7
426865777950081216,2020-11,2826.79,7241.19,1419.82,2102.38,-5096.96,-10427.66
426865777950081216,2020-12,3059.01,2372.33,4778.67,6988.31,-1522.96,-11950.62
430647964639544512,2020-01,4946.18,2159.53,0,4317.37,-1530.72,-1530.72
430647964639544512,2020-02,1152.81,675.57,1455.95,3051.03,-1117.84,-2648.56
430647964639544512,2020-03,1692.75,3300.32,0,3559.86,-5167.43,-7815.99
430647964639544512,2020-04,1864.69,5114.47,821.42,1955.42,-4383.78,-12199.77
430647964639544512,2020-05,1521.71,9402.87,0,2631.87,-10513.03,-22712.8
430647964639544512,2020-06,4273.25,5413.94,0,1318.08,-2458.77,-25171.57
430647964639544512,2020-07,1917.8,4357.65,1511.27,1395.63,-2324.21,-27495.78
430647964639544512,2020-08,3401.31,2835.26,3997.82,179.75,4384.12,-23111.66
430647964639544512,2020-09,5984.62,2734.39,1005.99,3462.67,793.55,-22318.11
430647964639544512,2020-11,0,826.34,1080.04,1227.37,-973.67,-23291.78
430647964639544512,2020-12,1694.14,489.59,801.08,0,2005.63,-21286.15
430932338007923648,2020-01,5980.82,2720.99,2336.4,1181.39,4414.84,4414.84
430932338007923648,2020-03,970.1,893.4,1909.83,0,1986.53,6401.37
430932338007923648,2020-04,2874.04,2418.59,1088.96,0,1544.41,7945.78
430932338007923648,2020-06,0,1767.79,1825.93,0,58.14,8003.92
430932338007923648,2020-07,191.66,0,1393.06,4179.07,-2594.35,5409.57
430932338007923648,2020-08,3373.02,0,260.24,0,3633.26,9042.83
430932338007923648,2020-09,617.16,2651.64,139.5,0,-1894.98,7147.85
430932338007923648,2020-10,1524.57,741.1,1419.67,124.74,2078.4,9226.25
430932338007923648,2020-11,3716.39,7195.02,0,3560.49,-7039.12,2187.13
430932338007923648,2020-12,1657.56,5247.54,63.29,1366.29,-4892.98,-2705.85
431174637164708160,2020-01,2700.22,750.34,0,292.9,1656.98,1656.98
431174637164708160,2020-02,0,976.39,1567.5,3696.01,-3104.9,-1447.92
431174637164708160,2020-03,1920.57,1543.03,4572.64,893.88,4056.3,2608.38
431174637164708160,2020-04,3931.95,1972.51,1633.71,5954.05,-2360.9,247.48
431174637164708160,2020-05,522.25,1752.09,2857.25,446.45,1180.96,1428.44
431174637164708160,2020-06,230.24,1336.7,1075.13,3604.56,-3635.89,-2207.45
431174637164708160,2020-07,3039.87,1119.42,0,0,1920.45,-287
431174637164708160,2020-08,1430.05,346.25,3401.74,1024.58,3460.96,3173.96
431174637164708160,2020-09,1692.9,1315.87,408.92,1324.58,-538.63,2635.33
431174637164708160,2020-10,522.68,0,1040.88,3469.01,-1905.45,729.88
431174637164708160,2020-11,195.58,362.61,0,0,-167.03,562.85
431174637164708160,2020-12,1334.27,1196.25,558.7,0,696.72,1259.57
431420370676259904,2020-02,1088.67,1149.21,0,1462.59,-1523.13,-1523.13
431420370676259904,2020-03,0,791.25,633.32,0,-157.93,-1681.06
431420370676259904,2020-04,2637.32,3275.33,0,0,-638.01,-2319.07
431420370676259904,2020-05,66.42,2227.82,2753.78,0,592.38,-1726.69
431420370676259904,2020-06,0,2069.08,1489.4,1441.33,-2021.01,-3747.7
431420370676259904,2020-07,140.61,0,3928.46,0,4069.07,321.37
431420370676259904,2020-08,0,3067.97,0,1789.72,-4857.69,-4536.32
431420370676259904,2020-09,1745.16,1470.38,1441.06,1744.59,-28.75,-4565.07
431420370676259904,2020-10,2269.19,2164.87,2814.57,4443.69,-1524.8,-6089.87
431420370676259904,2020-11,0,1214.01,1901.84,0,687.83,-5402.04
431420370676259904,2020-12,658.55,866.03,0,0,-207.48,-5609.52
433030888586426944,2020-01,0,1350.13,2525.14,1433.78,-258.77,-258.77
433030888586426944,2020-02,3201.15,1726.83,5049.6,1608.73,4915.19,4656.42
433030888586426944,2020-03,4515.8,232.54,2633.06,1661.15,5255.17,9911.59
433030888586426944,2020-04,2402.14,1789.24,1290.54,1131.41,772.03,10683.62
433030888586426944,2020-05,0,2723.23,2535.8,2207.44,-2394.87,8288.75
433030888586426944,2020-06,1552.98,4468.8,3480.69,2016.59,-1451.72,6837.03
433030888586426944,2020-07,1495.53,0,757.22,1392.91,859.84,7696.87
433030888586426944,2020-08,1008.48,1070.06,860.94,2860.13,-2060.77,5636.1
433030888586426944,2020-09,1699.38,5495.84,2033.81,2464.23,-4226.88,1409.22
433030888586426944,2020-10,2094.22,1373.67,0,0,720.55,2129.77
433030888586426944,2020-11,0,1435.64,6219.49,92.8,4691.05,6820.82
433030888586426944,2020-12,1700.98,2803.69,3009.89,201.8,1705.38,8526.2
433298978759811904,2020-02,186.44,0,0,0,186.44,186.44
433298978759811904,2020-06,955.07,0,0,1300.63,-345.56,-159.12
433298978759811904,2020-07,1213.91,0,0,0,1213.91,1054.79
433298978759811904,2020-10,1794.42,0,0,313,1481.42,2536.21
433298978759811904,2020-12,0,1448.62,1622.48,0,173.86,2710.07
434187609712466368,2020-01,1205.65,73.43,5050.07,5406.17,776.12,776.12
434187609712466368,2020-02,773.45,1975.7,258.6,0,-943.65,-167.53
434187609712466368,2020-03,2056.62,0,2601.55,0,4658.17,4490.64
434187609712466368,2020-05,0,1599.7,0,195.52,-1795.22,2695.42
434187609712466368,2020-06,3972.76,8367.1,3389.12,1535.65,-2540.87,154.55
434187609712466368,2020-07,0,4185.32,1724.16,1021.26,-3482.42,-3327.87
434187609712466368,2020-08,818.78,3294.14,2729.21,461.13,-207.28,-3535.15
434187609712466368,2020-09,3201.78,0,340.64,1115.98,2426.44,-1108.71
434187609712466368,2020-10,1422.16,0,1688.71,0,3110.87,2002.16
434187609712466368,2020-11,0,2193.91,1276.22,1784.47,-2702.16,-700
434187609712466368,2020-12,1780.78,2705.47,2914.58,2237.69,-247.8,-947.8
435146975925185728,2020-01,1918.88,0,1370.58,734.71,2554.75,2554.75
435146975925185728,2020-02,1191.1,2378.92,0,632.94,-1820.76,733.99
435146975925185728,2020-03,0,2727.81,2084,0,-643.81,90.18
435146975925185728,2020-04,2317.58,1997.79,3158.35,1370.46,2107.68,2197.86
435146975925185728,2020-05,826.57,0,1493.61,2332.54,-12.36,2185.5
435146975925185728,2020-06,2255.67,0,3395.93,1578.01,4073.59,6259.09
435146975925185728,2020-07,2345.12,1701.55,278.57,400.32,521.82,6780.91
435146975925185728,2020-08,2567.42,2381.36,469.15,0,655.21,7436.12
435146975925185728,2020-09,0,1507.63,955.04,1071.31,-1623.9,5812.22
435146975925185728,2020-10,2681.26,4148.76,1849.71,0,382.21,6194.43
435146975925185728,2020-11,1805.28,1881.31,1966.59,0,1890.56,8084.99
435146975925185728,2020-12,0,2672.75,0,3442.97,-6115.72,1969.27
435272748715784448,2020-02,0,783.32,0,0,-783.32,-783.32
435272748715784448,2020-03,0,567.19,0,0,-567.19,-1350.51
435272748715784448,2020-04,3056.79,0,412.94,0,3469.73,2119.22
435272748715784448,2020-05,0,432.82,725.08,0,292.26,2411.48
435272748715784448,2020-06,0,579.08,870.68,0,291.6,2703.08
435272748715784448,2020-09,0,1021.07,0,656.29,-1677.36,1025.72
435272748715784448,2020-11,1338.49,2983.44,0,0,-1644.95,-619.23
435272748715784448,2020-12,728.32,463.44,918.67,0,1183.55,564.32
436401297077996032,2020-01,9127.22,5826.68,3826.23,5918.73,1208.04,1208.04
436401297077996032,2020-02,4195.95,873.3,1856.58,2881.36,2297.87,3505.91
436401297077996032,2020-03,4116.07,6676.83,4298.78,4808.51,-3070.49,435.42
436401297077996032,2020-04,5840.28,3732.78,3140.64,4136.53,1111.61,1547.03
436401297077996032,2020-05,2314.22,2398.82,3336.47,6403.57,-3151.7,-1604.67
436401297077996032,2020-06,7935.05,6924.26,3171.56,3680.26,502.09,-1102.58
436401297077996032,2020-07,4003.34,2092.61,5980.67,1657.56,6233.84,5131.26
436401297077996032,2020-08,3432.05,7158.79,1880.4,7613.15,-9459.49,-4328.23
436401297077996032,2020-09,3984.91,3935.06,4183.1,5777.43,-1544.48,-5872.71
436401297077996032,2020-10,3189.42,1668.3,5276.64,8256.61,-1458.85,-7331.56
436401297077996032,2020-11,1142.28,5464.55,5652.19,5257.57,-3927.65,-11259.21
436401297077996032,2020-12,1969.51,5380.85,709.03,4062.85,-6765.16,-18024.37
437441275060561664,2020-01,5438.11,1705.59,3020.39,3169.6,3583.31,3583.31
437441275060561664,2020-02,5320.27,1595.16,4272,3332.7,4664.41,8247.72
437441275060561664,2020-03,5814.89,2140.18,7308.99,2029.69,8954.01,17201.73
437441275060561664,2020-04,8735.6,8040.29,316.45,10402.94,-9391.18,7810.55
437441275060561664,2020-05,1127.47,3297.66,6811.18,4507,133.99,7944.54
437441275060561664,2020-06,2639.24,2519.32,2061.67,5486.65,-3305.06,4639.48
437441275060561664,2020-07,6145.98,5491.25,3745.15,3164.17,1235.71,5875.19
437441275060561664,2020-08,1307.64,7483.34,4740.45,3159.39,-4594.64,1280.55
437441275060561664,2020-09,1226,3878.78,5636.35,2016.53,967.04,2247.59
437441275060561664,2020-10,5553.91,4541.62,6365.06,2526.16,4851.19,7098.78
437441275060561664,2020-11,948.19,2965.27,8662.62,2826.41,3819.13,10917.91
437441275060561664,2020-12,5904.71,3187.35,2026.56,6853.73,-2109.81,8808.1
439420335116934912,2020-01,4547.05,6473.9,2555.54,303.8,324.89,324.89
439420335116934912,2020-02,1482.78,4179.26,2567,1604.15,-1733.63,-1408.74
439420335116934912,2020-03,3077.7,5282.49,4518.83,8702.31,-6388.27,-7797.01
439420335116934912,2020-04,4643.89,659.43,458.71,5804.94,-1361.77,-9158.78
439420335116934912,2020-05,1358.58,6182.01,3104.86,1719.94,-3438.51,-12597.29
439420335116934912,2020-06,7078.01,5083.68,3074.1,2156.48,2911.95,-9685.34
439420335116934912,2020-07,7616.12,7938.37,8232.93,3393.9,4516.78,-5168.56
439420335116934912,2020-08,5554.59,9018.74,4933.03,3062.1,-1593.22,-6761.78
439420335116934912,2020-09,3486.4,1916.11,5057,3214.76,3412.53,-3349.25
439420335116934912,2020-10,1464.95,5155.81,4650.06,1535.54,-576.34,-3925.59
439420335116934912,2020-11,3478.9,7028.77,935.32,3060.99,-5675.54,-9601.13
439420335116934912,2020-12,618.77,1812.52,812.72,5502.33,-5883.36,-15484.49
440520407136697984,2020-01,463.54,1679.34,0,1721.41,-2937.21,-2937.21
440520407136697984,2020-03,0,594.39,1297.22,2066.88,-1364.05,-4301.26
440520407136697984,2020-04,0,755.16,681.83,2719.52,-2792.85,-7094.11
440520407136697984,2020-06,2317.36,0,1950.42,898.67,3369.11,-3725
440520407136697984,2020-09,1280.71,1741.55,0,0,-460.84,-4185.84
440520407136697984,2020-10,1181.2,872.57,0,4714.33,-4405.7,-8591.54
440520407136697984,2020-11,0,1498.42,91.98,2182.39,-3588.83,-12180.37
440520407136697984,2020-12,0,1822.96,0,0,-1822.96,-14003.33
444913511741294528,2020-01,2988.37,8169.27,6099.23,1012.96,-94.63,-94.63
444913511741294528,2020-02,4371.28,8492.65,1208.7,3999.07,-6911.74,-7006.37
444913511741294528,2020-03,1466.2,9558.59,3540.9,1940.9,-6492.39,-13498.76
444913511741294528,2020-04,3602.44,5908.41,3385.81,4501.38,-3421.54,-16920.3
444913511741294528,2020-05,6848.87,6498.18,4135.7,4438.22,48.17,-16872.13
444913511741294528,2020-06,4078.94,1913.16,7146.04,3848.44,5463.38,-11408.75
444913511741294528,2020-07,3454.73,6105.87,7454.82,3446.27,1357.41,-10051.34
444913511741294528,2020-08,7307.73,4644.63,4132.99,3347.5,3448.59,-6602.75
444913511741294528,2020-09,3350.25,3975.21,4961.48,3189.26,1147.26,-5455.49
444913511741294528,2020-10,6415.73,4586.17,1390.78,5230.15,-2009.81,-7465.3
444913511741294528,2020-11,3551.86,3393.01,3323.2,5329.09,-1847.04,-9312.34
444913511741294528,2020-12,3718.96,9304.91,3540.62,3112.7,-5158.03,-14470.37
445393004890119424,2020-01,71.24,0,591.38,1927.78,-1265.16,-1265.16
445393004890119424,2020-03,1136.53,1554.38,0,1884.65,-2302.5,-3567.66
445393004890119424,2020-04,1286.25,0,0,0,1286.25,-2281.41
445393004890119424,2020-05,2252.31,3267.56,0,512.01,-1527.26,-3808.67
445393004890119424,2020-06,2276.75,5290.47,4929.02,4076.63,-2161.33,-5970
445393004890119424,2020-07,1457.89,4551.02,2784.77,1113.49,-1421.85,-7391.85
445393004890119424,2020-08,250.87,243.51,2385.1,0,2392.46,-4999.39
445393004890119424,2020-09,2225.56,1591.58,5176.32,1565.92,4244.38,-755.01
445393004890119424,2020-10,0,1413.93,2019.44,0,605.51,-149.5
445393004890119424,2020-11,3672.71,916.81,2104.51,3593.59,1266.82,1117.32
445393004890119424,2020-12,0,910.81,0,0,-910.81,206.51
445734154702467264,2020-01,2564.95,2855.66,2987.31,7580.81,-4884.21,-4884.21
445734154702467264,2020-02,1621.42,1144.09,4006.16,318.79,4164.7,-719.51
445734154702467264,2020-03,3160.82,4314.12,339.42,3039.39,-3853.27,-4572.78
445734154702467264,2020-04,7243.48,2524.13,5868.57,4114.89,6473.03,1900.25
445734154702467264,2020-05,0,6480.91,5450.86,4465.34,-5495.39,-3595.14
445734154702467264,2020-06,2417.85,933.49,1842.87,4805.24,-1478.01,-5073.15
445734154702467264,2020-07,6105.21,7055.71,2450.31,220.4,1279.41,-3793.74
445734154702467264,2020-08,1513.25,4368.86,2035.31,6383.09,-7203.39,-10997.13
445734154702467264,2020-09,957.34,5517.28,4652.44,2810.43,-2717.93,-13715.06
445734154702467264,2020-10,3433.72,8613.09,4216.27,4283.81,-5246.91,-18961.97
445734154702467264,2020-11,1672.79,3255.81,3538.18,4163.77,-2208.61,-21170.58
445734154702467264,2020-12,4334.3,4244.23,4935.36,5079.15,-53.72,-21224.3
446981406845787968,2020-01,4257.93,482.31,6156.96,4969.23,4963.35,4963.35
446981406845787968,2020-02,6876.91,8474.13,11762.71,6188.91,3976.58,8939.93
446981406845787968,2020-03,3794.81,3312.32,1937.34,2536.45,-116.62,8823.31
446981406845787968,2020-04,8759.75,3714,2470.05,2996.01,4519.79,13343.1
446981406845787968,2020-05,4210.17,4489.91,6607.82,6971.25,-643.17,12699.93
446981406845787968,2020-06,2944.8,4662.57,8764.77,4128.62,2918.38,15618.31
446981406845787968,2020-07,0,2673.91,3916.65,2179.97,-937.23,14681.08
446981406845787968,2020-08,3705.28,1060.96,919.96,2081.5,1482.78,16163.86
446981406845787968,2020-09,5973.07,2200.89,4430.25,5757.21,2445.22,18609.08
446981406845787968,2020-10,543.32,5858.85,3559.17,1095.64,-2852,15757.08
446981406845787968,2020-11,3582.21,1698.19,2629.17,2382.02,2131.17,17888.25
446981406845787968,2020-12,4930.51,1227.85,6522.19,2660.28,7564.57,25452.82
449581410112973056,2020-01,2365.44,2471.12,2860.53,3235.8,-480.95,-480.95
449581410112973056,2020-02,4246.02,3664.89,49.46,2853.01,-2222.42,-2703.37
449581410112973056,2020-03,6826.25,6231.05,4710.2,2068.8,3236.6,533.23
449581410112973056,2020-04,1624.54,4066.71,3913.7,2622.84,-1151.31,-618.08
449581410112973056,2020-05,320.78,7924.3,2184.03,2668.89,-8088.38,-8706.46
449581410112973056,2020-06,3892.68,4074.59,4092.09,3441.41,468.77,-8237.69
449581410112973056,2020-07,5467.09,1188.69,4120.45,2595.46,5803.39,-2434.3
449581410112973056,2020-08,675.17,2108.2,3433.33,5768.29,-3767.99,-6202.29
449581410112973056,2020-09,2298.6,300.5,2802.64,5701.66,-900.92,-7103.21
449581410112973056,2020-10,4175.86,370.85,3768.07,7691.66,-118.58,-7221.79
449581410112973056,2020-11,6389.29,1077.49,2774.27,1387.76,6698.31,-523.48
449581410112973056,2020-12,487.1,310.45,1930.77,3419.28,-1311.86,-1835.34
450288796914077952,2020-02,710.29,0,117.7,0,827.99,827.99
450288796914077952,2020-05,0,1027.4,330.27,1055.55,-1752.68,-924.69
450288796914077952,2020-06,1466.32,1467.46,1953.64,0,1952.5,1027.81
450288796914077952,2020-08,2463.08,1596.34,1473.64,0,2340.38,3368.19
450288796914077952,2020-09,0,2616.64,1223.08,0,-1393.56,1974.63
450288796914077952,2020-10,0,1598.09,0,422.3,-2020.39,-45.76
450288796914077952,2020-11,0,1242.73,2220.93,0,978.2,932.44
450288796914077952,2020-12,0,253.38,0,0,-253.38,679.06
450977271673842880,2020-01,10299.45,2794.49,5030.41,8540.98,3994.39,3994.39
450977271673842880,2020-02,4659.45,1377.51,637.21,7533.55,-3614.4,379.99
450977271673842880,2020-03,5098.14,3761.76,2252.7,5244.27,-1655.19,-1275.2
450977271673842880,2020-04,351.67,2976.74,5708.2,4542.66,-1459.53,-2734.73
450977271673842880,2020-05,749.52,7074.09,1539.63,5199.66,-9984.6,-12719.33
450977271673842880,2020-06,1501.19,596.28,5493.32,7049.98,-651.75,-13371.08
450977271673842880,2020-07,3102.93,1485.53,7533.95,6585.36,2565.99,-10805.09
450977271673842880,2020-08,7239.14,907.43,3900.97,5310.89,4921.79,-5883.3
450977271673842880,2020-09,3476.82,2148.2,4792.98,3437.56,2684.04,-3199.26
450977271673842880,2020-10,325.54,3616.61,9189.36,5194.64,703.65,-2495.61
450977271673842880,2020-11,5878.59,5677.75,6824.71,336.38,6689.17,4193.56
450977271673842880,2020-12,4395.54,5416.39,4035.41,3259.53,-244.97,3948.59
453470985353475072,2020-01,98.05,0,983.94,0,1081.99,1081.99
453470985353475072,2020-02,622.7,0,1588.25,0,2210.95,3292.94
453470985353475072,2020-03,374.73,0,1366.2,0,1740.93,5033.87
453470985353475072,2020-04,0,1616.57,0,0,-1616.57,3417.3
453470985353475072,2020-07,0,1204.73,0,103.27,-1308,2109.3
453470985353475072,2020-08,0,1680.7,0,0,-1680.7,428.6
453470985353475072,2020-09,1790.56,0,955.74,0,2746.3,3174.9
453470985353475072,2020-10,0,1553.18,0,0,-1553.18,1621.72
453470985353475072,2020-11,0,194.89,0,1553.25,-1748.14,-126.42
453470985353475072,2020-12,0,3817.86,682.98,1667.22,-4802.1,-4928.52
453490540024528576,2020-01,3992.28,4950.03,6760.26,136.82,5665.69,5665.69
453490540024528576,2020-03,6637.88,2752.22,2838.85,8504.77,-1780.26,3885.43
453490540024528576,2020-04,556.17,5554.13,981.75,1778.15,-5794.36,-1908.93
453490540024528576,2020-05,1409.98,6500.41,5375.92,2106.48,-1820.99,-3729.92
453490540024528576,2020-06,9264.92,4469.79,3106.1,3135.28,4765.95,1036.03
453490540024528576,2020-07,6917.92,3631.38,3768.9,3915.3,3140.14,4176.17
453490540024528576,2020-08,1392.22,1990.67,7587.69,1353.17,5636.07,9812.24
453490540024528576,2020-09,5504.07,2910.21,2537.38,7.26,5123.98,14936.22
453490540024528576,2020-10,3456.02,5689.2,9094.9,5682.01,1179.71,16115.93
453490540024528576,2020-11,6810.37,4356.49,4278.04,6658.69,73.23,16189.16
453490540024528576,2020-12,8892.72,444.08,2869.46,1656.88,9661.22,25850.38
453743812873288320,2020-01,3462.81,0,1471.69,0,4934.5,4934.5
453743812873288320,2020-02,3923.62,4909.65,2928.19,2102.39,-160.23,4774.27
453743812873288320,2020-03,4013.11,4569.96,5156.24,1516.01,3083.38,7857.65
453743812873288320,2020-04,0,2134.85,2246.71,0,111.86,7969.51
453743812873288320,2020-05,0,2476.64,3376.15,2317.24,-1417.73,6551.78
453743812873288320,2020-06,1160.86,0,2033.07,1686.55,1507.38,8059.16
453743812873288320,2020-07,0,3800.27,3397.34,4588.25,-4991.18,3067.98
453743812873288320,2020-08,3221.24,1580.8,4166.35,7062.25,-1255.46,1812.52
453743812873288320,2020-09,3221.62,3710.84,1568.47,3590.23,-2510.98,-698.46
453743812873288320,2020-10,2543.14,3585.54,3139.82,2045.27,52.15,-646.31
453743812873288320,2020-11,4703.2,6305.85,3346.69,279.35,1464.69,818.38
453743812873288320,2020-12,4845.77,3444.54,2840.34,2090.68,2150.89,2969.27
454177807935203264,2020-01,3222.91,0,1434.73,1930.05,2727.59,2727.59
454177807935203264,2020-02,2260.76,1944.37,2047.71,1468.94,895.16,3622.75
454177807935203264,2020-03,236.27,0,4273.71,6734.28,-2224.3,1398.45
454177807935203264,2020-04,1742.48,3032.2,1275.82,766.01,-779.91,618.54
454177807935203264,2020-06,1596.18,1534.15,74.59,4057.77,-3921.15,-3302.61
454177807935203264,2020-07,1104.46,3458.75,2975.01,399.43,221.29,-3081.32
454177807935203264,2020-08,2162.1,931.99,3521.84,767.18,3984.77,903.45
454177807935203264,2020-09,10.31,3367.74,315.7,1724.21,-4765.94,-3862.49
454177807935203264,2020-10,5130.39,2883.2,416,1153.77,1509.42,-2353.07
454177807935203264,2020-11,1341.22,1765.64,3173.12,4683.21,-1934.51,-4287.58
454177807935203264,2020-12,1394.12,2069.36,0,1001.98,-1677.22,-5964.8
455055341861270208,2020-01,2138.85,3282.64,0,0,-1143.79,-1143.79
455055341861270208,2020-02,463.9,2267.31,1640.84,1995.22,-2157.79,-3301.58
455055341861270208,2020-03,1891,0,1616.46,884.48,2622.98,-678.6
455055341861270208,2020-04,978.13,1037.34,840.57,3006.31,-2224.95,-2903.55
455055341861270208,2020-06,1523.49,1512.29,0,578.73,-567.53,-3471.08
455055341861270208,2020-07,0,1748.89,1951.74,437.27,-234.42,-3705.5
455055341861270208,2020-08,0,185.23,0,0,-185.23,-3890.73
455055341861270208,2020-09,1303.98,1670.56,1082.55,0,715.97,-3174.76
455055341861270208,2020-10,1740.69,994.61,4144.81,0,4890.89,1716.13
455055341861270208,2020-11,670.24,0,0,0,670.24,2386.37
455055341861270208,2020-12,1903.72,1089.41,759.95,0,1574.26,3960.63
455079293702100288,2020-01,0,4084.75,3970.17,6166.24,-6280.82,-6280.82
455079293702100288,2020-02,1664.38,3599.64,94.27,3719.71,-5560.7,-11841.52
455079293702100288,2020-03,3552.14,4637.96,2238.5,6376.54,-5223.86,-17065.38
455079293702100288,2020-04,3981.09,6352.28,0,3523.42,-5894.61,-22959.99
455079293702100288,2020-05,3611.88,2938.66,3844.62,2927.85,1589.99,-21370
455079293702100288,2020-06,499.56,3440.25,3812.74,2015.39,-1143.34,-22513.34
455079293702100288,2020-07,3743.38,1011.82,3771.38,1797.68,4705.26,-17808.08
455079293702100288,2020-08,1428.14,2900.38,2315.93,1376.11,-532.42,-18340.5
455079293702100288,2020-09,4629.01,2380.51,4015.89,4229.53,2034.86,-16305.64
455079293702100288,2020-10,1602.96,2553.64,1553.52,0,602.84,-15702.8
455079293702100288,2020-11,3608.1,5364.77,1175.63,1680.39,-2261.43,-17964.23
455079293702100288,2020-12,3188.65,2802,2073.36,5619.48,-3159.47,-21123.7
455791386769576896,2020-01,3923.48,664.42,0,3156.54,102.52,102.52
455791386769576896,2020-02,2514.09,1516.99,4215.4,9980.04,-4767.54,-4665.02
455791386769576896,2020-03,6309.43,500.08,255.55,2259.91,3804.99,-860.03
455791386769576896,2020-04,4207.5,0,2755.35,855.69,6107.16,5247.13
455791386769576896,2020-05,3205.33,2078.3,3632.08,1993.2,2765.91,8013.04
455791386769576896,2020-06,900.44,1424.63,1501.03,2634.64,-1657.8,6355.24
455791386769576896,2020-07,2961.45,2744.74,0,1541.22,-1324.51,5030.73
455791386769576896,2020-08,0,1787.26,0,200.26,-1987.52,3043.21
455791386769576896,2020-09,1441.29,1457.34,2140.22,1847.09,277.08,3320.29
455791386769576896,2020-10,4568.18,1423.52,947.21,2040.58,2051.29,5371.58
455791386769576896,2020-11,2280.3,1780,1324.62,1999.47,-174.55,5197.03
455791386769576896,2020-12,2425.14,5700.38,3336.35,1578.42,-1517.31,3679.72
456198117041242432,2020-01,0,1656.25,4283.41,1678.71,948.45,948.45
456198117041242432,2020-02,3280.32,0,8323.64,3199.58,8404.38,9352.83
456198117041242432,2020-03,6713.53,3495.45,2096.62,9408.88,-4094.18,5258.65
456198117041242432,2020-04,2672.5,1610.11,1892.61,1061.41,1893.59,7152.24
456198117041242432,2020-05,3067,4960.82,4757.61,1988.08,875.71,8027.95
456198117041242432,2020-06,1032.74,2156.32,2968.51,4964.61,-3119.68,4908.27
456198117041242432,2020-07,3913.34,5664.22,7056.82,3120.69,2185.25,7093.52
456198117041242432,2020-08,2645.79,3069.16,3004.95,1545.85,1035.73,8129.25
456198117041242432,2020-09,987.99,4187.21,1247.16,401.33,-2353.39,5775.86
456198117041242432,2020-10,7337.46,1694.16,1958.56,2831.46,4770.4,10546.26
456198117041242432,2020-11,5017.12,5289.97,4031.12,6657.52,-2899.25,7647.01
456198117041242432,2020-12,1963.59,3635.69,2906.25,3360.08,-2125.93,5521.08
456340759779260928,2020-01,7080.13,1188.15,4483.24,3481.64,6893.58,6893.58
456340759779260928,2020-02,5588.65,6175.32,2426.09,2437.54,-598.12,6295.46
456340759779260928,2020-03,3889.1,3482.74,2735.82,9298.59,-6156.41,139.05
456340759779260928,2020-04,7746.02,3452.79,1797.29,4190.08,1900.44,2039.49
456340759779260928,2020-05,3288.12,5093.82,3469.42,4864.22,-3200.5,-1161.01
456340759779260928,2020-06,2800.01,5485.31,4275,4884.49,-3294.79,-4455.8
456340759779260928,2020-07,3325.34,3458.52,12107.22,2532.22,9441.82,4986.02
456340759779260928,2020-08,3059.84,6667.87,6080.65,3799.97,-1327.35,3658.67
456340759779260928,2020-09,2543.26,4894.42,5636.15,3341.4,-56.41,3602.26
456340759779260928,2020-10,4434.19,1298.53,6302.91,7582.8,1855.77,5458.03
456340759779260928,2020-11,7979.23,3414.72,2259.44,5089.81,1734.14,7192.17
456340759779260928,2020-12,6328.3,6646.05,3146.06,5226.34,-2398.03,4794.14
457412174407469120,2020-01,4340.96,135.5,0,0,4205.46,4205.46
457412174407469120,2020-02,804.74,2346.41,0,1100.65,-2642.32,1563.14
457412174407469120,2020-03,2497.39,3209.52,0,0,-712.13,851.01
457412174407469120,2020-04,1237.85,1869.2,3226.57,0,2595.22,3446.23
457412174407469120,2020-05,3984.99,3592.89,2419.29,101.16,2710.23,6156.46
457412174407469120,2020-07,1681.95,705.2,3692.77,3222.71,1446.81,7603.27
457412174407469120,2020-08,0,1676.33,465.28,1221.3,-2432.35,5170.92
457412174407469120,2020-10,3649.04,3544.25,1084.78,153.26,1036.31,6207.23
457412174407469120,2020-11,2726.35,1663.82,1849.84,1448.29,1464.08,7671.31
457412174407469120,2020-12,1477.39,1005.43,4664.14,2575.26,2560.84,10232.15
457706392270057920,2020-01,3495.13,3114.61,4349.05,5782.53,-1052.96,-1052.96
457706392270057920,2020-02,3518.8,889.68,3711.36,6140.31,200.17,-852.79
457706392270057920,2020-03,4153.92,3029.96,951.28,4450.71,-2375.47,-3228.26
457706392270057920,2020-04,5298.2,2955.62,1589.63,1884.89,2047.32,-1180.94
457706392270057920,2020-05,2186.47,3560.68,10291.97,6440.29,2477.47,1296.53
457706392270057920,2020-06,3585.68,3036.22,3005.31,6851.65,-3296.88,-2000.35
457706392270057920,2020-07,5916.16,3960.06,5939.56,2744.64,5151.02,3150.67
457706392270057920,2020-08,5010.03,6425.7,6729.42,7279.2,-1965.45,1185.22
457706392270057920,2020-09,5828.02,4507.83,5017.72,2485.92,3851.99,5037.21
457706392270057920,2020-10,6052.46,4128.47,6588.81,1411.44,7101.36,12138.57
457706392270057920,2020-11,4528.32,5908.69,5714.8,1248.14,3086.29,15224.86
457706392270057920,2020-12,525.11,1822.35,1320.5,4062.55,-4039.29,11185.57
457890766052440192,2020-01,3911.9,2818.43,2482.79,5201.3,-1625.04,-1625.04
457890766052440192,2020-02,0,2702.22,1986.99,2785.55,-3500.78,-5125.82
457890766052440192,2020-03,5979.71,3460.48,3561.83,4535.32,1545.74,-3580.08
457890766052440192,2020-04,3992.37,1589.33,3481.99,0,5885.03,2304.95
457890766052440192,2020-05,4892.96,5668.35,3695.83,6135.14,-3214.7,-909.75
457890766052440192,2020-06,3699.42,1735.24,6361.26,5900.57,2424.87,1515.12
457890766052440192,2020-07,5113.63,5793.38,7383.02,1202.2,5501.07,7016.19
457890766052440192,2020-08,534.62,2166.26,2844.24,726.09,486.51,7502.7
457890766052440192,2020-09,5867.3,6217.44,2932.47,1830.42,751.91,8254.61
457890766052440192,2020-10,4129.45,3163.85,0,2840.97,-1875.37,6379.24
457890766052440192,2020-11,1057.48,1319.98,4693.37,6053.11,-1622.24,4757
457890766052440192,2020-12,0,4116.66,1727.02,11440.3,-13829.94,-9072.94
460510105596125760,2020-01,3820.25,4960.92,353.74,4982.44,-5769.37,-5769.37
460510105596125760,2020-02,3317.64,2053.22,9590.77,5075.27,5779.92,10.55
460510105596125760,2020-03,5474.43,3953,8385.87,4845.39,5061.91,5072.46
460510105596125760,2020-04,2326.41,4412.27,7766.52,4719.23,961.43,6033.89
460510105596125760,2020-05,4519.03,6077.08,9891.47,10181.96,-1848.54,4185.35
460510105596125760,2020-06,6688.54,4445.61,6761.67,3962.04,5042.56,9227.91
460510105596125760,2020-07,2278.17,4134.45,2436.39,0,580.11,9808.02
460510105596125760,2020-08,8268.53,4880.6,4527.87,2889.47,5026.33,14834.35
460510105596125760,2020-09,4361.89,197.93,3237.16,4050.67,3350.45,18184.8
460510105596125760,2020-10,3582.5,3962.85,3490.66,2091,1019.31,19204.11
460510105596125760,2020-11,4188.87,950.04,4150.28,8245.67,-856.56,18347.55
460510105596125760,2020-12,8000.37,6068.81,1357.77,3720.24,-430.91,17916.64
461303356195103040,2020-01,0,1535.09,3089.2,0,1554.11,1554.11
461303356195103040,2020-02,516.87,0,1689.1,965.1,1240.87,2794.98
461303356195103040,2020-03,1539.85,2647.18,1165.85,1167.33,-1108.81,1686.17
461303356195103040,2020-04,1139.56,1947.88,2675.14,908,958.82,2644.99
461303356195103040,2020-06,892.91,3796.22,0,1571.54,-4474.85,-1829.86
461303356195103040,2020-09,0,2505.29,1133.84,1262.93,-2634.38,-4464.24
461303356195103040,2020-10,4806.11,1168.82,1619.19,0,5256.48,792.24
461303356195103040,2020-11,1594.25,378.41,0,0,1215.84,2008.08
461303356195103040,2020-12,1585.55,0,798.48,1054.71,1329.32,3337.4
461730093534546112,2020-02,0,174.37,0,0,-174.37,-174.37
461730093534546112,2020-04,0,787.69,0,0,-787.69,-962.06
461730093534546112,2020-07,1882.58,0,0,0,1882.58,920.52
461730093534546112,2020-12,0,754.86,1775.05,0,1020.19,1940.71
461750588906382400,2020-01,1966.64,3921.28,2579.08,286.05,338.39,338.39
461750588906382400,2020-02,2559.54,2390.67,1847.72,1111.08,905.51,1243.9
461750588906382400,2020-03,4408.35,1976.54,4792.07,5470.44,1753.44,2997.34
461750588906382400,2020-04,4083.07,136.93,1519.08,1981.06,3484.16,6481.5
461750588906382400,2020-05,662.24,1882.84,3553.7,1578.4,754.7,7236.2
461750588906382400,2020-06,2356.45,1908.74,2954.07,3368.05,33.73,7269.93
461750588906382400,2020-07,6822.56,549.03,4255.81,1822.47,8706.87,15976.8
461750588906382400,2020-08,3693.92,0,1672.86,2668.03,2698.75,18675.55
461750588906382400,2020-09,924.46,2755.94,1704.86,2245.01,-2371.63,16303.92
461750588906382400,2020-10,3891.54,2244.19,3100.17,0,4747.52,21051.44
461750588906382400,2020-11,1735.14,299.57,4395.34,0,5830.91,26882.35
461750588906382400,2020-12,181.38,1413.37,679.56,1443.86,-1996.29,24886.06
463042216825710528,2020-01,2069.5,0,0,0,2069.5,2069.5
463042216825710528,2020-03,0,1421.72,0,277.76,-1699.48,370.02
463042216825710528,2020-04,0,1768.15,1063.2,0,-704.95,-334.93
463042216825710528,2020-05,1424.47,1727.56,1711.01,0,1407.92,1072.99
463042216825710528,2020-06,91.65,105.13,0,0,-13.48,1059.51
463042216825710528,2020-07,0,1246,483.39,0,-762.61,296.9
463042216825710528,2020-08,0,1036.93,800.59,1982.85,-2219.19,-1922.29
463042216825710528,2020-09,2143.54,989.92,0,6216.11,-5062.49,-6984.78
463042216825710528,2020-10,3073.61,0,0,0,3073.61,-3911.17
463042216825710528,2020-11,1791.82,1811.37,1272.05,334.12,918.38,-2992.79
463042216825710528,2020-12,1158.96,1932.06,0,3172.93,-3946.03,-6938.82
463142348237778304,2020-01,0,2617.7,8006.45,441.93,4946.82,4946.82
463142348237778304,2020-02,1886.36,1160.73,2717.03,1292.68,2149.98,7096.8
463142348237778304,2020-03,0,3430.33,0,901.97,-4332.3,2764.5
463142348237778304,2020-05,2.57,0,2456.69,0,2459.26,5223.76
463142348237778304,2020-06,1296.03,1970.76,1124.68,1941.62,-1491.67,3732.09
463142348237778304,2020-07,1665.63,3390.5,0,1029.1,-2753.97,978.12
463142348237778304,2020-08,4083.35,3395.62,1304.52,2214.75,-222.5,755.62
463142348237778304,2020-09,0,101.68,2427.72,1751.04,575,1330.62
463142348237778304,2020-10,625.82,0,1248.42,1141.07,733.17,2063.79
463142348237778304,2020-11,2929.53,1348.53,0,0,1581,3644.79
463142348237778304,2020-12,0,417.91,979.23,3264.52,-2703.2,941.59
463356822853100864,2020-02,1682.94,3098.12,0,122.55,-1537.73,-1537.73
463356822853100864,2020-03,896.82,2638.35,0,0,-1741.53,-3279.26
463356822853100864,2020-04,1337.09,1437.57,0,0,-100.48,-3379.74
463356822853100864,2020-05,5111.45,0,1003.22,0,6114.67,2734.93
463356822853100864,2020-06,364.13,1988.44,3453.69,1661.72,167.66,2902.59
463356822853100864,2020-07,0,1020.3,0,1477.22,-2497.52,405.07
463356822853100864,2020-08,2317.3,0,24.04,0,2341.34,2746.41
463356822853100864,2020-09,1935.62,258.5,5051.1,429.88,6298.34,9044.75
463356822853100864,2020-10,2071.97,0,0,1933.8,138.17,9182.92
463356822853100864,2020-11,0,669.94,76.42,1834.49,-2428.01,6754.91
463356822853100864,2020-12,1763.16,3448.02,3034.81,0,1349.95,8104.86
463388652110339648,2020-01,4265.3,2457.68,3250.45,2973.28,2084.79,2084.79
463388652110339648,2020-02,954.1,3638.47,0,1189.16,-3873.53,-1788.74
463388652110339648,2020-03,3809.97,445.06,2360.84,5720.97,4.78,-1783.96
463388652110339648,2020-04,3959.96,3849.01,5881.62,1249.08,4743.49,2959.53
463388652110339648,2020-05,4450.28,0,2448.38,1787.83,5110.83,8070.36
463388652110339648,2020-06,3904.77,6791.93,1825.07,1612.75,-2674.84,5395.52
463388652110339648,2020-07,5233.2,2879.98,0,1048.75,1304.47,6699.99
463388652110339648,2020-08,2668.32,4352.34,1849.82,1501.61,-1335.81,5364.18
463388652110339648,2020-09,2372.38,3783.09,897.01,2700.33,-3214.03,2150.15
463388652110339648,2020-10,0,2603.63,2228.39,0,-375.24,1774.91
463388652110339648,2020-11,697.31,3836.37,5742.15,1073.33,1529.76,3304.67
463388652110339648,2020-12,1306.39,4257.73,1011.07,2738.67,-4678.94,-1374.27
463391308107212288,2020-01,11245.09,3339.76,7800.2,2952.23,12753.3,12753.3
463391308107212288,2020-02,6171.21,2314.03,5957.73,2731.02,7083.89,19837.19
463391308107212288,2020-03,1180,1555.29,8531.67,1951.29,6205.09,26042.28
463391308107212288,2020-04,4971.54,4536.32,3940.77,1955.24,2420.75,28463.03
463391308107212288,2020-05,4811.94,3189.69,7529.69,2580.49,6571.45,35034.48
463391308107212288,2020-06,2817,1462.16,1495.03,3668.13,-818.26,34216.22
463391308107212288,2020-07,5907.3,524.09,911.26,3893.82,2400.65,36616.87
463391308107212288,2020-08,3121.83,4147.25,7041.15,6424.29,-408.56,36208.31
463391308107212288,2020-09,5734.2,6427.15,3448.24,1449.41,1305.88,37514.19
463391308107212288,2020-10,4004.86,2504.6,3307.49,2227.16,2580.59,40094.78
463391308107212288,2020-11,2473.63,1770.43,5042.03,6896.41,-1151.18,38943.6
463391308107212288,2020-12,8317.61,7747.36,4055.16,11199.64,-6574.23,32369.37
464265620102313408,2020-01,526.22,0,0,0,526.22,526.22
464265620102313408,2020-02,284.04,0,0,2998.37,-2714.33,-2188.11
464265620102313408,2020-03,0,6695.38,684.08,0,-6011.3,-8199.41
464265620102313408,2020-05,0,894.34,0,1434.36,-2328.7,-10528.11
464265620102313408,2020-06,5421.85,4993.93,1685.75,1893.41,220.26,-10307.85
464265620102313408,2020-07,1869.19,1041.84,0,1818.38,-991.03,-11298.88
464265620102313408,2020-08,1987.97,0,0,2364.38,-376.41,-11675.29
464265620102313408,2020-09,2302.02,3766.51,0,1430.32,-2894.81,-14570.1
464265620102313408,2020-10,670.16,118.23,3974.84,2995.63,1531.14,-13038.96
464265620102313408,2020-11,0,114.72,0,1809.87,-1924.59,-14963.55
464265620102313408,2020-12,0,1558.45,2358.27,0,799.82,-14163.73
464598086313932416,2020-01,4880.75,1827.12,4012.09,3688.46,3377.26,3377.26
464598086313932416,2020-02,7673.74,1325.52,1430.06,1367.74,6410.54,9787.8
464598086313932416,2020-03,6257.61,4219.43,3186.63,3805.05,1419.76,11207.56
464598086313932416,2020-04,1198.84,1838.1,3860.05,0,3220.79,14428.35
464598086313932416,2020-05,394.94,4241.67,1021.27,565.51,-3390.97,11037.38
464598086313932416,2020-06,2733.07,4048.01,5288.8,1782.05,2191.81,13229.19
464598086313932416,2020-07,7297.84,3366.8,2219.07,6950.39,-800.28,12428.91
464598086313932416,2020-08,3432.96,3546.16,8017.28,2492.29,5411.79,17840.7
464598086313932416,2020-09,1823.58,692.01,3933.75,5597.85,-532.53,17308.17
464598086313932416,2020-10,3204.07,349.21,1881.37,4544.54,191.69,17499.86
464598086313932416,2020-11,5805.02,3777.6,469.16,2614.54,-117.96,17381.9
464598086313932416,2020-12,7353.1,5354.65,2806.44,1157.53,3647.36,21029.26
464928299544422656,2020-01,3178.34,4379.24,2549.33,1672.03,-323.6,-323.6
464928299544422656,2020-02,3582.21,2439.73,0,931.05,211.43,-112.17
464928299544422656,2020-03,0,795.09,0,1408.07,-2203.16,-2315.33
464928299544422656,2020-04,400.8,1884.95,1483.56,0,-0.59,-2315.92
464928299544422656,2020-05,699.19,557.51,59.74,582.93,-381.51,-2697.43
464928299544422656,2020-06,1183.8,3281.46,3531.06,1610.14,-176.74,-2874.17
464928299544422656,2020-07,406.25,3260.78,2252.77,0,-601.76,-3475.93
464928299544422656,2020-08,1429.24,5141.69,391.34,2633.77,-5954.88,-9430.81
464928299544422656,2020-09,1418.7,2541.22,1391.46,5175.56,-4906.62,-14337.43
464928299544422656,2020-10,2771.02,713.26,513.68,3263.41,-691.97,-15029.4
464928299544422656,2020-11,0,3413.96,2186.92,801.44,-2028.48,-17057.88
464928299544422656,2020-12,632.5,2999.92,2461.39,1802.34,-1708.37,-18766.25
465964332153014592,2020-01,9897.87,4340.27,2812.6,3539.61,4830.59,4830.59
465964332153014592,2020-02,4387.71,7001.82,2557.79,4278.39,-4334.71,495.88
465964332153014592,2020-03,6050.03,6352.38,7270.93,1456.08,5512.5,6008.38
465964332153014592,2020-04,6280.1,1962.81,2155.09,1955.72,4516.66,10525.04
465964332153014592,2020-05,2848.86,9712.47,2229.22,3258.7,-7893.09,2631.95
465964332153014592,2020-06,4398.61,3694.92,1080.74,2592.19,-807.76,1824.19
465964332153014592,2020-07,1910.23,7678.37,4921.18,3703.08,-4550.04,-2725.85
465964332153014592,2020-08,5881.53,309.42,6038.68,4872.31,6738.48,4012.63
465964332153014592,2020-09,648.54,5291.27,3506.2,977.05,-2113.58,1899.05
465964332153014592,2020-10,2149.77,5176.71,6019.39,6880.46,-3888.01,-1988.96
465964332153014592,2020-11,6324.48,2838.83,3859.17,1912.07,5432.75,3443.79
465964332153014592,2020-12,2651.08,5818.35,2925.96,7911.64,-8152.95,-4709.16
466234024393299904,2020-02,1884.07,0,0,0,1884.07,1884.07
466234024393299904,2020-12,509.14,0,0,0,509.14,2393.21
466649984890243968,2020-01,1129.7,2675.07,5232.9,625.19,3062.34,3062.34
466649984890243968,2020-03,1200.88,7304.41,2708.95,3038.44,-6433.02,-3370.68
466649984890243968,2020-04,4288.22,6437.89,2228,2407.37,-2329.04,-5699.72
466649984890243968,2020-05,5254.18,5710.5,9802.76,8497.04,849.4,-4850.32
466649984890243968,2020-06,1894.49,5151.6,1899.03,1305.74,-2663.82,-7514.14
466649984890243968,2020-07,5067.32,1320.96,4992.8,5870.95,2868.21,-4645.93
466649984890243968,2020-08,9400.24,2656.76,1976.9,461.73,8258.65,3612.72
466649984890243968,2020-09,3459.36,1993.99,5659.79,338.53,6786.63,10399.35
466649984890243968,2020-10,6795.46,5218.03,6588.23,4972.29,3193.37,13592.72
466649984890243968,2020-11,1930.66,2890.89,7925.56,0,6965.33,20558.05
466649984890243968,2020-12,3620.26,2590.94,2634.55,2703.57,960.3,21518.35
467289092237656384,2020-01,3895.33,0,1941.12,991.25,4845.2,4845.2
467289092237656384,2020-02,0,756.69,1037.59,814.33,-533.43,4311.77
467289092237656384,2020-03,842.22,2930.92,2688.09,1099.34,-499.95,3811.82
467289092237656384,2020-04,2963.43,466.52,0,1557.77,939.14,4750.96
467289092237656384,2020-05,748.9,3218.3,0,2059.49,-4528.89,222.07
467289092237656384,2020-06,4303.35,5142.15,0,3226.17,-4064.97,-3842.9
467289092237656384,2020-07,892.65,894.86,419.22,370.31,46.7,-3796.2
467289092237656384,2020-08,1894.73,0,1209.26,0,3103.99,-692.21
467289092237656384,2020-09,2190.06,0,968.22,1946.4,1211.88,519.67
467289092237656384,2020-10,0,2881.83,816.74,1593.74,-3658.83,-3139.16
467289092237656384,2020-11,1789.92,0,53.89,537.99,1305.82,-1833.34
467289092237656384,2020-12,0,1719.46,3055.71,663.73,672.52,-1160.82
467657554521931904,2020-01,1520.42,2302.84,744.25,2043.93,-2082.1,-2082.1
467657554521931904,2020-02,1877.57,1679.29,743.5,726.76,215.02,-1867.08
467657554521931904,2020-03,3311.57,27.52,225.42,5063.86,-1554.39,-3421.47
467657554521931904,2020-04,3750.75,2390.82,5527.89,1917.51,4970.31,1548.84
467657554521931904,2020-05,3909.38,3534.28,188.74,3934.83,-3370.99,-1822.15
467657554521931904,2020-06,4256.05,1334.62,4868.21,613.23,7176.41,5354.26
467657554521931904,2020-07,2286.73,0,3196.06,3075.33,2407.46,7761.72
467657554521931904,2020-08,3987.35,2727.33,3344.11,1972.22,2631.91,10393.63
467657554521931904,2020-09,1804.76,3336.29,2792.67,3860.02,-2598.88,7794.75
467657554521931904,2020-10,5674.86,3590.16,1386.72,6035.2,-2563.78,5230.97
467657554521931904,2020-11,2467.01,1313.01,2756.67,1582.38,2328.29,7559.26
467657554521931904,2020-12,2078.87,775.64,2470.49,436.23,3337.49,10896.75
468991284061887488,2020-01,7421.52,4534.55,3310.28,5580.15,617.1,617.1
468991284061887488,2020-02,3373.26,2483.12,2261.62,3049.28,102.48,719.58
468991284061887488,2020-03,3262.1,6259.92,3382.93,494.11,-109,610.58
468991284061887488,2020-04,10692.64,3181.57,1637.64,5091.12,4057.59,4668.17
468991284061887488,2020-05,4687.19,4588.71,4949.83,5701.17,-652.86,4015.31
468991284061887488,2020-06,4363.47,2594.23,2505.5,5110.46,-835.72,3179.59
468991284061887488,2020-07,5827.25,7335.22,2723.31,3350.63,-2135.29,1044.3
468991284061887488,2020-08,3098.94,4329.17,1046.9,2612.27,-2795.6,-1751.3
468991284061887488,2020-09,4060.59,4601.05,7264.39,3038.01,3685.92,1934.62
468991284061887488,2020-10,4073.27,3791.88,4043.93,6315.92,-1990.6,-55.98
468991284061887488,2020-11,1268.7,4624.59,6876.7,4856.21,-1335.4,-1391.38
468991284061887488,2020-12,2483.38,1422.67,5460.63,4367.84,2153.5,762.12
469377369894005696,2020-01,4649.75,5222.39,2473.68,5605.79,-3704.75,-3704.75
469377369894005696,2020-02,1745.41,847.42,1118.05,1596.58,419.46,-3285.29
469377369894005696,2020-03,4111.13,3141.62,5066.07,5399.97,635.61,-2649.68
469377369894005696,2020-04,0,4527.2,1183.28,1870.13,-5214.05,-7863.73
469377369894005696,2020-05,3373.35,4791.71,2074.18,3787.59,-3131.77,-10995.5
469377369894005696,2020-06,3176.97,4427.02,4024.18,1978.4,795.73,-10199.77
469377369894005696,2020-07,3619.46,2928.14,3895.15,3660.54,925.93,-9273.84
469377369894005696,2020-08,1397.17,2508.92,195.48,9835.35,-10751.62,-20025.46
469377369894005696,2020-09,4376.49,3591.56,4497.34,6307.37,-1025.1,-21050.56
469377369894005696,2020-10,2294.23,7505.42,4597.16,8269.97,-8884,-29934.56
469377369894005696,2020-11,2553.59,2460.21,7937.19,2496.09,5534.48,-24400.08
469377369894005696,2020-12,1260.32,757.91,2568.94,6027.91,-2956.56,-27356.64
471840685634785664,2020-01,451.26,990.58,0,1387.39,-1926.71,-1926.71
471840685634785664,2020-02,2536.22,583.93,1854.3,0,3806.59,1879.88
471840685634785664,2020-03,0,136.17,1572.98,936.72,500.09,2379.97
471840685634785664,2020-04,483.27,1627.35,249.06,1679.18,-2574.2,-194.23
471840685634785664,2020-05,1057.35,1419.6,913.7,4960.73,-4409.28,-4603.51
471840685634785664,2020-06,247.9,0,596.13,0,844.03,-3759.48
471840685634785664,2020-08,798.6,60.04,1873.31,1368.59,1243.28,-2516.2
471840685634785664,2020-09,1120.47,1137.69,470.76,0,453.54,-2062.66
471840685634785664,2020-10,2847.16,0,4968.18,0,7815.34,5752.68
471840685634785664,2020-12,1268.46,1813.76,30,72.27,-587.57,5165.11
472680632163447808,2020-04,0,236.93,828.86,0,591.93,591.93
472680632163447808,2020-06,1126.64,0,0,0,1126.64,1718.57
472680632163447808,2020-08,0,1771.5,0,0,-1771.5,-52.93
472680632163447808,2020-10,678.87,0,2847.16,0,3526.03,3473.1
472680632163447808,2020-11,1743.14,39.56,0,0,1703.58,5176.68
474312582245913216,2020-01,1024.56,306.6,850.98,0,1568.94,1568.94
474312582245913216,2020-03,1591.98,0,1417.72,0,3009.7,4578.64
474312582245913216,2020-04,92.33,1238.65,894.55,0,-251.77,4326.87
474312582245913216,2020-07,601.07,0,0,1048.57,-447.5,3879.37
474312582245913216,2020-08,1065.28,0,0,0,1065.28,4944.65
474312582245913216,2020-10,0,279.93,281.03,0,1.1,4945.75
475110233761515776,2020-01,5017.71,2727.87,1815.81,5820.02,-1714.37,-1714.37
475110233761515776,2020-02,9741.92,5632.09,5296.21,2198.53,7207.51,5493.14
475110233761515776,2020-03,8497.94,3729.71,8556.67,3881.14,9443.76,14936.9
475110233761515776,2020-04,5482.85,6215.89,5940.18,3956.84,1250.3,16187.2
475110233761515776,2020-05,7419.92,4180.93,3422.11,1067.64,5593.46,21780.66
475110233761515776,2020-06,2220.61,3961.23,3810.72,2145.79,-75.69,21704.97
475110233761515776,2020-07,3318.99,7000.25,9725.95,3078.99,2965.7,24670.67
475110233761515776,2020-08,1224.51,8402.28,4175.19,3192.61,-6195.19,18475.48
475110233761515776,2020-09,3463.84,6551.07,1096.02,5015.32,-7006.53,11468.95
475110233761515776,2020-10,7733.09,4522.9,5004.49,7524.19,690.49,12159.44
475110233761515776,2020-11,4861.91,4600.69,5359.52,6034.61,-413.87,11745.57
475110233761515776,2020-12,3851.27,5291.18,1898.37,9760.47,-9302.01,2443.56
475383975227229120,2020-01,785.51,5400.75,8292.58,4818.06,-1140.72,-1140.72
475383975227229120,2020-02,2522.17,1180.21,3461.67,2629.14,2174.49,1033.77
475383975227229120,2020-03,3177.4,4711.67,1172.81,3029.47,-3390.93,-2357.16
475383975227229120,2020-04,0,7702.21,1367.66,3394.03,-9728.58,-12085.74
475383975227229120,2020-05,3449.3,2751.7,4639.9,1076.26,4261.24,-7824.5
475383975227229120,2020-06,1949.29,4228.28,1364.6,6515.03,-7429.42,-15253.92
475383975227229120,2020-07,4084.64,6890.13,3956.04,4548.46,-3397.91,-18651.83
475383975227229120,2020-08,5784.83,4664.67,5224.88,2816.49,3528.55,-15123.28
475383975227229120,2020-09,2442.61,5663.63,3289.78,5865.32,-5796.56,-20919.84
475383975227229120,2020-10,3586.12,1806.01,3392.2,1888.11,3284.2,-17635.64
475383975227229120,2020-11,4732.49,7152.89,4316.43,6567.29,-4671.26,-22306.9
475383975227229120,2020-12,1948.18,0,6421.04,4113.59,4255.63,-18051.27
476341108299686592,2020-01,3979.68,4483.12,502.13,4250.5,-4251.81,-4251.81
476341108299686592,2020-02,0,4907.83,6933.48,3056.51,-1030.86,-5282.67
476341108299686592,2020-03,6524.15,6788.51,7050.23,4826.04,1959.83,-3322.84
476341108299686592,2020-04,3247.61,4434.29,6384.04,3813.9,1383.46,-1939.38
476341108299686592,2020-05,5286.33,1445.06,2298.06,3898.8,2240.53,301.15
476341108299686592,2020-06,4979.83,5553.71,5247.28,4204.71,468.69,769.84
476341108299686592,2020-07,1366.24,8909.27,2763.94,3048.8,-7827.89,-7058.05
476341108299686592,2020-08,2033.57,8857.58,3420.51,2932.55,-6336.05,-13394.1
476341108299686592,2020-09,7284.52,3135.83,5478.01,2732.42,6894.28,-6499.82
476341108299686592,2020-10,2133.74,1460.15,4443.23,0,5116.82,-1383
476341108299686592,2020-11,2460.41,3541.43,3432.24,4686.79,-2335.57,-3718.57
476341108299686592,2020-12,1746.52,5108.29,3237.98,2552.21,-2676,-6394.57
479029441649650560,2020-01,3653.42,1930.79,1798.98,4669.43,-1147.82,-1147.82
479029441649650560,2020-02,0,773.79,0,2922.74,-3696.53,-4844.35
479029441649650560,2020-03,731.19,1036.25,2393.54,0,2088.48,-2755.87
479029441649650560,2020-04,2779.43,4821.29,1787.89,1785.76,-2039.73,-4795.6
479029441649650560,2020-05,6308.42,2055.21,1734.16,1892.24,4095.13,-700.47
479029441649650560,2020-06,0,2507.25,3177.86,3097.27,-2426.66,-3127.13
479029441649650560,2020-07,2619.45,609.5,1793.16,2545.37,1257.74,-1869.39
479029441649650560,2020-08,5039.46,1557,4225.8,1485.6,6222.66,4353.27
479029441649650560,2020-09,2773.28,2249.19,1687.06,1272.56,938.59,5291.86
479029441649650560,2020-10,3108.84,1632.4,2523.41,2179.34,1820.51,7112.37
479029441649650560,2020-11,1908.49,2892.09,4061.23,4691.85,-1614.22,5498.15
479029441649650560,2020-12,2422.76,7117.19,1007.03,3299.33,-6986.73,-1488.58
480252855561935616,2020-01,0,1901.07,0,121.74,-2022.81,-2022.81
480252855561935616,2020-02,0,863.89,2899.64,1865.52,170.23,-1852.58
480252855561935616,2020-03,1845.63,473.52,1937.62,604.07,2705.66,853.08
480252855561935616,2020-04,1737.04,0,1768.78,0,3505.82,4358.9
480252855561935616,2020-05,2158.35,2624.09,0,1256.44,-1722.18,2636.72
480252855561935616,2020-06,1958.04,674.77,1259.86,1360.52,1182.61,3819.33
480252855561935616,2020-07,2988.16,1449.38,0,0,1538.78,5358.11
480252855561935616,2020-10,0,1871.97,705.26,359.28,-1525.99,3832.12
480252855561935616,2020-11,4055.42,2413.48,0,853.13,788.81,4620.93
480263381205378176,2020-01,6577.08,2911.01,3067.62,3494.57,3239.12,3239.12
480263381205378176,2020-02,8797.23,1529.72,4224.4,9258.9,2233.01,5472.13
480263381205378176,2020-03,1593.91,2899.59,6806.62,1266.52,4234.42,9706.55
480263381205378176,2020-04,3474.46,4056.7,2464.82,2915.22,-1032.64,8673.91
480263381205378176,2020-05,2669.66,5192.31,6060.33,6905.82,-3368.14,5305.77
480263381205378176,2020-06,617.37,8617.55,4386.45,8650.82,-12264.55,-6958.78
480263381205378176,2020-07,5569.34,6198.1,5337.24,1609.96,3098.52,-3860.26
480263381205378176,2020-08,3389.74,2517.53,3344.65,5968.3,-1751.44,-5611.7
480263381205378176,2020-09,2245.48,4882.11,3920.84,5655.63,-4371.42,-9983.12
480263381205378176,2020-10,665.95,5620.24,5563.84,9839.62,-9230.07,-19213.19
480263381205378176,2020-11,2901.18,3512.34,1314.67,8937.16,-8233.65,-27446.84
480263381205378176,2020-12,1172.9,3682.52,1287.42,2551.72,-3773.92,-31220.76
480711292502291200,2020-01,4342.55,3050.56,4808.88,8336.75,-2235.88,-2235.88
480711292502291200,2020-02,4298.83,1024.9,2265.53,1027.05,4512.41,2276.53
480711292502291200,2020-03,641.83,5729.58,1907.01,10673.83,-13854.57,-11578.04
480711292502291200,2020-04,5599.73,3918.84,5538.14,3183.53,4035.5,-7542.54
480711292502291200,2020-05,5740.12,1461.73,4731.08,5755.99,3253.48,-4289.06
480711292502291200,2020-06,1981.67,2578.54,8605.84,2139.96,5869.01,1579.95
480711292502291200,2020-07,1913.22,6074.81,5015.2,5526.74,-4673.13,-3093.18
480711292502291200,2020-08,4762.03,6343.28,6001.57,3107.19,1313.13,-1780.05
480711292502291200,2020-09,2407.88,5647.34,6241.54,2723.92,278.16,-1501.89
480711292502291200,2020-10,4084.33,3871.85,5125.19,3739.52,1598.15,96.26
480711292502291200,2020-11,3471.76,3119.11,3446.55,1715.04,2084.16,2180.42
480711292502291200,2020-12,5658.69,3202.64,4397.7,3354.92,3498.83,5679.25
483450587153391296,2020-01,1650.01,2303.66,0,0,-653.65,-653.65
483450587153391296,2020-02,210.26,1788.71,3359.59,0,1781.14,1127.49
483450587153391296,2020-03,1987.61,0,0,2526.34,-538.73,588.76
483450587153391296,2020-04,0,3567.68,985.11,788.39,-3370.96,-2782.2
483450587153391296,2020-05,5439.47,0,15.36,0,5454.83,2672.63
483450587153391296,2020-06,1928.48,510.22,0,0,1418.26,4090.89
483450587153391296,2020-07,1969.47,2507.16,1396.08,1747.75,-889.36,3201.53
483450587153391296,2020-08,0,1140.87,0,0,-1140.87,2060.66
483450587153391296,2020-09,4623.21,0,0,0,4623.21,6683.87
483450587153391296,2020-10,1333.59,4209.04,0,985.93,-3861.38,2822.49
483450587153391296,2020-11,0,1113.25,0,2995.01,-4108.26,-1285.77
483450587153391296,2020-12,3430.94,1210.62,717.56,2782.27,155.61,-1130.16
483890061473658432,2020-01,7976,6049.07,4524.54,4109.36,2342.11,2342.11
483890061473658432,2020-02,4608.33,7646.85,2100.55,2650.15,-3588.12,-1246.01
483890061473658432,2020-03,3278.99,6387.57,5144.61,6327.12,-4291.09,-5537.1
483890061473658432,2020-04,4752.36,8182.63,2644.69,2354.87,-3140.45,-8677.55
483890061473658432,2020-05,3305.13,1305.44,1983.44,2754.23,1228.9,-7448.65
483890061473658432,2020-06,4904.11,6278.39,908.84,2807.87,-3273.31,-10721.96
483890061473658432,2020-07,5250.43,2529.24,3885.21,6340.87,265.53,-10456.43
483890061473658432,2020-08,6868.99,5391,949.56,1568.51,859.04,-9597.39
483890061473658432,2020-09,4593.51,2632.8,1091.81,1586.38,1466.14,-8131.25
483890061473658432,2020-10,1675.52,0,11943.42,5922.68,7696.26,-434.99
483890061473658432,2020-11,3704.49,111.42,0,1106.98,2486.09,2051.1
483890061473658432,2020-12,1016.61,3689.8,3078.73,230.76,174.78,2225.88
484055737510499584,2020-02,3037.34,608.43,0,0,2428.91,2428.91
484055737510499584,2020-03,1941.62,0,1844.63,2868.87,917.38,3346.29
484055737510499584,2020-04,427.5,314.27,1798.98,0,1912.21,5258.5
484055737510499584,2020-05,2145.61,385.09,2787.81,0,4548.33,9806.83
484055737510499584,2020-06,0,1669.29,1898.24,0,228.95,10035.78
484055737510499584,2020-07,843.36,0,3240.64,4832.05,-748.05,9287.73
484055737510499584,2020-08,418.79,1498.9,389.06,1292.89,-1983.94,7303.79
484055737510499584,2020-09,0,3360.21,2329.08,3108.86,-4139.99,3163.8
484055737510499584,2020-10,1456.54,564.63,5499.32,1717.08,4674.15,7837.95
484055737510499584,2020-11,0,261.75,2800.01,0,2538.26,10376.21
484055737510499584,2020-12,1348.48,0,0,1844.45,-495.97,9880.24
484800659326387392,2020-01,826.23,2913.1,2237.42,1201.95,-1051.4,-1051.4
484800659326387392,2020-02,194.86,566.2,212.82,467.87,-626.39,-1677.79
484800659326387392,2020-03,723.05,3619.41,0,3494.07,-6390.43,-8068.22
484800659326387392,2020-04,0,1639.79,1099.43,0,-540.36,-8608.58
484800659326387392,2020-05,3130.41,0,3428.04,138.47,6419.98,-2188.6
484800659326387392,2020-07,1454.89,628.93,1836.67,2479.69,182.94,-2005.66
484800659326387392,2020-08,4368.93,4191.61,1287.13,0,1464.45,-541.21
484800659326387392,2020-09,2726.89,0,2911.02,1271.6,4366.31,3825.1
484800659326387392,2020-10,1270.76,0,530.55,0,1801.31,5626.41
484800659326387392,2020-11,473.03,2065.53,2468.68,1987.39,-1111.21,4515.2
484800659326387392,2020-12,2696.88,2716.69,5837.81,1847.09,3970.91,8486.11
485071695727347136,2020-01,0,1920.3,68.92,403.17,-2254.55,-2254.55
485071695727347136,2020-02,1763.3,3931.67,2390.68,42.81,179.5,-2075.05
485071695727347136,2020-03,0,211.76,1296.58,1462.95,-378.13,-2453.18
485071695727347136,2020-04,0,1179.33,0,1127.05,-2306.38,-4759.56
485071695727347136,2020-05,679.59,1554.83,0,0,-875.24,-5634.8
485071695727347136,2020-06,3317.17,3298.55,967.35,0,985.97,-4648.83
485071695727347136,2020-07,5981.68,223.07,0,3541.9,2216.71,-2432.12
485071695727347136,2020-08,1398.86,0,1114.35,314.88,2198.33,-233.79
485071695727347136,2020-09,1854.14,0,1338.21,0,3192.35,2958.56
485071695727347136,2020-10,1722.77,443.97,853.49,0,2132.29,5090.85
485071695727347136,2020-11,0,3448.34,2625.09,2953.96,-3777.21,1313.64
485071695727347136,2020-12,3204.74,2560.16,690.65,461.86,873.37,2187.01
486580152509244992,2020-01,5503.96,4458.92,4149.54,3234.43,1960.15,1960.15
486580152509244992,2020-02,5398.93,1381.24,2022.6,2533.66,3506.63,5466.78
486580152509244992,2020-03,4192.43,2853.09,4781.57,4706.18,1414.73,6881.51
486580152509244992,2020-04,6703.36,2524.1,4729.83,466,8443.09,15324.6
486580152509244992,2020-05,4926.16,1654.59,2583.52,3806.55,2048.54,17373.14
486580152509244992,2020-06,8318.21,1462.79,189.37,3238.54,3806.25,21179.39
486580152509244992,2020-07,2298.78,2188.35,1203.24,3049.03,-1735.36,19444.03
486580152509244992,2020-08,6770.56,1244.97,5508.85,4968.61,6065.83,25509.86
486580152509244992,2020-09,5711.98,2271.33,1832.84,4768.14,505.35,26015.21
486580152509244992,2020-10,1676.05,1773.66,2831.03,1129.21,1604.21,27619.42
486580152509244992,2020-11,1152.41,9639.01,0,4348.38,-12834.98,14784.44
486580152509244992,2020-12,950.13,4618.84,2282.64,5802.73,-7188.8,7595.64
489391823384269376,2020-01,2260.27,4756.7,5125.42,3507.63,-878.64,-878.64
489391823384269376,2020-02,5058.41,2477.31,3648.13,4719.39,1509.84,631.2
489391823384269376,2020-03,2994.11,1585.73,1488.28,3840.91,-944.25,-313.05
489391823384269376,2020-04,6479.09,3138.94,6524.45,4380.52,5484.08,5171.03
489391823384269376,2020-05,4981.79,759.29,3696.48,3427.62,4491.36,9662.39
489391823384269376,2020-06,5225.88,3405.36,2679.82,4541.83,-41.49,9620.9
489391823384269376,2020-07,3537.03,5189.11,2909.8,3276.46,-2018.74,7602.16
489391823384269376,2020-08,1335.91,3627.44,6074.75,6058.05,-2274.83,5327.33
489391823384269376,2020-09,2411.21,2860.19,4275.78,2047.06,1779.74,7107.07
489391823384269376,2020-10,5889.9,0,3484.8,4287.95,5086.75,12193.82
489391823384269376,2020-11,2600.89,2786.48,128.96,5325.6,-5382.23,6811.59
489391823384269376,2020-12,3282.45,1872.86,4374.91,921.51,4862.99,11674.58
489969059427249152,2020-01,568.89,0,0,3999.49,-3430.6,-3430.6
489969059427249152,2020-02,2527.62,1563.57,157.82,948.38,173.49,-3257.11
489969059427249152,2020-03,1886.24,1951.43,1413.4,1799.95,-451.74,-3708.85
489969059427249152,2020-04,400.21,900.58,5055.59,1143.25,3411.97,-296.88
489969059427249152,2020-05,4697.67,0,1418.22,5263.17,852.72,555.84
489969059427249152,2020-06,2927.59,3487.23,932.46,495.6,-122.78,433.06
489969059427249152,2020-07,3277.24,3540.13,577.55,2509.08,-2194.42,-1761.36
489969059427249152,2020-08,726.57,912.44,7489.84,221.31,7082.66,5321.3
489969059427249152,2020-09,1147.9,3291.24,2812.46,2509.58,-1840.46,3480.84
489969059427249152,2020-10,1753.65,627.33,1078.85,7162.78,-4957.61,-1476.77
489969059427249152,2020-11,1974.2,2417.16,3412.32,4367.72,-1398.36,-2875.13
489969059427249152,2020-12,2580.32,275.99,1917.09,2085.35,2136.07,-739.06
490020028911978496,2020-01,6911.91,5981.69,5166.71,11303.93,-5207,-5207
490020028911978496,2020-02,4359.89,4840.86,4277.51,2823.63,972.91,-4234.09
490020028911978496,2020-03,5042.13,3170.75,2482.3,2323.14,2030.54,-2203.55
490020028911978496,2020-04,1983.71,6741.09,3928.68,4782.32,-5611.02,-7814.57
490020028911978496,2020-05,1616.05,3981.1,2614.04,2110.72,-1861.73,-9676.3
490020028911978496,2020-06,2931.69,7946.57,3142.73,4130.97,-6003.12,-15679.42
490020028911978496,2020-07,4081.72,3842.17,4740.43,1943.28,3036.7,-12642.72
490020028911978496,2020-08,6051.47,901.15,6740.21,1959.09,9931.44,-2711.28
490020028911978496,2020-09,4235.22,8874.21,1438.08,5255.9,-8456.81,-11168.09
490020028911978496,2020-10,2105.03,252.31,1595.36,9449.21,-6001.13,-17169.22
490020028911978496,2020-11,3710.24,4157.56,5712.71,4641.09,624.3,-16544.92
490020028911978496,2020-12,3060.06,2821.42,4683.05,3454.76,1466.93,-15077.99
490380431695332288,2020-01,1889.85,1024.12,2503.74,2990.72,378.75,378.75
490380431695332288,2020-02,4143.5,2877.33,3559.04,6316.24,-1491.03,-1112.28
490380431695332288,2020-03,1707.22,8093.41,6288.37,3970.59,-4068.41,-5180.69
490380431695332288,2020-04,7053.19,6108.32,1663.8,4805.8,-2197.13,-7377.82
490380431695332288,2020-05,2053.78,2546.45,5757.39,3856.52,1408.2,-5969.62
490380431695332288,2020-06,3102.6,3255.2,3680.95,4437.24,-908.89,-6878.51
490380431695332288,2020-07,1293.46,5834.37,2975.72,3664.54,-5229.73,-12108.24
490380431695332288,2020-08,5160.79,79.3,1655.33,2603.56,4133.26,-7974.98
490380431695332288,2020-09,6651.06,3609.97,2250.18,3786.52,1504.75,-6470.23
490380431695332288,2020-10,3303.91,2266.83,2198.8,347.92,2887.96,-3582.27
490380431695332288,2020-11,5494.32,1978.36,5325.25,2012.61,6828.6,3246.33
490380431695332288,2020-12,0,1004.99,6962.6,3142.56,2815.05,6061.38
492775528255108864,2020-04,1877.91,0,0,0,1877.91,1877.91
492775528255108864,2020-07,991.76,0,0,0,991.76,2869.67
492775528255108864,2020-10,1084.24,0,0,0,1084.24,3953.91
495018283064913280,2020-01,2664.08,707.54,0,1874.71,81.83,81.83
495018283064913280,2020-02,2457.27,0,3906.09,454.47,5908.89,5990.72
495018283064913280,2020-04,2970.87,0,1405.77,0,4376.64,10367.36
495018283064913280,2020-05,1896.7,5100.66,723.23,5037.23,-7517.96,2849.4
495018283064913280,2020-06,0,228.76,0,2234.21,-2462.97,386.43
495018283064913280,2020-07,0,1196.09,1791.73,4163.96,-3568.32,-3181.89
495018283064913280,2020-08,0,2831.42,4304.87,3529.43,-2055.98,-5237.87
495018283064913280,2020-09,1554.92,1980.15,1658.56,2285.57,-1052.24,-6290.11
495018283064913280,2020-10,2139.1,499.38,1705.79,2891.61,453.9,-5836.21
495018283064913280,2020-11,764.05,2182.54,947.66,0,-470.83,-6307.04
495018283064913280,2020-12,1264.47,0,5242.88,849.84,5657.51,-649.53
495089055546256960,2020-01,5045.28,2271.08,738.31,2944.64,567.87,567.87
495089055546256960,2020-02,4306.81,5357.56,291.26,447.37,-1206.86,-638.99
495089055546256960,2020-03,2951.66,1610.96,3066.09,1917.83,2488.96,1849.97
495089055546256960,2020-04,4544.42,1109.02,7107.58,1561.89,8981.09,10831.06
495089055546256960,2020-05,3063.86,4994.46,1183.25,395.49,-1142.84,9688.22
495089055546256960,2020-06,0,3547.02,3445.22,486.95,-588.75,9099.47
495089055546256960,2020-07,920.21,795.55,902.97,2191.18,-1163.55,7935.92
495089055546256960,2020-08,6297.92,6277.15,2206.48,2960.81,-733.56,7202.36
495089055546256960,2020-09,692.05,4224.14,0,921.2,-4453.29,2749.07
495089055546256960,2020-10,3495.56,1600.06,1280.33,1996.05,1179.78,3928.85
495089055546256960,2020-11,2667.89,1025.93,5134.05,2258.04,4517.97,8446.82
495089055546256960,2020-12,0,1963.61,0,943.05,-2906.66,5540.16
495357133580503360,2020-01,0,1214.89,496.7,45.26,-763.45,-763.45
495357133580503360,2020-02,1988.62,887.64,3130.42,886.64,3344.76,2581.31
495357133580503360,2020-04,0,976.39,3086.96,0,2110.57,4691.88
495357133580503360,2020-05,723.06,0,4519.06,3372.49,1869.63,6561.51
495357133580503360,2020-06,1966.36,0,0,568.48,1397.88,7959.39
495357133580503360,2020-07,0,1544.49,2146.53,0,602.04,8561.43
495357133580503360,2020-08,387.39,1971.01,1122.57,0,-461.05,8100.38
495357133580503360,2020-09,468.44,33.86,0,85.32,349.26,8449.64
495357133580503360,2020-10,1457.83,0,0,1940.29,-482.46,7967.18
495357133580503360,2020-11,1913.92,3453.73,0,0,-1539.81,6427.37
495357133580503360,2020-12,1625.8,891.98,69.01,2698.66,-1895.83,4531.54
495972259210793280,2020-01,1691.44,706.54,705.29,1911.5,-221.31,-221.31
495972259210793280,2020-02,85.08,1414.17,3207.4,2709.84,-831.53,-1052.84
495972259210793280,2020-03,0,1623.77,3594.76,2966.7,-995.71,-2048.55
495972259210793280,2020-04,1495.12,643.92,3028.26,1512.18,2367.28,318.73
495972259210793280,2020-05,0,1797.31,3507.08,3527.53,-1817.76,-1499.03
495972259210793280,2020-06,0,2470.59,3439.6,1621.7,-652.69,-2151.72
495972259210793280,2020-07,3823.81,1674.29,4555.35,1424.46,5280.41,3128.69
495972259210793280,2020-08,3679.29,0,1344.55,1043.99,3979.85,7108.54
495972259210793280,2020-09,5476.2,2956.4,578.18,2563.4,534.58,7643.12
495972259210793280,2020-10,0,4268.68,0,4420.09,-8688.77,-1045.65
495972259210793280,2020-11,1823.39,1775.35,2587.86,1649.64,986.26,-59.39
495972259210793280,2020-12,1625.73,0,3968.79,2099.29,3495.23,3435.84
496433452868406400,2020-01,1982.18,0,131.24,6656.35,-4542.93,-4542.93
496433452868406400,2020-02,4545.06,2941.16,5363.66,4823.34,2144.22,-2398.71
496433452868406400,2020-03,6077.23,5355.61,1737.25,2772.64,-313.77,-2712.48
496433452868406400,2020-04,685.56,1691.29,3900.2,6027.27,-3132.8,-5845.28
496433452868406400,2020-05,2313.54,789.55,2980.54,0,4504.53,-1340.75
496433452868406400,2020-06,6353.15,867.69,5726.6,5332.69,5879.37,4538.62
496433452868406400,2020-07,5673.07,5235.02,2630.14,5629.2,-2561.01,1977.61
496433452868406400,2020-08,2374.21,3703.34,1734.16,4806.1,-4401.07,-2423.46
496433452868406400,2020-09,7097.55,4425.53,491.15,4019.46,-856.29,-3279.75
496433452868406400,2020-10,440.47,2078.1,2705.93,1751.52,-683.22,-3962.97
496433452868406400,2020-11,119.05,5416.75,2650.43,3766.1,-6413.37,-10376.34
496433452868406400,2020-12,3094.69,4098.13,2484.52,4426.63,-2945.55,-13321.89
497394424512684224,2020-01,5933.13,1517.7,25.94,3936.29,505.08,505.08
497394424512684224,2020-02,409.73,3291.55,2837.68,901.62,-945.76,-440.68
497394424512684224,2020-03,4955.99,3812.92,8813.66,6001.04,3955.69,3515.01
497394424512684224,2020-04,1417.87,0,662.22,1393.3,686.79,4201.8
497394424512684224,2020-05,3347.75,6399.97,261.74,1433.56,-4224.04,-22.24
497394424512684224,2020-06,1718.64,3990.43,5544.03,2484.87,787.37,765.13
497394424512684224,2020-07,0,2703.88,4151.49,2800.41,-1352.8,-587.67
497394424512684224,2020-08,2285.66,2549.07,1383.73,5503.42,-4383.1,-4970.77
497394424512684224,2020-09,0,3284.91,3758.09,1351.41,-878.23,-5849
497394424512684224,2020-10,2286.36,2439.27,0,2727.99,-2880.9,-8729.9
497394424512684224,2020-11,766.18,5639,0,2628.44,-7501.26,-16231.16
497394424512684224,2020-12,338.53,2618.82,1279.23,3919.57,-4920.63,-21151.79
498707011599497856,2020-01,777.28,638.5,4923.82,5451.74,-389.14,-389.14
498707011599497856,2020-02,4707.27,7873.72,2894.1,3470.18,-3742.53,-4131.67
498707011599497856,2020-03,5447.19,1850.85,658.49,832.2,3422.63,-709.04
498707011599497856,2020-04,902.89,1852.61,8998.19,1868.4,6180.07,5471.03
498707011599497856,2020-05,0,2649.43,331.04,4342.52,-6660.91,-1189.88
498707011599497856,2020-06,3132.38,3024.32,1783.29,2310.82,-419.47,-1609.35
498707011599497856,2020-07,142.27,706.58,3010.72,4763.04,-2316.63,-3925.98
498707011599497856,2020-08,1505.65,0,1365.28,4725.46,-1854.53,-5780.51
498707011599497856,2020-09,2657.94,4428.93,3678.28,3868.98,-1961.69,-7742.2
498707011599497856,2020-10,1627.65,3266.02,3366.23,5240.23,-3512.37,-11254.57
498707011599497856,2020-11,4043.88,2192.97,5156.95,1435.32,5572.54,-5682.03
498707011599497856,2020-12,4143.26,2652.7,1736.16,2100.53,1126.19,-4555.84
500668813715630400,2020-01,2644.66,2401.53,1646.57,2489.27,-599.57,-599.57
500668813715630400,2020-02,1457.74,610.19,2515.58,1131.99,2231.14,1631.57
500668813715630400,2020-03,4599.45,4555.27,1699.98,143.55,1600.61,3232.18
500668813715630400,2020-04,2525.51,2399.71,237.38,2723.07,-2359.89,872.29
500668813715630400,2020-05,4315.59,797.92,1746.11,4015.57,1248.21,2120.5
500668813715630400,2020-06,6573.29,3935.18,1966.75,1771.32,2833.54,4954.04
500668813715630400,2020-07,1135.96,4938.57,5004.65,4747.55,-3545.51,1408.53
500668813715630400,2020-08,2363.53,1648.33,2218.59,8229.14,-5295.35,-3886.82
500668813715630400,2020-09,1101.1,918.51,3907.45,1303.03,2787.01,-1099.81
500668813715630400,2020-10,3232.81,1760.55,2891.26,3088.37,1275.15,175.34
500668813715630400,2020-11,4448.54,1409.77,3101.1,2485.49,3654.38,3829.72
500668813715630400,2020-12,1776.13,0,4870.5,3625.22,3021.41,6851.13
500981218246005760,2020-01,5674.73,9057.29,1693.55,3843.92,-5532.93,-5532.93
500981218246005760,2020-02,4159.6,1250.57,3529.25,1516.55,4921.73,-611.2
500981218246005760,2020-03,8951.6,4835.45,2511.07,2048.4,4578.82,3967.62
500981218246005760,2020-04,3505.04,4819.11,2166.89,3210.37,-2357.55,1610.07
500981218246005760,2020-05,5481.04,4541.82,6372.99,5680.54,1631.67,3241.74
500981218246005760,2020-06,4725.61,3571.57,3858.98,4884.34,128.68,3370.42
500981218246005760,2020-07,7371.79,5278.68,3218.48,8378.04,-3066.45,303.97
500981218246005760,2020-08,6236.54,9102.43,1660.39,4174.69,-5380.19,-5076.22
500981218246005760,2020-09,4164.26,7272.68,1599.83,3555.43,-5064.02,-10140.24
500981218246005760,2020-10,5380.85,3301.37,3157.6,2475.08,2762,-7378.24
500981218246005760,2020-11,4947.09,1492.15,2704.83,1251.22,4908.55,-2469.69
500981218246005760,2020-12,1971.83,1958.04,3258.93,5885.96,-2613.24,-5082.93
502915210255323072,2020-01,0,6458.69,6300.36,9437.58,-9595.91,-9595.91
502915210255323072,2020-02,3193.7,2491.24,3490.6,7537.96,-3344.9,-12940.81
502915210255323072,2020-03,736.45,2962.74,2301.58,3640.76,-3565.47,-16506.28
502915210255323072,2020-04,2030.48,3201.41,1304.78,4364.36,-4230.51,-20736.79
502915210255323072,2020-05,3832.85,6225.96,2248.44,8371.4,-8516.07,-29252.86
502915210255323072,2020-06,2166.06,5186.72,4906.87,2503.84,-617.63,-29870.49
502915210255323072,2020-07,3245.06,4157.2,4562.14,3128.2,521.8,-29348.69
502915210255323072,2020-08,0,804.98,2262.06,5935.35,-4478.27,-33826.96
502915210255323072,2020-09,6954.91,3171.9,3862.17,3102.62,4542.56,-29284.4
502915210255323072,2020-10,7257.09,3236.61,4559.65,3750.42,4829.71,-24454.69
502915210255323072,2020-11,4412.17,6977.44,3892.87,3660.91,-2333.31,-26788
502915210255323072,2020-12,2808.99,3528.03,4286.53,2499.61,1067.88,-25720.12
503120746126945024,2020-01,1089.54,2381.61,209.41,3985.25,-5067.91,-5067.91
503120746126945024,2020-02,181.81,4959.49,2959.86,6943.52,-8761.34,-13829.25
503120746126945024,2020-03,2716.6,5448.82,2421.54,5478.48,-5789.16,-19618.41
503120746126945024,2020-04,3663.58,5348.81,3439.45,2816.8,-1062.58,-20680.99
503120746126945024,2020-05,7551.46,5906.13,3894.05,4185.05,1354.33,-19326.66
503120746126945024,2020-06,882.03,3107.5,4548.6,0,2323.13,-17003.53
503120746126945024,2020-07,4604.76,9147.05,6938.5,3298.69,-902.48,-17906.01
503120746126945024,2020-08,5503.47,3019.61,2375,6566.88,-1708.02,-19614.03
503120746126945024,2020-09,4257.19,2179.97,4764.07,3974.81,2866.48,-16747.55
503120746126945024,2020-10,7903.33,5734.28,2016.49,10880.1,-6694.56,-23442.11
503120746126945024,2020-11,6606.96,10395.84,7864.71,1833.85,2241.98,-21200.13
503120746126945024,2020-12,6411.6,4019.28,4829.66,4149.19,3072.79,-18127.34
504066436234799168,2020-01,3760.5,3076.02,6882.11,7943.42,-376.83,-376.83
504066436234799168,2020-02,5698.97,5072.35,2075.11,5766.66,-3064.93,-3441.76
504066436234799168,2020-03,5745.36,4690.99,7037.59,3582.58,4509.38,1067.62
504066436234799168,2020-04,2547.15,7755.68,3709.94,5577.34,-7075.93,-6008.31
504066436234799168,2020-05,1098.15,3286.33,6246.37,7281.79,-3223.6,-9231.91
504066436234799168,2020-06,187.64,3698.17,4659.68,3194.34,-2045.19,-11277.1
504066436234799168,2020-07,5230.82,4852.63,4456.54,359.92,4474.81,-6802.29
504066436234799168,2020-08,4071.35,7570.53,1739.94,9227.55,-10986.79,-17789.08
504066436234799168,2020-09,8422.09,2823.15,3074.41,3933.36,4739.99,-13049.09
504066436234799168,2020-10,1689.52,5967.51,8892.65,5893.74,-1279.08,-14328.17
504066436234799168,2020-11,2892.17,3536.17,3420.39,4609.23,-1832.84,-16161.01
504066436234799168,2020-12,301.25,2600.41,3823.32,6173.15,-4648.99,-20810
505252806141210752,2020-08,1118.9,0,0,0,1118.9,1118.9
505417692999304384,2020-01,862.94,901.47,8495.16,1121.61,7335.02,7335.02
505417692999304384,2020-02,0,637.92,324.66,3852.69,-4165.95,3169.07
505417692999304384,2020-03,5199.59,3606.41,230.92,0,1824.1,4993.17
505417692999304384,2020-04,307.46,1321.87,1749.67,1404.74,-669.48,4323.69
505417692999304384,2020-05,2482.67,0,1362.2,3545.62,299.25,4622.94
505417692999304384,2020-06,2963.53,1735.52,1632.05,1935.14,924.92,5547.86
505417692999304384,2020-07,3101.04,336.04,3975.48,4393.48,2347,7894.86
505417692999304384,2020-08,0,2179.78,3332.79,1173.14,-20.13,7874.73
505417692999304384,2020-09,3368.78,0,3829.68,652.22,6546.24,14420.97
505417692999304384,2020-10,1748.39,590.65,3997.4,1876.54,3278.6,17699.57
505417692999304384,2020-11,5751.4,660.92,498.7,901.13,4688.05,22387.62
505417692999304384,2020-12,2332.64,2355.3,2525.85,1097.84,1405.35,23792.97
505544071731232960,2020-05,1850.93,0,1283.66,0,3134.59,3134.59
506186709467167296,2020-02,114.87,148.58,0,1416.24,-1449.95,-1449.95
506186709467167296,2020-04,1160.87,2424.97,0,613.96,-1878.06,-3328.01
506186709467167296,2020-05,0,850.98,1794.05,0,943.07,-2384.94
506186709467167296,2020-06,2645.44,612.86,0,1864.65,167.93,-2217.01
506186709467167296,2020-07,3587.62,0,1733.32,0,5320.94,3103.93
506186709467167296,2020-08,816.17,977.69,0,0,-161.52,2942.41
506186709467167296,2020-09,240.44,1708.22,1744.93,2131.05,-1853.9,1088.51
506186709467167296,2020-10,792.71,1359.93,0,749.15,-1316.37,-227.86
506186709467167296,2020-11,3435.47,782.83,110.79,0,2763.43,2535.57
506186709467167296,2020-12,3215.84,1773.34,920.06,799.23,1563.33,4098.9
508409497220225152,2020-01,488.94,1475.37,2809.3,0,1822.87,1822.87
508409497220225152,2020-02,199.09,0,0,1854.63,-1655.54,167.33
508409497220225152,2020-03,455.91,0,2558.72,0,3014.63,3181.96
508409497220225152,2020-04,1183.76,0,0,1057.72,126.04,3308
508409497220225152,2020-05,709.09,0,498.96,0,1208.05,4516.05
508409497220225152,2020-06,855.27,1621.11,528.45,0,-237.39,4278.66
508409497220225152,2020-07,0,1185.72,2454.59,0,1268.87,5547.53
508409497220225152,2020-08,1612.7,0,973.65,3243.76,-657.41,4890.12
508409497220225152,2020-09,2853.88,1874.39,571.71,772.64,778.56,5668.68
508409497220225152,2020-10,3054.98,0,1956.28,0,5011.26,10679.94
508409497220225152,2020-11,2041.77,3028.94,2135.26,1028.41,119.68,10799.62
508409497220225152,2020-12,4045.76,0,566.12,0,4611.88,15411.5
508472104884324224,2020-01,4952.42,415.37,3052.31,4756.46,2832.9,2832.9
508472104884324224,2020-02,5913.71,4118.25,1541.11,1176.86,2159.71,4992.61
508472104884324224,2020-03,4516.36,4409.64,1574.66,0,1681.38,6673.99
508472104884324224,2020-04,583.95,2636.98,2942.86,1417.97,-528.14,6145.85
508472104884324224,2020-05,0,4850.52,2997.44,0,-1853.08,4292.77
508472104884324224,2020-06,7361.58,2134.77,909.49,1578.95,4557.35,8850.12
508472104884324224,2020-07,5526.19,1446.08,1205.61,2932.75,2352.97,11203.09
508472104884324224,2020-08,590.87,1469.93,1831.61,1884.8,-932.25,10270.84
508472104884324224,2020-09,3335.03,3082.39,3896.14,3072.41,1076.37,11347.21
508472104884324224,2020-10,82.87,5259.47,1604.53,0,-3572.07,7775.14
508472104884324224,2020-11,4829.37,813.2,1980.14,3121.6,2874.71,10649.85
508472104884324224,2020-12,2015.59,2367.73,4624.67,241.19,4031.34,14681.19
508938127918012736,2020-01,3037.57,0,3368.43,3961.15,2444.85,2444.85
508938127918012736,2020-02,3451.24,850.58,1118.85,3389.98,329.53,2774.38
508938127918012736,2020-03,356.44,9361.57,1307.84,4672.47,-12369.76,-9595.38
508938127918012736,2020-04,553.2,0,5848.89,844.85,5557.24,-4038.14
508938127918012736,2020-05,1376.43,3236.25,3092.76,2836.88,-1603.94,-5642.08
508938127918012736,2020-06,1289.25,725.32,4495.63,0,5059.56,-582.52
508938127918012736,2020-07,3962.87,3352.18,3711.5,2851.87,1470.32,887.8
508938127918012736,2020-08,719.26,3972.12,2316.78,2022.83,-2958.91,-2071.11
508938127918012736,2020-09,4928.47,2988.73,4225.61,3150.21,3015.14,944.03
508938127918012736,2020-10,5103.08,4176.75,9.92,741.15,195.1,1139.13
508938127918012736,2020-11,1947.64,23.64,737.86,11674.01,-9012.15,-7873.02
508938127918012736,2020-12,0,1507.39,2783.88,4273.6,-2997.11,-10870.13
509281836645315264,2020-01,5741.64,3366.8,6129.36,4486.15,4018.05,4018.05
509281836645315264,2020-02,2008.03,1369.55,1363.95,5297.7,-3295.27,722.78
509281836645315264,2020-03,2316.04,4226.43,2867.84,1190.13,-232.68,490.1
509281836645315264,2020-04,5018.19,0,2910.12,1704.55,6223.76,6713.86
509281836645315264,2020-05,2052.46,5970.15,2413.15,5008.54,-6513.08,200.78
509281836645315264,2020-06,2614.55,287.12,1856.69,2153.04,2031.08,2231.86
509281836645315264,2020-07,5836.98,153.04,1407.32,4801.27,2289.99,4521.85
509281836645315264,2020-08,4960.35,3305.71,3267.29,5673.2,-751.27,3770.58
509281836645315264,2020-09,8471.92,908.18,2765.07,2881.32,7447.49,11218.07
509281836645315264,2020-10,4424.95,2719.59,1717.48,2847.26,575.58,11793.65
509281836645315264,2020-11,1443.77,922.36,4033.95,2202.45,2352.91,14146.56
509281836645315264,2020-12,8016.95,2803.18,4576.05,3087.97,6701.85,20848.41
509445981666377600,2020-02,1777.66,0,0,0,1777.66,1777.66
509445981666377600,2020-03,0,1265.11,0,0,-1265.11,512.55
509445981666377600,2020-05,0,1071.39,0,0,-1071.39,-558.84
509445981666377600,2020-07,0,818.2,1538.99,0,720.79,161.95
509445981666377600,2020-09,0,1486.06,1597.23,158.68,-47.51,114.44
509489723264755520,2020-01,5865.68,7074.98,8510.28,2519.63,4781.35,4781.35
509489723264755520,2020-02,5300.97,799.59,1805.94,1259.12,5048.2,9829.55
509489723264755520,2020-03,5149.4,6520.97,4978.2,5113.21,-1506.58,8322.97
509489723264755520,2020-04,2103.51,4521.27,2197.41,428.17,-648.52,7674.45
509489723264755520,2020-05,9539.74,1301.66,4970.69,3220.63,9988.14,17662.59
509489723264755520,2020-06,3369.16,3025.25,1214.31,2426.68,-868.46,16794.13
509489723264755520,2020-07,4215.59,4039.78,2282.85,3436.34,-977.68,15816.45
509489723264755520,2020-08,5887.73,4494.71,5868.77,2580.95,4680.84,20497.29
509489723264755520,2020-09,1780.37,3775.26,9825.42,3084.55,4745.98,25243.27
509489723264755520,2020-10,2370.05,8172.78,4539.14,1961.07,-3224.66,22018.61
509489723264755520,2020-11,2127.08,2126.65,3262.75,447.77,2815.41,24834.02
509489723264755520,2020-12,10940.57,4827.76,6167.34,4846.97,7433.18,32267.2
509555585552595840,2020-01,1814.73,948.9,2738.72,3538.8,65.75,65.75
509555585552595840,2020-02,5455.14,2641.47,560.68,0,3374.35,3440.1
509555585552595840,2020-03,531.22,1807.63,1934.77,0,658.36,4098.46
509555585552595840,2020-04,1445.08,0,0,1181.78,263.3,4361.76
509555585552595840,2020-05,2643.31,2146.36,2280.58,0,2777.53,7139.29
509555585552595840,2020-06,3614.77,1772.01,0,1252.12,590.64,7729.93
509555585552595840,2020-07,917.52,0,664.59,942.06,640.05,8369.98
509555585552595840,2020-08,1551.6,2257.42,0,0,-705.82,7664.16
509555585552595840,2020-09,0,847.54,1018.1,0,170.56,7834.72
509555585552595840,2020-10,1862.61,2243.37,1456.34,0,1075.58,8910.3
509555585552595840,2020-11,2280.83,0,4993.56,0,7274.39,16184.69
509555585552595840,2020-12,2312.88,0,917.81,0,3230.69,19415.38
509733257441406848,2020-01,2272.26,1057.18,800.98,0,2016.06,2016.06
509733257441406848,2020-02,508.07,1251.6,1248.6,1235.18,-730.11,1285.95
509733257441406848,2020-03,3166.29,5189.64,661.61,640.22,-2001.96,-716.01
509733257441406848,2020-04,4459.01,2412.46,2321.6,688.59,3679.56,2963.55
509733257441406848,2020-05,2274.78,1413.81,4385.15,2822.83,2423.29,5386.84
509733257441406848,2020-06,2098.03,3531.65,3262.83,1548.55,280.66,5667.5
509733257441406848,2020-07,4348.44,37.73,1719.69,0,6030.4,11697.9
509733257441406848,2020-08,6240.77,0,2432.94,4425.36,4248.35,15946.25
509733257441406848,2020-10,5455.27,2822.03,7376.12,114.66,9894.7,25840.95
509733257441406848,2020-11,3074.89,1970.85,2411.36,0,3515.4,29356.35
509733257441406848,2020-12,2286.37,2070.72,2874.05,5256.9,-2167.2,27189.15
509931996436464064,2020-01,5941.49,2212.57,1759.54,5370.49,117.97,117.97
509931996436464064,2020-02,3426.56,4965.51,0,0,-1538.95,-1420.98
509931996436464064,2020-03,2964.9,2880.13,6716.94,139.55,6662.16,5241.18
509931996436464064,2020-04,1291.7,1032.55,2088.58,2178.64,169.09,5410.27
509931996436464064,2020-05,2812.25,4333.98,2342.16,1190.28,-369.85,5040.42
509931996436464064,2020-06,4776.59,3796.48,1991.73,450.14,2521.7,7562.12
509931996436464064,2020-07,3410.65,2284.82,6898.42,610.95,7413.3,14975.42
509931996436464064,2020-08,1479.68,5172.05,5565.35,1583.52,289.46,15264.88
509931996436464064,2020-09,6613.78,3651.19,1291.69,3386.04,868.24,16133.12
509931996436464064,2020-10,3576.07,1106.1,1216.15,3188.66,497.46,16630.58
509931996436464064,2020-11,7486.83,0,1359.95,3806.27,5040.51,21671.09
509931996436464064,2020-12,718.78,3066.75,3642.12,6841.04,-5546.89,16124.2
510849868406597248,2020-01,1343.45,2276.36,0,820.88,-1753.79,-1753.79
510849868406597248,2020-02,813.58,2395.41,2218.03,222.35,413.85,-1339.94
510849868406597248,2020-03,4305.14,516.87,1079.39,3049.78,1817.88,477.94
510849868406597248,2020-04,5766.82,2529.44,0,1184.13,2053.25,2531.19
510849868406597248,2020-05,3346.11,0,2745.53,425.23,5666.41,8197.6
510849868406597248,2020-06,0,2994.99,5189.94,3955.83,-1760.88,6436.72
510849868406597248,2020-07,4474.26,1962.5,1597.32,2171.6,1937.48,8374.2
510849868406597248,2020-08,3184.51,986.74,2974.48,2269.78,2902.47,11276.67
510849868406597248,2020-09,365.97,3498.42,3811.25,0,678.8,11955.47
510849868406597248,2020-10,342.31,0,2659.67,2350.04,651.94,12607.41
510849868406597248,2020-11,1532.84,2091.56,937.84,2358.33,-1979.21,10628.2
510849868406597248,2020-12,2063.99,2915.36,1815.56,1717.66,-753.47,9874.73
511936590083615104,2020-02,1925.61,1402.23,0,0,523.38,523.38
513150960332876096,2020-01,224.64,1678.67,0,0,-1454.03,-1454.03
513150960332876096,2020-02,166.48,0,0,1728.03,-1561.55,-3015.58
513150960332876096,2020-03,157.34,1041.99,0,2553.45,-3438.1,-6453.68
513150960332876096,2020-06,593.93,544.77,2017.74,0,2066.9,-4386.78
513150960332876096,2020-07,0,289.34,1638.1,918.11,430.65,-3956.13
513150960332876096,2020-08,0,1968.72,1094.66,2139.81,-3013.87,-6970
513150960332876096,2020-11,0,1718.06,1920.34,1635.78,-1433.5,-8403.5
514922477860514304,2020-01,1989.06,2559.06,3330.16,1911.67,848.49,848.49
514922477860514304,2020-03,0,1179.56,1655.69,594.72,-118.59,729.9
514922477860514304,2020-04,1310.61,1955.43,775.33,1381.56,-1251.05,-521.15
514922477860514304,2020-05,356.75,1939.28,919.81,440.62,-1103.34,-1624.49
514922477860514304,2020-07,1489.74,3060.98,212.34,694.18,-2053.08,-3677.57
514922477860514304,2020-08,1982.27,3189.09,2727.7,300.26,1220.62,-2456.95
514922477860514304,2020-09,2224.95,1010.88,0,1922.11,-708.04,-3164.99
514922477860514304,2020-10,0,1460.86,1673,2423.62,-2211.48,-5376.47
514922477860514304,2020-11,3166.12,0,3003.89,850.1,5319.91,-56.56
514922477860514304,2020-12,1355.84,1616.55,3179.46,0,2918.75,2862.19
515041259080587584,2020-01,1334.69,3133.78,7913,3443.54,2670.37,2670.37
515041259080587584,2020-02,3273.8,5659.09,1253.36,1077.09,-2209.02,461.35
515041259080587584,2020-03,2611.6,2264.37,3912.01,2505.57,1753.67,2215.02
515041259080587584,2020-04,1396.75,3055.26,3366.04,5880.35,-4172.82,-1957.8
515041259080587584,2020-05,1773.98,2903.9,7091.08,4865.58,1095.58,-862.22
515041259080587584,2020-06,4063.95,3130.44,3499.16,3266.88,1165.79,303.57
515041259080587584,2020-07,4794.77,3186.47,2217.67,1564.75,2261.22,2564.79
515041259080587584,2020-08,1094.92,3509.46,1644.94,1314.38,-2083.98,480.81
515041259080587584,2020-09,301.45,1867.94,284.04,164.11,-1446.56,-965.75
515041259080587584,2020-10,5665.35,646.28,2733.44,12043.32,-4290.81,-5256.56
515041259080587584,2020-11,186,654.98,4909.05,6608.4,-2168.33,-7424.89
515041259080587584,2020-12,4877.55,2867.57,3134,6616.82,-1472.84,-8897.73
516370330152292736,2020-01,0,8850.73,4174.34,6287.91,-10964.3,-10964.3
516370330152292736,2020-02,5606.76,4989.45,3585.11,2160.15,2042.27,-8922.03
516370330152292736,2020-03,3857.45,7437.64,2012.44,7472.53,-9040.28,-17962.31
516370330152292736,2020-04,2300.53,1899.46,4280.86,3749.86,932.07,-17030.24
516370330152292736,2020-05,2177.63,2363.37,3723.09,7154.93,-3617.58,-20647.82
516370330152292736,2020-06,1132.77,2194.74,4093.48,4000.04,-968.53,-21616.35
516370330152292736,2020-07,2474.42,2503.28,3954.79,3811.35,114.58,-21501.77
516370330152292736,2020-08,4102.59,603.27,3682.57,8536.25,-1354.36,-22856.13
516370330152292736,2020-09,126.6,4218.92,7121.56,5405.71,-2376.47,-25232.6
516370330152292736,2020-10,11367.12,6847.85,2340.83,5485.44,1374.66,-23857.94
516370330152292736,2020-11,4004.06,2853.15,4713.93,4613.83,1251.01,-22606.93
516370330152292736,2020-12,5345.78,4813.54,1718.06,5796.67,-3546.37,-26153.3
516565533695811520,2020-01,6608.57,2923.37,6900.71,2140.46,8445.45,8445.45
516565533695811520,2020-02,4260.79,1701.38,0,3639.07,-1079.66,7365.79
516565533695811520,2020-03,3545.75,14768.19,2279.86,3410.54,-12353.12,-4987.33
516565533695811520,2020-04,4711.29,3868.62,5952.57,3945.71,2849.53,-2137.8
516565533695811520,2020-05,9590.45,6270.67,5273.94,5474.27,3119.45,981.65
516565533695811520,2020-06,2813.93,2823.67,2370.95,2926.73,-565.52,416.13
516565533695811520,2020-07,0,2390.36,3953.96,36.64,1526.96,1943.09
516565533695811520,2020-08,0,5047.33,1976.32,2473.42,-5544.43,-3601.34
516565533695811520,2020-09,0,1530.21,1984.37,3141.22,-2687.06,-6288.4
516565533695811520,2020-10,264.6,5700.28,4887.76,1817.04,-2364.96,-8653.36
516565533695811520,2020-11,0,1994.6,5544.65,660.77,2889.28,-5764.08
516565533695811520,2020-12,0,1273.11,2801.58,2480.02,-951.55,-6715.63
516730593908826112,2020-01,943.73,1665.14,910.14,2707.3,-2518.57,-2518.57
516730593908826112,2020-02,1769.47,1397.61,3349.67,595.96,3125.57,607
516730593908826112,2020-03,907.4,0,1276.96,0,2184.36,2791.36
516730593908826112,2020-04,3344.02,3103.42,2116.66,4560.61,-2203.35,588.01
516730593908826112,2020-05,2763.4,4907.62,2061.08,529.62,-612.76,-24.75
516730593908826112,2020-06,1765.6,3888.08,2342.89,2394.39,-2173.98,-2198.73
516730593908826112,2020-07,3341.33,1528,6685.11,3980,4518.44,2319.71
516730593908826112,2020-08,2553.16,1965.3,740.42,3197.15,-1868.87,450.84
516730593908826112,2020-09,4767.44,3219.92,4521.99,815.45,5254.06,5704.9
516730593908826112,2020-10,2484.02,0,4928.51,10107.57,-2695.04,3009.86
516730593908826112,2020-11,2591.43,1010.53,6523.23,2720.45,5383.68,8393.54
516730593908826112,2020-12,7137.76,1572.79,4857.16,1046.02,9376.11,17769.65
518535133569654656,2020-01,6672.6,2332.75,2862.22,4047.51,3154.56,3154.56
518535133569654656,2020-02,3862.7,5501.09,4010.53,5774.81,-3402.67,-248.11
518535133569654656,2020-03,3890.89,2024.45,5335.67,5604.55,1597.56,1349.45
518535133569654656,2020-04,3784.21,2633.74,11067.74,282.69,11935.52,13284.97
518535133569654656,2020-05,3835.47,8004.45,3905.18,5226.58,-5490.38,7794.59
518535133569654656,2020-06,3550.29,4175.85,6442.49,4008.79,1808.14,9602.73
518535133569654656,2020-07,6821.18,7077.75,3173.66,4675.66,-1758.57,7844.16
518535133569654656,2020-08,3464.44,4779.83,4509.15,4345.75,-1151.99,6692.17
518535133569654656,2020-09,3145.05,2148.6,3597.46,6572.96,-1979.05,4713.12
518535133569654656,2020-10,4906.16,6045.47,7705.03,371.02,6194.7,10907.82
518535133569654656,2020-11,7610.55,2450.43,2992.13,5853.15,2299.1,13206.92
518535133569654656,2020-12,6200.13,8814.2,4615.24,4353.99,-2352.82,10854.1
520469234068772928,2020-01,6623.68,2262.43,3852.06,9130.59,-917.28,-917.28
520469234068772928,2020-02,6801.05,1932.99,1358.45,7303.5,-1076.99,-1994.27
520469234068772928,2020-03,4660.68,3282.91,2725.99,4443.65,-339.89,-2334.16
520469234068772928,2020-04,3748.4,0,2316.13,3561.84,2502.69,168.53
520469234068772928,2020-05,9282.39,3558.43,4489.9,5383.2,4830.66,4999.19
520469234068772928,2020-06,4234.67,1784.7,8348.57,5124.48,5674.06,10673.25
520469234068772928,2020-07,5522.55,6333.19,3032.46,6240.58,-4018.76,6654.49
520469234068772928,2020-08,4890.9,4259.17,5275.23,5937.05,-30.09,6624.4
520469234068772928,2020-09,7090.65,7614.04,10952.39,1687.35,8741.65,15366.05
520469234068772928,2020-10,7645.75,7483.55,5377.04,4323.54,1215.7,16581.75
520469234068772928,2020-11,4865.12,5460.93,3256.94,4495.36,-1834.23,14747.52
520469234068772928,2020-12,4948.78,1986.42,2147.09,3423.38,1686.07,16433.59
522127749674748928,2020-01,1618.63,2947.5,125.91,750.53,-1953.49,-1953.49
522127749674748928,2020-02,0,4340.01,781.49,0,-3558.52,-5512.01
522127749674748928,2020-03,0,4537.91,2703.95,0,-1833.96,-7345.97
522127749674748928,2020-04,1703.98,7451.97,2697.09,1026.26,-4077.16,-11423.13
522127749674748928,2020-05,0,597.73,4723.73,589.36,3536.64,-7886.49
522127749674748928,2020-06,80.74,2765.34,1586.68,1323.76,-2421.68,-10308.17
522127749674748928,2020-08,4143.13,3588.01,0,1204.67,-649.55,-10957.72
522127749674748928,2020-09,0,3104.48,0,3894.29,-6998.77,-17956.49
522127749674748928,2020-10,2042.16,450.04,3209.01,1505.63,3295.5,-14660.99
522127749674748928,2020-11,0,1967.51,2355.61,1087.41,-699.31,-15360.3
522127749674748928,2020-12,2384.13,874.42,2932.87,0,4442.58,-10917.72
523565090658612800,2020-01,1674.88,1874.33,2992.22,2524.14,268.63,268.63
523565090658612800,2020-02,121.54,5502.4,0,1160.7,-6541.56,-6272.93
523565090658612800,2020-03,0,3835.5,3597.74,1903.41,-2141.17,-8414.1
523565090658612800,2020-04,2244,895.15,3983.15,1596.94,3735.06,-4679.04
523565090658612800,2020-05,0,5891.37,3690.45,1864.3,-4065.22,-8744.26
523565090658612800,2020-06,378.46,37.34,0,1456.11,-1114.99,-9859.25
523565090658612800,2020-07,5520.25,1104.93,51.3,0,4466.62,-5392.63
523565090658612800,2020-09,0,3044.86,1649.94,1914.66,-3309.58,-8702.21
523565090658612800,2020-10,1700.63,0,2149.01,0,3849.64,-4852.57
523565090658612800,2020-11,0,1974.8,702.99,1640.63,-2912.44,-7765.01
523565090658612800,2020-12,2416.95,2376.13,0,1930.91,-1890.09,-9655.1
523746572221879360,2020-01,1245.9,665.27,531.13,3565.17,-2453.41,-2453.41
523746572221879360,2020-02,702.27,406.17,6263.59,3199.7,3359.99,906.58
523746572221879360,2020-03,3430.85,6557.33,2501.79,3717,-4341.69,-3435.11
523746572221879360,2020-04,1738.88,3467.12,4646.96,3037.08,-118.36,-3553.47
523746572221879360,2020-05,3541.34,6652.86,1658.62,5982.92,-7435.82,-10989.29
523746572221879360,2020-06,4126.98,1604.5,707.28,2966.72,263.04,-10726.25
523746572221879360,2020-07,4904.41,1059.65,1906.14,2957.61,2793.29,-7932.96
523746572221879360,2020-08,0,617.56,785.42,3898.53,-3730.67,-11663.63
523746572221879360,2020-09,3197.74,4824.29,3746.71,2184.63,-64.47,-11728.1
523746572221879360,2020-10,5569.61,2491.24,2181,293.2,4966.17,-6761.93
523746572221879360,2020-11,1226.45,224.69,4790.88,1329.1,4463.54,-2298.39
523746572221879360,2020-12,3019.69,6797.03,0,4576.54,-8353.88,-10652.27
524012769305319680,2020-01,3029.02,830.89,703.24,0,2901.37,2901.37
524012769305319680,2020-02,2369.53,2835.15,1479.02,1760.39,-746.99,2154.38
524012769305319680,2020-03,0,1560.33,2697.82,155.85,981.64,3136.02
524012769305319680,2020-04,1324.24,0,0,1764.17,-439.93,2696.09
524012769305319680,2020-05,3332.27,0,2038.74,0,5371.01,8067.1
524012769305319680,2020-06,0,1767.24,1168.14,3410.67,-4009.77,4057.33
524012769305319680,2020-07,497.24,1820.18,880.69,2724.69,-3166.94,890.39
524012769305319680,2020-08,0,1648.56,1746.27,1688.48,-1590.77,-700.38
524012769305319680,2020-10,0,3793.34,716.24,0,-3077.1,-3777.48
524012769305319680,2020-11,1355.45,0,827.55,3932.04,-1749.04,-5526.52
524012769305319680,2020-12,2398.57,1873.89,748.79,2516.91,-1243.44,-6769.96
524158651130532608,2020-01,4148.41,3345.8,2815.01,3363.82,253.8,253.8
524158651130532608,2020-02,5264.65,2841.83,4655.86,3271.76,3806.92,4060.72
524158651130532608,2020-03,4418.49,5430.53,2401.72,4239.11,-2849.43,1211.29
524158651130532608,2020-04,0,2490.07,0,2445.45,-4935.52,-3724.23
524158651130532608,2020-05,3169.67,6785.3,7378.93,237.31,3525.99,-198.24
524158651130532608,2020-06,1862.29,3421.87,6180.46,0,4620.88,4422.64
524158651130532608,2020-07,2528.59,2509.56,4569.23,2868.71,1719.55,6142.19
524158651130532608,2020-08,6254.09,3386.4,4207.84,3280.46,3795.07,9937.26
524158651130532608,2020-09,1846.53,1073.02,1802.94,3389.82,-813.37,9123.89
524158651130532608,2020-10,8622.07,3664.64,1489.22,2951.38,3495.27,12619.16
524158651130532608,2020-11,5170.84,1387.91,1026.7,1243.68,3565.95,16185.11
524158651130532608,2020-12,860.26,6320.01,3770.75,1902.25,-3591.25,12593.86
524668001368069696,2020-01,7262.08,5889.45,4279.59,2477.39,3174.83,3174.83
524668001368069696,2020-02,5305.94,2969.43,5038.2,4603.1,2771.61,5946.44
524668001368069696,2020-03,5414.44,5272.18,3739.7,1896.09,1985.87,7932.31
524668001368069696,2020-04,4598.31,5383.34,8392.15,3191.93,4415.19,12347.5
524668001368069696,2020-05,3977.41,3349.6,3712.66,7727.72,-3387.25,8960.25
524668001368069696,2020-06,4197.08,0,4830.88,8167.07,860.89,9821.14
524668001368069696,2020-07,6917.5,8729.82,2302.74,3032.61,-2542.19,7278.95
524668001368069696,2020-08,4098.14,1611.97,5023.38,7064.43,445.12,7724.07
524668001368069696,2020-09,5549.61,988.01,1737.81,4425.06,1874.35,9598.42
524668001368069696,2020-10,2425.74,4326.06,7480.88,5723.36,-142.8,9455.62
524668001368069696,2020-11,5294.5,6526.45,1578.7,4625.11,-4278.36,5177.26
524668001368069696,2020-12,3462.08,11416.71,4960.89,7144,-10137.74,-4960.48
525135461365961280,2020-01,2368.33,366.39,43.91,802.56,1243.29,1243.29
525135461365961280,2020-02,510.23,1837.38,3336.9,1894.17,115.58,1358.87
525135461365961280,2020-03,0,2519.39,0,324.48,-2843.87,-1485
525135461365961280,2020-04,1846.46,1358.55,1120.07,1182.74,425.24,-1059.76
525135461365961280,2020-05,1104.17,1491.02,1542.54,19.27,1136.42,76.66
525135461365961280,2020-06,1813.97,1528.3,1817.59,2194.35,-91.09,-14.43
525135461365961280,2020-07,1265.81,1818.28,0,764.18,-1316.65,-1331.08
525135461365961280,2020-08,1972.48,58.04,71.61,783.13,1202.92,-128.16
525135461365961280,2020-09,1595.12,1999.49,0,1083.2,-1487.57,-1615.73
525135461365961280,2020-10,3278.82,1579.73,3083.12,359.16,4423.05,2807.32
525135461365961280,2020-11,2451.65,1559.99,242.46,0,1134.12,3941.44
525135461365961280,2020-12,3039.21,2690,461.51,1424.85,-614.13,3327.31
526034664785966912,2020-01,3681.95,6075.48,8224.88,1088.56,4742.79,4742.79
526034664785966912,2020-02,1232.11,6999.21,6611.31,0,844.21,5587
526034664785966912,2020-03,2834.46,2141.08,4059.27,6274.3,-1521.65,4065.35
526034664785966912,2020-04,4327.07,7695.85,8519.8,2655.02,2496,6561.35
526034664785966912,2020-05,2924,3643.97,581.93,3239.92,-3377.96,3183.39
526034664785966912,2020-06,665.64,881.35,10802.28,2832.09,7754.48,10937.87
526034664785966912,2020-07,5126.16,6940.73,4127.11,1006.41,1306.13,12244
526034664785966912,2020-08,5962.55,6275.85,5762.73,6063.23,-613.8,11630.2
526034664785966912,2020-09,4984.41,5489.47,4336.85,3399.37,432.42,12062.62
526034664785966912,2020-10,2551.89,2897.85,3574.94,7100.17,-3871.19,8191.43
526034664785966912,2020-11,10952.6,7447.26,2489.14,5484.55,509.93,8701.36
526034664785966912,2020-12,7027.82,5735.18,5641.27,7108.75,-174.84,8526.52
526589291777107520,2020-03,0,1364.48,0,0,-1364.48,-1364.48
526589291777107520,2020-06,48.24,0,0,0,48.24,-1316.24
526589291777107520,2020-09,2476.21,0,625.62,16.23,3085.6,1769.36
526589291777107520,2020-10,1766.23,0,704.96,1251.99,1219.2,2988.56
526589291777107520,2020-11,1211.99,1610.1,0,0,-398.11,2590.45
526589291777107520,2020-12,574.5,0,1571.3,1570.09,575.71,3166.16
526635455802388864,2020-01,765.03,0,0,640.43,124.6,124.6
526635455802388864,2020-02,1785.4,1818.38,2272.23,0,2239.25,2363.85
526635455802388864,2020-03,4254.13,1546.54,1545.1,787.39,3465.3,5829.15
526635455802388864,2020-04,2248.71,1188.28,4418.91,2594.49,2884.85,8714
526635455802388864,2020-05,755.43,2366.54,3090.9,4961.72,-3481.93,5232.07
526635455802388864,2020-06,4518.15,0,3926.74,0,8444.89,13676.96
526635455802388864,2020-07,4019.65,2621.81,2411.72,170.67,3638.89,17315.85
526635455802388864,2020-08,1079.9,3652.54,2955.84,1538.85,-1155.65,16160.2
526635455802388864,2020-09,256.74,210.12,0,1460.38,-1413.76,14746.44
526635455802388864,2020-10,1909.22,922.54,2977.56,4183.58,-219.34,14527.1
526635455802388864,2020-11,4574.14,3618.57,268.07,2534.97,-1311.33,13215.77
526635455802388864,2020-12,4352.55,0,1225.51,3082.8,2495.26,15711.03
527035049282656064,2020-01,3688.92,6302.04,4094.76,5312.05,-3830.41,-3830.41
527035049282656064,2020-02,1831.32,1572.18,2329.61,217.2,2371.55,-1458.86
527035049282656064,2020-03,5473.45,5960.47,3585.5,1952.37,1146.11,-312.75
527035049282656064,2020-04,1110.45,5226.85,4960.32,3086.68,-2242.76,-2555.51
527035049282656064,2020-05,4740.81,1162.2,2469.56,3992.37,2055.8,-499.71
527035049282656064,2020-06,3849.87,554.03,0,1552.86,1742.98,1243.27
527035049282656064,2020-07,1581.99,7782.54,2600.5,1482.55,-5082.6,-3839.33
527035049282656064,2020-08,6837.6,3024.38,2092.61,7937.73,-2031.9,-5871.23
527035049282656064,2020-09,1825.94,5266.88,1280.17,2855.23,-5016,-10887.23
527035049282656064,2020-10,3321.97,3879.39,1058.56,3160.65,-2659.51,-13546.74
527035049282656064,2020-11,3540.23,181.32,7836.55,4314.96,6880.5,-6666.24
527035049282656064,2020-12,2290.08,4344.08,2897.43,3098.53,-2255.1,-8921.34
528537702869016256,2020-01,3263.08,0,0,0,3263.08,3263.08
528537702869016256,2020-02,4892.07,5426.59,1799.86,1813.46,-548.12,2714.96
528537702869016256,2020-03,8008.58,1616.19,0,7026.51,-634.12,2080.84
528537702869016256,2020-04,3242.36,0,638.58,969.11,2911.83,4992.67
528537702869016256,2020-05,278.38,0,1745.07,0,2023.45,7016.12
528537702869016256,2020-06,1746.55,4109.43,0,2608.64,-4971.52,2044.6
528537702869016256,2020-07,0,2922.71,398.98,3508.76,-6032.49,-3987.89
528537702869016256,2020-08,0,246.29,1677.05,4570.28,-3139.52,-7127.41
528537702869016256,2020-09,3948.36,1803.73,1423.17,0,3567.8,-3559.61
528537702869016256,2020-10,2357.97,1946.08,3413.86,3311.46,514.29,-3045.32
528537702869016256,2020-11,4253.32,1416.54,1764.24,1775.91,2825.11,-220.21
528537702869016256,2020-12,888.83,0,3724.69,902.88,3710.64,3490.43
530850461994106496,2020-01,85.71,4873.19,1309.07,6692.69,-10171.1,-10171.1
530850461994106496,2020-02,1569.21,6200.74,1677.07,1859.42,-4813.88,-14984.98
530850461994106496,2020-03,7908.41,3103.34,6153.62,5338.06,5620.63,-9364.35
530850461994106496,2020-04,4063.91,984.45,6900.88,2644,7336.34,-2028.01
530850461994106496,2020-05,1084.42,0,10523.7,2000.45,9607.67,7579.66
530850461994106496,2020-06,7179.27,5021.31,3256.61,4299.49,1115.08,8694.74
530850461994106496,2020-07,5535.59,5905.63,3585.54,3532.19,-316.69,8378.05
530850461994106496,2020-08,6824.08,3723.73,4144.81,7847.23,-602.07,7775.98
530850461994106496,2020-09,3206.05,5520.38,4758.2,3650.16,-1206.29,6569.69
530850461994106496,2020-10,1730.81,1276.75,6853.52,1855.25,5452.33,12022.02
530850461994106496,2020-11,7470.95,2565.72,4603.85,4672.25,4836.83,16858.85
530850461994106496,2020-12,4287.84,5184.61,2588.31,1342.13,349.41,17208.26
532651509225740672,2020-01,3518.4,2367.36,1864.72,4579.62,-1563.86,-1563.86
532651509225740672,2020-02,4547.49,4900.64,868.79,3160.98,-2645.34,-4209.2
532651509225740672,2020-03,3953.63,4102.02,3008.18,3159.86,-300.07,-4509.27
532651509225740672,2020-04,1002.51,4161.95,4100.88,2159.64,-1218.2,-5727.47
532651509225740672,2020-05,5153.98,3868.62,1042.31,6029.86,-3702.19,-9429.66
532651509225740672,2020-06,5456.27,2710.66,4279.31,2781.11,4243.81,-5185.85
532651509225740672,2020-07,5389.39,3759.34,4391.85,5574.69,447.21,-4738.64
532651509225740672,2020-08,2272.04,3342.22,1512.39,1612.31,-1170.1,-5908.74
532651509225740672,2020-09,3951.34,3193.38,1247.86,2228.6,-222.78,-6131.52
532651509225740672,2020-10,3325.22,4493.59,4565.5,4171.28,-774.15,-6905.67
532651509225740672,2020-11,3561.52,3632.07,1497.45,2895.5,-1468.6,-8374.27
532651509225740672,2020-12,2577.29,3356.34,4055.93,3256.5,20.38,-8353.89
532727482664064192,2020-01,1860.36,3185.1,3692.8,5410.29,-3042.23,-3042.23
532727482664064192,2020-02,3035.13,3434.69,3292.15,2165.39,727.2,-2315.03
532727482664064192,2020-03,5132.06,2838.03,3700.65,3505.72,2488.96,173.93
532727482664064192,2020-04,5290.15,3917.47,1141.85,5225.22,-2710.69,-2536.76
532727482664064192,2020-05,1539.24,1510.21,0,1660.58,-1631.55,-4168.31
532727482664064192,2020-06,0,617.4,2094.81,1637.08,-159.67,-4327.98
532727482664064192,2020-07,1996.53,3546.08,4103.8,2324.56,229.69,-4098.29
532727482664064192,2020-08,0,4913.66,7928.4,5023.18,-2008.44,-6106.73
532727482664064192,2020-09,1794.84,1690.89,2679.16,3292.36,-509.25,-6615.98
532727482664064192,2020-10,2803.07,4774.32,2797.04,2348.48,-1522.69,-8138.67
532727482664064192,2020-11,3279.22,646.54,2676.57,2184.56,3124.69,-5013.98
532727482664064192,2020-12,2147.07,2644.72,5251.97,1101.31,3653.01,-1360.97
534452015751000640,2020-01,5070.91,4642.19,1980.94,10835.81,-8426.15,-8426.15
534452015751000640,2020-02,4704.37,5415.54,3440.47,5668.7,-2939.4,-11365.55
534452015751000640,2020-03,1362.63,3248.38,3142.48,0,1256.73,-10108.82
534452015751000640,2020-04,3125.54,3707.03,885.79,4192.94,-3888.64,-13997.46
534452015751000640,2020-05,3141.06,9222.13,1627.28,3095.45,-7549.24,-21546.7
534452015751000640,2020-06,5330.54,4941.75,5848.68,1706.61,4530.86,-17015.84
534452015751000640,2020-07,7129.55,4828.51,5980.32,2108.46,6172.9,-10842.94
534452015751000640,2020-08,4626.48,9194.58,5958.23,2700.77,-1310.64,-12153.58
534452015751000640,2020-09,2782.69,9332.86,6011.98,2580.69,-3118.88,-15272.46
534452015751000640,2020-10,5271.61,3353.2,5498.7,10390.43,-2973.32,-18245.78
534452015751000640,2020-11,8069.68,4774.07,4057.56,4832.36,2520.81,-15724.97
534452015751000640,2020-12,4544.07,2677.24,3852.3,2364.97,3354.16,-12370.81
534977583101047744,2020-01,6097.19,4259.55,2203.03,4044.43,-3.76,-3.76
534977583101047744,2020-02,2403.64,2923.61,4998.71,7589.01,-3110.27,-3114.03
534977583101047744,2020-03,4205.69,3695.77,5272.82,2369.81,3412.93,298.9
534977583101047744,2020-04,4702.81,5489.17,948.28,2831.05,-2669.13,-2370.23
534977583101047744,2020-05,4047.94,8625.08,8050.16,2628.9,844.12,-1526.11
534977583101047744,2020-06,2766.9,6742.68,6963.64,1217.01,1770.85,244.74
534977583101047744,2020-07,406.26,5342.04,1880.69,4564.36,-7619.45,-7374.71
534977583101047744,2020-08,4745.16,2877.9,5107.65,231.63,6743.28,-631.43
534977583101047744,2020-09,6836.76,6700.23,1730.42,231.24,1635.71,1004.28
534977583101047744,2020-10,3677.64,3145.67,9891.38,5233.92,5189.43,6193.71
534977583101047744,2020-11,2832.09,5486.11,6134.14,3346.62,133.5,6327.21
534977583101047744,2020-12,9495.77,6426.93,6780.61,1104.49,8744.96,15072.17
537186534353290240,2020-01,1214.42,1669.54,1980.41,0,1525.29,1525.29
537186534353290240,2020-03,297.76,608.7,0,287.2,-598.14,927.15
537186534353290240,2020-04,2771.62,3135.15,0,1509.74,-1873.27,-946.12
537186534353290240,2020-06,154.48,1629.68,2910.19,271.08,1163.91,217.79
537186534353290240,2020-07,864.62,1271.46,556.15,509.95,-360.64,-142.85
537186534353290240,2020-09,3339.46,4142.78,3033.94,2694.95,-464.33,-607.18
537186534353290240,2020-10,999.56,0,1513.31,0,2512.87,1905.69
537186534353290240,2020-11,2629.91,0,0,0,2629.91,4535.6
537628398804455168,2020-01,1265.89,3657.24,5380.98,4008.9,-1019.27,-1019.27
537628398804455168,2020-02,0,5641.06,4082.09,2642,-4200.97,-5220.24
537628398804455168,2020-03,2679.66,7196.9,5481.13,6365.78,-5401.89,-10622.13
537628398804455168,2020-04,5389.07,2158.31,6285.45,3434.49,6081.72,-4540.41
537628398804455168,2020-05,7131.22,5711.29,647.2,2384.32,-317.19,-4857.6
537628398804455168,2020-06,10035.6,5538.69,5627.71,3712.77,6411.85,1554.25
537628398804455168,2020-07,4806.72,6967.11,5666.7,5054.1,-1547.79,6.46
537628398804455168,2020-08,1375.39,2798.99,1278.83,174.87,-319.64,-313.18
537628398804455168,2020-09,3967.48,1428.39,4450.77,0,6989.86,6676.68
537628398804455168,2020-10,7196.15,7163.42,9671,2561.02,7142.71,13819.39
537628398804455168,2020-11,3907.34,279.14,1649.36,1022.01,4255.55,18074.94
537628398804455168,2020-12,7496.46,7009.15,5824.04,5894.41,416.94,18491.88
538277553418866048,2020-01,504.88,0,1354.33,3310.64,-1451.43,-1451.43
538277553418866048,2020-02,10.61,0,2598.92,1869.55,739.98,-711.45
538277553418866048,2020-03,4549.34,3138.95,4334.22,968.27,4776.34,4064.89
538277553418866048,2020-05,0,2021.09,6266.09,2146.94,2098.06,6162.95
538277553418866048,2020-06,3234.24,0,2156.58,2035.59,3355.23,9518.18
538277553418866048,2020-07,3645.5,1729.98,3992.41,1553.84,4354.09,13872.27
538277553418866048,2020-08,404.89,479.04,1289.78,5003.57,-3787.94,10084.33
538277553418866048,2020-09,5050.05,813.72,1496.57,0,5732.9,15817.23
538277553418866048,2020-10,3737.3,2908.24,0,1974.22,-1145.16,14672.07
538277553418866048,2020-11,1891.5,845.45,2793.82,1897.88,1941.99,16614.06
538277553418866048,2020-12,992,0,3959.58,2246.89,2704.69,19318.75
538283798447075840,2020-01,0,1132.26,1150.55,466.71,-448.42,-448.42
538283798447075840,2020-02,3692.83,1118.11,767.38,8943,-5600.9,-6049.32
538283798447075840,2020-03,2104.41,1329.83,1414.79,1974.8,214.57,-5834.75
538283798447075840,2020-04,342.3,2143.06,772.71,4655.26,-5683.31,-11518.06
538283798447075840,2020-05,1830.81,4537.09,3435.31,3002.18,-2273.15,-13791.21
538283798447075840,2020-06,7539.35,4235.17,4129.16,4510.96,2922.38,-10868.83
538283798447075840,2020-07,2996.21,2297.67,8544.36,3944.75,5298.15,-5570.68
538283798447075840,2020-08,1711.42,1523.99,3411.42,1545.32,2053.53,-3517.15
538283798447075840,2020-09,1629.17,546.99,2489.79,5610.29,-2038.32,-5555.47
538283798447075840,2020-10,1061.98,2513.99,3836.93,1509.65,875.27,-4680.2
538283798447075840,2020-11,0,10456.7,6132.94,8021.55,-12345.31,-17025.51
538283798447075840,2020-12,2231.3,1316.71,1751.09,1860.09,805.59,-16219.92
539643151269079168,2020-02,0,773.44,0,136.51,-909.95,-909.95
539643151269079168,2020-04,0,1291.07,0,0,-1291.07,-2201.02
541532630481975552,2020-01,1643.71,1559.27,3195.21,2438.05,841.6,841.6
541532630481975552,2020-02,2174.89,7673.25,7649.81,7123.76,-4972.31,-4130.71
541532630481975552,2020-03,2379.06,3809.55,3923.95,4872.43,-2378.97,-6509.68
541532630481975552,2020-04,0,2886.93,8010.38,3399.7,1723.75,-4785.93
541532630481975552,2020-05,5124.84,8064.87,1602.46,2307.89,-3645.46,-8431.39
541532630481975552,2020-06,1947.76,687.98,4209.1,9921.84,-4452.96,-12884.35
541532630481975552,2020-07,5268.65,2293.57,4180.87,4504.85,2651.1,-10233.25
541532630481975552,2020-08,4132.15,2737.41,3799.24,3385.34,1808.64,-8424.61
541532630481975552,2020-09,1813.06,9549.34,980.51,5632.58,-12388.35,-20812.96
541532630481975552,2020-10,4315.03,3317.82,4000.43,3700.78,1296.86,-19516.1
541532630481975552,2020-11,5565.2,3312.91,2439.1,4583.7,107.69,-19408.41
541532630481975552,2020-12,4998.23,5802.65,5309.91,1810.73,2694.76,-16713.65
541532790748751552,2020-01,5241.62,3673.37,2424.63,2486.24,1506.64,1506.64
541532790748751552,2020-02,2602.83,5223.28,2618.21,1295.79,-1298.03,208.61
541532790748751552,2020-03,653.33,8478.21,514.68,1321.33,-8631.53,-8422.92
541532790748751552,2020-04,3715.3,3626.92,366.59,4326.44,-3871.47,-12294.39
541532790748751552,2020-05,6551.9,5242.45,2842.07,5464.79,-1313.27,-13607.66
541532790748751552,2020-06,1050.2,6209.16,2736.06,5730.81,-8153.71,-21761.37
541532790748751552,2020-07,1259.22,2961.15,1671.9,4912.6,-4942.63,-26704
541532790748751552,2020-08,2124.49,4575.07,5589.84,6960.56,-3821.3,-30525.3
541532790748751552,2020-09,1059.11,5173.58,7463.59,6009.68,-2660.56,-33185.86
541532790748751552,2020-10,2985.83,3246.12,3450.91,5251.9,-2061.28,-35247.14
541532790748751552,2020-11,1763.98,2705.07,3506.57,7810.43,-5244.95,-40492.09
541532790748751552,2020-12,6147.11,4250.69,4692.86,7124.89,-535.61,-41027.7
541572363874914304,2020-01,1743.77,2721.51,1706.25,719.17,9.34,9.34
541572363874914304,2020-02,814.62,3722.05,8453.01,906.59,4638.99,4648.33
541572363874914304,2020-03,6816.21,886.12,4613.42,3184.99,7358.52,12006.85
541572363874914304,2020-04,91.19,1764.86,2451.66,3800.45,-3022.46,8984.39
541572363874914304,2020-05,3283.7,1120.48,1267.44,3304.73,125.93,9110.32
541572363874914304,2020-06,2345.54,7692.9,2183.36,4027.47,-7191.47,1918.85
541572363874914304,2020-07,8087.77,309.34,3435.09,2958.15,8255.37,10174.22
541572363874914304,2020-08,4121.37,1516.25,819.69,2746.92,677.89,10852.11
541572363874914304,2020-09,3263.71,0,603.47,32.45,3834.73,14686.84
541572363874914304,2020-10,4824.32,4505.5,0,2273.68,-1954.86,12731.98
541572363874914304,2020-11,3352.5,0,4315.59,1770.86,5897.23,18629.21
541572363874914304,2020-12,0,2395.72,14.8,3352.48,-5733.4,12895.81
543269957911512640,2020-01,4552.71,5966.87,0,3704.26,-5118.42,-5118.42
543269957911512640,2020-02,3916.91,4770.93,2310.87,3613.06,-2156.21,-7274.63
543269957911512640,2020-03,2345.8,11212.27,5604.31,1579.28,-4841.44,-12116.07
543269957911512640,2020-04,4491.68,2891.12,6336.66,1858.16,6079.06,-6037.01
543269957911512640,2020-05,3946.84,2529.23,6691.44,3409.52,4699.53,-1337.48
543269957911512640,2020-06,3638.72,1691.32,2143.81,3829.71,261.5,-1075.98
543269957911512640,2020-07,3434.54,4824.43,444.94,4602.16,-5547.11,-6623.09
543269957911512640,2020-08,1715.4,2981.76,4823.95,4832.43,-1274.84,-7897.93
543269957911512640,2020-09,2080.04,1712.05,4259.02,5103.78,-476.77,-8374.7
543269957911512640,2020-10,7780.08,9826.79,5306.71,2462.6,797.4,-7577.3
543269957911512640,2020-11,1894.68,2542.11,12256.35,5678.34,5930.58,-1646.72
543269957911512640,2020-12,5432.02,5174.31,7412.54,5011.49,2658.76,1012.04
543967230970500672,2020-02,712.51,0,1302.38,298.27,1716.62,1716.62
543967230970500672,2020-03,1301.08,5290.39,0,2204.13,-6193.44,-4476.82
543967230970500672,2020-04,0,981.8,947.11,0,-34.69,-4511.51
543967230970500672,2020-05,1975.47,0,0,1801.79,173.68,-4337.83
543967230970500672,2020-06,1930.24,0,187.75,1875.44,242.55,-4095.28
543967230970500672,2020-07,1805.87,1816.23,3781.59,1335.75,2435.48,-1659.8
543967230970500672,2020-08,0,2324.43,1826.76,2870.33,-3368,-5027.8
543967230970500672,2020-09,2647.99,0,1406.23,957.05,3097.17,-1930.63
543967230970500672,2020-10,1874.51,1116.8,0,0,757.71,-1172.92
543967230970500672,2020-11,0,1967.61,0,0,-1967.61,-3140.53
543967230970500672,2020-12,0,1269.73,1734.69,602.12,-137.16,-3277.69
545471681443437504,2020-07,0,1585.29,0,0,-1585.29,-1585.29
545471681443437504,2020-09,1267.81,0,0,0,1267.81,-317.48
545471681443437504,2020-10,508.83,1640.05,0,0,-1131.22,-1448.7
546866726400147584,2020-01,8628.75,2663.48,3992.82,10508.39,-550.3,-550.3
546866726400147584,2020-02,12367.61,3757.88,4687.36,3223.45,10073.64,9523.34
546866726400147584,2020-03,6299.53,2074.26,7818.76,7547.41,4496.62,14019.96
546866726400147584,2020-04,2618.47,2145.37,2998.59,3263.33,208.36,14228.32
546866726400147584,2020-05,0,5455.22,1635.95,2708,-6527.27,7701.05
546866726400147584,2020-06,6589.44,8100.39,5336.71,810.35,3015.41,10716.46
546866726400147584,2020-07,5693.92,678.2,1192.56,8382.11,-2173.83,8542.63
546866726400147584,2020-08,5529.87,3635.03,3008.13,7168.57,-2265.6,6277.03
546866726400147584,2020-09,3099.21,6104.47,4489.74,4006.33,-2521.85,3755.18
546866726400147584,2020-10,7114.44,3428.52,4299.13,2745.24,5239.81,8994.99
546866726400147584,2020-11,8298.39,4410.23,4147.08,4577.82,3457.42,12452.41
546866726400147584,2020-12,1570.81,3230.51,5299.11,6180.59,-2541.18,9911.23
547820592848630272,2020-01,1327.29,4204.67,2843.42,1805.05,-1839.01,-1839.01
547820592848630272,2020-02,0,2991.6,1132.91,2732.06,-4590.75,-6429.76
547820592848630272,2020-03,1416.36,3506.08,4299.46,859.78,1349.96,-5079.8
547820592848630272,2020-04,1316.99,1595.68,4435.61,4124.47,32.45,-5047.35
547820592848630272,2020-05,4080.49,3942.9,3436.81,2250.24,1324.16,-3723.19
547820592848630272,2020-06,6415.94,1948.09,5640.42,2284.47,7823.8,4100.61
547820592848630272,2020-07,8165.16,1704.64,4288.3,913.08,9835.74,13936.35
547820592848630272,2020-08,9432.44,1623.73,6647.89,1155.82,13300.78,27237.13
547820592848630272,2020-09,1932.72,4999.27,1777.81,1261.9,-2550.64,24686.49
547820592848630272,2020-10,3642.67,6196.13,6256.18,8997.08,-5294.36,19392.13
547820592848630272,2020-11,1486.73,661.49,2099.27,8260.33,-5335.82,14056.31
547820592848630272,2020-12,3369.48,3730.52,3338.92,1475.05,1502.83,15559.14
548356499581734080,2020-01,4047.03,2452.88,0,2790.28,-1196.13,-1196.13
548356499581734080,2020-02,3137.77,0,1779.9,2386.47,2531.2,1335.07
548356499581734080,2020-03,3112.35,3600.33,3100.63,3080.9,-468.25,866.82
548356499581734080,2020-04,1734.39,411.41,1051.67,0,2374.65,3241.47
548356499581734080,2020-05,4078.34,3288.65,3592.1,3472.53,909.26,4150.73
548356499581734080,2020-06,1138.56,5161.98,2715.5,4400.57,-5708.49,-1557.76
548356499581734080,2020-07,6550.42,2553.34,1753.07,2563.07,3187.08,1629.32
548356499581734080,2020-08,2852.91,1098.06,7023.82,5774.1,3004.57,4633.89
548356499581734080,2020-09,941.69,2308,1110.53,4274.2,-4529.98,103.91
548356499581734080,2020-10,2700.79,1689.44,1674.37,913.03,1772.69,1876.6
548356499581734080,2020-11,3385.13,2869.17,2702.82,3967.72,-748.94,1127.66
548356499581734080,2020-12,738.75,1314.52,1585.35,69.21,940.37,2068.03
549002175781568192,2020-02,1012.88,0,674.13,0,1687.01,1687.01
549002175781568192,2020-03,1071.57,0,1279.74,4392.82,-2041.51,-354.5
549002175781568192,2020-04,2765.4,3460.86,1250.16,0,554.7,200.2
549002175781568192,2020-05,541.7,3940.13,1173.69,1970.07,-4194.81,-3994.61
549002175781568192,2020-06,0,3809.63,99.67,1502.43,-5212.39,-9207
549002175781568192,2020-07,0,1377.5,778.97,4179.49,-4778.02,-13985.02
549002175781568192,2020-08,1940.72,883.85,2347.8,1312.56,2092.11,-11892.91
549002175781568192,2020-09,1567.4,1656.88,1459.97,0,1370.49,-10522.42
549002175781568192,2020-10,1783.29,1399.29,1210.46,0,1594.46,-8927.96
549002175781568192,2020-12,3275.25,1994.49,1718.86,0,2999.62,-5928.34
549342018340393088,2020-01,292.57,1796.14,2107.28,0,603.71,603.71
549342018340393088,2020-02,0,2348.67,39.17,804.67,-3114.17,-2510.46
549342018340393088,2020-03,3146.08,2372.93,3251.43,0,4024.58,1514.12
549342018340393088,2020-04,2858.02,1879.75,1822.75,2713.06,87.96,1602.08
549342018340393088,2020-05,0,1506.39,2336.17,0,829.78,2431.86
549342018340393088,2020-06,1603.49,0,3847.24,0,5450.73,7882.59
549342018340393088,2020-07,417.8,2436.6,931.45,2155.16,-3242.51,4640.08
549342018340393088,2020-08,4259.11,1055.03,1778.16,960.95,4021.29,8661.37
549342018340393088,2020-09,3591.79,0,3136.51,1957.5,4770.8,13432.17
549342018340393088,2020-10,1142.1,2173.91,4532.66,3798.53,-297.68,13134.49
549342018340393088,2020-11,1560.31,2264.06,0,2216.74,-2920.49,10214
549342018340393088,2020-12,2943.81,1633.37,1241.36,0,2551.8,12765.8
549450617688814144,2020-01,3536.38,2547.45,984.15,219.12,1753.96,1753.96
549450617688814144,2020-02,2223.39,1310.03,1656.67,7415.18,-4845.15,-3091.19
549450617688814144,2020-03,4496.24,3308.2,1486.24,3212.24,-537.96,-3629.15
549450617688814144,2020-04,2065.79,1047.75,2960.68,2772.49,1206.23,-2422.92
549450617688814144,2020-05,221.86,3334.2,4129.06,2009.83,-993.11,-3416.03
549450617688814144,2020-06,2237.48,6659.85,1485.28,2200.4,-5137.49,-8553.52
549450617688814144,2020-07,3041.12,0,2026.23,5104.68,-37.33,-8590.85
549450617688814144,2020-08,923.27,7990.96,134.42,2297.6,-9230.87,-17821.72
549450617688814144,2020-09,0,2735.87,1667.46,2202.08,-3270.49,-21092.21
549450617688814144,2020-10,1853.82,5871.5,1535.42,1627.41,-4109.67,-25201.88
549450617688814144,2020-11,0,2550.87,2844.34,573.37,-279.9,-25481.78
549770178479152320,2020-02,2575.85,732.33,3145.73,1698.2,3291.05,3291.05
549770178479152320,2020-03,0,4394.77,3104.61,1979.23,-3269.39,21.66
549770178479152320,2020-04,1447.22,0,793.35,1403.54,837.03,858.69
549770178479152320,2020-05,1940.88,0,0,1554.1,386.78,1245.47
549770178479152320,2020-06,0,1064.53,0,2352.95,-3417.48,-2172.01
549770178479152320,2020-08,811.69,883.72,0,0,-72.03,-2244.04
549770178479152320,2020-09,531.39,2161.23,974.91,0,-654.93,-2898.97
549770178479152320,2020-10,1428.09,0,1972.51,0,3400.6,501.63
549770178479152320,2020-11,557.19,0,1674.83,0,2232.02,2733.65
549770178479152320,2020-12,0,1082.92,1767.07,2790.25,-2106.1,627.55
551549480172898944,2020-01,1516.06,733.09,148.68,4365.02,-3433.37,-3433.37
551549480172898944,2020-02,1758.41,0,0,285.44,1472.97,-1960.4
551549480172898944,2020-03,692.92,3011.36,2698.44,1155.82,-775.82,-2736.22
551549480172898944,2020-04,4783.17,3977.97,0,0,805.2,-1931.02
551549480172898944,2020-05,0,860.07,551.28,672.7,-981.49,-2912.51
551549480172898944,2020-06,791.66,1798.78,0,3688.71,-4695.83,-7608.34
551549480172898944,2020-07,1851.7,1722.47,1127.35,1661.92,-405.34,-8013.68
551549480172898944,2020-08,1815.83,3612.3,1749.78,5329.76,-5376.45,-13390.13
551549480172898944,2020-09,0,3014.6,0,0,-3014.6,-16404.73
551549480172898944,2020-10,3715.17,0,1595.22,3954.54,1355.85,-15048.88
551549480172898944,2020-11,338.12,2719.68,1904.27,204.21,-681.5,-15730.38
551549480172898944,2020-12,0,3501.04,6248.07,2327.8,419.23,-15311.15
552409769738794304,2020-01,253.13,4910.7,2128.45,1214.97,-3744.09,-3744.09
552409769738794304,2020-02,1646.26,0,0,3030.01,-1383.75,-5127.84
552409769738794304,2020-03,4437.63,799.22,1347.47,1010.11,3975.77,-1152.07
552409769738794304,2020-04,5896.73,2239.51,209.26,0,3866.48,2714.41
552409769738794304,2020-05,527.49,1571.87,1433.98,1141.55,-751.95,1962.46
552409769738794304,2020-06,2081.45,999.28,364.9,0,1447.07,3409.53
552409769738794304,2020-07,4426.64,0,1409.08,364.23,5471.49,8881.02
552409769738794304,2020-08,0,3357.71,4561.32,1880.14,-676.53,8204.49
552409769738794304,2020-09,1837.09,6429.34,8018.73,3162.09,264.39,8468.88
552409769738794304,2020-10,0,4420.6,0,0,-4420.6,4048.28
552409769738794304,2020-11,1034.42,1413.65,1848.3,0,1469.07,5517.35
552409769738794304,2020-12,3576.05,1905.3,0,377.23,1293.52,6810.87
553845833311154240,2020-01,3216.47,2848.47,1208.3,4564.5,-2988.2,-2988.2
553845833311154240,2020-02,8995.33,3750.93,5941.92,4807.23,6379.09,3390.89
553845833311154240,2020-03,771.16,6853.8,7558.65,4281.6,-2805.59,585.3
553845833311154240,2020-04,4512.56,7863.36,1235.37,4545.31,-6660.74,-6075.44
553845833311154240,2020-05,4655.34,2213.32,2184.75,9478.65,-4851.88,-10927.32
553845833311154240,2020-06,3802.54,1957.6,4125.26,2303.72,3666.48,-7260.84
553845833311154240,2020-07,5528.17,302.5,3437.84,2227.98,6435.53,-825.31
553845833311154240,2020-08,2728.41,1949.62,4307.93,3638.73,1447.99,622.68
553845833311154240,2020-09,6108.11,449.48,2959.99,10046.88,-1428.26,-805.58
553845833311154240,2020-10,2922.33,4255.55,5452.97,1567.44,2552.31,1746.73
553845833311154240,2020-11,8017.65,4122.38,6006.96,3753.23,6149,7895.73
553845833311154240,2020-12,4971.29,4528.48,6492.63,6552.33,383.11,8278.84
553877761827634368,2020-01,5034.87,1902.94,5538.98,3500.46,5170.45,5170.45
553877761827634368,2020-02,3158,2785.73,4868.36,5822.19,-581.56,4588.89
553877761827634368,2020-03,8577.36,1943.65,8593.31,6040.86,9186.16,13775.05
553877761827634368,2020-04,6318.29,9107.3,3184.82,4011.67,-3615.86,10159.19
553877761827634368,2020-05,8072.69,5811.5,1629.79,5842.39,-1951.41,8207.78
553877761827634368,2020-06,9739.88,4185.28,4875.77,2131.79,8298.58,16506.36
553877761827634368,2020-07,4309.04,6246.13,4222.27,3555.28,-1270.1,15236.26
553877761827634368,2020-08,4176.63,3169.39,1156.84,5393.59,-3229.51,12006.75
553877761827634368,2020-09,2842.31,4657.73,4110,3056.62,-762.04,11244.71
553877761827634368,2020-10,3320.55,4200.29,6431.78,4659.24,892.8,12137.51
553877761827634368,2020-11,4955.53,3851.64,5256.32,57.17,6303.04,18440.55
553877761827634368,2020-12,6291.47,6638.08,9748.92,2868.14,6534.17,24974.72
554400726544294464,2020-01,6312.87,4330.54,3862.29,8144.55,-2299.93,-2299.93
554400726544294464,2020-02,5280.77,1480.64,3622.69,2882.34,4540.48,2240.55
554400726544294464,2020-03,2646.73,1127.91,3417.22,4074.49,861.55,3102.1
554400726544294464,2020-04,2032.3,1095.17,1133.02,4305.08,-2234.93,867.17
554400726544294464,2020-05,5005.6,5876.55,3079.3,3058.41,-850.06,17.11
554400726544294464,2020-06,4265.61,4228.93,3915.74,6374.56,-2422.14,-2405.03
554400726544294464,2020-07,4119.74,7526.35,1129.11,3463.03,-5740.53,-8145.56
554400726544294464,2020-08,3499.26,10231.28,7032.7,5966.67,-5665.99,-13811.55
554400726544294464,2020-09,4324.59,2250.65,3760.23,3963.2,1870.97,-11940.58
554400726544294464,2020-10,6582.13,2747.72,3593.31,1232.96,6194.76,-5745.82
554400726544294464,2020-11,913.03,2904.82,5234.18,8904.86,-5662.47,-11408.29
554400726544294464,2020-12,2165.62,6135.23,3240.47,1332.27,-2061.41,-13469.7
554745589994320704,2020-01,429.7,1985.28,293.78,293.03,-1554.83,-1554.83
554745589994320704,2020-02,927.45,2097.39,2748.79,0,1578.85,24.02
554745589994320704,2020-03,3046.96,1372.97,0,0,1673.99,1698.01
554745589994320704,2020-04,2278.72,0,85.21,1432.19,931.74,2629.75
554745589994320704,2020-05,1226.24,735.19,1098.29,85.51,1503.83,4133.58
554745589994320704,2020-06,2856.95,0,2848.31,4468.11,1237.15,5370.73
554745589994320704,2020-07,383.82,1486.34,1653.29,188.85,361.92,5732.65
554745589994320704,2020-08,779.44,248.57,1506.54,0.56,2036.85,7769.5
554745589994320704,2020-09,785.53,650.56,3700.67,0,3835.64,11605.14
554745589994320704,2020-10,3805.07,970.47,0,342.4,2492.2,14097.34
554745589994320704,2020-11,365.84,1630.7,5812.22,2129.82,2417.54,16514.88
554745589994320704,2020-12,1782.49,2453.32,1598.19,2118.8,-1191.44,15323.44
555210813361430656,2020-01,3204.12,2125.26,0,3205.75,-2126.89,-2126.89
555210813361430656,2020-02,396.91,1882.66,1358.08,838.18,-965.85,-3092.74
555210813361430656,2020-03,345.68,1879.91,3494.65,932.16,1028.26,-2064.48
555210813361430656,2020-04,1656.17,1602.61,0,1813.89,-1760.33,-3824.81
555210813361430656,2020-05,3073.45,0,880.73,6889.46,-2935.28,-6760.09
555210813361430656,2020-06,0,39.73,2273.83,0,2234.1,-4525.99
555210813361430656,2020-07,1382.47,483.89,2266.46,483.12,2681.92,-1844.07
555210813361430656,2020-08,2679.42,0,0,1410.13,1269.29,-574.78
555210813361430656,2020-09,1962.7,6325.07,2325.13,0,-2037.24,-2612.02
555210813361430656,2020-11,701.75,124.73,919.38,494.06,1002.34,-1609.68
555210813361430656,2020-12,801.97,0,4337.04,0,5139.01,3529.33
555267790260254144,2020-01,8314.47,5778.02,5134.62,8003.5,-332.43,-332.43
555267790260254144,2020-02,5236.73,3139.93,6032.84,3375.95,4753.69,4421.26
555267790260254144,2020-03,5306.31,11583.74,7657.99,5897.99,-4517.43,-96.17
555267790260254144,2020-04,2359.72,6283.62,4851.49,4926.65,-3999.06,-4095.23
555267790260254144,2020-05,2953.71,3543.73,7387.38,2130.53,4666.83,571.6
555267790260254144,2020-06,4963.47,7715.89,2755.64,4175.93,-4172.71,-3601.11
555267790260254144,2020-07,3516.7,4498.29,4122.25,3451.2,-310.54,-3911.65
555267790260254144,2020-08,5161.19,1510.74,6042.23,3032.07,6660.61,2748.96
555267790260254144,2020-09,3711.53,8278.58,2204.88,6940.48,-9302.65,-6553.69
555267790260254144,2020-10,1078.32,5510.94,1255.93,6698.58,-9875.27,-16428.96
555267790260254144,2020-11,3496.15,4850.47,6468.71,6483.45,-1369.06,-17798.02
555267790260254144,2020-12,1953.64,3430.03,7779.73,2546.44,3756.9,-14041.12
556295770816320320,2020-01,10029.35,4732.47,0,6128.99,-832.11,-832.11
556295770816320320,2020-02,2775.11,1388.65,2391.86,7032.95,-3254.63,-4086.74
556295770816320320,2020-03,2884.24,2224.73,3072.67,5708.01,-1975.83,-6062.57
556295770816320320,2020-04,7383.38,1630.29,2219.47,942.21,7030.35,967.78
556295770816320320,2020-05,2232.43,5430.63,4184.22,4313.67,-3327.65,-2359.87
556295770816320320,2020-06,4322.23,1479.15,1914.89,5464.28,-706.31,-3066.18
556295770816320320,2020-07,1875.28,110.26,7124.77,2689.24,6200.55,3134.37
556295770816320320,2020-08,6130.05,1805.73,3126.29,4466.4,2984.21,6118.58
556295770816320320,2020-09,5882.56,5523.33,2615.08,537.03,2437.28,8555.86
556295770816320320,2020-10,6021.53,2637.31,3373.45,1489.42,5268.25,13824.11
556295770816320320,2020-11,3014.66,3840.48,1677.74,4466.29,-3614.37,10209.74
556295770816320320,2020-12,3081.78,6561.52,0,3089.46,-6569.2,3640.54
558207976659453184,2020-01,0,4740.19,0,1043.51,-5783.7,-5783.7
558207976659453184,2020-02,1727.67,1663.93,104.62,2601.37,-2433.01,-8216.71
558207976659453184,2020-03,3059.82,4315.22,3034.81,2135.12,-355.71,-8572.42
558207976659453184,2020-04,0,393.95,10.72,4130.49,-4513.72,-13086.14
558207976659453184,2020-05,4083.8,1733.56,0,3632.23,-1281.99,-14368.13
558207976659453184,2020-06,2045.85,2332.53,0,1534.07,-1820.75,-16188.88
558207976659453184,2020-07,2250.88,1693.14,900.03,1980.46,-522.69,-16711.57
558207976659453184,2020-08,0,6567.88,1328.27,675.77,-5915.38,-22626.95
558207976659453184,2020-09,4739.49,4108.66,0,1556.5,-925.67,-23552.62
558207976659453184,2020-10,1781.16,519.78,2412.11,2081.91,1591.58,-21961.04
558207976659453184,2020-11,0,2715.68,1627.31,3279.87,-4368.24,-26329.28
558207976659453184,2020-12,1554.35,1567.1,376.94,0,364.19,-25965.09
558384681416663104,2020-01,5071.5,1470.04,2226.39,2010.86,3816.99,3816.99
558384681416663104,2020-02,322.25,4029,1563.36,416.86,-2560.25,1256.74
558384681416663104,2020-03,1672.59,0,0,2244.84,-572.25,684.49
558384681416663104,2020-04,1537.02,0,454.96,1964,27.98,712.47
558384681416663104,2020-05,4053.7,5141.28,97.85,533.04,-1522.77,-810.3
558384681416663104,2020-06,4831.75,2324.15,2824.71,747.07,4585.24,3774.94
558384681416663104,2020-07,0,3260.33,730.86,4253.31,-6782.78,-3007.84
558384681416663104,2020-08,853.4,1390.84,4814.81,1904.87,2372.5,-635.34
558384681416663104,2020-09,399.54,215.36,354.66,2345.79,-1806.95,-2442.29
558384681416663104,2020-10,3463.33,948.86,1548.66,1389.19,2673.94,231.65
558384681416663104,2020-11,0,1306.79,872.16,0,-434.63,-202.98
558384681416663104,2020-12,3264.71,1457.51,3050.43,6564.91,-1707.28,-1910.26
558874953703302400,2020-01,1642.58,1570.49,2562.3,4222.5,-1588.11,-1588.11
558874953703302400,2020-02,1799.91,6107.76,3577.27,2556.9,-3287.48,-4875.59
558874953703302400,2020-03,4281.96,2266.44,449.91,3790.34,-1324.91,-6200.5
558874953703302400,2020-04,2093.27,1050.31,1767.95,1415.5,1395.41,-4805.09
558874953703302400,2020-05,718.47,2486.58,2337.37,1194.91,-625.65,-5430.74
558874953703302400,2020-06,9173.37,1289.51,4152.68,1308.42,10728.12,5297.38
558874953703302400,2020-07,5003.14,6338.73,4151.76,3499.76,-683.59,4613.79
558874953703302400,2020-08,1664.64,3644.82,1937.31,3152.24,-3195.11,1418.68
558874953703302400,2020-09,2714.55,1753.19,3890.64,0,4852,6270.68
558874953703302400,2020-10,0,17.48,1536.05,6095.93,-4577.36,1693.32
558874953703302400,2020-11,1499.93,1963.01,3562.11,1822.79,1276.24,2969.56
558874953703302400,2020-12,5046.49,3475.77,3170.44,5682.27,-941.11,2028.45
558934177634408832,2020-01,3563.43,0,3027.84,2770.11,3821.16,3821.16
558934177634408832,2020-02,3833.72,2477.24,0,2853.27,-1496.79,2324.37
558934177634408832,2020-03,2636.13,4085.63,1685.06,2705.92,-2470.36,-145.99
558934177634408832,2020-04,1646.31,4140.35,5132.46,3246.52,-608.1,-754.09
558934177634408832,2020-05,3442.17,3227.93,0,3216.16,-3001.92,-3756.01
558934177634408832,2020-06,670.46,9141.14,1031.76,3651.43,-11090.35,-14846.36
558934177634408832,2020-07,3481.08,817.39,3706.5,3023.6,3346.59,-11499.77
558934177634408832,2020-08,8017.22,7871.27,3770.51,2238.4,1678.06,-9821.71
558934177634408832,2020-09,6226.15,4567.93,3518.93,5657.8,-480.65,-10302.36
558934177634408832,2020-10,1700.64,1467.86,3557.54,158.25,3632.07,-6670.29
558934177634408832,2020-11,3795.03,0,4458.16,4310.05,3943.14,-2727.15
558934177634408832,2020-12,848.33,897.06,5062.28,0,5013.55,2286.4
559458500844138304,2020-01,1835.21,0,3710.11,3427.93,2117.39,2117.39
559458500844138304,2020-02,987.76,1491.44,105.97,0,-397.71,1719.68
559458500844138304,2020-04,869.18,0,1243.69,0,2112.87,3832.55
559458500844138304,2020-08,0,666.42,1270.96,311.39,293.15,4125.7
559458500844138304,2020-09,0,849.31,0,1017.43,-1866.74,2258.96
559458500844138304,2020-10,203.69,0,0,819.7,-616.01,1642.95
559458500844138304,2020-12,1588.16,488.88,0,0,1099.28,2742.23
562828086859443456,2020-01,5556.62,3262.12,2119.24,0,4413.74,4413.74
562828086859443456,2020-02,2801.59,652.61,2779.55,0,4928.53,9342.27
562828086859443456,2020-03,4821.69,7416.41,4437.92,4213.71,-2370.51,6971.76
562828086859443456,2020-04,6074.74,1365.72,8643.95,2742.15,10610.82,17582.58
562828086859443456,2020-05,1950.68,3533.89,3145.42,3798.79,-2236.58,15346
562828086859443456,2020-06,1905.51,14.17,0,3085.26,-1193.92,14152.08
562828086859443456,2020-07,1394.03,1678.36,1997.47,2508.86,-795.72,13356.36
562828086859443456,2020-08,545.8,3169.65,4673.48,1913.77,135.86,13492.22
562828086859443456,2020-09,868.53,1962.26,780.58,4393.2,-4706.35,8785.87
562828086859443456,2020-10,1382.89,1268.39,7555.82,1788.82,5881.5,14667.37
562828086859443456,2020-11,0,88.02,1839.7,1198.13,553.55,15220.92
562828086859443456,2020-12,4201.1,4111.98,3795.83,869.71,3015.24,18236.16
565886342274184960,2020-05,0,1364.19,0,413.11,-1777.3,-1777.3
565886342274184960,2020-12,1043.78,1589.89,0,0,-546.11,-2323.41
566971933804816640,2020-01,2008.79,2088.3,1842.54,1658.69,104.34,104.34
566971933804816640,2020-02,8459.11,6401.14,9876.62,2227.28,9707.31,9811.65
566971933804816640,2020-03,6375.02,3094.05,4477.73,2894.04,4864.66,14676.31
566971933804816640,2020-04,2568.57,2818.75,6117.61,3415.74,2451.69,17128
566971933804816640,2020-05,3484.65,12875.5,5468.63,2540.68,-6462.9,10665.1
566971933804816640,2020-06,3532.45,2231.55,4984.17,1446.27,4838.8,15503.9
566971933804816640,2020-07,10016.95,3783.06,3071.84,4121.1,5184.63,20688.53
566971933804816640,2020-08,8891.73,1039.25,3511.82,8177.26,3187.04,23875.57
566971933804816640,2020-09,3992.9,6499.79,3798.21,3596.09,-2304.77,21570.8
566971933804816640,2020-10,6081.7,705.88,5226.83,5443.56,5159.09,26729.89
566971933804816640,2020-11,2872.94,4884.85,3784.95,4393.39,-2620.35,24109.54
566971933804816640,2020-12,3251.43,6388.98,4979.3,6377.93,-4536.18,19573.36
568802897200326592,2020-01,0,1049.26,1238.35,2629.56,-2440.47,-2440.47
568802897200326592,2020-02,1721.58,1514.96,1159.46,30.21,1335.87,-1104.6
568802897200326592,2020-03,1082.42,1961.36,1241.7,1084.67,-721.91,-1826.51
568802897200326592,2020-04,1015.83,6947.14,3088.57,95.51,-2938.25,-4764.76
568802897200326592,2020-05,3659.42,524.18,1865.88,1408.25,3592.87,-1171.89
568802897200326592,2020-07,536.02,2000.74,0,925.43,-2390.15,-3562.04
568802897200326592,2020-08,0,1617.86,127.99,548.16,-2038.03,-5600.07
568802897200326592,2020-09,3323.24,2409.05,2946.63,1412.8,2448.02,-3152.05
568802897200326592,2020-10,967.68,3794.03,2627.67,0,-198.68,-3350.73
568802897200326592,2020-11,1218.52,0,3172.83,2478.1,1913.25,-1437.48
568802897200326592,2020-12,2729.98,0,1052.28,3330.51,451.75,-985.73
569196856363929536,2020-03,0,456.41,1323.38,0,866.97,866.97
569196856363929536,2020-05,0,383.53,0,0,-383.53,483.44
569982868420369280,2020-02,61.12,2192.11,0,0,-2130.99,-2130.99
569982868420369280,2020-03,1935.39,1026.09,3747.02,0,4656.32,2525.33
569982868420369280,2020-04,0,819.42,0,196.89,-1016.31,1509.02
569982868420369280,2020-05,0,4117.01,0,1628.38,-5745.39,-4236.37
569982868420369280,2020-06,1747.86,0,0,1817.09,-69.23,-4305.6
569982868420369280,2020-07,756.87,1959.82,1046.31,1667.94,-1824.58,-6130.18
569982868420369280,2020-08,0,2950.87,0,0,-2950.87,-9081.05
569982868420369280,2020-09,0,1708.31,1461.2,1678,-1925.11,-11006.16
569982868420369280,2020-10,0,1876.35,1685.09,559.65,-750.91,-11757.07
569982868420369280,2020-11,702.69,304.12,1490.15,0,1888.72,-9868.35
571410543986682176,2020-01,3278.73,6.36,0,5190.74,-1918.37,-1918.37
571410543986682176,2020-02,847.73,1444.25,5312.46,2202.9,2513.04,594.67
571410543986682176,2020-03,0,447.12,444.68,511.24,-513.68,80.99
571410543986682176,2020-04,4063.66,784.95,1103.41,4396.72,-14.6,66.39
571410543986682176,2020-05,2334.64,0,2962.82,0,5297.46,5363.85
571410543986682176,2020-06,1902.66,345.86,1502.65,2674.7,384.75,5748.6
571410543986682176,2020-07,121.51,3081.79,2925.36,0,-34.92,5713.68
571410543986682176,2020-08,3020.07,0,921.11,1486.43,2454.75,8168.43
571410543986682176,2020-09,2015.31,1354.11,1719.74,2015.1,365.84,8534.27
571410543986682176,2020-10,1430.14,6263.12,0,4463.08,-9296.06,-761.79
571410543986682176,2020-11,1437.22,1505.56,0,1130.89,-1199.23,-1961.02
571410543986682176,2020-12,0,3517.83,0,1965.47,-5483.3,-7444.32
571464116616235456,2020-01,3355.86,519.52,2588.83,3171.75,2253.42,2253.42
571464116616235456,2020-02,555.16,0,4582.61,0,5137.77,7391.19
571464116616235456,2020-03,0,2183.86,1534.72,1915.35,-2564.49,4826.7
571464116616235456,2020-04,5020.16,5220.72,4230.3,1129.01,2900.73,7727.43
571464116616235456,2020-05,5355.54,1838.52,1913.8,3028.63,2402.19,10129.62
571464116616235456,2020-06,2194.97,2246.54,3840.49,0,3788.92,13918.54
571464116616235456,2020-08,860.98,5356.47,3149.92,1083.63,-2429.2,11489.34
571464116616235456,2020-09,1998.67,2116.7,1160.38,4202.72,-3160.37,8328.97
571464116616235456,2020-10,1942.8,0,5763.96,1933,5773.76,14102.73
571464116616235456,2020-11,214.41,2370.47,3153.58,176.61,820.91,14923.64
571464116616235456,2020-12,5115.56,2925.86,168.92,0,2358.62,17282.26
571555537682798976,2020-01,2421.53,2137.42,3110.73,2256.33,1138.51,1138.51
571555537682798976,2020-02,4110.2,3437.16,940.02,2573.4,-960.34,178.17
571555537682798976,2020-03,1221.88,2953.75,4717.45,9256.79,-6271.21,-6093.04
571555537682798976,2020-04,3799.86,1485.03,1517.91,5102.31,-1269.57,-7362.61
571555537682798976,2020-05,4180.01,1816.47,1756.09,1643.96,2475.67,-4886.94
571555537682798976,2020-06,2397.12,3023.94,3612.99,5158.65,-2172.48,-7059.42
571555537682798976,2020-07,7435.1,5901.99,5450.04,8212.93,-1229.78,-8289.2
571555537682798976,2020-08,5230.86,4534.92,8776.13,5107.19,4364.88,-3924.32
571555537682798976,2020-09,3342.43,1982.29,6085.36,2185.49,5260.01,1335.69
571555537682798976,2020-10,663.03,1910.07,2517.11,2886.32,-1616.25,-280.56
571555537682798976,2020-11,92.8,3503.97,4074.6,1940.93,-1277.5,-1558.06
571555537682798976,2020-12,4652.87,461.94,0,796.69,3394.24,1836.18
573585639746188608,2020-01,6036.56,7209.76,2356.58,3843.03,-2659.65,-2659.65
573585639746188608,2020-02,0,1943.38,3561.35,4216.74,-2598.77,-5258.42
573585639746188608,2020-03,2668.19,1959.05,4631.9,5397.41,-56.37,-5314.79
573585639746188608,2020-04,1636.58,9164.56,7755.84,3139.16,-2911.3,-8226.09
573585639746188608,2020-05,7885.8,3429.28,5033.8,1398.84,8091.48,-134.61
573585639746188608,2020-06,2416.1,3850.36,5596.61,10209.89,-6047.54,-6182.15
573585639746188608,2020-07,4080.71,5690.6,3888.19,2801.75,-523.45,-6705.6
573585639746188608,2020-08,6371.78,4329.92,6140.73,3955.21,4227.38,-2478.22
573585639746188608,2020-09,5168.37,3918.77,3161.28,1572.41,2838.47,360.25
573585639746188608,2020-10,1074.41,8470.47,7192.47,3733.74,-3937.33,-3577.08
573585639746188608,2020-11,3929.67,4170.05,5485.63,5350.76,-105.51,-3682.59
573585639746188608,2020-12,5629.29,9316.69,2531.12,2733.74,-3890.02,-7572.61
574092238798863616,2020-01,6840.82,3865.13,2705.26,6413.69,-732.74,-732.74
574092238798863616,2020-02,3581.44,2443.99,2763.57,1842.38,2058.64,1325.9
574092238798863616,2020-03,372.4,3519.91,5156.94,1890.57,118.86,1444.76
574092238798863616,2020-04,2341.8,4251.23,2301.21,3628.27,-3236.49,-1791.73
574092238798863616,2020-05,3039.85,10329.67,4230.62,5281.94,-8341.14,-10132.87
574092238798863616,2020-06,2602.89,4419.93,5944.02,2280.9,1846.08,-8286.79
574092238798863616,2020-07,3062.29,4639.54,4217.67,1838.3,802.12,-7484.67
574092238798863616,2020-08,6811.78,1644.93,6107.68,2634.11,8640.42,1155.75
574092238798863616,2020-09,0,4583.46,1542,4910.21,-7951.67,-6795.92
574092238798863616,2020-10,4999.05,1561.53,1806.82,4313.39,930.95,-5864.97
574092238798863616,2020-11,4087,2647.11,5229.62,5047.16,1622.35,-4242.62
574092238798863616,2020-12,6224.74,3774.47,2745.17,6550.17,-1354.73,-5597.35
574562920369879168,2020-01,1428.66,0,822.13,1616.58,634.21,634.21
574562920369879168,2020-03,0,1228.76,1453.47,734.59,-509.88,124.33
574562920369879168,2020-05,0,1010.71,48.67,0,-962.04,-837.71
574562920369879168,2020-07,453.08,1060.05,1081.3,0,474.33,-363.38
574562920369879168,2020-09,0,1109.7,1984.54,0,874.84,511.46
574562920369879168,2020-11,1553.04,0,1707.64,0,3260.68,3772.14
574562920369879168,2020-12,1679.81,1339.98,1865.88,2438.68,-232.97,3539.17
580090437827170048,2020-01,1114.86,3544.04,7620.65,3632.95,1558.52,1558.52
580090437827170048,2020-02,1189.42,0,740.21,1054.18,875.45,2433.97
580090437827170048,2020-03,7289.17,0,6433.68,2672.04,11050.81,13484.78
580090437827170048,2020-04,5074.34,322.62,1666.14,3439.63,2978.23,16463.01
580090437827170048,2020-05,1514.06,3998.66,3451.88,1741.64,-774.36,15688.65
580090437827170048,2020-06,4064.94,2283.71,572.14,0,2353.37,18042.02
580090437827170048,2020-07,5860.57,1562.74,2294.81,2316.36,4276.28,22318.3
580090437827170048,2020-08,4611.89,1591.15,3983.28,3640.82,3363.2,25681.5
580090437827170048,2020-09,1325.38,4174.57,2127.05,3761.9,-4484.04,21197.46
580090437827170048,2020-10,5735.59,3959.41,726.07,3289.19,-786.94,20410.52
580090437827170048,2020-11,313.59,2787.51,329.1,4925.45,-7070.27,13340.25
580090437827170048,2020-12,0,1726.6,3137.71,7442.7,-6031.59,7308.66
580506987247854592,2020-01,1629.92,2108.91,0,0,-478.99,-478.99
580506987247854592,2020-02,1493.54,1459.54,285.44,0,319.44,-159.55
580506987247854592,2020-03,0,2057.86,2580.98,0,523.12,363.57
580506987247854592,2020-04,0,2847.83,0,0,-2847.83,-2484.26
580506987247854592,2020-06,2575.89,872.9,0,1709.53,-6.54,-2490.8
580506987247854592,2020-07,3418.52,1923.62,635,0,2129.9,-360.9
580506987247854592,2020-08,2313.9,1753.44,692.04,535.24,717.26,356.36
580506987247854592,2020-09,1746.43,0,682.47,639.04,1789.86,2146.22
580506987247854592,2020-10,0,7.45,1039.81,0,1032.36,3178.58
580506987247854592,2020-11,1643.75,0,0,582.11,1061.64,4240.22
581537221241878656,2020-02,0,6.76,1609.54,1654.08,-51.3,-51.3
581537221241878656,2020-03,1559.25,1768.01,927.03,210.82,507.45,456.15
581537221241878656,2020-04,2004.29,1910.72,1447.52,821.44,719.65,1175.8
581537221241878656,2020-05,1221.15,725.13,1496.62,0,1992.64,3168.44
581537221241878656,2020-06,0,422.81,1680.52,1379.16,-121.45,3046.99
581537221241878656,2020-07,1190.07,0,0,0,1190.07,4237.06
581537221241878656,2020-08,3414.76,631.31,0,315.09,2468.36,6705.42
581537221241878656,2020-09,91.21,0,839.38,1442.47,-511.88,6193.54
581537221241878656,2020-10,0,674.65,1883.28,0,1208.63,7402.17
581537221241878656,2020-11,2795.15,0,0,1009.15,1786,9188.17
581537221241878656,2020-12,0,819.17,1481.79,1005.35,-342.73,8845.44
581791900879690752,2020-01,4018.27,1887.66,6792.72,6169.82,2753.51,2753.51
581791900879690752,2020-02,2439.54,4146.53,6468.63,8041.69,-3280.05,-526.54
581791900879690752,2020-03,7331,4548.41,3324.53,2350.53,3756.59,3230.05
581791900879690752,2020-04,3097.9,4991.4,5564.34,4077.13,-406.29,2823.76
581791900879690752,2020-05,6762.52,2413.9,4773.86,3951.63,5170.85,7994.61
581791900879690752,2020-06,6837.86,6226.58,1564.97,4055.28,-1879.03,6115.58
581791900879690752,2020-07,6689.56,3036.31,3610.44,4106.28,3157.41,9272.99
581791900879690752,2020-08,427,5365.16,5746.78,2920.91,-2112.29,7160.7
581791900879690752,2020-09,4117.16,9430.02,2268.68,5984.51,-9028.69,-1867.99
581791900879690752,2020-10,10387.91,3061,2393.63,3380.99,6339.55,4471.56
581791900879690752,2020-11,5345.57,4538.82,8445.8,3728.74,5523.81,9995.37
581791900879690752,2020-12,6202.71,5067.36,4831.25,3932.8,2033.8,12029.17
581851710399460480,2020-01,1631.51,3888.33,4278.07,2974.47,-953.22,-953.22
581851710399460480,2020-02,7670.27,1890.22,5619.47,68.74,11330.78,10377.56
581851710399460480,2020-03,3609.25,0,1721.59,3004.75,2326.09,12703.65
581851710399460480,2020-04,0,2096.82,1860.46,1972.63,-2208.99,10494.66
581851710399460480,2020-05,157.12,2702.8,1810.36,1039.94,-1775.26,8719.4
581851710399460480,2020-06,488.29,701.8,3552.11,985.7,2352.9,11072.3
581851710399460480,2020-07,2637.84,365.58,4305.35,3701.96,2875.65,13947.95
581851710399460480,2020-08,4279.58,1554.64,2649.75,3064.78,2309.91,16257.86
581851710399460480,2020-09,2918.01,2501.06,263.33,1849.82,-1169.54,15088.32
581851710399460480,2020-10,1102.59,2996.82,3160.91,1510.06,-243.38,14844.94
581851710399460480,2020-11,2457.94,1450.88,1062.23,3334.61,-1265.32,13579.62
581851710399460480,2020-12,3903.17,671.35,3208.5,1446.12,4994.2,18573.82
583042521834511104,2020-01,10137.46,1846.73,5886.96,3188.51,10989.18,10989.18
583042521834511104,2020-02,4714.02,4029.84,5934.52,2729.56,3889.14,14878.32
583042521834511104,2020-03,6317.98,3291.48,3996.35,4213.57,2809.28,17687.6
583042521834511104,2020-04,6679.63,5131.34,6466.73,5837.53,2177.49,19865.09
583042521834511104,2020-05,5266.65,4218.52,4734,67.41,5714.72,25579.81
583042521834511104,2020-06,5083.57,1984.07,5411.78,2103.84,6407.44,31987.25
583042521834511104,2020-07,790.4,3571.66,7052.79,6162.27,-1890.74,30096.51
583042521834511104,2020-08,5259.33,6039.64,8029.54,4991.07,2258.16,32354.67
583042521834511104,2020-09,5423.69,2992.4,6725.3,4599.23,4557.36,36912.03
583042521834511104,2020-10,3781.45,2421.01,2901.18,2290.43,1971.19,38883.22
583042521834511104,2020-11,228.73,9775.14,1478.38,2780.25,-10848.28,28034.94
583042521834511104,2020-12,5787.27,4996.11,5119.72,2380.62,3530.26,31565.2
583247921304773504,2020-01,1964.85,0,991.81,1646.84,1309.82,1309.82
583247921304773504,2020-02,1621.25,1357.26,0,1480.74,-1216.75,93.07
583247921304773504,2020-03,1856.75,2777.88,338.53,3962.29,-4544.89,-4451.82
583247921304773504,2020-04,1996.8,929.12,442.32,1708.24,-198.24,-4650.06
583247921304773504,2020-05,4208.19,4705.08,704.14,729.11,-521.86,-5171.92
583247921304773504,2020-06,1314.7,2553.47,2544.89,1443.06,-136.94,-5308.86
583247921304773504,2020-07,0,5036.86,2400.62,4031.08,-6667.32,-11976.18
583247921304773504,2020-08,3651.07,3056.83,4006.16,1867.36,2733.04,-9243.14
583247921304773504,2020-09,211.69,2571.92,3117,1516.74,-759.97,-10003.11
583247921304773504,2020-10,1451.5,3377.05,2658.84,4693.02,-3959.73,-13962.84
583247921304773504,2020-11,3521.88,0,1815.24,1291.3,4045.82,-9917.02
583247921304773504,2020-12,142.32,2925.48,843.54,1419.95,-3359.57,-13276.59
583335318668436096,2020-01,19.55,5599.78,1809.69,1918.75,-5689.29,-5689.29
583335318668436096,2020-02,129.99,0,0,1033.57,-903.58,-6592.87
583335318668436096,2020-03,7109.71,1734.65,1925.46,1242.71,6057.81,-535.06
583335318668436096,2020-04,1802.52,0,1083.4,3645.91,-759.99,-1295.05
583335318668436096,2020-05,753.79,0,30.53,1060.67,-276.35,-1571.4
583335318668436096,2020-06,32.12,1071.63,0,921.31,-1960.82,-3532.22
583335318668436096,2020-07,1099.89,0,1639.57,0,2739.46,-792.76
583335318668436096,2020-08,2459.93,0,2172.25,1827.58,2804.6,2011.84
583335318668436096,2020-09,0,2175.03,0,1518.53,-3693.56,-1681.72
583335318668436096,2020-10,4483.72,443.67,1712.17,4149.9,1602.32,-79.4
583335318668436096,2020-11,0,713.08,0,0,-713.08,-792.48
583335318668436096,2020-12,1080.93,1651.74,544.84,0,-25.97,-818.45
583365271418457344,2020-01,1678.45,1896.03,1034.59,3034.32,-2217.31,-2217.31
583365271418457344,2020-02,0,1903.16,0,0,-1903.16,-4120.47
583365271418457344,2020-03,2544.45,1546.42,836.17,1315.84,518.36,-3602.11
583365271418457344,2020-04,0,2375.77,3354.82,3641.93,-2662.88,-6264.99
583365271418457344,2020-05,1762.9,2864.31,382.71,0,-718.7,-6983.69
583365271418457344,2020-06,3953.96,3027.41,576.16,2769.58,-1266.87,-8250.56
583365271418457344,2020-07,2405.75,106.59,2855.81,104.36,5050.61,-3199.95
583365271418457344,2020-08,1958.92,0,469.43,3048.97,-620.62,-3820.57
583365271418457344,2020-09,2310.55,1537.82,0,1000.25,-227.52,-4048.09
583365271418457344,2020-10,165.3,558.23,1909.06,3353.92,-1837.79,-5885.88
583365271418457344,2020-11,579.26,3923.54,1332.25,0,-2012.03,-7897.91
583365271418457344,2020-12,1037.76,173.47,0,1247.54,-383.25,-8281.16
583672074199625728,2020-01,7734.57,2181.31,1334.12,1453.5,5433.88,5433.88
583672074199625728,2020-02,2706.08,1928.18,217.37,2611.25,-1615.98,3817.9
583672074199625728,2020-03,3715.81,4337.64,865.8,1476.95,-1232.98,2584.92
583672074199625728,2020-04,5694.17,487.04,7427.11,2699.14,9935.1,12520.02
583672074199625728,2020-05,2974.06,5085.66,3060.89,3736.38,-2787.09,9732.93
583672074199625728,2020-06,1549.73,1334.37,67.95,2846.69,-2563.38,7169.55
583672074199625728,2020-07,1452.22,2094.28,5169.07,3758.42,768.59,7938.14
583672074199625728,2020-08,4122.09,4465.08,2512.59,658.72,1510.88,9449.02
583672074199625728,2020-09,7057.39,3564.07,5266.51,1729.94,7029.89,16478.91
583672074199625728,2020-10,3453.32,0,7907.99,1720.03,9641.28,26120.19
583672074199625728,2020-11,2286.58,5073.99,7566.27,4293.44,485.42,26605.61
583672074199625728,2020-12,4466.53,3431.44,2025.96,4689.15,-1628.1,24977.51
583793297779589248,2020-01,2564.36,1065.3,6934.32,5534.29,2899.09,2899.09
583793297779589248,2020-02,1459.65,3880.7,3983.68,1818.07,-255.44,2643.65
583793297779589248,2020-03,4202.66,0,5216.46,6985.94,2433.18,5076.83
583793297779589248,2020-04,5197.41,5611.24,1623.1,3085.68,-1876.41,3200.42
583793297779589248,2020-05,3474.62,3417.09,3754.11,396.12,3415.52,6615.94
583793297779589248,2020-06,5200.78,5614.49,1970.92,2497.39,-940.18,5675.76
583793297779589248,2020-07,3493.09,8464.48,9426.16,2974.8,1479.97,7155.73
583793297779589248,2020-08,5784.05,4783.16,2482.14,6695.8,-3212.77,3942.96
583793297779589248,2020-09,69.97,6024.28,632.37,2135.23,-7457.17,-3514.21
583793297779589248,2020-10,2219.54,2436.43,0,4909.88,-5126.77,-8640.98
583793297779589248,2020-11,1996.34,2367.36,8223.8,4092.4,3760.38,-4880.6
583793297779589248,2020-12,7119.92,6909.16,2571.8,459.85,2322.71,-2557.89
584523009191425792,2020-01,2391.57,1311.56,1517.98,6420.38,-3822.39,-3822.39
584523009191425792,2020-02,1437.18,3499.96,7796.7,3338.52,2395.4,-1426.99
584523009191425792,2020-03,900.95,5971.02,2460.27,2361.88,-4971.68,-6398.67
584523009191425792,2020-04,1414.66,4722.27,3295.7,2420.23,-2432.14,-8830.81
584523009191425792,2020-05,4790.33,5819.86,5248.73,1677.43,2541.77,-6289.04
584523009191425792,2020-06,2120.39,1279.33,7194.4,3970.26,4065.2,-2223.84
584523009191425792,2020-07,4773.62,2456.6,8032.68,1982.1,8367.6,6143.76
584523009191425792,2020-08,547.13,1707.86,2219.29,1423.47,-364.91,5778.85
584523009191425792,2020-09,320.45,4464.9,4035.38,2978.94,-3088.01,2690.84
584523009191425792,2020-10,2550.03,2937.7,1643.32,2870.32,-1614.67,1076.17
584523009191425792,2020-11,8899.01,6368.74,7217.39,699.47,9048.19,10124.36
584523009191425792,2020-12,6482.75,0,1128.07,1034.79,6576.03,16700.39
584574290352137728,2020-01,0,1205.87,4358.88,3979.26,-826.25,-826.25
584574290352137728,2020-02,0,5277.4,1874.78,1908.59,-5311.21,-6137.46
584574290352137728,2020-03,2742.64,1253.16,2718.62,2915.29,1292.81,-4844.65
584574290352137728,2020-04,2033.85,2458.49,434.77,1282.97,-1272.84,-6117.49
584574290352137728,2020-05,2503.87,1926.94,2479.37,1821.58,1234.72,-4882.77
584574290352137728,2020-06,947.57,3121.48,1539.5,0,-634.41,-5517.18
584574290352137728,2020-07,0,3667.8,415.97,0,-3251.83,-8769.01
584574290352137728,2020-08,1092.97,559.43,2015.96,636.38,1913.12,-6855.89
584574290352137728,2020-09,535.47,2486.84,0,1743.53,-3694.9,-10550.79
584574290352137728,2020-10,5059.5,1359.92,1104.98,1730.06,3074.5,-7476.29
584574290352137728,2020-11,0,432.47,1471.2,3153.09,-2114.36,-9590.65
584574290352137728,2020-12,576.61,1972.27,1484.92,1773.9,-1684.64,-11275.29
585508082821748864,2020-01,6302.06,1334.7,4411.61,6161.67,3217.3,3217.3
585508082821748864,2020-02,7322.88,3595.41,2699.65,3714.75,2712.37,5929.67
585508082821748864,2020-03,5489.57,2230.02,5289.58,5071.17,3477.96,9407.63
585508082821748864,2020-04,3857.01,4434.83,1455.39,3435.5,-2557.93,6849.7
585508082821748864,2020-05,1479.68,4367.39,7582.06,3578.6,1115.75,7965.45
585508082821748864,2020-06,355.6,1856.58,500.59,4651.33,-5651.72,2313.73
585508082821748864,2020-07,2960.8,3639.96,5205.65,3256.97,1269.52,3583.25
585508082821748864,2020-08,11790.82,2715.76,3083.62,5398.99,6759.69,10342.94
585508082821748864,2020-09,3605.3,4081.86,1398.79,6297.95,-5375.72,4967.22
585508082821748864,2020-10,3661.47,2776.42,3685.08,4085.47,484.66,5451.88
585508082821748864,2020-11,4151.42,4096.9,2787.34,3398.72,-556.86,4895.02
585508082821748864,2020-12,3360.03,1862.05,6456.29,3844.85,4109.42,9004.44
585868916463362304,2020-01,1792.88,471.31,1779.36,475.16,2625.77,2625.77
585868916463362304,2020-02,0,768.82,860.46,0,91.64,2717.41
585868916463362304,2020-03,740.51,0,0,3525.09,-2784.58,-67.17
585868916463362304,2020-04,0,987.66,0,414.62,-1402.28,-1469.45
585868916463362304,2020-05,0,2126.97,0,0,-2126.97,-3596.42
585868916463362304,2020-06,529.34,3329.28,1011.98,0,-1787.96,-5384.38
585868916463362304,2020-07,707.68,3159.69,725.53,321.84,-2048.32,-7432.7
585868916463362304,2020-08,8833.61,3568.27,2140.58,2557.4,4848.52,-2584.18
585868916463362304,2020-09,0,242.42,0,4640.45,-4882.87,-7467.05
585868916463362304,2020-10,1405.54,0,1232.37,1581.7,1056.21,-6410.84
585868916463362304,2020-11,157.6,0,0,1724.88,-1567.28,-7978.12
585868916463362304,2020-12,884.93,0,1480.79,0,2365.72,-5612.4
586379725854718720,2020-01,2577.48,0,652.04,2941.91,287.61,287.61
586379725854718720,2020-02,344.65,0,0,3238.9,-2894.25,-2606.64
586379725854718720,2020-03,0,455.3,0,3125.04,-3580.34,-6186.98
586379725854718720,2020-04,1526.42,189.51,564.82,0,1901.73,-4285.25
586379725854718720,2020-05,438.1,760.29,0,0,-322.19,-4607.44
586379725854718720,2020-07,828.35,1991.97,1581.32,0,417.7,-4189.74
586379725854718720,2020-08,134.04,0,887.12,634.62,386.54,-3803.2
586379725854718720,2020-09,39.51,1662.64,0,1802.2,-3425.33,-7228.53
586379725854718720,2020-10,572.89,2628.67,0,0,-2055.78,-9284.31
586379725854718720,2020-12,2601.15,0,958.36,0,3559.51,-5724.8
587694725720035968,2020-01,2884.35,6295.77,1895.7,359.38,-1875.1,-1875.1
587694725720035968,2020-02,3379.95,7039.55,4106.42,3026.69,-2579.87,-4454.97
587694725720035968,2020-03,2412.24,4111.62,1191.29,9100.39,-9608.48,-14063.45
587694725720035968,2020-04,4424.99,2635.08,5377.77,2162.8,5004.88,-9058.57
587694725720035968,2020-05,4134.14,11834.36,1076.78,0,-6623.44,-15682.01
587694725720035968,2020-06,2756.42,3351.7,1071.88,1800.46,-1323.86,-17005.87
587694725720035968,2020-07,8580.79,2279.45,7455.41,5664.94,8091.81,-8914.06
587694725720035968,2020-08,3571.96,3554.42,8247.57,3824.46,4440.65,-4473.41
587694725720035968,2020-09,3939.47,1948.11,6616.54,5757.72,2850.18,-1623.23
587694725720035968,2020-10,3274.97,2340,4459.37,1253.04,4141.3,2518.07
587694725720035968,2020-11,2398.46,2840.97,6861.54,1322.02,5097.01,7615.08
587694725720035968,2020-12,5256.59,5093.48,8106.41,7432.47,837.05,8452.13
587704064879274496,2020-01,2236.58,4458.97,1709.01,0,-513.38,-513.38
587704064879274496,2020-02,3967.05,4853.56,6752.78,2235.85,3630.42,3117.04
587704064879274496,2020-03,2380.3,10141.81,5683.77,4690.21,-6767.95,-3650.91
587704064879274496,2020-04,2592.28,4690.45,4277.5,5252.51,-3073.18,-6724.09
587704064879274496,2020-05,2206.59,1137.05,7270.38,5400.71,2939.21,-3784.88
587704064879274496,2020-06,6721.68,2171.64,4180.54,3121.67,5608.91,1824.03
587704064879274496,2020-07,8021.77,6337.7,4004.5,1852.34,3836.23,5660.26
587704064879274496,2020-08,522.88,5107.24,4258.38,7157.49,-7483.47,-1823.21
587704064879274496,2020-09,2872.65,2835.83,6540.54,788.4,5788.96,3965.75
587704064879274496,2020-10,5740.21,8658.72,1943.64,4703.88,-5678.75,-1713
587704064879274496,2020-11,2598.03,5684.43,7147.02,674.53,3386.09,1673.09
587704064879274496,2020-12,5493.07,4546.13,7108.91,1104.22,6951.63,8624.72
588035887038201600,2020-01,1134.5,3705.07,1022.54,1786.33,-3334.36,-3334.36
588035887038201600,2020-02,5356.38,3739.08,750.76,3951.77,-1583.71,-4918.07
588035887038201600,2020-03,6350.58,2829.34,6291.41,7842.09,1970.56,-2947.51
588035887038201600,2020-04,3164.2,3477.42,7605.39,5174.25,2117.92,-829.59
588035887038201600,2020-05,2932.44,3231.4,874.1,1922.25,-1347.11,-2176.7
588035887038201600,2020-06,4534.77,373.43,0,1725,2436.34,259.64
588035887038201600,2020-07,4726.39,209.64,1765.99,1212.06,5070.68,5330.32
588035887038201600,2020-08,5385.47,2809.6,2954.76,3342.48,2188.15,7518.47
588035887038201600,2020-09,4590.22,2701.54,3939.65,5788.8,39.53,7558
588035887038201600,2020-10,2579.35,6253.52,1611.74,7460.32,-9522.75,-1964.75
588035887038201600,2020-11,3629.81,6342.21,3620.77,6398.75,-5490.38,-7455.13
588035887038201600,2020-12,880.03,1128.21,592.38,1964.08,-1619.88,-9075.01
588783712488378880,2020-01,30.32,3978.15,1999.5,1121.52,-3069.85,-3069.85
588783712488378880,2020-02,4479.1,4246.52,10406.64,2166.09,8473.13,5403.28
588783712488378880,2020-03,2655.09,7272.13,5519.96,184.71,718.21,6121.49
588783712488378880,2020-04,4181.85,5143.31,442.72,1974.26,-2493,3628.49
588783712488378880,2020-05,1496,7173,3141.32,872.72,-3408.4,220.09
588783712488378880,2020-06,8004.82,4924.64,5449.34,1164.66,7364.86,7584.95
588783712488378880,2020-07,3694.64,3098.78,1735.64,5675.34,-3343.84,4241.11
588783712488378880,2020-08,2887.99,4727.82,4476.41,1759.8,876.78,5117.89
588783712488378880,2020-09,5424,3921.16,5554.33,1349.63,5707.54,10825.43
588783712488378880,2020-10,3059.35,701.5,939.76,3992.36,-694.75,10130.68
588783712488378880,2020-11,5738.95,3316.07,602.5,1171.96,1853.42,11984.1
588783712488378880,2020-12,2148,5828.34,3158.06,5874.81,-6397.09,5587.01
589612079302060928,2020-01,0,703.98,1313.95,1766.61,-1156.64,-1156.64
589612079302060928,2020-02,0,1021.07,1998.69,1359.86,-382.24,-1538.88
589612079302060928,2020-03,0,2780.2,1912.32,0,-867.88,-2406.76
589612079302060928,2020-04,3539.16,0,1336.83,0,4875.99,2469.23
589612079302060928,2020-05,2397.58,0,0,2964.43,-566.85,1902.38
589612079302060928,2020-06,1385.19,3310.84,1528.93,174.77,-571.49,1330.89
589612079302060928,2020-07,364.44,1773.9,2028.31,3997.73,-3378.88,-2047.99
589612079302060928,2020-08,1253.57,857.57,2384.23,552.69,2227.54,179.55
589612079302060928,2020-09,1894.84,1643.45,237.33,953.32,-464.6,-285.05
589612079302060928,2020-10,0,762.09,540.1,1956.1,-2178.09,-2463.14
589612079302060928,2020-11,1003.76,1913.75,0,0,-909.99,-3373.13
589612079302060928,2020-12,0,458.4,1278.22,2853.29,-2033.47,-5406.6
590813079537007744,2020-01,974.45,4363.37,6756.78,3953.25,-585.39,-585.39
590813079537007744,2020-02,2576.01,3643.97,5781.18,5586.81,-873.59,-1458.98
590813079537007744,2020-03,3058.56,1812.23,4147.27,2405.04,2988.56,1529.58
590813079537007744,2020-04,2493.72,4399.95,1623.08,7269.29,-7552.44,-6022.86
590813079537007744,2020-05,2532.12,2297.05,1407.94,3551.5,-1908.49,-7931.35
590813079537007744,2020-06,3036.92,3587.93,3433.72,5375.73,-2493.02,-10424.37
590813079537007744,2020-07,4338.33,4850.41,9471.56,5822.92,3136.56,-7287.81
590813079537007744,2020-08,0,3168.12,7381.56,5843.11,-1629.67,-8917.48
590813079537007744,2020-09,6487.47,2925.4,1298.22,0,4860.29,-4057.19
590813079537007744,2020-10,3737.52,3863.37,1768.89,1474.91,168.13,-3889.06
590813079537007744,2020-11,784.29,3783.06,13221.63,7970.22,2252.64,-1636.42
590813079537007744,2020-12,5650.43,3390.18,5859.41,2690.85,5428.81,3792.39
590944644407458688,2020-01,607.33,1723.5,1012.19,1308.16,-1412.14,-1412.14
590944644407458688,2020-02,2249.98,457.97,1056.28,1364.99,1483.3,71.16
590944644407458688,2020-03,3482.46,4784.5,7743.14,794.06,5647.04,5718.2
590944644407458688,2020-04,3108.12,1684.4,4027.08,0,5450.8,11169
590944644407458688,2020-05,4661.34,7395.92,1677.95,2267.98,-3324.61,7844.39
590944644407458688,2020-06,2392.28,2303.85,5625.26,2471.11,3242.58,11086.97
590944644407458688,2020-07,5303.78,3229.43,63.08,259.76,1877.67,12964.64
590944644407458688,2020-08,3575.04,0,928.89,6968.72,-2464.79,10499.85
590944644407458688,2020-09,5144.23,0,9103.55,2826.26,11421.52,21921.37
590944644407458688,2020-10,1515.42,1873.2,2857.37,2122.54,377.05,22298.42
590944644407458688,2020-11,0,5840.51,4337.56,3176.78,-4679.73,17618.69
590944644407458688,2020-12,3545.59,4685.55,0,4306.26,-5446.22,12172.47
591376583396523520,2020-01,4832.72,2428.8,3490.84,9559.14,-3664.38,-3664.38
591376583396523520,2020-02,0,1814.61,6363.49,3363.58,1185.3,-2479.08
591376583396523520,2020-03,3508.03,5309.44,2513.7,4976.93,-4264.64,-6743.72
591376583396523520,2020-04,6233.49,9071.59,2787.77,6271.06,-6321.39,-13065.11
591376583396523520,2020-05,2585.79,3295.14,2892.5,6270.66,-4087.51,-17152.62
591376583396523520,2020-06,6726.69,2490.16,4182.12,2611.93,5806.72,-11345.9
591376583396523520,2020-07,7064.37,5884.1,7374.53,3251.88,5302.92,-6042.98
591376583396523520,2020-08,5473.42,5397.23,7225.21,4490.16,2811.24,-3231.74
591376583396523520,2020-09,7855.55,2966.52,1223.05,1305.2,4806.88,1575.14
591376583396523520,2020-10,7154.96,4098.77,5448.19,5997.97,2506.41,4081.55
591376583396523520,2020-11,6985.15,2281.74,6136.06,12807.29,-1967.82,2113.73
591376583396523520,2020-12,2348.98,3743.78,2790.17,5873.95,-4478.58,-2364.85
591589154709053952,2020-01,4165.86,0,3913.07,1471.55,6607.38,6607.38
591589154709053952,2020-02,5605.32,2035.5,495.38,1839.55,2225.65,8833.03
591589154709053952,2020-03,3436.99,3545.99,3782.92,4057.83,-383.91,8449.12
591589154709053952,2020-04,2667.87,0,0,4496.77,-1828.9,6620.22
591589154709053952,2020-05,2452.88,483.29,719.47,2279.23,409.83,7030.05
591589154709053952,2020-06,3910.93,3673.27,1252.8,5187.76,-3697.3,3332.75
591589154709053952,2020-07,2643.33,2377.66,1375.69,673.73,967.63,4300.38
591589154709053952,2020-08,4532.07,2919.25,5334.42,2495.08,4452.16,8752.54
591589154709053952,2020-09,2203.45,5911.55,1624.23,1938.08,-4021.95,4730.59
591589154709053952,2020-10,2936.01,2727.74,3257.95,2491.8,974.42,5705.01
591589154709053952,2020-11,2449.82,18.12,2127.65,0,4559.35,10264.36
591589154709053952,2020-12,1072.28,1469.95,6939.58,1848.25,4693.66,14958.02
593779334199381248,2020-01,1629.72,1866.58,0,1877.22,-2114.08,-2114.08
593779334199381248,2020-02,200.6,1456.72,2323.16,3783.83,-2716.79,-4830.87
593779334199381248,2020-03,4190.74,1166.11,1786.04,0,4810.67,-20.2
593779334199381248,2020-04,969.45,0,2400.93,2860.19,510.19,489.99
593779334199381248,2020-06,2491.89,0,0,1700.39,791.5,1281.49
593779334199381248,2020-07,0,3297.44,3303.76,4305.95,-4299.63,-3018.14
593779334199381248,2020-08,0,2537.06,1984.77,403.77,-956.06,-3974.2
593779334199381248,2020-09,0,1534.15,2400.17,371.94,494.08,-3480.12
593779334199381248,2020-10,544.13,0,1932.86,1763.87,713.12,-2767
593779334199381248,2020-11,1815.61,1404.07,0,0,411.54,-2355.46
593779334199381248,2020-12,1891.78,2767.52,2001.79,1826.79,-700.74,-3056.2
595408757200193536,2020-01,6888.7,10287.67,3236.01,4264.1,-4427.06,-4427.06
595408757200193536,2020-02,2088.82,4275.15,4195.66,5279.87,-3270.54,-7697.6
595408757200193536,2020-03,2799.63,7489.63,367.58,4852.11,-9174.53,-16872.13
595408757200193536,2020-04,2408.13,4997.49,3472.42,4693.77,-3810.71,-20682.84
595408757200193536,2020-05,3848.56,3062.35,6066.85,6195.74,657.32,-20025.52
595408757200193536,2020-06,3396,4119.74,1861.93,6022.28,-4884.09,-24909.61
595408757200193536,2020-07,2867.6,7081.74,5455.5,2165.95,-924.59,-25834.2
595408757200193536,2020-08,3368.15,3743.27,572.86,3321.53,-3123.79,-28957.99
595408757200193536,2020-09,4833.38,3252.44,4768.43,9391.4,-3042.03,-32000.02
595408757200193536,2020-10,6151.23,2475.24,1363.84,3445.37,1594.46,-30405.56
595408757200193536,2020-11,7296.65,2607.57,4300.67,2939.65,6050.1,-24355.46
595408757200193536,2020-12,1534.25,3076.35,2053.66,4521.39,-4009.83,-28365.29
595418286364792192,2020-01,1906.45,2353.04,1836.09,1717.25,-327.75,-327.75
595418286364792192,2020-02,1889.6,282.14,1627.98,1509.53,1725.91,1398.16
595418286364792192,2020-03,1826.42,1507.28,413.75,683.91,48.98,1447.14
595418286364792192,2020-04,1139.49,2541,663.98,0,-737.53,709.61
595418286364792192,2020-05,0,3228.35,0,0,-3228.35,-2518.74
595418286364792192,2020-06,1436.05,1346.61,0,6603.22,-6513.78,-9032.52
595418286364792192,2020-07,958.84,2595.4,0,890.89,-2527.45,-11559.97
595418286364792192,2020-08,2566.26,1476.39,288.24,0,1378.11,-10181.86
595418286364792192,2020-09,0,560.52,1092.14,1049.69,-518.07,-10699.93
595418286364792192,2020-10,0,1180.68,0,0,-1180.68,-11880.61
595418286364792192,2020-11,0,317.99,964.21,80.36,565.86,-11314.75
595718332336401280,2020-01,7258.39,5411.66,1360.32,935.81,2271.24,2271.24
595718332336401280,2020-02,7132.43,3095.63,4525.58,3320.8,5241.58,7512.82
595718332336401280,2020-03,2747.91,2959.89,894.25,4074.52,-3392.25,4120.57
595718332336401280,2020-04,5736.77,1399.63,7364.24,4640.94,7060.44,11181.01
595718332336401280,2020-05,3940.15,3360.9,3690.42,6333.58,-2063.91,9117.1
595718332336401280,2020-06,8119.99,4005.26,3913.34,6599.22,1428.85,10545.95
595718332336401280,2020-07,2970.03,3893.9,5383.74,5821.1,-1361.23,9184.72
595718332336401280,2020-08,3736.37,6585.31,2918,3317.96,-3248.9,5935.82
595718332336401280,2020-09,5327.66,9066.8,4202.26,1177.51,-714.39,5221.43
595718332336401280,2020-10,3906.24,2785.51,6771.2,8956.14,-1064.21,4157.22
595718332336401280,2020-11,5351.74,1463.61,5275.99,3796.14,5367.98,9525.2
595718332336401280,2020-12,3465.36,1515.74,676.86,5408.39,-2781.91,6743.29
596276252624880768,2020-01,14.33,0,539.19,2199.54,-1646.02,-1646.02
596276252624880768,2020-02,340.09,1602.44,3264.95,4905.25,-2902.65,-4548.67
596276252624880768,2020-03,1918.45,0,1181.9,701.65,2398.7,-2149.97
596276252624880768,2020-04,787.7,4389.84,1942.69,2051.65,-3711.1,-5861.07
596276252624880768,2020-05,2306.04,2617.75,0,1706.71,-2018.42,-7879.49
596276252624880768,2020-06,3287.75,72.61,0,1378.58,1836.56,-6042.93
596276252624880768,2020-07,2158.92,2352.15,630.2,0,436.97,-5605.96
596276252624880768,2020-08,1995.77,1960.79,3071.02,0,3106,-2499.96
596276252624880768,2020-09,1124.19,3299.75,0,5258.85,-7434.41,-9934.37
596276252624880768,2020-10,4374.82,687.8,3168.37,90.89,6764.5,-3169.87
596276252624880768,2020-11,1491.72,3411.49,0,5239.37,-7159.14,-10329.01
596276252624880768,2020-12,3083.19,0,3126.56,4591.49,1618.26,-8710.75
596605660738072832,2020-01,2638.22,3169.14,1995.2,2751.26,-1286.98,-1286.98
596605660738072832,2020-02,0,5864.4,2103.06,195.84,-3957.18,-5244.16
596605660738072832,2020-03,1333.99,338.75,4140.9,0,5136.14,-108.02
596605660738072832,2020-04,4487.67,4568.99,3630.93,4075.09,-525.48,-633.5
596605660738072832,2020-05,564.1,447.06,4297.21,3825.26,588.99,-44.51
596605660738072832,2020-06,3484.29,2096.57,2481.17,2842.96,1025.93,981.42
596605660738072832,2020-07,4009.94,3862.03,4085.53,4222.49,10.95,992.37
596605660738072832,2020-08,3272.78,5849.45,3145.67,3741.48,-3172.48,-2180.11
596605660738072832,2020-09,4512.26,7042.34,3556.57,3111.44,-2084.95,-4265.06
596605660738072832,2020-10,5324.03,3006.23,4917.5,3176.59,4058.71,-206.35
596605660738072832,2020-11,3958.73,35.64,3502.89,5366.73,2059.25,1852.9
596605660738072832,2020-12,4430.11,2994.81,2325.09,3944.8,-184.41,1668.49
597126287610093696,2020-01,4694.36,2243.65,0,1098.55,1352.16,1352.16
597126287610093696,2020-02,2475.25,3098.07,1144.88,762.6,-240.54,1111.62
597126287610093696,2020-03,5478.72,1683.15,877.95,3764.66,908.86,2020.48
597126287610093696,2020-04,0,3503.67,1590.76,2082.86,-3995.77,-1975.29
597126287610093696,2020-05,1780.51,219.19,887.05,785.32,1663.05,-312.24
597126287610093696,2020-06,4179.76,0,0,0,4179.76,3867.52
597126287610093696,2020-07,480.71,1645.77,0,1413.28,-2578.34,1289.18
597126287610093696,2020-09,604.14,0,1931.52,1270.44,1265.22,2554.4
597126287610093696,2020-10,5506.34,2199.91,0,982.47,2323.96,4878.36
597126287610093696,2020-11,842.63,1014.42,4876.35,1856.77,2847.79,7726.15
597126287610093696,2020-12,1186.94,0,1561.9,0,2748.84,10474.99
598577066311852800,2020-01,1931.85,433.1,2555.64,1317.99,2736.4,2736.4
598577066311852800,2020-02,3158.32,1836.02,0,4683.32,-3361.02,-624.62
598577066311852800,2020-03,807.7,3755.52,8398.14,0,5450.32,4825.7
598577066311852800,2020-04,3277.59,306.12,0,2457.65,513.82,5339.52
598577066311852800,2020-05,4254.36,1266.41,0,4913.97,-1926.02,3413.5
598577066311852800,2020-06,2676.68,1075.25,3669.75,0,5271.18,8684.68
598577066311852800,2020-07,1191.71,3910.34,2372.75,1869.81,-2215.69,6468.99
598577066311852800,2020-08,1213.61,1755.99,4430.57,917.25,2970.94,9439.93
598577066311852800,2020-09,3785.62,295.79,1574.45,1413.55,3650.73,13090.66
598577066311852800,2020-10,2117.66,3617.08,1373.59,2056.57,-2182.4,10908.26
598577066311852800,2020-11,1702.15,1803.39,1448.75,1938.54,-591.03,10317.23
598577066311852800,2020-12,3374.72,0,2441.03,1416.05,4399.7,14716.93
598658639376484864,2020-01,7554.61,4910.83,3539.04,12285.83,-6103.01,-6103.01
598658639376484864,2020-02,3628.05,1622.65,2982.17,3275.82,1711.75,-4391.26
598658639376484864,2020-03,4196.65,7404.14,6696.77,6677.96,-3188.68,-7579.94
598658639376484864,2020-04,881.27,2998.43,5376.6,5317.89,-2058.45,-9638.39
598658639376484864,2020-05,6199.33,8151.64,4114,2238.81,-77.12,-9715.51
598658639376484864,2020-06,2361.92,0,6984.23,1434.08,7912.07,-1803.44
598658639376484864,2020-07,8939.44,1519.78,3227.45,5551.93,5095.18,3291.74
598658639376484864,2020-08,8068.83,3537.02,4201.32,5883.27,2849.86,6141.6
598658639376484864,2020-09,2962.18,526.05,5434.94,4048.55,3822.52,9964.12
598658639376484864,2020-10,6035.96,3955.33,5590.11,8555.49,-884.75,9079.37
598658639376484864,2020-11,3687.01,3073.97,4023.72,4346.45,290.31,9369.68
598658639376484864,2020-12,5040.22,1243.52,7309.59,3981.15,7125.14,16494.82
599737300903096320,2020-01,132.51,1461.87,0,1610.07,-2939.43,-2939.43
599737300903096320,2020-02,0,1963,2341.96,920.95,-541.99,-3481.42
599737300903096320,2020-03,282.74,1081.17,574.04,341.71,-566.1,-4047.52
599737300903096320,2020-04,817.68,614.29,4351.86,2784.39,1770.86,-2276.66
599737300903096320,2020-05,1898.71,0,1942.35,0,3841.06,1564.4
599737300903096320,2020-06,0,3524.82,2537.74,0,-987.08,577.32
599737300903096320,2020-08,321.59,0,0,2913.96,-2592.37,-2015.05
599737300903096320,2020-09,186.17,0,4163.99,1945.52,2404.64,389.59
599737300903096320,2020-10,1568.85,1941.16,1454.18,2469.11,-1387.24,-997.65
599737300903096320,2020-11,0,2691.25,2001.92,1448.19,-2137.52,-3135.17
599737300903096320,2020-12,2900.32,0,251.65,2754.52,397.45,-2737.72
600394996590536576,2020-03,0,1647.75,0,2824.39,-4472.14,-4472.14
600394996590536576,2020-04,1976.23,0,556.19,0,2532.42,-1939.72
600394996590536576,2020-05,1998.74,0,0,0,1998.74,59.02
600394996590536576,2020-06,1234.91,1768.36,0,0,-533.45,-474.43
600394996590536576,2020-08,64.8,2879.37,296.22,0,-2518.35,-2992.78
600394996590536576,2020-09,0,572.13,0,0,-572.13,-3564.91
600394996590536576,2020-12,159.61,0,1479.92,1616.66,22.87,-3542.04
600512393467042048,2020-01,1830.26,4718.71,3714.26,4430.04,-3604.23,-3604.23
600512393467042048,2020-03,1750.85,2192.78,1081.51,1284.2,-644.62,-4248.85
600512393467042048,2020-04,0,322.53,1692.26,4717.25,-3347.52,-7596.37
600512393467042048,2020-05,5448.74,1420.69,0,1288.44,2739.61,-4856.76
600512393467042048,2020-06,3639.13,3291.4,2162.08,0,2509.81,-2346.95
600512393467042048,2020-07,2714.91,4370.88,5257.41,6885.63,-3284.19,-5631.14
600512393467042048,2020-08,1630.66,4545.06,5081.36,1969.77,197.19,-5433.95
600512393467042048,2020-09,4064.23,2787.27,901.19,1883.53,294.62,-5139.33
600512393467042048,2020-10,3389.59,0,3645.85,3095.98,3939.46,-1199.87
600512393467042048,2020-11,0,77.21,3240.54,1279.83,1883.5,683.63
600512393467042048,2020-12,603.16,0,3009.12,2892.76,719.52,1403.15
601065409569061632,2020-01,1839.59,1901.98,3472.07,1562.91,1846.77,1846.77
601065409569061632,2020-02,1659.09,0,1229.59,2949.54,-60.86,1785.91
601065409569061632,2020-03,1608.72,3676.81,2118.31,2195.67,-2145.45,-359.54
601065409569061632,2020-04,582.68,2.24,2817.1,1035.41,2362.13,2002.59
601065409569061632,2020-05,3181.65,1851.17,0,2931.73,-1601.25,401.34
601065409569061632,2020-06,1685.65,2802.6,1702.68,4561.6,-3975.87,-3574.53
601065409569061632,2020-07,61.83,929.18,2874.02,1404.28,602.39,-2972.14
601065409569061632,2020-08,731.07,3051.96,1296.18,4049.48,-5074.19,-8046.33
601065409569061632,2020-10,3123.6,819.5,0,0,2304.1,-5742.23
601065409569061632,2020-11,0,2982.67,3296.31,0,313.64,-5428.59
601065409569061632,2020-12,1569.39,2670.18,249.74,1341.99,-2193.04,-7621.63
601067372211241088,2020-01,962.16,2453.61,5104.99,3919.5,-305.96,-305.96
601067372211241088,2020-02,4004.35,9461.7,7057.8,2678.04,-1077.59,-1383.55
601067372211241088,2020-03,0,4888.06,1800.89,5574.78,-8661.95,-10045.5
601067372211241088,2020-04,4185.29,6882.32,2915.5,3751.69,-3533.22,-13578.72
601067372211241088,2020-05,7451.86,5565.38,8526.11,1464.49,8948.1,-4630.62
601067372211241088,2020-06,3735.61,2974.26,0,5410.75,-4649.4,-9280.02
601067372211241088,2020-07,1659.54,3209.42,1129.68,7016.23,-7436.43,-16716.45
601067372211241088,2020-08,391.95,4133.2,6642.49,9643.63,-6742.39,-23458.84
601067372211241088,2020-09,4392.24,3912.83,3605.86,7119.44,-3034.17,-26493.01
601067372211241088,2020-10,3443.33,3028.8,4736.11,6591.03,-1440.39,-27933.4
601067372211241088,2020-11,1008.58,3556.5,5326.65,3422.55,-643.82,-28577.22
601067372211241088,2020-12,3797.61,0,2820.62,5854.37,763.86,-27813.36
601200989263904256,2020-01,3748.87,3620.17,3780.23,2191.62,1717.31,1717.31
601200989263904256,2020-02,5128.14,2833.19,5747.38,1817.64,6224.69,7942
601200989263904256,2020-03,2716.98,8869.32,4254.21,1455.1,-3353.23,4588.77
601200989263904256,2020-04,10112.03,7023.63,4879.04,288.17,7679.27,12268.04
601200989263904256,2020-05,5487.05,1738.21,5719.56,3172.83,6295.57,18563.61
601200989263904256,2020-06,1037.76,235.45,2879.58,8589.43,-4907.54,13656.07
601200989263904256,2020-07,3716.57,5315.49,717.48,3659.58,-4541.02,9115.05
601200989263904256,2020-08,3673.82,2869.35,5609.17,5585.05,828.59,9943.64
601200989263904256,2020-09,12581.45,3785.93,5864.12,1893.38,12766.26,22709.9
601200989263904256,2020-10,2284.44,5106.4,4465.55,6925.34,-5281.75,17428.15
601200989263904256,2020-11,3363.14,11653.08,5232.95,10459.71,-13516.7,3911.45
601200989263904256,2020-12,2546.61,5080.19,1249.45,7040.01,-8324.14,-4412.69
601222624846978688,2020-01,1628.62,0,3078.83,0,4707.45,4707.45
601222624846978688,2020-03,0,2756.68,0,1881.66,-4638.34,69.11
601222624846978688,2020-04,592.13,0,0,0,592.13,661.24
601222624846978688,2020-06,1516.7,0,0,388.47,1128.23,1789.47
601222624846978688,2020-11,0,1620.71,0,844.06,-2464.77,-675.3
601222624846978688,2020-12,0,1981.29,719.9,0,-1261.39,-1936.69
601497201754867072,2020-01,3053.06,2309.44,0,1151.17,-407.55,-407.55
601497201754867072,2020-02,2148.11,5232.86,5032.71,1571.44,376.52,-31.03
601497201754867072,2020-03,2389.99,0,4023.2,4697.13,1716.06,1685.03
601497201754867072,2020-04,2366.63,2188.5,5246.21,2053.64,3370.7,5055.73
601497201754867072,2020-05,2613.06,5569.85,5725.95,8465.75,-5696.59,-640.86
601497201754867072,2020-06,5338.35,7047.87,1395.8,4846.68,-5160.4,-5801.26
601497201754867072,2020-07,3099.32,4334.82,4654.23,1534.9,1883.83,-3917.43
601497201754867072,2020-08,3127.46,1261.27,2298.63,1665.65,2499.17,-1418.26
601497201754867072,2020-09,6614.95,11001.54,3556.3,3609.11,-4439.4,-5857.66
601497201754867072,2020-10,561.32,1414.85,3306.47,3372.95,-920.01,-6777.67
601497201754867072,2020-11,3853.05,228.22,3460.98,3979.01,3106.8,-3670.87
601497201754867072,2020-12,2640.97,3432.06,3700.19,1366.16,1542.94,-2127.93
604726804905773312,2020-04,0,324.09,0,1686.39,-2010.48,-2010.48
604769784219033984,2020-01,1821.63,4107.24,3698.2,4049.58,-2636.99,-2636.99
604769784219033984,2020-02,1935.9,9748.34,6927.69,7802.49,-8687.24,-11324.23
604769784219033984,2020-03,1417.94,4266.39,4688.82,9398.26,-7557.89,-18882.12
604769784219033984,2020-04,7225.36,3626.58,2024.11,854.52,4768.37,-14113.75
604769784219033984,2020-05,0,5278.42,5307.59,3185.41,-3156.24,-17269.99
604769784219033984,2020-06,0,4213.54,2356.04,6386.86,-8244.36,-25514.35
604769784219033984,2020-07,2359.94,2787.11,4198.95,2447.36,1324.42,-24189.93
604769784219033984,2020-08,3369.77,55.11,4205.43,3197.32,4322.77,-19867.16
604769784219033984,2020-09,3986.54,6187.93,6606.73,1257.06,3148.28,-16718.88
604769784219033984,2020-10,4241.69,2321.46,2347.23,3705.76,561.7,-16157.18
604769784219033984,2020-11,8919.3,4328.44,4943.17,969.91,8564.12,-7593.06
604769784219033984,2020-12,6398.15,5278.85,7754.5,2105.92,6767.88,-825.18
607297649659746048,2020-01,1860.79,2126.21,0,0,-265.42,-265.42
607297649659746048,2020-02,297.97,3414.33,2615.1,5684.45,-6185.71,-6451.13
607297649659746048,2020-03,2140.75,3859.69,3582.28,5717.55,-3854.21,-10305.34
607297649659746048,2020-04,3248,4842.6,2241.81,6230.14,-5582.93,-15888.27
607297649659746048,2020-05,1476.91,1544.37,1212.6,0,1145.14,-14743.13
607297649659746048,2020-06,2693.05,1651.66,3519.31,472.06,4088.64,-10654.49
607297649659746048,2020-07,1713.39,0,1269.22,2826.4,156.21,-10498.28
607297649659746048,2020-08,803.26,3341.55,70.24,1166.18,-3634.23,-14132.51
607297649659746048,2020-09,3749.7,1358.6,1378.89,2185.27,1584.72,-12547.79
607297649659746048,2020-10,3679.92,1596.03,3038.4,3186.57,1935.72,-10612.07
607297649659746048,2020-11,2492.22,4422.77,1134.23,3249.65,-4045.97,-14658.04
607297649659746048,2020-12,3304.09,1893.66,1235.52,1721.58,924.37,-13733.67
608279316822741760,2020-01,617.38,5252.07,2139.53,4109.55,-6604.71,-6604.71
608279316822741760,2020-02,2896.45,3120.97,1569.7,723.35,621.83,-5982.88
608279316822741760,2020-03,3077.92,5255.28,966.85,1641.32,-2851.83,-8834.71
608279316822741760,2020-04,2916.6,2219.29,511.45,5894.46,-4685.7,-13520.41
608279316822741760,2020-05,2201.16,4680.12,3524.07,4551.94,-3506.83,-17027.24
608279316822741760,2020-06,648.9,3429.67,3551.01,4324.2,-3553.96,-20581.2
608279316822741760,2020-07,0,2652.55,3091.02,1561.77,-1123.3,-21704.5
608279316822741760,2020-08,2618.94,2865.13,3366.9,1308.03,1812.68,-19891.82
608279316822741760,2020-09,0,4785.17,3472.57,2767.75,-4080.35,-23972.17
608279316822741760,2020-10,2291.1,4134.59,1478.84,2702.85,-3067.5,-27039.67
608279316822741760,2020-11,1689.04,4109.59,1300.43,2469.47,-3589.59,-30629.26
608279316822741760,2020-12,3793.81,2189.29,3847.68,0,5452.2,-25177.06
608399404296218368,2020-01,3245.05,1865.22,304.33,3464.27,-1780.11,-1780.11
608399404296218368,2020-02,3677.2,496.37,0,1161.81,2019.02,238.91
608399404296218368,2020-03,6694.64,0,2336.99,2986.15,6045.48,6284.39
608399404296218368,2020-04,0,3690.78,1874.37,2470.46,-4286.87,1997.52
608399404296218368,2020-05,0,1934.8,429.19,0,-1505.61,491.91
608399404296218368,2020-06,1094.41,821.61,1246.03,1528.66,-9.83,482.08
608399404296218368,2020-07,322.8,1129.11,416.05,2266.66,-2656.92,-2174.84
608399404296218368,2020-08,3887.79,1567.71,3100.22,0,5420.3,3245.46
608399404296218368,2020-09,1205.44,1050.67,885.61,763.51,276.87,3522.33
608399404296218368,2020-10,914.43,1401.11,1412.57,0,925.89,4448.22
608399404296218368,2020-11,2248.38,1615.01,4764.37,4538.55,859.19,5307.41
608399404296218368,2020-12,2093.64,0,0,309.67,1783.97,7091.38
608726415812971392,2020-01,3088.51,6448.84,1409.15,2513.25,-4464.43,-4464.43
608726415812971392,2020-02,0,1764.48,3868.79,511.38,1592.93,-2871.5
608726415812971392,2020-03,685.39,3069.69,3249.65,226.09,639.26,-2232.24
608726415812971392,2020-04,2176.68,1295.31,3877.43,9447.31,-4688.51,-6920.75
608726415812971392,2020-05,2624.51,1176.73,750.71,1219.44,979.05,-5941.7
608726415812971392,2020-06,1327.63,901.51,509.58,6409.57,-5473.87,-11415.57
608726415812971392,2020-07,62.97,1310.48,4004.97,909.84,1847.62,-9567.95
608726415812971392,2020-08,467.86,4323.96,635.81,1045.73,-4266.02,-13833.97
608726415812971392,2020-09,7240.71,1737.37,2534.78,1548.23,6489.89,-7344.08
608726415812971392,2020-10,991.18,4891.32,5536.24,0,1636.1,-5707.98
608726415812971392,2020-11,0,3317.41,6709.66,2630.23,762.02,-4945.96
609309379043301120,2020-01,1986.41,2023.53,4692.13,6190.16,-1535.15,-1535.15
609309379043301120,2020-02,651.41,5205.01,4194.86,949.87,-1308.61,-2843.76
609309379043301120,2020-03,3480.53,2148.74,5908.67,2802.75,4437.71,1593.95
609309379043301120,2020-04,4153.5,2531.13,2042.18,0,3664.55,5258.5
609309379043301120,2020-05,883.89,5379.32,2714.19,1938.72,-3719.96,1538.54
609309379043301120,2020-06,2326.54,7820.39,5927.88,1817.43,-1383.4,155.14
609309379043301120,2020-07,4703.47,3672.33,0,2554.01,-1522.87,-1367.73
609309379043301120,2020-08,1165.28,3901.66,3806.49,1774.95,-704.84,-2072.57
609309379043301120,2020-09,382.72,1840.32,0,3089.86,-4547.46,-6620.03
609309379043301120,2020-10,853.03,1383.62,1311.69,8297.63,-7516.53,-14136.56
609309379043301120,2020-11,4049.17,5879.91,658.87,0,-1171.87,-15308.43
609309379043301120,2020-12,2625.32,4010.14,4005.41,810.86,1809.73,-13498.7
609502082558713728,2020-01,2730.43,2689.36,2325.09,3056.43,-690.27,-690.27
609502082558713728,2020-02,5053.65,763.92,0,5460.62,-1170.89,-1861.16
609502082558713728,2020-03,3548.89,8383.44,2645.98,1363.34,-3551.91,-5413.07
609502082558713728,2020-04,3003.28,3439.34,1667.23,2884.36,-1653.19,-7066.26
609502082558713728,2020-05,353.62,3186.63,1373.11,4651.56,-6111.46,-13177.72
609502082558713728,2020-06,3277.11,2161.2,3500.93,3729.32,887.52,-12290.2
609502082558713728,2020-07,4332.4,3094.51,4128.21,2787.83,2578.27,-9711.93
609502082558713728,2020-08,1953.91,3396.88,1196.9,4950.06,-5196.13,-14908.06
609502082558713728,2020-09,1240.64,5238.94,4288.3,9006.76,-8716.76,-23624.82
609502082558713728,2020-10,2105.73,3812.5,0,1527.21,-3233.98,-26858.8
609502082558713728,2020-11,162.21,3626.55,3786.87,4150.74,-3828.21,-30687.01
609502082558713728,2020-12,2046.88,1391.58,1840.01,2432.68,62.63,-30624.38
610923464112581376,2020-01,1400.03,0,4700.2,1061.71,5038.52,5038.52
610923464112581376,2020-02,6950.38,2180.91,1171.34,2818.89,3121.92,8160.44
610923464112581376,2020-03,5009.97,2116.87,1508.09,3070.99,1330.2,9490.64
610923464112581376,2020-04,2246.69,5450.63,7430.5,538.79,3687.77,13178.41
610923464112581376,2020-05,1394.44,0,7972.96,3100.82,6266.58,19444.99
610923464112581376,2020-06,7593.61,2707.86,1125.35,4575.07,1436.03,20881.02
610923464112581376,2020-07,2335,1278.62,3973.58,1382.77,3647.19,24528.21
610923464112581376,2020-08,4651.35,904.59,1655.38,482.98,4919.16,29447.37
610923464112581376,2020-09,3425.34,3262.01,401.58,1035.21,-470.3,28977.07
610923464112581376,2020-10,4138.05,296.7,2522.69,933.66,5430.38,34407.45
610923464112581376,2020-11,3599.75,1404.7,2261.44,1956.24,2500.25,36907.7
610923464112581376,2020-12,2727.72,0,2388.03,4697.66,418.09,37325.79
613560614927307648,2020-01,3866.33,4031.24,2850.01,4435.31,-1750.21,-1750.21
613560614927307648,2020-02,2816.41,5786.45,401.2,3380.2,-5949.04,-7699.25
613560614927307648,2020-03,3324.44,0,1313.43,3811.38,826.49,-6872.76
613560614927307648,2020-04,2870.76,5111.16,991.85,216.46,-1465.01,-8337.77
613560614927307648,2020-05,6679.15,2175.81,5012.48,1913.96,7601.86,-735.91
613560614927307648,2020-06,1772.31,4346.4,3413.05,2098.16,-1259.2,-1995.11
613560614927307648,2020-07,4291.27,5389.3,3780.73,6516.19,-3833.49,-5828.6
613560614927307648,2020-08,7066.68,6196.73,4613.39,0,5483.34,-345.26
613560614927307648,2020-09,7773.46,155.78,5795.05,2973.58,10439.15,10093.89
613560614927307648,2020-10,4528.1,4533.01,6474.25,1758.41,4710.93,14804.82
613560614927307648,2020-11,6751.71,5024.24,2774.45,2968.53,1533.39,16338.21
613560614927307648,2020-12,3831.73,6214.19,5109.57,6791.71,-4064.6,12273.61
613780152411097728,2020-01,3239.38,0,0,1379.63,1859.75,1859.75
613780152411097728,2020-02,1214.67,686.13,0,3455.76,-2927.22,-1067.47
613780152411097728,2020-03,28.76,903.7,2962.27,1857.36,229.97,-837.5
613780152411097728,2020-04,2594.81,1335.03,1292.37,1343.44,1208.71,371.21
613780152411097728,2020-05,1294.82,2083.87,0,745.15,-1534.2,-1162.99
613780152411097728,2020-06,5026.92,2038.91,3618.84,953.59,5653.26,4490.27
613780152411097728,2020-07,1751.79,1782.24,0,1717.91,-1748.36,2741.91
613780152411097728,2020-08,5481.92,5269.39,1014.53,1062.36,164.7,2906.61
613780152411097728,2020-09,0,4027.33,2408.17,558.56,-2177.72,728.89
613780152411097728,2020-10,1600.05,202.97,1605.37,1090.02,1912.43,2641.32
613780152411097728,2020-11,2884.45,2317.64,2301.25,999.39,1868.67,4509.99
613780152411097728,2020-12,4492.19,0,1720.24,0,6212.43,10722.42
615774123672984320,2020-01,0,3542.75,2867.61,2368.3,-3043.44,-3043.44
615774123672984320,2020-02,3183.17,2826.42,5925.52,0,6282.27,3238.83
615774123672984320,2020-03,6665.63,0,305.74,7157.15,-185.78,3053.05
615774123672984320,2020-04,4226.37,4965.76,9008.4,3053.25,5215.76,8268.81
615774123672984320,2020-05,3186.88,2355.33,7473.39,5575.48,2729.46,10998.27
615774123672984320,2020-06,1569.98,1977.27,4467.59,3513.17,547.13,11545.4
615774123672984320,2020-07,404.98,3436.11,7352.83,5946.1,-1624.4,9921
615774123672984320,2020-08,5746.86,1834.26,3328.12,3496.21,3744.51,13665.51
615774123672984320,2020-09,4192.88,892.87,6845.01,4942.07,5202.95,18868.46
615774123672984320,2020-10,5636.65,5827.55,4999.01,7463.72,-2655.61,16212.85
615774123672984320,2020-11,2337.66,3840.53,4261.42,8933.72,-6175.17,10037.68
615774123672984320,2020-12,0,5998.9,4803.98,1976.33,-3171.25,6866.43
616432976795651072,2020-01,4902.2,463.45,4122.58,4991.16,3570.17,3570.17
616432976795651072,2020-02,3097.91,536.39,1727.53,1359.35,2929.7,6499.87
616432976795651072,2020-03,5555.38,1532.57,2348.04,7419.1,-1048.25,5451.62
616432976795651072,2020-04,4538.37,6410.78,3262.86,3532.69,-2142.24,3309.38
616432976795651072,2020-05,4594.63,3505.52,2583.9,5998.38,-2325.37,984.01
616432976795651072,2020-06,3348.45,6406.97,2955.07,1141.19,-1244.64,-260.63
616432976795651072,2020-07,6236.89,3795.98,4937.19,2627.31,4750.79,4490.16
616432976795651072,2020-08,4886.33,4315.77,3033,3967.07,-363.51,4126.65
616432976795651072,2020-09,2854.06,7505.19,3172.49,6137.16,-7615.8,-3489.15
616432976795651072,2020-10,6539.99,5597.33,2538.04,6588.74,-3108.04,-6597.19
616432976795651072,2020-11,7550.94,5153.16,3722.45,3860.93,2259.3,-4337.89
616432976795651072,2020-12,4045.48,2444.92,3694.92,6496.85,-1201.37,-5539.26
616670563775819264,2020-01,0,1911.3,1808.68,0,-102.62,-102.62
616670563775819264,2020-02,0,821.41,2884.82,911.21,1152.2,1049.58
616670563775819264,2020-04,0,895.63,0,462.22,-1357.85,-308.27
616670563775819264,2020-05,1281.79,0,3093.24,710.67,3664.36,3356.09
616670563775819264,2020-06,0,1871.73,1038.85,1858.91,-2691.79,664.3
616670563775819264,2020-08,1668.74,0,1288.52,1332.34,1624.92,2289.22
616670563775819264,2020-09,2081.07,0,0,0,2081.07,4370.29
616670563775819264,2020-10,0,2227.15,2355.08,0,127.93,4498.22
616670563775819264,2020-11,0,467.06,281.18,0,-185.88,4312.34
616670563775819264,2020-12,0,741.8,0,0,-741.8,3570.54
617090330164236288,2020-01,5762.9,1414.39,2164.6,6293.02,220.09,220.09
617090330164236288,2020-02,5754.13,2264.46,1615.63,2437.57,2667.73,2887.82
617090330164236288,2020-03,3197.13,5076.46,3505.72,337.02,1289.37,4177.19
617090330164236288,2020-04,4909.26,1243.84,2560.68,94.89,6131.21,10308.4
617090330164236288,2020-05,4387.71,4003.59,922.89,1927.1,-620.09,9688.31
617090330164236288,2020-06,3313.65,4745.67,1509.16,1490.13,-1412.99,8275.32
617090330164236288,2020-07,0,3311.09,7146.56,2986.72,848.75,9124.07
617090330164236288,2020-08,4058.37,8479.18,2885.25,998.89,-2534.45,6589.62
617090330164236288,2020-09,2918.31,0,1603.23,4580.23,-58.69,6530.93
617090330164236288,2020-10,2189.25,1657.32,1976.61,3917.34,-1408.8,5122.13
617090330164236288,2020-11,1782.06,2287.25,4494.75,2238.54,1751.02,6873.15
617090330164236288,2020-12,5034.41,3335.02,7628.18,2549.37,6778.2,13651.35
618843437576273152,2020-01,2488.1,4088.2,672.49,84.86,-1012.47,-1012.47
618843437576273152,2020-02,3217.66,3472.3,2369,2348.82,-234.46,-1246.93
618843437576273152,2020-03,3300.19,1808.03,3882.52,2252.23,3122.45,1875.52
618843437576273152,2020-04,1951.78,1874,2036.69,1047.4,1067.07,2942.59
618843437576273152,2020-05,4000.91,3014.32,4558.73,1512.32,4033,6975.59
618843437576273152,2020-06,1193.69,1721.82,2787.69,1787.26,472.3,7447.89
618843437576273152,2020-07,1387,1758.13,2697.58,2410.12,-83.67,7364.22
618843437576273152,2020-08,2266.63,2560.73,1457.25,1193.69,-30.54,7333.68
618843437576273152,2020-09,1824.96,1603.46,5094.08,23.8,5291.78,12625.46
618843437576273152,2020-10,3360.48,1582.24,597.05,2536.42,-161.13,12464.33
618843437576273152,2020-11,0,2075.51,3888.62,2129.4,-316.29,12148.04
618843437576273152,2020-12,1429.44,3876.96,3991.22,2679.24,-1135.54,11012.5
619059293044547328,2020-01,0,4860.61,3384.44,2431.4,-3907.57,-3907.57
619059293044547328,2020-02,1838.51,2025.71,8545.7,14.46,8344.04,4436.47
619059293044547328,2020-03,5396.71,2055.05,1855.23,0,5196.89,9633.36
619059293044547328,2020-04,2235.88,660.35,2986.83,4739.9,-177.54,9455.82
619059293044547328,2020-05,4079.63,3352.94,2356.22,5497.98,-2415.07,7040.75
619059293044547328,2020-06,775.2,4972.35,2946.61,6914.43,-8164.97,-1124.22
619059293044547328,2020-07,1980.62,762.07,838.9,3676.53,-1619.08,-2743.3
619059293044547328,2020-08,4981.91,2484.74,1150.71,5813.23,-2165.35,-4908.65
619059293044547328,2020-09,3762.46,3627.98,1936.92,3509.27,-1437.87,-6346.52
619059293044547328,2020-10,2233.3,3031.67,2135.8,51.79,1285.64,-5060.88
619059293044547328,2020-11,1554.2,449.32,2477.88,1972.86,1609.9,-3450.98
619059293044547328,2020-12,1707.15,0,1927.59,4250.69,-615.95,-4066.93
619676219067468672,2020-03,1381.66,934.99,1517.14,0,1963.81,1963.81
619676219067468672,2020-04,1801.05,0,0,0,1801.05,3764.86
619676219067468672,2020-07,0,1261.84,0,1903.18,-3165.02,599.84
620056188366471040,2020-01,0,246.16,0,662.93,-909.09,-909.09
620056188366471040,2020-02,996.32,1449.68,1976.86,1658.86,-135.36,-1044.45
620056188366471040,2020-04,0,1341.15,0,1105.23,-2446.38,-3490.83
620056188366471040,2020-05,0,1102.75,0,1924.53,-3027.28,-6518.11
620056188366471040,2020-06,1512.18,0,0,780,732.18,-5785.93
620056188366471040,2020-07,417.6,776.01,1024.16,636.47,29.28,-5756.65
620056188366471040,2020-09,1904.08,0,773.5,0,2677.58,-3079.07
620056188366471040,2020-10,0,1935.93,4914.97,1547.1,1431.94,-1647.13
620056188366471040,2020-11,575.19,0,1407.54,213.5,1769.23,122.1
621220605582400512,2020-01,468.99,0,1673.76,5238.4,-3095.65,-3095.65
621220605582400512,2020-03,226.77,491.25,0,694.75,-959.23,-4054.88
621220605582400512,2020-04,2190.49,0,0,255.42,1935.07,-2119.81
621220605582400512,2020-05,3379.94,838.89,1812.89,0,4353.94,2234.13
621220605582400512,2020-06,0,1114.89,909.01,530.9,-736.78,1497.35
621220605582400512,2020-07,1185.94,499.29,0,1556.86,-870.21,627.14
621220605582400512,2020-08,2765.96,311.77,2019.45,481.8,3991.84,4618.98
621220605582400512,2020-09,3253.68,7471.25,0,0,-4217.57,401.41
621220605582400512,2020-10,2333.33,272.16,1425.8,319.04,3167.93,3569.34
621220605582400512,2020-11,0,4127.07,2644.47,0,-1482.6,2086.74
621240909647661312,2020-01,1233.78,2769.73,5582.5,4963.69,-917.14,-917.14
621240909647661312,2020-02,0,2784.72,0,5056.21,-7840.93,-8758.07
621240909647661312,2020-03,1277.57,0,4869.58,877.07,5270.08,-3487.99
621240909647661312,2020-04,3702.44,2486.87,2271.93,10227.81,-6740.31,-10228.3
621240909647661312,2020-05,3564.29,0,6468.94,5414.66,4618.57,-5609.73
621240909647661312,2020-07,2130.61,2770.63,4864.64,1452.92,2771.7,-2838.03
621240909647661312,2020-08,3483.45,2952.95,3162.79,432.45,3260.84,422.81
621240909647661312,2020-09,2364.24,3448.32,1886.36,1656.35,-854.07,-431.26
621240909647661312,2020-10,0,4542.65,2399.51,2724.06,-4867.2,-5298.46
621240909647661312,2020-11,1408.7,3076.92,4642.66,0,2974.44,-2324.02
621240909647661312,2020-12,3672.16,767.75,2761.57,2585.79,3080.19,756.17
621300226782813952,2020-01,4254.54,1119.71,6992.64,2005.06,8122.41,8122.41
621300226782813952,2020-02,2922.24,1234.69,2825.39,622.8,3890.14,12012.55
621300226782813952,2020-03,0,4008.57,2308.55,1486.35,-3186.37,8826.18
621300226782813952,2020-04,4136.73,3624.62,3094.92,3349.19,257.84,9084.02
621300226782813952,2020-05,4581.45,1587.49,2279.22,5260.33,12.85,9096.87
621300226782813952,2020-06,4475.47,2277.23,1775.3,3087.02,886.52,9983.39
621300226782813952,2020-07,418.68,8138.73,2628.28,2518.25,-7610.02,2373.37
621300226782813952,2020-08,1628.48,3145.9,5989.41,1472.62,2999.37,5372.74
621300226782813952,2020-09,6345.79,2170.9,1952.79,2690.39,3437.29,8810.03
621300226782813952,2020-10,4699.04,6247.46,7584.4,3031.71,3004.27,11814.3
621300226782813952,2020-11,2169.33,0,474.37,455.35,2188.35,14002.65
621300226782813952,2020-12,4119.74,1467.44,2265.18,3720.07,1197.41,15200.06
621691649576356352,2020-01,1959.85,1056.65,5485.95,3171.28,3217.87,3217.87
621691649576356352,2020-02,2793.83,2140.3,45.74,3382.75,-2683.48,534.39
621691649576356352,2020-03,2247.93,2080.31,769.59,0,937.21,1471.6
621691649576356352,2020-04,1919.55,1436.54,4584.21,4317.6,749.62,2221.22
621691649576356352,2020-05,7119.45,0,3574.7,2116.63,8577.52,10798.74
621691649576356352,2020-06,3696.76,0,1731.69,1986.09,3442.36,14241.1
621691649576356352,2020-07,1904.45,1242.18,0,1296.21,-633.94,13607.16
621691649576356352,2020-08,2722.85,0,394.49,1547.51,1569.83,15176.99
621691649576356352,2020-09,1914.3,2015.95,485.7,0,384.05,15561.04
621691649576356352,2020-10,445.47,4825.73,4532.76,1887.48,-1734.98,13826.06
621691649576356352,2020-11,2809.23,0,472.8,2245.89,1036.14,14862.2
621691649576356352,2020-12,233.89,559.08,2512.4,1400.79,786.42,15648.62
621851600382652288,2020-01,0,2602.64,1668.04,0,-934.6,-934.6
621851600382652288,2020-02,1719.18,0,0,896.13,823.05,-111.55
621851600382652288,2020-03,1880.27,0,5094.24,3414.52,3559.99,3448.44
621851600382652288,2020-04,0,1037.16,2403.21,0,1366.05,4814.49
621851600382652288,2020-05,1218.49,5185.01,2354.43,2391.63,-4003.72,810.77
621851600382652288,2020-06,670.31,1851.87,773.24,0,-408.32,402.45
621851600382652288,2020-07,2499.1,0,0,6048.98,-3549.88,-3147.43
621851600382652288,2020-08,1776.03,4426.85,1947.43,0,-703.39,-3850.82
621851600382652288,2020-09,734.13,3237.75,0,1488.2,-3991.82,-7842.64
621851600382652288,2020-10,0,1525.98,1627.36,225.09,-123.71,-7966.35
621851600382652288,2020-11,3212.88,2746.93,3658.41,2448.5,1675.86,-6290.49
621851600382652288,2020-12,1517.54,1901.31,2077.09,1316.69,376.63,-5913.86
625663890106545920,2020-01,1070.85,1842.41,0,945.18,-1716.74,-1716.74
625663890106545920,2020-03,1153.45,0,1462.59,127.62,2488.42,771.68
625663890106545920,2020-05,0,1589.03,486.54,0,-1102.49,-330.81
625663890106545920,2020-06,0,3285.49,1005.88,1937.53,-4217.14,-4547.95
625663890106545920,2020-07,923.52,0,0,1430.1,-506.58,-5054.53
625663890106545920,2020-08,876.6,0,0,0,876.6,-4177.93
625663890106545920,2020-09,1281.54,0,0,0,1281.54,-2896.39
625663890106545920,2020-10,0,656.48,0,0,-656.48,-3552.87
625663890106545920,2020-12,687.25,1083.96,0,2429.75,-2826.46,-6379.33
627296532614839296,2020-01,585.62,3407.73,1893.04,0,-929.07,-929.07
627296532614839296,2020-04,1172.55,567.67,1668.71,0,2273.59,1344.52
627296532614839296,2020-05,0,22.08,615.03,2559.85,-1966.9,-622.38
627296532614839296,2020-06,896.59,1639.52,1646.85,0,903.92,281.54
627296532614839296,2020-08,0,1931.16,0,1627.87,-3559.03,-3277.49
627296532614839296,2020-09,1665.27,1770.79,0,0,-105.52,-3383.01
627296532614839296,2020-10,861.07,2431.02,875.15,1189.91,-1884.71,-5267.72
627296532614839296,2020-11,0,1203.49,0,1917.23,-3120.72,-8388.44
627296532614839296,2020-12,1028.29,122.23,0,1126.77,-220.71,-8609.15
628454641998004224,2020-03,577.69,745.99,0,0,-168.3,-168.3
628454641998004224,2020-04,4568.92,0,989.71,1837.87,3720.76,3552.46
628454641998004224,2020-05,0,1378.2,849.02,0,-529.18,3023.28
628454641998004224,2020-07,0,423.53,0,0,-423.53,2599.75
628454641998004224,2020-08,2925.92,840.08,0,0,2085.84,4685.59
628454641998004224,2020-12,0,1779.83,3323.65,0,1543.82,6229.41
628784948256726784,2020-01,3.49,1806.37,1269.56,2175.66,-2708.98,-2708.98
628784948256726784,2020-02,2095.49,1814.83,5225.56,0,5506.22,2797.24
628784948256726784,2020-03,4057.75,282.14,6952.43,1817.99,8910.05,11707.29
628784948256726784,2020-04,1781.81,2030.05,415.57,4757.22,-4589.89,7117.4
628784948256726784,2020-05,3880.89,1508.9,444.16,3581.66,-765.51,6351.89
628784948256726784,2020-06,3890.86,1362.98,2098.2,2161.56,2464.52,8816.41
628784948256726784,2020-07,2353.07,5006.75,0,0,-2653.68,6162.73
628784948256726784,2020-08,731.41,4244.62,1411.62,4885.11,-6986.7,-823.97
628784948256726784,2020-09,3432.47,2114.44,543.97,0,1862,1038.03
628784948256726784,2020-10,2605.35,1958.15,2238.18,354.83,2530.55,3568.58
628784948256726784,2020-12,2336.44,3294.82,1229.03,2651.83,-2381.18,1187.4
629065994218916864,2020-01,5959.03,3401.11,4172.7,238.21,6492.41,6492.41
629065994218916864,2020-02,3117,2929.72,5302.14,2755.62,2733.8,9226.21
629065994218916864,2020-03,3068.77,3762.24,5798.38,4510.96,593.95,9820.16
629065994218916864,2020-04,5644.04,4040.41,2628.73,2309.46,1922.9,11743.06
629065994218916864,2020-05,1463.26,4388.76,7812.56,7179.75,-2292.69,9450.37
629065994218916864,2020-06,3289.24,2082.29,3749.95,4044.57,912.33,10362.7
629065994218916864,2020-07,1203.25,2189.95,3488.98,2095.66,406.62,10769.32
629065994218916864,2020-08,1820.74,941.56,2195.95,3386.67,-311.54,10457.78
629065994218916864,2020-09,3897.03,7101.14,8732.82,9391.68,-3862.97,6594.81
629065994218916864,2020-10,1962.36,4155.97,3738.67,2562.32,-1017.26,5577.55
629065994218916864,2020-11,2970.45,5200.75,3882.74,5052.11,-3399.67,2177.88
629065994218916864,2020-12,923.58,3739.69,3119.88,4061.97,-3758.2,-1580.32
629137516976936064,2020-01,1622.58,2022.95,371.57,1110.47,-1139.27,-1139.27
629137516976936064,2020-02,3147.56,1137.57,1093.3,0,3103.29,1964.02
629137516976936064,2020-03,2912.68,731.9,283.78,3983.45,-1518.89,445.13
629137516976936064,2020-04,139.06,2107.48,2158.8,5189.68,-4999.3,-4554.17
629137516976936064,2020-05,2578.77,7145.2,1995.88,1852.84,-4423.39,-8977.56
629137516976936064,2020-06,3280.9,5496.25,2845.7,8090.51,-7460.16,-16437.72
629137516976936064,2020-07,2401.66,4032.65,1410.22,4628.54,-4849.31,-21287.03
629137516976936064,2020-08,1966.66,702.47,2678.29,3770,172.48,-21114.55
629137516976936064,2020-09,3072.26,3128.3,4933.8,3936.25,941.51,-20173.04
629137516976936064,2020-10,3233.81,304.82,3997.38,3827.29,3099.08,-17073.96
629137516976936064,2020-11,6396.84,6150.77,2028.74,2961.16,-686.35,-17760.31
629137516976936064,2020-12,4579.07,1815.21,1384.41,1621.34,2526.93,-15233.38
629919336589008256,2020-01,8779.88,2875.11,7260.84,1709.75,11455.86,11455.86
629919336589008256,2020-02,6032.44,3755.49,1889.74,2883.91,1282.78,12738.64
629919336589008256,2020-03,3492.08,4598.17,4997.88,5323.88,-1432.09,11306.55
629919336589008256,2020-04,6264.3,2461.89,1542.37,6801.51,-1456.73,9849.82
629919336589008256,2020-05,1646.51,2101.25,5952.61,4770.66,727.21,10577.03
629919336589008256,2020-06,8550.24,6126.01,3933.29,3465.47,2892.05,13469.08
629919336589008256,2020-07,3666.91,6526.99,4246.73,4534.48,-3147.83,10321.25
629919336589008256,2020-08,4808.73,5822.41,4700.33,2616.62,1070.03,11391.28
629919336589008256,2020-09,8053.32,1675.34,10389.64,4021.81,12745.81,24137.09
629919336589008256,2020-10,3269.08,1789.56,1967.39,5719,-2272.09,21865
629919336589008256,2020-11,2066.06,3990.4,6720.84,4435.85,360.65,22225.65
629919336589008256,2020-12,670.69,1450.58,2053.43,3413.66,-2140.12,20085.53
630007370068535040,2020-01,5427.82,3865.53,3202.68,543.45,4221.52,4221.52
630007370068535040,2020-02,5513.68,5173.75,7574.68,7272.5,642.11,4863.63
630007370068535040,2020-03,7770.77,3601.87,6307.62,6719.08,3757.44,8621.07
630007370068535040,2020-04,1927.09,6046.22,4050.61,5770.75,-5839.27,2781.8
630007370068535040,2020-05,1824.99,869.63,7255.7,4636.47,3574.59,6356.39
630007370068535040,2020-06,6756.86,3355.53,6374.6,4125.41,5650.52,12006.91
630007370068535040,2020-07,9751.44,8824.71,3403.79,332.73,3997.79,16004.7
630007370068535040,2020-08,5352.52,2821.66,5979.71,2319.39,6191.18,22195.88
630007370068535040,2020-09,4148.61,3591.15,2805.7,1601.38,1761.78,23957.66
630007370068535040,2020-10,3307.42,8087.77,5035.51,2972.38,-2717.22,21240.44
630007370068535040,2020-11,3510.2,4079.17,2180.23,1764.34,-153.08,21087.36
630007370068535040,2020-12,2692.33,6464.02,12211.16,4050.42,4389.05,25476.41
630717183733555072,2020-01,3111.41,849.32,3109.45,332.58,5038.96,5038.96
630717183733555072,2020-02,5309.09,4772.93,888.18,4522.68,-3098.34,1940.62
630717183733555072,2020-03,2643.08,0,3291.02,1385.93,4548.17,6488.79
630717183733555072,2020-04,5737.61,691.09,3567.21,504.75,8108.98,14597.77
630717183733555072,2020-05,3153.27,6628.59,1179.27,3219.17,-5515.22,9082.55
630717183733555072,2020-06,0,3738.7,4168.63,994.14,-564.21,8518.34
630717183733555072,2020-07,2829.76,5331.17,2917.31,3207.73,-2791.83,5726.51
630717183733555072,2020-08,4280.77,2335.85,3136.66,7064.13,-1982.55,3743.96
630717183733555072,2020-09,5929.14,5873.05,5150.31,940.68,4265.72,8009.68
630717183733555072,2020-10,3020.1,3389.39,1720.09,3810.43,-2459.63,5550.05
630717183733555072,2020-11,6525.13,3452,0,5482.94,-2409.81,3140.24
630717183733555072,2020-12,2457.49,688.29,0,1861.14,-91.94,3048.3
631055150042360832,2020-01,1446.07,4132.33,3266.68,7148.25,-6567.83,-6567.83
631055150042360832,2020-02,4942.58,4736.96,6760.05,11119.42,-4153.75,-10721.58
631055150042360832,2020-03,2843.28,1269.73,4923.3,7870.2,-1373.35,-12094.93
631055150042360832,2020-04,2804.13,4444.28,2079.48,1163.9,-724.57,-12819.5
631055150042360832,2020-05,5983.69,2650.44,691.59,5178.46,-1153.62,-13973.12
631055150042360832,2020-06,1973.13,1099.69,4336.8,2825.71,2384.53,-11588.59
631055150042360832,2020-07,1209.55,7917.97,7064.14,3418.43,-3062.71,-14651.3
631055150042360832,2020-08,2350.74,3074.55,2742.86,953.86,1065.19,-13586.11
631055150042360832,2020-09,8729.6,1442.57,2621.56,6276.76,3631.83,-9954.28
631055150042360832,2020-10,8810.7,6724.45,4323.64,7336.37,-926.48,-10880.76
631055150042360832,2020-11,3899.42,918.73,7269.04,4394.99,5854.74,-5026.02
631055150042360832,2020-12,13178.77,4421.41,4491.49,2321.21,10927.64,5901.62
632885686400359680,2020-01,3854.89,6215.41,3338.07,6440.21,-5462.66,-5462.66
632885686400359680,2020-02,2936.44,5451.52,5529.02,1136.38,1877.56,-3585.1
632885686400359680,2020-03,1801.66,5704.85,1899.94,0,-2003.25,-5588.35
632885686400359680,2020-04,1853.65,5297.19,4708.08,4030.91,-2766.37,-8354.72
632885686400359680,2020-05,797.35,4461.88,3611.17,5127.47,-5180.83,-13535.55
632885686400359680,2020-06,3248.47,5294.26,7482.01,3575.85,1860.37,-11675.18
632885686400359680,2020-07,5962.16,3682.01,2159.37,4982.44,-542.92,-12218.1
632885686400359680,2020-08,5298.29,3338.91,8270.8,5049.64,5180.54,-7037.56
632885686400359680,2020-09,5318.93,0,2339.48,2548.75,5109.66,-1927.9
632885686400359680,2020-10,1425.12,4658.55,1887.26,501.57,-1847.74,-3775.64
632885686400359680,2020-11,9117.95,1707.2,0,5003.77,2406.98,-1368.66
632885686400359680,2020-12,5884.68,1323.99,3141.7,2960.72,4741.67,3373.01
635841251687430656,2020-01,590.4,338.79,0,0,251.61,251.61
635841251687430656,2020-03,0,1454.58,0,1535.51,-2990.09,-2738.48
635841251687430656,2020-07,0,1605.39,0,0,-1605.39,-4343.87
635841251687430656,2020-08,1779.54,0,0,0,1779.54,-2564.33
635841251687430656,2020-09,1435.48,1716.47,0,0,-280.99,-2845.32
635841251687430656,2020-10,0,1344.56,0,0,-1344.56,-4189.88
635841251687430656,2020-11,188.84,0,683.38,0,872.22,-3317.66
635977358429491072,2020-01,376.66,2705.51,4757.72,3203.38,-774.51,-774.51
635977358429491072,2020-02,3285.38,3536.92,6769.88,7811.91,-1293.57,-2068.08
635977358429491072,2020-03,1710.89,4796.23,5596.07,4825.12,-2314.39,-4382.47
635977358429491072,2020-04,1236.31,1496.98,1950.46,2824.05,-1134.26,-5516.73
635977358429491072,2020-05,5239.92,832.7,6184.69,7153.7,3438.21,-2078.52
635977358429491072,2020-06,6883.62,5347.92,1319.43,4264.61,-1409.48,-3488
635977358429491072,2020-07,3046.02,6711.3,7306.2,3305.94,334.98,-3153.02
635977358429491072,2020-08,5611.86,1614.74,5018.95,4154,4862.07,1709.05
635977358429491072,2020-09,7154.12,5064.25,7985.39,4399.79,5675.47,7384.52
635977358429491072,2020-10,6858.34,2499.88,401.18,2078.19,2681.45,10065.97
635977358429491072,2020-11,7526.7,8896.52,1963.52,4985.8,-4392.1,5673.87
635977358429491072,2020-12,2178.52,3708.14,2412.43,7571.06,-6688.25,-1014.38
637735776804361728,2020-01,3989.97,3579.46,2670.6,4598.7,-1517.59,-1517.59
637735776804361728,2020-02,6262.8,3912.87,2756.69,7397.23,-2290.61,-3808.2
637735776804361728,2020-03,5148.44,6799.37,5614.22,5197.01,-1233.72,-5041.92
637735776804361728,2020-04,7939.13,2425.39,2948.63,1321.04,7141.33,2099.41
637735776804361728,2020-05,2763.65,2980.85,0,3278.64,-3495.84,-1396.43
637735776804361728,2020-06,340.68,3221.31,4777.01,8859.67,-6963.29,-8359.72
637735776804361728,2020-07,5838.34,4475.72,1059.46,2985.9,-563.82,-8923.54
637735776804361728,2020-08,4453.54,5049.98,3707.35,1787.55,1323.36,-7600.18
637735776804361728,2020-09,642.54,5798.76,0,5478.58,-10634.8,-18234.98
637735776804361728,2020-10,2915.76,1624.73,3547.06,335.56,4502.53,-13732.45
637735776804361728,2020-11,3.35,3813.28,3707.99,1789.8,-1891.74,-15624.19
637735776804361728,2020-12,951.12,4293.73,967.5,4514.94,-6890.05,-22514.24
637989035957502592,2020-01,0,2564.05,373.14,0,-2190.91,-2190.91
637989035957502592,2020-04,1150.7,1982.83,1340.87,0,508.74,-1682.17
637989035957502592,2020-05,0,1833.17,1166.58,0,-666.59,-2348.76
637989035957502592,2020-06,1542.58,0,0,0,1542.58,-806.18
637989035957502592,2020-07,0,1477.52,728.09,317.9,-1067.33,-1873.51
637989035957502592,2020-08,0,2824.09,0,1885.63,-4709.72,-6583.23
637989035957502592,2020-09,0,107.64,0,0,-107.64,-6690.87
637989035957502592,2020-11,1171.7,0,240.63,1206.8,205.53,-6485.34
637989035957502592,2020-12,2322.88,2704.99,0,0,-382.11,-6867.45
638724179493692928,2020-01,0,365.94,2109.47,0,1743.53,1743.53
638724179493692928,2020-02,27.43,3286.33,174.95,3625.45,-6709.4,-4965.87
638724179493692928,2020-04,4041.2,0,2254.85,0,6296.05,1330.18
638724179493692928,2020-05,0,1228.95,0,0,-1228.95,101.23
638724179493692928,2020-08,385.82,2120.39,0,966.77,-2701.34,-2600.11
638724179493692928,2020-09,0,1946.13,1557.24,670.8,-1059.69,-3659.8
638724179493692928,2020-10,1418.59,0,2865.59,519.43,3764.75,104.95
638724179493692928,2020-11,0,1600.31,0,1031.32,-2631.63,-2526.68
638724179493692928,2020-12,534.27,0,215.55,0,749.82,-1776.86
638810770999674368,2020-01,0,994.76,0,0,-994.76,-994.76
638810770999674368,2020-02,1773.47,1768.84,0,1762.44,-1757.81,-2752.57
638810770999674368,2020-03,1142.44,0,3052.12,1435.67,2758.89,6.32
638810770999674368,2020-04,0,930.61,1221.37,246.05,44.71,51.03
638810770999674368,2020-05,534.5,0,3680.89,0,4215.39,4266.42
638810770999674368,2020-06,5191.63,154.59,0,0,5037.04,9303.46
638810770999674368,2020-08,1967.63,0,0,729.66,1237.97,10541.43
638810770999674368,2020-09,1319.01,0,0,0,1319.01,11860.44
638810770999674368,2020-10,1375.35,0,0,0,1375.35,13235.79
638810770999674368,2020-11,1176.4,0,0,0,1176.4,14412.19
639049093491520640,2020-01,1642.85,3154.91,290.35,5666.5,-6888.21,-6888.21
639049093491520640,2020-02,2013.2,4080.96,3411.32,4466.61,-3123.05,-10011.26
639049093491520640,2020-03,1693.43,7148.72,2912.34,3970,-6512.95,-16524.21
639049093491520640,2020-04,4425.69,1059.77,5995.36,1735.78,7625.5,-8898.71
639049093491520640,2020-05,1333.29,0,367.87,1417.79,283.37,-8615.34
639049093491520640,2020-06,2532.92,6349.42,6454.34,1829.32,808.52,-7806.82
639049093491520640,2020-07,2062.76,1894.65,527.85,0,695.96,-7110.86
639049093491520640,2020-08,671.31,1065.49,2935.16,5912.13,-3371.15,-10482.01
639049093491520640,2020-09,6479.64,6158.89,3006.41,1873.07,1454.09,-9027.92
639049093491520640,2020-10,4201.7,3867.36,1204.66,693.88,845.12,-8182.8
639049093491520640,2020-11,6177.42,3527.35,3714.09,4496.56,1867.6,-6315.2
639049093491520640,2020-12,1549.95,0,1781.67,525.99,2805.63,-3509.57
639052608205363968,2020-01,0,2531.11,2190.02,1823.66,-2164.75,-2164.75
639052608205363968,2020-02,3220.02,666.89,0,1851.88,701.25,-1463.5
639052608205363968,2020-04,903.09,396.67,0,0,506.42,-957.08
639052608205363968,2020-05,391.3,912.31,0,1258.52,-1779.53,-2736.61
639052608205363968,2020-06,1985.17,0,0,0,1985.17,-751.44
639052608205363968,2020-07,721.09,0,1212.31,0,1933.4,1181.96
639052608205363968,2020-08,1212.21,1486.02,1928.23,1500.36,154.06,1336.02
639052608205363968,2020-09,4484.91,2803.58,3917.03,254.34,5344.02,6680.04
639052608205363968,2020-10,0,472.77,5789.78,1626.69,3690.32,10370.36
639052608205363968,2020-11,1919.02,1371.63,0,636.16,-88.77,10281.59
639052608205363968,2020-12,537.93,0,72.74,1478.1,-867.43,9414.16
639911479009065728,2020-01,692.98,1777.73,2282.72,2351.3,-1153.33,-1153.33
639911479009065728,2020-02,1783.98,530.41,5256.7,0,6510.27,5356.94
639911479009065728,2020-03,682.17,719.41,2990.09,1975.44,977.41,6334.35
639911479009065728,2020-04,0,260.42,269.31,321.85,-312.96,6021.39
639911479009065728,2020-05,3822.11,1465.61,881.8,0,3238.3,9259.69
639911479009065728,2020-06,1706.53,1378.51,2828.97,1853.72,1303.27,10562.96
639911479009065728,2020-07,3435.48,1751.18,0,76.09,1608.21,12171.17
639911479009065728,2020-08,1342.7,2544.52,373.79,6.98,-835.01,11336.16
639911479009065728,2020-09,4567.72,2033.64,3319.11,1616.28,4236.91,15573.07
639911479009065728,2020-10,0,3623.2,1149.66,0,-2473.54,13099.53
639911479009065728,2020-11,1294.52,4540.78,2552.14,1354.54,-2048.66,11050.87
639911479009065728,2020-12,2910.19,5341.88,5814,491.14,2891.17,13942.04
641736724986978432,2020-01,3521.53,5505.98,388.53,8297.39,-9893.31,-9893.31
641736724986978432,2020-02,3390.76,3885.07,3739.3,4087.45,-842.46,-10735.77
641736724986978432,2020-03,1894.95,1705.96,2490.39,5575.99,-2896.61,-13632.38
641736724986978432,2020-04,1230.12,2150.3,5998.84,2971.47,2107.19,-11525.19
641736724986978432,2020-05,5752.94,2057.35,2599.03,3171.71,3122.91,-8402.28
641736724986978432,2020-06,6345.53,3840.34,5496.49,3256.57,4745.11,-3657.17
641736724986978432,2020-07,4281.25,4427.33,5044.99,3312.63,1586.28,-2070.89
641736724986978432,2020-08,10605.18,4641.63,4153.89,3180.46,6936.98,4866.09
641736724986978432,2020-09,3176.97,4866.93,3786.15,6439.86,-4343.67,522.42
641736724986978432,2020-10,0,5134.3,3100.38,614.07,-2647.99,-2125.57
641736724986978432,2020-11,2085.48,2876.57,8987.02,6781.2,1414.73,-710.84
641736724986978432,2020-12,1467.33,1243.75,5620.65,3623.83,2220.4,1509.56
642862959963418496,2020-01,0,3445.42,1268.83,537.06,-2713.65,-2713.65
642862959963418496,2020-02,0,2595.87,1434.81,1149.07,-2310.13,-5023.78
642862959963418496,2020-03,3833.06,0,1155.28,3859.86,1128.48,-3895.3
642862959963418496,2020-04,3057.15,2462.47,130.62,2451.04,-1725.74,-5621.04
642862959963418496,2020-05,3686.51,3781.2,509.9,1429.16,-1013.95,-6634.99
642862959963418496,2020-06,580.72,1897.99,0,0,-1317.27,-7952.26
642862959963418496,2020-07,0,4543.59,1823.85,89.03,-2808.77,-10761.03
642862959963418496,2020-08,3103.96,3065.45,178.61,0,217.12,-10543.91
642862959963418496,2020-09,3700.89,1480.7,0,146.16,2074.03,-8469.88
642862959963418496,2020-10,0,1539.94,291.68,671.92,-1920.18,-10390.06
642862959963418496,2020-11,738.5,815.37,0,1898.48,-1975.35,-12365.41
642862959963418496,2020-12,1257.34,3247.67,2174.44,2310.58,-2126.47,-14491.88
642986765029162752,2020-01,0,424.49,515.52,887.38,-796.35,-796.35
642986765029162752,2020-02,3230.84,4703.94,3076.44,0,1603.34,806.99
642986765029162752,2020-04,1504.03,1238.66,0,3563.37,-3298,-2491.01
642986765029162752,2020-05,3596.29,0,3592.04,1380.01,5808.32,3317.31
642986765029162752,2020-07,381.89,226.5,0,1173.17,-1017.78,2299.53
642986765029162752,2020-08,2975.8,1154.65,0,0,1821.15,4120.68
642986765029162752,2020-09,0,1921.73,2563.07,1487.93,-846.59,3274.09
642986765029162752,2020-10,513.44,2391.77,1610.66,0,-267.67,3006.42
642986765029162752,2020-11,0,3156.69,0,0,-3156.69,-150.27
642986765029162752,2020-12,4292.83,0,1065.63,2279.37,3079.09,2928.82
643056608223555584,2020-01,2887.94,4541.84,284.28,1722.76,-3092.38,-3092.38
643056608223555584,2020-02,2472.2,1923.11,750.29,1849.99,-550.61,-3642.99
643056608223555584,2020-03,1295.9,2865.45,0,0,-1569.55,-5212.54
643056608223555584,2020-04,0,4260.84,5083.04,1411.06,-588.86,-5801.4
643056608223555584,2020-05,1189.8,2530.53,1519.05,2442.38,-2264.06,-8065.46
643056608223555584,2020-06,2251.38,5633.94,4724.31,2614.17,-1272.42,-9337.88
643056608223555584,2020-07,4990.39,3377.62,4576.55,2868.45,3320.87,-6017.01
643056608223555584,2020-08,4463.38,0,771.26,3663.66,1570.98,-4446.03
643056608223555584,2020-09,4331.62,0,497.62,859.48,3969.76,-476.27
643056608223555584,2020-10,5850.47,4795.75,1115.7,4603.2,-2432.78,-2909.05
643056608223555584,2020-11,8343.11,800.05,1976.24,3179.17,6340.13,3431.08
643056608223555584,2020-12,0,1457.59,0,3049.74,-4507.33,-1076.25
644145216558971264,2020-01,506.39,0,0,0,506.39,506.39
644145216558971264,2020-05,1809.8,0,0,3051.84,-1242.04,-735.65
644145216558971264,2020-06,0,1359.54,0,0,-1359.54,-2095.19
644145216558971264,2020-07,0,1074.98,0,211.59,-1286.57,-3381.76
644145216558971264,2020-09,0,525.97,0,0,-525.97,-3907.73
644145216558971264,2020-11,1671.93,0,1675.66,0,3347.59,-560.14
646307376433173888,2020-01,4251.22,3700.29,2266.67,1004.39,1813.21,1813.21
646307376433173888,2020-02,4524.45,1228.49,7732.21,3606.87,7421.3,9234.51
646307376433173888,2020-03,4914.32,7505.72,3834.76,7681.6,-6438.24,2796.27
646307376433173888,2020-04,2392.87,3610.24,2555.96,5570.59,-4232,-1435.73
646307376433173888,2020-05,3498.83,3185.22,1533.69,4607.94,-2760.64,-4196.37
646307376433173888,2020-06,7369.04,3518.57,1473.08,7005.99,-1682.44,-5878.81
646307376433173888,2020-07,3405.76,6135.6,3692.93,3950.19,-2987.1,-8865.91
646307376433173888,2020-08,8903.08,1461.83,9813.27,3090.86,14163.66,5297.75
646307376433173888,2020-09,4916.99,1289.62,2905.32,11197.77,-4665.08,632.67
646307376433173888,2020-10,3270.9,8740.68,9912.64,8689.86,-4247,-3614.33
646307376433173888,2020-11,4005.11,3229.8,7036.44,6765.29,1046.46,-2567.87
646307376433173888,2020-12,4862.15,3059.02,2418.56,7802.13,-3580.44,-6148.31
647098222087970432,2020-01,2226.62,702.95,4372.63,0,5896.3,5896.3
647098222087970432,2020-02,1894.91,2416.14,1134.79,1863.38,-1249.82,4646.48
647098222087970432,2020-03,0,4213.98,2943.7,3250.61,-4520.89,125.59
647098222087970432,2020-04,1974.56,2700.5,7621.71,0,6895.77,7021.36
647098222087970432,2020-05,5242.42,738.16,1411.9,1135.55,4780.61,11801.97
647098222087970432,2020-06,5227.25,0,3487.05,719.74,7994.56,19796.53
647098222087970432,2020-07,2689.19,3758.32,2064.11,3424.3,-2429.32,17367.21
647098222087970432,2020-08,3613.31,633.12,2641,4640.48,980.71,18347.92
647098222087970432,2020-09,2475.07,4143.6,2080.35,3627.34,-3215.52,15132.4
647098222087970432,2020-10,2131.2,1598.71,4212.73,3536.57,1208.65,16341.05
647098222087970432,2020-11,1578.21,3968.81,6022.48,1345.09,2286.79,18627.84
647098222087970432,2020-12,5873.16,1269.29,2679.31,2771.18,4512,23139.84
647764975088778624,2020-01,3373.25,1917.67,1680.18,1277.15,1858.61,1858.61
647764975088778624,2020-02,0,2286.03,3915.84,904.36,725.45,2584.06
647764975088778624,2020-03,1191.78,1749.69,0,531.78,-1089.69,1494.37
647764975088778624,2020-04,1414.68,2749.05,0,323.88,-1658.25,-163.88
647764975088778624,2020-05,305.35,1900.78,2852.03,3160.43,-1903.83,-2067.71
647764975088778624,2020-06,1751.79,0,958.23,1343.06,1366.96,-700.75
647764975088778624,2020-07,2437.13,3731.42,0,5250.41,-6544.7,-7245.45
647764975088778624,2020-08,3287.39,3385.89,0,1356.05,-1454.55,-8700
647764975088778624,2020-09,849.52,6244.41,3818.2,3525.45,-5102.14,-13802.14
647764975088778624,2020-10,3686.57,563.58,246.65,3650.86,-281.22,-14083.36
647764975088778624,2020-11,1066.85,0,1871.65,0,2938.5,-11144.86
647764975088778624,2020-12,1193.75,1160.54,681.75,0,714.96,-10429.9
648355199840677888,2020-01,4985.96,693.43,739.49,0,5032.02,5032.02
648355199840677888,2020-02,2913.86,2281.69,1811.9,7816.82,-5372.75,-340.73
648355199840677888,2020-03,1039.17,7086.06,2828.5,3374.43,-6592.82,-6933.55
648355199840677888,2020-04,1336.52,97.59,2293.46,2068.19,1464.2,-5469.35
648355199840677888,2020-05,1504.73,974.15,2784.44,0,3315.02,-2154.33
648355199840677888,2020-06,1919.61,0,1768.85,1727.44,1961.02,-193.31
648355199840677888,2020-07,1920.93,986.91,0,5196.86,-4262.84,-4456.15
648355199840677888,2020-08,3200.07,4655.78,3382.94,1480.38,446.85,-4009.3
648355199840677888,2020-09,1035.72,1466.35,3635.61,1847.73,1357.25,-2652.05
648355199840677888,2020-10,3187.19,2326.51,27.66,3084.13,-2195.79,-4847.84
648355199840677888,2020-11,1949.51,6665.57,242.56,662.48,-5135.98,-9983.82
648355199840677888,2020-12,4114.2,1465.5,2509.99,4919.13,239.56,-9744.26
649267614396044160,2020-01,0,3454.4,1606.62,2286.67,-4134.45,-4134.45
649267614396044160,2020-02,0,356.16,828.14,611.96,-139.98,-4274.43
649267614396044160,2020-04,694.17,729.47,3088.79,0,3053.49,-1220.94
649267614396044160,2020-05,2313.15,0,0,305.9,2007.25,786.31
649267614396044160,2020-06,633.82,0,0,0,633.82,1420.13
649267614396044160,2020-09,284.1,0,615.92,0,900.02,2320.15
649267614396044160,2020-11,222.84,2409.1,1863.91,0,-322.35,1997.8
650591056051212160,2020-01,4968.09,3740.93,4630.1,3561.86,2295.4,2295.4
650591056051212160,2020-02,984.31,3082.73,2071.16,3024.07,-3051.33,-755.93
650591056051212160,2020-03,836.7,10001.79,5646.44,3422.57,-6941.22,-7697.15
650591056051212160,2020-04,4673.06,3552.22,2636.53,0,3757.37,-3939.78
650591056051212160,2020-05,3466.28,3193.25,5499.42,6276.61,-504.16,-4443.94
650591056051212160,2020-06,1065.35,0,3915.61,5833.89,-852.93,-5296.87
650591056051212160,2020-07,1937.04,4621.34,1694.8,2138.19,-3127.69,-8424.56
650591056051212160,2020-08,2899.69,9119.11,7571.3,507.22,844.66,-7579.9
650591056051212160,2020-09,4400.85,3380.14,2227.95,1704.38,1544.28,-6035.62
650591056051212160,2020-10,4917.05,3651.28,4937.76,0,6203.53,167.91
650591056051212160,2020-11,3180.75,4478.6,2713.04,5147.81,-3732.62,-3564.71
650591056051212160,2020-12,2394.95,2162.19,9531.42,1189.67,8574.51,5009.8
652203124043357824,2020-01,207.3,0,1885.7,0,2093,2093
652203124043357824,2020-03,2390.1,934.83,878.48,0,2333.75,4426.75
652203124043357824,2020-04,68.91,3588.02,135.38,1331.98,-4715.71,-288.96
652203124043357824,2020-05,0,772.41,1642.56,3962.47,-3092.32,-3381.28
652203124043357824,2020-06,122.65,1858.84,1574.47,1684.63,-1846.35,-5227.63
652203124043357824,2020-07,2265.62,3196.06,1794.4,1679.01,-815.05,-6042.68
652203124043357824,2020-08,2670.51,2785.35,0,503.03,-617.87,-6660.55
652203124043357824,2020-10,1515.44,1420.04,1701.04,816.72,979.72,-5680.83
652203124043357824,2020-12,136.9,3133.98,1847.15,0,-1149.93,-6830.76
654299418757323520,2020-01,3212.81,2693.43,6734.46,1777.79,5476.05,5476.05
654299418757323520,2020-02,7842.71,1842.97,1423.17,1381.35,6041.56,11517.61
654299418757323520,2020-03,2698.31,3284.86,1707.2,5294.07,-4173.42,7344.19
654299418757323520,2020-04,2955.11,623.31,4135.36,5568.94,898.22,8242.41
654299418757323520,2020-05,4634.88,2143.11,4092.07,5052.85,1530.99,9773.4
654299418757323520,2020-06,1803.16,2747.73,5236.55,877.52,3414.46,13187.86
654299418757323520,2020-07,2523.74,6308.05,5975.05,1646.97,543.77,13731.63
654299418757323520,2020-08,1745.13,3068.94,3041.9,3926.5,-2208.41,11523.22
654299418757323520,2020-09,6299.49,4412.47,3879.94,1666.35,4100.61,15623.83
654299418757323520,2020-10,786.54,6653.68,0,5839.49,-11706.63,3917.2
654299418757323520,2020-11,2023.54,2356.76,5487.21,1360.51,3793.48,7710.68
654299418757323520,2020-12,2459.04,2328.99,5964.97,2121.56,3973.46,11684.14
655689399278278016,2020-01,352.03,1069.93,412.97,36.99,-341.92,-341.92
655689399278278016,2020-02,1772.53,3830.71,3136.59,0,1078.41,736.49
655689399278278016,2020-03,1232.76,0,4494.79,3821.17,1906.38,2642.87
655689399278278016,2020-04,1685.87,2131.21,5353.49,1980.51,2927.64,5570.51
655689399278278016,2020-05,472.09,3726.11,2391.27,1894.59,-2757.34,2813.17
655689399278278016,2020-06,1187.73,3568.84,1415.6,2783.39,-3748.9,-935.73
655689399278278016,2020-07,0,3120.59,0,51.4,-3171.99,-4107.72
655689399278278016,2020-08,2298.09,1597.37,4068.64,6322.05,-1552.69,-5660.41
655689399278278016,2020-11,3644.45,0,1352.45,3752.34,1244.56,-4415.85
655689399278278016,2020-12,67.21,0,1854.74,0,1921.95,-2493.9
655704141481812608,2020-01,1148.35,5056.53,5335.4,2810.13,-1382.91,-1382.91
655704141481812608,2020-02,3241.3,3238.52,6360.87,3589.62,2774.03,1391.12
655704141481812608,2020-03,2692.25,3276.55,561.05,2602.41,-2625.66,-1234.54
655704141481812608,2020-04,37.68,2655.67,1487.3,3138.8,-4269.49,-5504.03
655704141481812608,2020-05,1337.76,5635.73,3672.04,5871.97,-6497.9,-12001.93
655704141481812608,2020-06,7407.09,4738.91,0,1629.87,1038.31,-10963.62
655704141481812608,2020-07,3246.38,3615.62,3889.64,5887.59,-2367.19,-13330.81
655704141481812608,2020-08,3528.32,4038.42,6035.2,1551.12,3973.98,-9356.83
655704141481812608,2020-09,2971.66,7840.9,1978.32,863.35,-3754.27,-13111.1
655704141481812608,2020-10,1577.44,3983.89,3121.47,715.33,-0.31,-13111.41
655704141481812608,2020-11,4377.5,2997.2,714.77,1726.05,369.02,-12742.39
655704141481812608,2020-12,1934.97,1721.41,3832.06,2754.63,1290.99,-11451.4
656002510307174656,2020-01,3401.23,253.55,1911.93,3901.26,1158.35,1158.35
656002510307174656,2020-02,3616.89,720.24,2175.56,2165.63,2906.58,4064.93
656002510307174656,2020-03,2140.71,9177.5,1941.64,1865.07,-6960.22,-2895.29
656002510307174656,2020-04,7198.56,3735.89,1593.98,1105.07,3951.58,1056.29
656002510307174656,2020-05,4590.39,864,0,0,3726.39,4782.68
656002510307174656,2020-06,1243.55,3659.05,137.92,1758.46,-4036.04,746.64
656002510307174656,2020-07,3656.8,833.68,3675.48,2000.46,4498.14,5244.78
656002510307174656,2020-08,3756.91,3646.36,2141.61,1437.3,814.86,6059.64
656002510307174656,2020-09,2069.45,1415.92,3277.23,331.93,3598.83,9658.47
656002510307174656,2020-10,3316.56,1959.89,2105.55,9176.54,-5714.32,3944.15
656002510307174656,2020-11,1914.05,3464.34,3851.18,2939.17,-638.28,3305.87
656002510307174656,2020-12,1573.51,3517.8,4233.5,3182.52,-893.31,2412.56
656099507429390592,2020-01,1245.14,1825.81,2987.65,1786.82,620.16,620.16
656099507429390592,2020-03,1802.58,2577.86,3666.69,850.8,2040.61,2660.77
656099507429390592,2020-04,2640.18,1064.67,1147.42,828.58,1894.35,4555.12
656099507429390592,2020-05,1926.63,3086.26,2499.81,951.57,388.61,4943.73
656099507429390592,2020-06,1045.54,0,0,2966.2,-1920.66,3023.07
656099507429390592,2020-07,0,1415.75,2491.45,974.77,100.93,3124
656099507429390592,2020-08,4538.04,3557.89,0,871.71,108.44,3232.44
656099507429390592,2020-09,1430.19,1789.5,0,3655.36,-4014.67,-782.23
656099507429390592,2020-10,3564.5,1808.03,0,0,1756.47,974.24
656099507429390592,2020-12,3321.75,142.05,5899.44,0,9079.14,10053.38
656257590608910464,2020-01,2290.18,6612.99,3674.89,3435.3,-4083.22,-4083.22
656257590608910464,2020-02,1756.19,3789.73,5343.17,2559.67,749.96,-3333.26
656257590608910464,2020-03,912.87,960.54,7178.73,348.62,6782.44,3449.18
656257590608910464,2020-04,1998.52,5707.08,1698.04,995.12,-3005.64,443.54
656257590608910464,2020-05,7954.86,691.17,0,5993.66,1270.03,1713.57
656257590608910464,2020-06,1866.05,249.64,0,3051.03,-1434.62,278.95
656257590608910464,2020-07,1336.58,3773.6,5989.15,7803.46,-4251.33,-3972.38
656257590608910464,2020-08,3724.99,4230.29,1270.03,5113.31,-4348.58,-8320.96
656257590608910464,2020-09,962.72,1561.49,4431.62,1813.73,2019.12,-6301.84
656257590608910464,2020-10,2364.71,2981.96,6921.15,1100.33,5203.57,-1098.27
656257590608910464,2020-11,2577.51,0,3284.8,6683.57,-821.26,-1919.53
656257590608910464,2020-12,7098.18,5593.65,1363.1,5279.83,-2412.2,-4331.73
656405596143303040,2020-01,2550.15,1325.94,632.54,5429.67,-3572.92,-3572.92
656405596143303040,2020-02,7193.58,3719.43,8074.19,872.41,10675.93,7103.01
656405596143303040,2020-03,2516.48,3578.78,5341.07,0,4278.77,11381.78
656405596143303040,2020-04,1859.46,1907.18,289.55,3728.07,-3486.24,7895.54
656405596143303040,2020-05,8172.21,5487.88,7375.2,2203.6,7855.93,15751.47
656405596143303040,2020-06,7703.43,1704.76,2192.22,2869.34,5321.55,21073.02
656405596143303040,2020-07,4383.82,1179.02,6713.55,1394.52,8523.83,29596.85
656405596143303040,2020-08,2694.22,6279.88,6708.64,1306.59,1816.39,31413.24
656405596143303040,2020-09,1955.85,3531.54,3500.85,2259.36,-334.2,31079.04
656405596143303040,2020-10,4860.01,7337.2,1899.62,1831.84,-2409.41,28669.63
656405596143303040,2020-11,5563.31,3051.04,6386.4,3203.77,5694.9,34364.53
656405596143303040,2020-12,3858.8,3613.47,3915.16,2427.39,1733.1,36097.63
657292760310745856,2020-01,450.86,1544.71,1050.17,1624.45,-1668.13,-1668.13
657292760310745856,2020-02,3806.24,878.21,2494.11,0,5422.14,3754.01
657292760310745856,2020-03,1649.67,176.3,0,2700.71,-1227.34,2526.67
657292760310745856,2020-04,1375.14,1718.95,457.07,333.6,-220.34,2306.33
657292760310745856,2020-05,2590.7,0,0,0,2590.7,4897.03
657292760310745856,2020-06,0,1018.37,1485.74,0,467.37,5364.4
657292760310745856,2020-07,213.05,3395,15.78,0,-3166.17,2198.23
657292760310745856,2020-08,1201.1,1737.31,1432.83,955.52,-58.9,2139.33
657292760310745856,2020-09,0,776.25,1008.95,0,232.7,2372.03
657292760310745856,2020-10,2642.29,323.2,723.72,0,3042.81,5414.84
657292760310745856,2020-11,0,2335.22,0,276.09,-2611.31,2803.53
657901889542576768,2020-01,413.39,4437.12,6050.1,775.42,1250.95,1250.95
657901889542576768,2020-02,6053.88,4627.24,648.05,3463.38,-1388.69,-137.74
657901889542576768,2020-03,10464.53,3944.16,5805.6,4602.75,7723.22,7585.48
657901889542576768,2020-04,2471.23,4730.81,4491.72,5971.05,-3738.91,3846.57
657901889542576768,2020-05,3628.07,3095.85,3136.65,6434.09,-2765.22,1081.35
657901889542576768,2020-06,5263.98,5889.29,5499.48,4513.9,360.27,1441.62
657901889542576768,2020-07,4355.43,7992.92,2899.1,743.53,-1481.92,-40.3
657901889542576768,2020-08,6631.25,9186.56,9178.96,9824.81,-3201.16,-3241.46
657901889542576768,2020-09,6653.45,2898.4,5498.16,5043.53,4209.68,968.22
657901889542576768,2020-10,2919.19,2243.84,7474.78,5884.42,2265.71,3233.93
657901889542576768,2020-11,295,3466.84,5087.42,3780.85,-1865.27,1368.66
657901889542576768,2020-12,2832.36,4880.3,1125.26,3220.24,-4142.92,-2774.26
658054685253660800,2020-01,2139.82,55.64,421.39,1155.98,1349.59,1349.59
658054685253660800,2020-02,3370.13,4156.31,0,0,-786.18,563.41
658054685253660800,2020-03,2111.19,458.71,1668.83,0,3321.31,3884.72
658054685253660800,2020-04,0,2185.58,4797.98,182.05,2430.35,6315.07
658054685253660800,2020-05,1556.2,3062.95,0,1219.34,-2726.09,3588.98
658054685253660800,2020-06,1262.4,1457.69,2234.85,1938.78,100.78,3689.76
658054685253660800,2020-07,0,2122.3,1628.43,1231.54,-1725.41,1964.35
658054685253660800,2020-08,146.13,0,760.28,0,906.41,2870.76
658054685253660800,2020-09,510.41,3066.19,1726.19,2473.1,-3302.69,-431.93
658054685253660800,2020-10,163.43,805.87,796.97,1932.74,-1778.21,-2210.14
658054685253660800,2020-11,1086.33,1453.53,291.32,653.64,-729.52,-2939.66
658054685253660800,2020-12,1070.55,495.14,3314.15,3078.17,811.39,-2128.27
659134324062715264,2020-01,3109.8,3253.21,4503.79,0,4360.38,4360.38
659134324062715264,2020-02,0,1811.66,3374.92,2331.31,-768.05,3592.33
659134324062715264,2020-03,0,2517.47,3301.55,1403.48,-619.4,2972.93
659134324062715264,2020-04,1327.26,1471.57,2014.5,3253.46,-1383.27,1589.66
659134324062715264,2020-05,0,394.98,1276.62,306.18,575.46,2165.12
659134324062715264,2020-06,71.14,953.01,1551.59,1131.41,-461.69,1703.43
659134324062715264,2020-07,2227.71,1246.08,1429.54,2902.08,-490.91,1212.52
659134324062715264,2020-09,1180.1,1064.25,2477.84,2676.25,-82.56,1129.96
659134324062715264,2020-10,2623.32,2980.6,0,792.04,-1149.32,-19.36
659134324062715264,2020-11,1275.09,1571.08,3498.02,0,3202.03,3182.67
659134324062715264,2020-12,3558.78,2863.03,2541,371.53,2865.22,6047.89
660185041243099648,2020-01,3457.33,5194.32,6758.55,3766.67,1254.89,1254.89
660185041243099648,2020-02,5060.15,4969.4,3174.83,5077.31,-1811.73,-556.84
660185041243099648,2020-03,5416.15,4575.81,6494.18,2669.62,4664.9,4108.06
660185041243099648,2020-04,5927.5,3358.94,1163.79,8377.01,-4644.66,-536.6
660185041243099648,2020-05,6405.12,4919.79,4787.38,9436.59,-3163.88,-3700.48
660185041243099648,2020-06,9375.69,5685.11,6242.02,4551.95,5380.65,1680.17
660185041243099648,2020-07,7552.56,4604.31,5383.5,3714.68,4617.07,6297.24
660185041243099648,2020-08,5113.66,6072.74,6123.24,4080.49,1083.67,7380.91
660185041243099648,2020-09,4902.97,965.89,4188.05,5492.3,2632.83,10013.74
660185041243099648,2020-10,3197.06,6867.61,6492.23,5566.7,-2745.02,7268.72
660185041243099648,2020-11,3573.96,2833.64,8275.8,2237.38,6778.74,14047.46
660185041243099648,2020-12,4211.89,5624.96,2853.52,1989.62,-549.17,13498.29
660430009504909696,2020-01,2574.9,3610.48,3874.63,2748.06,90.99,90.99
660430009504909696,2020-02,3273.43,205.4,1049.67,321.42,3796.28,3887.27
660430009504909696,2020-03,2781.98,3212.68,1671.56,2237.84,-996.98,2890.29
660430009504909696,2020-04,1204.12,4742.82,13855.33,1659.92,8656.71,11547
660430009504909696,2020-05,860.78,4150.22,4897.05,3365.14,-1757.53,9789.47
660430009504909696,2020-06,2063.23,5881.81,4109.38,3549.22,-3258.42,6531.05
660430009504909696,2020-07,1440,1827.97,2489.38,7418.82,-5317.41,1213.64
660430009504909696,2020-08,2367.47,857.04,3441.79,3740.96,1211.26,2424.9
660430009504909696,2020-09,2760.3,5508.24,7401.36,3826.32,827.1,3252
660430009504909696,2020-10,487.48,0,1021.96,3845.75,-2336.31,915.69
660430009504909696,2020-11,3264.56,1230.75,3041.05,1874.82,3200.04,4115.73
660430009504909696,2020-12,4646.35,2192.68,1455.55,3697.91,211.31,4327.04
660477289778632704,2020-01,201.28,0,1316.77,1409.65,108.4,108.4
660477289778632704,2020-02,1092.65,0,0,558.23,534.42,642.82
660477289778632704,2020-03,0,2514.72,0,0,-2514.72,-1871.9
660477289778632704,2020-04,1683.12,74.63,0,791.08,817.41,-1054.49
660477289778632704,2020-05,0,112.95,959.1,0,846.15,-208.34
660477289778632704,2020-06,457.9,140.8,65.7,1325.72,-942.92,-1151.26
660477289778632704,2020-09,1336.76,0,0,951.75,385.01,-766.25
660477289778632704,2020-10,1378.37,1873.15,1807.84,760.61,552.45,-213.8
660477289778632704,2020-12,1732.8,1147.43,1399.52,0,1984.89,1771.09
661110642365853952,2020-01,2692.03,3110.84,4283.11,4880.69,-1016.39,-1016.39
661110642365853952,2020-02,3008.12,3186.02,1885.83,1227.83,480.1,-536.29
661110642365853952,2020-03,6402.8,2276.69,5006.51,726.65,8405.97,7869.68
661110642365853952,2020-04,2131.25,0,1714.74,3188.14,657.85,8527.53
661110642365853952,2020-05,49.7,6179,3207.17,1758.85,-4680.98,3846.55
661110642365853952,2020-06,592.95,5082.09,0,1314.82,-5803.96,-1957.41
661110642365853952,2020-07,6352.54,3211.25,1525.92,1108.16,3559.05,1601.64
661110642365853952,2020-08,3700.37,2266.31,3038.8,1501.51,2971.35,4572.99
661110642365853952,2020-09,3144.73,5104.54,1693.49,3320.41,-3586.73,986.26
661110642365853952,2020-10,1094.77,93.13,397.01,6357.06,-4958.41,-3972.15
661110642365853952,2020-11,3769.53,2430.69,2457.44,791.62,3004.66,-967.49
661110642365853952,2020-12,2097.7,44.57,2601.91,201.91,4453.13,3485.64
661988884283212544,2020-01,6509.11,4421.36,2785.09,5617.69,-744.85,-744.85
661988884283212544,2020-02,1328.78,7717.65,5320.3,6127.42,-7195.99,-7940.84
661988884283212544,2020-03,10182.5,2187.9,9552.88,80.93,17466.55,9525.71
661988884283212544,2020-04,7491.65,2800.37,2572.98,2483.02,4781.24,14306.95
661988884283212544,2020-05,7027.29,3107.15,2386.29,1808.35,4498.08,18805.03
661988884283212544,2020-06,2614.04,1927.33,3489.43,1242.16,2933.98,21739.01
661988884283212544,2020-07,1596.1,531.61,3196.64,4016.68,244.45,21983.46
661988884283212544,2020-08,6502.75,6451.09,7531.3,7914.63,-331.67,21651.79
661988884283212544,2020-09,1060.37,2968.56,3880.45,4146.91,-2174.65,19477.14
661988884283212544,2020-10,8561.01,2536.52,8042.45,7676.83,6390.11,25867.25
661988884283212544,2020-11,2524.11,5113.48,3010.7,3315.07,-2893.74,22973.51
661988884283212544,2020-12,0,3414.78,6813.86,5264.88,-1865.8,21107.71
662267027644877312,2020-04,0,1899.67,0,0,-1899.67,-1899.67
662267027644877312,2020-09,0,1646.83,0,0,-1646.83,-3546.5
662267027644877312,2020-10,0,1531.38,0,0,-1531.38,-5077.88
662267027644877312,2020-12,202.78,0,0,0,202.78,-4875.1
662332483855393408,2020-01,3610.98,412.45,2680.15,3246.88,2631.8,2631.8
662332483855393408,2020-02,2268.44,0,3286.74,0,5555.18,8186.98
662332483855393408,2020-03,1082.77,1486.02,640.65,2805.08,-2567.68,5619.3
662332483855393408,2020-04,1999.58,1407.76,2308.07,4462.27,-1562.38,4056.92
662332483855393408,2020-05,3165.05,1254.14,0,3976.13,-2065.22,1991.7
662332483855393408,2020-06,0,4958.2,1613.25,361.54,-3706.49,-1714.79
662332483855393408,2020-07,2899.19,3037.65,2035.71,1997.65,-100.4,-1815.19
662332483855393408,2020-08,321.71,0,1545.76,5147.78,-3280.31,-5095.5
662332483855393408,2020-09,3277.42,628.57,1562.97,2827.27,1384.55,-3710.95
662332483855393408,2020-10,3906.91,2274.02,0.74,1981.96,-348.33,-4059.28
662332483855393408,2020-11,2519.26,2883.74,824.9,714.33,-253.91,-4313.19
662332483855393408,2020-12,1964.62,3043.89,2264.13,2356.27,-1171.41,-5484.6
663008063645259648,2020-01,0,1923.71,0,1999.71,-3923.42,-3923.42
663008063645259648,2020-02,1218.16,3035.31,1607.36,1469.88,-1679.67,-5603.09
663008063645259648,2020-03,653.78,0,2358.97,0,3012.75,-2590.34
663008063645259648,2020-04,896.14,1582.53,0,252.19,-938.58,-3528.92
663008063645259648,2020-05,1530.67,1806.09,1737.38,2308.01,-846.05,-4374.97
663008063645259648,2020-06,0,873.74,2629.91,0,1756.17,-2618.8
663008063645259648,2020-07,1237.97,0,735.26,0,1973.23,-645.57
663008063645259648,2020-08,732.28,2910.13,2049.64,2138.7,-2266.91,-2912.48
663008063645259648,2020-09,4128.08,3471.75,1833.48,2239.3,250.51,-2661.97
663008063645259648,2020-10,0,1019.8,1954.77,566.01,368.96,-2293.01
663008063645259648,2020-11,0,285.01,1203.89,276.36,642.52,-1650.49
663008063645259648,2020-12,1174.69,1914.81,6663.66,1603.63,4319.91,2669.42
663865810234435840,2020-01,4156.91,11555.61,2163.51,6389.19,-11624.38,-11624.38
663865810234435840,2020-02,3792.16,2409,5770.18,3776.04,3377.3,-8247.08
663865810234435840,2020-03,7706.84,2061.18,3050.94,4705.82,3990.78,-4256.3
663865810234435840,2020-04,5223.81,7510.2,3090.05,2652.14,-1848.48,-6104.78
663865810234435840,2020-05,1320.19,3288.25,7613.03,6637.97,-993,-7097.78
663865810234435840,2020-06,2400.33,5188.25,738.82,687.37,-2736.47,-9834.25
663865810234435840,2020-07,4954.43,3806.78,5359.08,5909.31,597.42,-9236.83
663865810234435840,2020-08,7412.88,7040.27,8247.27,1595.02,7024.86,-2211.97
663865810234435840,2020-09,10698.77,2527.42,1654.82,6579.57,3246.6,1034.63
663865810234435840,2020-10,5583.09,5593.86,7290.96,3002.43,4277.76,5312.39
663865810234435840,2020-11,2066.59,2781.4,5947.1,2173.18,3059.11,8371.5
663865810234435840,2020-12,5044.17,5162.42,3495.71,4121.46,-744,7627.5
664458270754524416,2020-01,1947.97,2824.14,8882.91,3339.54,4667.2,4667.2
664458270754524416,2020-02,4448.31,2452.94,752,5564.47,-2817.1,1850.1
664458270754524416,2020-03,3635.56,3364.04,3386.68,1768.02,1890.18,3740.28
664458270754524416,2020-04,3903.35,12396.71,4241.31,5243.54,-9495.59,-5755.31
664458270754524416,2020-05,4060.62,3163.72,5700.18,6293.43,303.65,-5451.66
664458270754524416,2020-06,7459.37,4537.9,4372,11331.78,-4038.31,-9489.97
664458270754524416,2020-07,2875.36,7613.76,4697.92,5070.52,-5111,-14600.97
664458270754524416,2020-08,8942.58,5051.58,7141.14,1110.06,9922.08,-4678.89
664458270754524416,2020-09,803.7,7549.75,4888.47,5664,-7521.58,-12200.47
664458270754524416,2020-10,6304.03,8536.06,7694.81,3560.88,1901.9,-10298.57
664458270754524416,2020-11,32.53,6264.92,6191.99,3748.53,-3788.93,-14087.5
664458270754524416,2020-12,5415.45,5102.98,4918.71,5493.89,-262.71,-14350.21
664582005887549184,2020-01,3017.78,4249.95,920.3,1773.29,-2085.16,-2085.16
664582005887549184,2020-02,0,100.03,0,530.55,-630.58,-2715.74
664582005887549184,2020-03,2352.66,2672.44,2586.31,2482.04,-215.51,-2931.25
664582005887549184,2020-04,0,2405.35,1099.19,742.17,-2048.33,-4979.58
664582005887549184,2020-05,947.42,3746.26,1291.83,2555.31,-4062.32,-9041.9
664582005887549184,2020-06,1081.14,91.96,2664.68,1359.16,2294.7,-6747.2
664582005887549184,2020-07,1227.93,0,0,632.35,595.58,-6151.62
664582005887549184,2020-08,272.06,0,0,2480.77,-2208.71,-8360.33
664582005887549184,2020-09,3529.18,1511.83,4820.29,0,6837.64,-1522.69
664582005887549184,2020-11,0,1476.71,2034.19,1298.65,-741.17,-2263.86
664582005887549184,2020-12,3071.9,289.98,6423.93,7140.83,2065.02,-198.84
665283314283462656,2020-01,1575.75,4826.89,2884.51,1931.15,-2297.78,-2297.78
665283314283462656,2020-02,4857.61,0,3867.89,0,8725.5,6427.72
665283314283462656,2020-03,7099.85,5546.07,4666.75,0,6220.53,12648.25
665283314283462656,2020-04,4469.49,4912.76,711.61,3654.04,-3385.7,9262.55
665283314283462656,2020-05,3671.81,3558.23,2739.39,8127.19,-5274.22,3988.33
665283314283462656,2020-06,677.56,334.12,4531.57,2934.28,1940.73,5929.06
665283314283462656,2020-07,1443.53,2382.6,0,180.21,-1119.28,4809.78
665283314283462656,2020-08,2054.86,1427.31,8402.8,2275.46,6754.89,11564.67
665283314283462656,2020-09,4805.9,1711.45,5237.16,3016.13,5315.48,16880.15
665283314283462656,2020-10,0,34.49,1635.78,3514.28,-1912.99,14967.16
665283314283462656,2020-11,1698.68,4594.99,9.09,3554.38,-6441.6,8525.56
665283314283462656,2020-12,6614.72,582.99,1086.82,1525.24,5593.31,14118.87
665608492301247104,2020-01,0,706.42,0,0,-706.42,-706.42
665608492301247104,2020-12,1016.64,0,0,0,1016.64,310.22
665738565835560448,2020-02,0,547.45,974.71,1201.4,-774.14,-774.14
665738565835560448,2020-03,0,427.8,2496.05,1748.27,319.98,-454.16
665738565835560448,2020-05,6509.74,0,822.62,0,7332.36,6878.2
665738565835560448,2020-07,0,2980.09,1828.42,184.92,-1336.59,5541.61
665738565835560448,2020-08,156.71,0,0,0,156.71,5698.32
665738565835560448,2020-09,828.19,0,0,0,828.19,6526.51
665738565835560448,2020-10,0,2664.47,474.69,0,-2189.78,4336.73
665738565835560448,2020-11,4802.02,3042.22,2854.28,1240.34,3373.74,7710.47
665738565835560448,2020-12,1733.38,3019.72,392.14,0,-894.2,6816.27
666052696990312576,2020-01,769.68,406.82,0,81.93,280.93,280.93
666052696990312576,2020-02,0,1462.09,1686.59,67.44,157.06,437.99
666052696990312576,2020-04,0,319.97,2003.5,934.7,748.83,1186.82
666052696990312576,2020-05,1459.9,225.28,878.87,0,2113.49,3300.31
666052696990312576,2020-06,1096.74,2.04,1180.31,1301.83,973.18,4273.49
666052696990312576,2020-07,1245.98,0,1898.64,0,3144.62,7418.11
666052696990312576,2020-08,586.92,0,0,2424.64,-1837.72,5580.39
666052696990312576,2020-09,0,1137.18,0,1155.7,-2292.88,3287.51
666052696990312576,2020-10,846.25,970.49,811.22,1859.03,-1172.05,2115.46
666052696990312576,2020-11,3005.26,1834.57,1283.6,0,2454.29,4569.75
666052696990312576,2020-12,3127.36,0,0,0,3127.36,7697.11
666454899306893568,2020-01,8441.17,845.18,0,0,7595.99,7595.99
666454899306893568,2020-02,391.11,0,0,368.71,22.4,7618.39
666454899306893568,2020-03,1874.23,1925.81,734.94,5237.42,-4554.06,3064.33
666454899306893568,2020-04,0,1641.78,4520.37,3529.46,-650.87,2413.46
666454899306893568,2020-05,3479.27,1699.71,4361.65,1736.85,4404.36,6817.82
666454899306893568,2020-06,2730.37,2050.13,2065.76,205.52,2540.48,9358.3
666454899306893568,2020-07,1912.04,1177.41,2760.66,0,3495.29,12853.59
666454899306893568,2020-08,0,616.86,0,694.03,-1310.89,11542.7
666454899306893568,2020-09,2190.53,457.63,1875.07,1660.95,1947.02,13489.72
666454899306893568,2020-10,0,1430.01,303.89,6437.46,-7563.58,5926.14
666454899306893568,2020-11,2316.12,0,319.79,1978.56,657.35,6583.49
666454899306893568,2020-12,1990.11,2178.71,0,0,-188.6,6394.89
667087528604895360,2020-01,0,2052.51,0,1304.04,-3356.55,-3356.55
667087528604895360,2020-02,1454.74,1330.75,1110.09,0,1234.08,-2122.47
667087528604895360,2020-04,1771.13,0,3649.48,0,5420.61,3298.14
667087528604895360,2020-06,1983.91,0,476.03,0,2459.94,5758.08
667087528604895360,2020-07,0,493.29,0,0,-493.29,5264.79
667087528604895360,2020-10,1399.63,1751.3,0,0,-351.67,4913.12
667087528604895360,2020-11,357.69,1430.39,0,0,-1072.7,3840.42
667087528604895360,2020-12,0,687.64,0,0,-687.64,3152.78
667573026116255616,2020-01,2909.15,2829.26,0,0,79.89,79.89
667573026116255616,2020-02,2005.73,2662.16,991.45,3602.69,-3267.67,-3187.78
667573026116255616,2020-03,2083.67,6758.07,1747.32,3209.42,-6136.5,-9324.28
667573026116255616,2020-04,1328.58,3271.11,1305.53,691.23,-1328.23,-10652.51
667573026116255616,2020-05,357.68,837.99,1337.17,4019.68,-3162.82,-13815.33
667573026116255616,2020-06,1726.18,2784.02,2915.47,307.7,1549.93,-12265.4
667573026116255616,2020-07,2813.46,0,3944.67,3979.11,2779.02,-9486.38
667573026116255616,2020-08,0,3534.67,0,440.58,-3975.25,-13461.63
667573026116255616,2020-09,2196.25,849.23,2657.98,285.53,3719.47,-9742.16
667573026116255616,2020-10,2908.01,1208.49,118.74,6219.04,-4400.78,-14142.94
667573026116255616,2020-11,1192.89,1527.54,996.16,0,661.51,-13481.43
667573026116255616,2020-12,1396.68,1617.31,1977.77,1815.27,-58.13,-13539.56
668769153649548160,2020-01,4323.52,1518.04,2659.97,4933.03,532.42,532.42
668769153649548160,2020-02,3716.94,5344.89,3295.65,4836.5,-3168.8,-2636.38
668769153649548160,2020-04,1715.2,0,395.27,235.51,1874.96,-761.42
668769153649548160,2020-05,4341.93,4451.45,1943.29,3352.9,-1519.13,-2280.55
668769153649548160,2020-06,2156.55,1642.32,1434.65,0,1948.88,-331.67
668769153649548160,2020-07,353.8,0,4096.64,5169.65,-719.21,-1050.88
668769153649548160,2020-08,0,2172.2,1696.61,1723.22,-2198.81,-3249.69
668769153649548160,2020-09,1878.32,1229.54,0,1118.99,-470.21,-3719.9
668769153649548160,2020-10,2574.32,1185.51,0,2703.32,-1314.51,-5034.41
668769153649548160,2020-11,4912.86,6083.66,3873.02,1263.53,1438.69,-3595.72
668769153649548160,2020-12,8327.42,1532.36,150.51,2228.9,4716.67,1120.95
668986002229710208,2020-01,5519.55,3734.6,359.73,6219.2,-4074.52,-4074.52
668986002229710208,2020-02,4827.91,6845.84,0,151.54,-2169.47,-6243.99
668986002229710208,2020-03,1376.02,4182.53,585.22,5680.64,-7901.93,-14145.92
668986002229710208,2020-04,1521.31,6925.82,7397.03,1444.08,548.44,-13597.48
668986002229710208,2020-05,659.32,4477.66,4191.29,6930.56,-6557.61,-20155.09
668986002229710208,2020-06,1936.26,2185.69,1913.04,1696.39,-32.78,-20187.87
668986002229710208,2020-07,2875.8,1628.69,4821.6,2210.13,3858.58,-16329.29
668986002229710208,2020-08,1978.62,3001.56,4223.34,9178.52,-5978.12,-22307.41
668986002229710208,2020-09,2949.02,3836.26,5434.23,3549.1,997.89,-21309.52
668986002229710208,2020-10,2171.39,4389.54,3726.48,3138.05,-1629.72,-22939.24
668986002229710208,2020-11,2282.69,4145.44,2585.05,5611.56,-4889.26,-27828.5
668986002229710208,2020-12,1680.26,4615.49,3975.47,6231.96,-5191.72,-33020.22
669400950628924800,2020-04,0,257.87,0,0,-257.87,-257.87
669400950628924800,2020-05,1195.37,3428.06,4129.3,1783.25,113.36,-144.51
669400950628924800,2020-07,0,379.89,0,0,-379.89,-524.4
669400950628924800,2020-08,0,1565.4,0,0,-1565.4,-2089.8
669400950628924800,2020-11,336.88,0,0,1853.34,-1516.46,-3606.26
671085368658041344,2020-01,1080.58,7861.06,1850.67,3548.65,-8478.46,-8478.46
671085368658041344,2020-02,5014.98,4015.94,5419.07,2645.4,3772.71,-4705.75
671085368658041344,2020-03,2488.91,73.83,4652.98,2065.2,5002.86,297.11
671085368658041344,2020-04,8261.22,6960.58,3576.33,1870.76,3006.21,3303.32
671085368658041344,2020-05,5365.43,1198.77,7510.38,3294.59,8382.45,11685.77
671085368658041344,2020-06,0,10938.64,837.07,2819.68,-12921.25,-1235.48
671085368658041344,2020-07,4507.34,0,2340.9,3747.88,3100.36,1864.88
671085368658041344,2020-08,2715.96,841.22,3099.83,1977.49,2997.08,4861.96
671085368658041344,2020-09,3590.8,6147.92,4591.23,382.99,1651.12,6513.08
671085368658041344,2020-10,2078.74,773.53,6660.26,4059.43,3906.04,10419.12
671085368658041344,2020-11,6007.66,8497.18,5218.6,2963.19,-234.11,10185.01
671085368658041344,2020-12,2491.97,7356.67,3652.8,2231.44,-3443.34,6741.67
672886094509137792,2020-01,11998.22,4355.42,1242.52,1300.32,7585,7585
672886094509137792,2020-02,3623.61,1738.46,2124.46,3439.34,570.27,8155.27
672886094509137792,2020-03,1389.56,2676.31,4580.74,429.8,2864.19,11019.46
672886094509137792,2020-04,6204.24,4060.93,6844.88,5112.39,3875.8,14895.26
672886094509137792,2020-05,8898.62,8724.3,7892.28,6906.19,1160.41,16055.67
672886094509137792,2020-06,7819.25,2192.39,2458.44,4923.05,3162.25,19217.92
672886094509137792,2020-07,6584.72,9685.19,3100.42,4679.74,-4679.79,14538.13
672886094509137792,2020-08,2152.96,2483.12,4940.33,7196.34,-2586.17,11951.96
672886094509137792,2020-09,8482.18,2304.25,4888.96,177.07,10889.82,22841.78
672886094509137792,2020-10,3229.54,1892.56,1056.83,2027.25,366.56,23208.34
672886094509137792,2020-11,4681.4,1190,1349.33,3174.66,1666.07,24874.41
672886094509137792,2020-12,6907.79,5132.03,3907.07,2350.34,3332.49,28206.9
673400190950103808,2020-01,880.78,4651.77,6138.9,6978.61,-4610.7,-4610.7
673400190950103808,2020-02,2567.03,7406.06,3593.59,2160.32,-3405.76,-8016.46
673400190950103808,2020-03,5554.76,3536.24,5183.85,1136.31,6066.06,-1950.4
673400190950103808,2020-04,7919.46,3650.45,10165.99,2392.19,12042.81,10092.41
673400190950103808,2020-05,5409.34,3282.85,1993.32,1919.87,2199.94,12292.35
673400190950103808,2020-06,4815.16,308.4,8024.78,0,12531.54,24823.89
673400190950103808,2020-07,4359.29,7450.32,4030.53,2317.88,-1378.38,23445.51
673400190950103808,2020-08,4652.84,4555.45,10936.74,3427.96,7606.17,31051.68
673400190950103808,2020-09,2765.37,4459.29,2382.03,3909.75,-3221.64,27830.04
673400190950103808,2020-10,9281.44,8174.04,5474.27,3519.09,3062.58,30892.62
673400190950103808,2020-11,4559.37,11466.54,3778.72,3002.46,-6130.91,24761.71
673400190950103808,2020-12,0,1205.45,3320.91,4833,-2717.54,22044.17
674566305036026112,2020-01,6718.82,5206.93,3605.97,6595.82,-1477.96,-1477.96
674566305036026112,2020-02,6577.48,8428.11,2636.82,1891.93,-1105.74,-2583.7
674566305036026112,2020-03,8163.63,3292.45,2565.78,3694.36,3742.6,1158.9
674566305036026112,2020-04,5593.98,3002.18,4787.7,4639.25,2740.25,3899.15
674566305036026112,2020-05,4199.22,10651.38,3854.59,2605.19,-5202.76,-1303.61
674566305036026112,2020-06,8823.27,2787.51,2552.12,4641.69,3946.19,2642.58
674566305036026112,2020-07,3270.36,4681.61,2825.09,4484.92,-3071.08,-428.5
674566305036026112,2020-08,3225.16,4490.36,2789.36,9301.43,-7777.27,-8205.77
674566305036026112,2020-09,2567.04,6463.2,3660.46,1856.05,-2091.75,-10297.52
674566305036026112,2020-10,6491.12,5527.75,12666.69,3235.81,10394.25,96.73
674566305036026112,2020-11,4173.18,2034.61,4137.83,3550.65,2725.75,2822.48
674566305036026112,2020-12,4607.98,9051.77,5015.84,4744.38,-4172.33,-1349.85
674961947612972032,2020-01,3951.56,1520.47,1107.27,1950.61,1587.75,1587.75
674961947612972032,2020-02,7131.67,2426.28,5288.18,3611.85,6381.72,7969.47
674961947612972032,2020-03,2920.49,6558.54,3942.33,1517.91,-1213.63,6755.84
674961947612972032,2020-04,3962.29,6696.98,4099.86,1695.32,-330.15,6425.69
674961947612972032,2020-05,8522.14,4560.06,1914.94,2691.23,3185.79,9611.48
674961947612972032,2020-06,5368.98,697.46,3156.21,0,7827.73,17439.21
674961947612972032,2020-07,326.95,3391.78,6176.47,1004.16,2107.48,19546.69
674961947612972032,2020-08,868.38,2745.58,9160.13,0,7282.93,26829.62
674961947612972032,2020-09,3619.78,5173.04,344.69,2143.62,-3352.19,23477.43
674961947612972032,2020-10,1691.44,1094.28,0,1504.99,-907.83,22569.6
674961947612972032,2020-11,0,212.07,4916.81,487.85,4216.89,26786.49
674961947612972032,2020-12,2053.11,1287.16,4087.48,3780.96,1072.47,27858.96
676925913577993984,2020-01,3464.76,962.84,816.43,5605.45,-2287.1,-2287.1
676925913577993984,2020-02,2234.49,7444.96,1346.88,2773.3,-6636.89,-8923.99
676925913577993984,2020-03,5697.05,4857.94,3172.46,1846.39,2165.18,-6758.81
676925913577993984,2020-04,985.56,6474.85,2890.62,3961.55,-6560.22,-13319.03
676925913577993984,2020-05,3484.97,4940.62,3137.17,8067.17,-6385.65,-19704.68
676925913577993984,2020-06,3371.8,3046.66,5275.83,3503.52,2097.45,-17607.23
676925913577993984,2020-07,0,3673.35,6795.62,271.21,2851.06,-14756.17
676925913577993984,2020-08,2358.49,3473,1176.15,2009.99,-1948.35,-16704.52
676925913577993984,2020-09,5370.57,1446.95,5489.04,7598.22,1814.44,-14890.08
676925913577993984,2020-10,5217.89,3702.01,1024.05,74.6,2465.33,-12424.75
676925913577993984,2020-11,4882.5,832.87,2104.74,2612.15,3542.22,-8882.53
676925913577993984,2020-12,4027.56,3757.8,2806.56,367.95,2708.37,-6174.16
676998197234032896,2020-02,1341.5,0,436.36,0,1777.86,1777.86
676998197234032896,2020-03,1764.46,0,1792.86,444.85,3112.47,4890.33
676998197234032896,2020-04,550.36,0,0,1567.59,-1017.23,3873.1
676998197234032896,2020-06,1034.82,2020.15,0,0,-985.33,2887.77
676998197234032896,2020-07,0,2071.89,1153.79,349.49,-1267.59,1620.18
676998197234032896,2020-08,0,84.27,2125.88,504.02,1537.59,3157.77
676998197234032896,2020-09,1002.17,518.81,2352,719.04,2116.32,5274.09
676998197234032896,2020-10,614.53,300.06,0,0,314.47,5588.56
676998197234032896,2020-11,190.92,1079.39,1776.64,2310.86,-1422.69,4165.87
676998197234032896,2020-12,1493.25,632.55,1845.74,0,2706.44,6872.31
677922494510791040,2020-01,345.68,0,191.18,0,536.86,536.86
677922494510791040,2020-02,1301.32,0,1925.06,1533,1693.38,2230.24
677922494510791040,2020-03,566.03,339.88,1663.45,0,1889.6,4119.84
677922494510791040,2020-04,4601.17,2339.81,793.44,2208.75,846.05,4965.89
677922494510791040,2020-05,0,1567.17,1628.3,339.3,-278.17,4687.72
677922494510791040,2020-06,414.61,5362,1758.61,0,-3188.78,1498.94
677922494510791040,2020-07,3471.58,3320.74,1326.48,1882.41,-405.09,1093.85
677922494510791040,2020-08,0,358.96,1793.82,0,1434.86,2528.71
677922494510791040,2020-09,0,588.07,1529.83,1023.54,-81.78,2446.93
677922494510791040,2020-10,3849.05,1435.5,731.37,1102.32,2042.6,4489.53
677922494510791040,2020-11,0,3069,748.47,5986.65,-8307.18,-3817.65
677922494510791040,2020-12,342.79,2966.75,1164.02,2195.92,-3655.86,-7473.51
678847529372377728,2020-01,3978.56,2275.36,2805.92,6706.35,-2197.23,-2197.23
678847529372377728,2020-02,5022.16,213.07,6222.55,4368.05,6663.59,4466.36
678847529372377728,2020-03,1819.55,3348.47,1825.18,3066.65,-2770.39,1695.97
678847529372377728,2020-04,10234.14,10358.86,2512.39,1979.26,408.41,2104.38
678847529372377728,2020-05,3139.13,847.78,1850.58,1476.75,2665.18,4769.56
678847529372377728,2020-06,2127.37,4423.16,9335.18,1039.87,5999.52,10769.08
678847529372377728,2020-07,850.34,5017.03,1909.1,5274.62,-7532.21,3236.87
678847529372377728,2020-08,1664.96,36.47,8391.12,4197.18,5822.43,9059.3
678847529372377728,2020-09,3334.18,3090.1,5662.43,8476.2,-2569.69,6489.61
678847529372377728,2020-10,0,3390.42,4659.68,4118.47,-2849.21,3640.4
678847529372377728,2020-11,3425.62,1116.98,3673.97,2712.42,3270.19,6910.59
678847529372377728,2020-12,5768.23,12299.27,1924.7,8267.64,-12873.98,-5963.39
680992238827492480,2020-01,2579.96,6309.38,9152.36,2294.97,3127.97,3127.97
680992238827492480,2020-02,4158.69,1238.82,2098.85,4213.57,805.15,3933.12
680992238827492480,2020-03,1251.42,4772.21,3039.53,1186.54,-1667.8,2265.32
680992238827492480,2020-04,850.86,3604.35,5550.25,8127.33,-5330.57,-3065.25
680992238827492480,2020-05,1476.58,7619.33,2426.7,1762.75,-5478.8,-8544.05
680992238827492480,2020-06,2296.4,3452.22,2711.45,1967.6,-411.97,-8956.02
680992238827492480,2020-07,1967.35,1124.89,4640.62,677.49,4805.59,-4150.43
680992238827492480,2020-08,13958.07,5611.63,2789.19,4829.43,6306.2,2155.77
680992238827492480,2020-09,3204.08,4261.61,4111.16,2761.5,292.13,2447.9
680992238827492480,2020-10,1132,1779.66,0,2537.61,-3185.27,-737.37
680992238827492480,2020-11,4098.81,2481.88,6419.2,4534.06,3502.07,2764.7
680992238827492480,2020-12,10957.69,5566.12,3608.21,2479.04,6520.74,9285.44
681435645132419968,2020-01,2830.02,2143.3,3578.4,2833.01,1432.11,1432.11
681435645132419968,2020-02,4840.49,3770.92,3144.3,2123.74,2090.13,3522.24
681435645132419968,2020-03,5528.48,3565.79,2385.91,2054.32,2294.28,5816.52
681435645132419968,2020-04,6193,4681.04,3291.99,6959.86,-2155.91,3660.61
681435645132419968,2020-05,1364,8761.11,5401.3,3802.1,-5797.91,-2137.3
681435645132419968,2020-06,4020.73,1490.87,2910.24,5408.68,31.42,-2105.88
681435645132419968,2020-07,1412.7,6922.23,4429.75,2636.62,-3716.4,-5822.28
681435645132419968,2020-08,4166.57,2022.16,6163.62,10498.61,-2190.58,-8012.86
681435645132419968,2020-09,100.74,4267.4,4659.59,4890.21,-4397.28,-12410.14
681435645132419968,2020-10,9041.81,2923.73,3253.2,2889.27,6482.01,-5928.13
681435645132419968,2020-11,2401.04,6603.32,7081.25,7634.97,-4756,-10684.13
681435645132419968,2020-12,1612.09,3327.97,917.7,0,-798.18,-11482.31
683207827649773440,2020-02,10464.93,4612.14,2343.27,2878.94,5317.12,5317.12
683207827649773440,2020-03,73.3,1228.94,1798.28,602.63,40.01,5357.13
683207827649773440,2020-04,0,4095.69,0,0,-4095.69,1261.44
683207827649773440,2020-05,2643.34,1621.44,5455.81,2616.11,3861.6,5123.04
683207827649773440,2020-06,934.65,3890.27,3243.78,1845.65,-1557.49,3565.55
683207827649773440,2020-07,0,3609.13,3345.98,2324.36,-2587.51,978.04
683207827649773440,2020-08,0,1821.98,1085.19,3886.26,-4623.05,-3645.01
683207827649773440,2020-09,4306.56,1655.84,1320.65,3240.6,730.77,-2914.24
683207827649773440,2020-10,5796.36,2675.1,0,830.18,2291.08,-623.16
683207827649773440,2020-11,2147.91,4163.02,1532.61,1022.73,-1505.23,-2128.39
683207827649773440,2020-12,2710.78,6003.91,2511.5,4700.56,-5482.19,-7610.58
683613755888436608,2020-01,1832.86,389.35,279.62,3156.68,-1433.55,-1433.55
683613755888436608,2020-02,5168.76,44.76,1228.32,1170.33,5181.99,3748.44
683613755888436608,2020-03,2183.08,115.32,0,4137.9,-2070.14,1678.3
683613755888436608,2020-04,652.89,711.87,1807.43,0,1748.45,3426.75
683613755888436608,2020-05,2786.01,812.3,1666.77,2526.27,1114.21,4540.96
683613755888436608,2020-06,0,847.72,1643.57,2017.89,-1222.04,3318.92
683613755888436608,2020-07,0,950.74,1045.02,1808.53,-1714.25,1604.67
683613755888436608,2020-08,1196.34,1970.65,0,2075.38,-2849.69,-1245.02
683613755888436608,2020-09,1983.07,1804.97,1622.6,442.24,1358.46,113.44
683613755888436608,2020-10,0,920.3,2317.35,692.22,704.83,818.27
683613755888436608,2020-11,1756.59,1614.3,0,603.99,-461.7,356.57
683613755888436608,2020-12,461.65,0,0,2785.25,-2323.6,-1967.03
685753758940921472,2020-01,1912.59,5183.45,4949.53,5790.29,-4111.62,-4111.62
685753758940921472,2020-02,4706.2,2974.24,451.27,5328.84,-3145.61,-7257.23
685753758940921472,2020-03,3852.26,3449.2,6005.88,7632.31,-1223.37,-8480.6
685753758940921472,2020-04,1274.84,1666.34,721.79,6052.93,-5722.64,-14203.24
685753758940921472,2020-05,4429.09,2891.93,0,538.39,998.77,-13204.47
685753758940921472,2020-06,623.14,130.45,389.85,8498.82,-7616.28,-20820.75
685753758940921472,2020-07,3765.39,4816.65,4675.31,5151.35,-1527.3,-22348.05
685753758940921472,2020-08,8102.38,4653,5721.02,1151.96,8018.44,-14329.61
685753758940921472,2020-09,5280.94,2928.3,966.35,5538.56,-2219.57,-16549.18
685753758940921472,2020-10,4734.99,5285.69,3037.97,6179.17,-3691.9,-20241.08
685753758940921472,2020-11,6472.14,3305.23,8914.59,2874.08,9207.42,-11033.66
685753758940921472,2020-12,3986.25,1676.58,3736.99,2764.28,3282.38,-7751.28
686911269362345728,2020-01,1760.69,240.05,2999.82,1422.37,3098.09,3098.09
686911269362345728,2020-02,1955.66,1582.27,6627.97,2860.92,4140.44,7238.53
686911269362345728,2020-03,2096.93,2862.93,2590.83,2543.6,-718.77,6519.76
686911269362345728,2020-04,4996.77,2947.46,2076.12,1522.49,2602.94,9122.7
686911269362345728,2020-05,683.09,4726.72,3607.95,9003.41,-9439.09,-316.39
686911269362345728,2020-06,6187.53,4273.07,3370.2,1695.09,3589.57,3273.18
686911269362345728,2020-07,1190.69,2077.97,0,436.87,-1324.15,1949.03
686911269362345728,2020-08,3117.55,1916.12,914.4,3061.19,-945.36,1003.67
686911269362345728,2020-09,3447.08,870.92,826.53,7236.93,-3834.24,-2830.57
686911269362345728,2020-10,1739.48,4025.9,2989.3,1400.81,-697.93,-3528.5
686911269362345728,2020-11,826.03,4585.46,2804.29,3524.08,-4479.22,-8007.72
686911269362345728,2020-12,8665.37,4208.27,431.81,1048.12,3840.79,-4166.93
686968935959369728,2020-01,0,12892.04,4128.58,2284.88,-11048.34,-11048.34
686968935959369728,2020-02,3757.86,7635.32,2958.51,4005.9,-4924.85,-15973.19
686968935959369728,2020-03,3513.82,1107.98,160.16,3345.68,-779.68,-16752.87
686968935959369728,2020-04,4086.28,5148.98,6005.06,5261.51,-319.15,-17072.02
686968935959369728,2020-05,4302.37,3031.33,5570.33,4488.83,2352.54,-14719.48
686968935959369728,2020-06,6778.86,7647.95,6177.08,3132.18,2175.81,-12543.67
686968935959369728,2020-07,7914.26,1072.44,3602.85,4969.29,5475.38,-7068.29
686968935959369728,2020-08,6455.12,4031.71,11719.72,3970.84,10172.29,3104
686968935959369728,2020-09,6166.15,4548.98,1717.32,2578.85,755.64,3859.64
686968935959369728,2020-10,10349.53,9209.83,2348.1,3467.54,20.26,3879.9
686968935959369728,2020-11,3316.37,3531.44,3737.04,9402.97,-5881,-2001.1
686968935959369728,2020-12,6698.17,4933.72,3714.3,7765.59,-2286.84,-4287.94
687263168538997888,2020-01,4456.87,6963.54,3091.98,6403.15,-5817.84,-5817.84
687263168538997888,2020-02,2865.84,10640.92,2285.26,10094.68,-15584.5,-21402.34
687263168538997888,2020-03,1679.79,3323.42,3587.31,6661.86,-4718.18,-26120.52
687263168538997888,2020-04,1968.58,10258.54,1882.65,5584.55,-11991.86,-38112.38
687263168538997888,2020-05,5625.54,8023.66,3512.01,5776.51,-4662.62,-42775
687263168538997888,2020-06,8238.78,3840.56,3440.59,2638.9,5199.91,-37575.09
687263168538997888,2020-07,5923.49,4757.08,10802.84,6965.32,5003.93,-32571.16
687263168538997888,2020-08,2485.49,3389.43,8246.13,904.13,6438.06,-26133.1
687263168538997888,2020-09,7892.72,5735.78,8216.76,6223.91,4149.79,-21983.31
687263168538997888,2020-10,3720.63,4963.22,1302.76,3825.72,-3765.55,-25748.86
687263168538997888,2020-11,3361.02,5034.32,4491.95,5896.07,-3077.42,-28826.28
687263168538997888,2020-12,1760.48,5055.44,2840.28,7380.96,-7835.64,-36661.92
687591633298225152,2020-01,1900.58,2405.9,4017.11,3169.32,342.47,342.47
687591633298225152,2020-02,920.69,1599.6,1636.49,3690.09,-2732.51,-2390.04
687591633298225152,2020-03,3130.69,4537.65,1979.55,8294.09,-7721.5,-10111.54
687591633298225152,2020-04,860.16,3964.29,2781.82,2512.22,-2834.53,-12946.07
687591633298225152,2020-05,2167.77,7600.09,2532.37,2843.24,-5743.19,-18689.26
687591633298225152,2020-06,3291.65,655.64,2232.37,3865.7,1002.68,-17686.58
687591633298225152,2020-07,4302.39,6149.31,3871.09,4721.61,-2697.44,-20384.02
687591633298225152,2020-08,4310.89,1415.68,735.26,3194.41,436.06,-19947.96
687591633298225152,2020-09,3367.46,1540.85,6376.63,3714.57,4488.67,-15459.29
687591633298225152,2020-10,5570.98,2356.13,3172.42,5118.19,1269.08,-14190.21
687591633298225152,2020-11,1177.26,1890.49,2591.55,2002.14,-123.82,-14314.03
687591633298225152,2020-12,0,2541.21,1114.53,618.96,-2045.64,-16359.67
688835438707003264,2020-01,2913.25,4456.55,2593,2307.57,-1257.87,-1257.87
688835438707003264,2020-02,0,3720.62,6354.8,0,2634.18,1376.31
688835438707003264,2020-03,3293.16,2145.64,3459.92,3700.84,906.6,2282.91
688835438707003264,2020-04,2897.83,7799.28,6424.18,5354.66,-3831.93,-1549.02
688835438707003264,2020-05,5352.46,167.93,2605.82,7580.25,210.1,-1338.92
688835438707003264,2020-06,5209.8,5310.12,1840.8,4329.04,-2588.56,-3927.48
688835438707003264,2020-07,6216.64,5033.7,3500.07,0,4683.01,755.53
688835438707003264,2020-08,1638.37,5536.17,5685.09,0,1787.29,2542.82
688835438707003264,2020-09,1577.81,2872.83,2312.89,4243.18,-3225.31,-682.49
688835438707003264,2020-10,5932.93,1384.57,1796.08,3362.21,2982.23,2299.74
688835438707003264,2020-11,3362.97,1176.81,3859.35,3423.1,2622.41,4922.15
688835438707003264,2020-12,939.63,5198.64,7507.37,1931.65,1316.71,6238.86
689344742969902208,2020-01,3854.33,297.43,1231.97,194.57,4594.3,4594.3
689344742969902208,2020-02,0,1337.73,5852.05,1220.69,3293.63,7887.93
689344742969902208,2020-03,1530.94,3139.02,1508.87,1687.34,-1786.55,6101.38
689344742969902208,2020-04,510.24,1272.59,2376.45,641,973.1,7074.48
689344742969902208,2020-05,2996.22,1908.83,1665.78,3904.25,-1151.08,5923.4
689344742969902208,2020-06,2930.95,124.3,3507.58,1141.84,5172.39,11095.79
689344742969902208,2020-07,2737.8,3436.09,2487.9,0,1789.61,12885.4
689344742969902208,2020-08,1309.12,4316.31,1044.89,2270.68,-4232.98,8652.42
689344742969902208,2020-09,3608.24,1891.88,1047.49,1380.12,1383.73,10036.15
689344742969902208,2020-10,582.07,1771.68,0,2487.39,-3677,6359.15
689344742969902208,2020-11,370.8,1414.87,1222.83,3886.56,-3707.8,2651.35
689344742969902208,2020-12,2208.38,1000.75,1489.35,3524.02,-827.04,1824.31
690982544499967616,2020-01,0,1688.51,1184.48,3238.93,-3742.96,-3742.96
690982544499967616,2020-03,0,1091.16,0,1304.04,-2395.2,-6138.16
690982544499967616,2020-04,1797.67,0,2999.98,1733.17,3064.48,-3073.68
690982544499967616,2020-06,176.89,0,697.41,0,874.3,-2199.38
690982544499967616,2020-07,231.56,1493.39,0,1964.65,-3226.48,-5425.86
690982544499967616,2020-08,1491.71,305.88,1762.16,1529.92,1418.07,-4007.79
690982544499967616,2020-09,1784.94,1021.67,5297.85,0,6061.12,2053.33
690982544499967616,2020-10,425.39,1316.19,0,0,-890.8,1162.53
690982544499967616,2020-11,0,3341.44,1832.15,3852.49,-5361.78,-4199.25
690982544499967616,2020-12,0,377.26,0,669.31,-1046.57,-5245.82
691823551238027904,2020-01,4510.43,6026.06,1764.41,6480.24,-6231.46,-6231.46
691823551238027904,2020-02,176.16,6841.63,3207.72,5694.89,-9152.64,-15384.1
691823551238027904,2020-03,2930.9,2634.59,8262.64,6159.65,2399.3,-12984.8
691823551238027904,2020-04,8668.09,1678.96,12328.85,4023.09,15294.89,2310.09
691823551238027904,2020-05,2746.11,4747.77,6566.5,4627.86,-63.02,2247.07
691823551238027904,2020-06,3375.37,3226.5,5043.96,2752.56,2440.27,4687.34
691823551238027904,2020-07,2735.25,1552.24,4736.92,3460.28,2459.65,7146.99
691823551238027904,2020-08,6602.92,815.16,5079.31,1523.17,9343.9,16490.89
691823551238027904,2020-09,6774.4,4589.72,2890.43,2566.68,2508.43,18999.32
691823551238027904,2020-10,5663.85,1261.56,6767.37,1623.25,9546.41,28545.73
691823551238027904,2020-11,4535.09,2412.87,250.97,2691.24,-318.05,28227.68
691823551238027904,2020-12,7183.04,11114.47,6170.51,3974.89,-1735.81,26491.87
692283679923727488,2020-02,345.46,0,496.42,0,841.88,841.88
692283679923727488,2020-04,1947.05,0,0,0,1947.05,2788.93
692283679923727488,2020-05,1270.78,0,0,0,1270.78,4059.71
692283679923727488,2020-06,1054.83,3186.35,0,0,-2131.52,1928.19
692283679923727488,2020-07,764.24,2923.05,0,1018.4,-3177.21,-1249.02
692283679923727488,2020-08,1775.51,0,413.59,0,2189.1,940.08
692283679923727488,2020-09,0,1229.08,0,0,-1229.08,-289
692283679923727488,2020-10,796.11,1709.32,0,0,-913.21,-1202.21
692283679923727488,2020-11,0,1737.33,0,0,-1737.33,-2939.54
692816800283292928,2020-01,3061.75,2499.92,1065.89,174.57,1453.15,1453.15
692816800283292928,2020-02,935.16,2429.4,0,2121.84,-3616.08,-2162.93
692816800283292928,2020-03,2194.57,3589.53,2640.58,2457.64,-1212.02,-3374.95
692816800283292928,2020-04,1419.38,312.04,4446.89,4470.17,1084.06,-2290.89
692816800283292928,2020-05,1756.36,3891.2,3899.76,3555.41,-1790.49,-4081.38
692816800283292928,2020-06,942.57,5829.63,3900.21,2416.16,-3403.01,-7484.39
692816800283292928,2020-07,3078.5,2279.59,1519.41,2487.22,-168.9,-7653.29
692816800283292928,2020-08,3319.6,0,151.9,6864.64,-3393.14,-11046.43
692816800283292928,2020-09,417.85,3884.13,1233.76,2202.93,-4435.45,-15481.88
692816800283292928,2020-10,141.5,5732.71,0,2809.59,-8400.8,-23882.68
692816800283292928,2020-11,3446.9,1485.38,3394.02,2752.81,2602.73,-21279.95
692816800283292928,2020-12,3885.99,2663,1427.77,1050.93,1599.83,-19680.12
693342459319881984,2020-01,2097.14,5517.53,3693.26,3975.41,-3702.54,-3702.54
693342459319881984,2020-02,2644.01,1898.44,4322.98,1747.39,3321.16,-381.38
693342459319881984,2020-03,4231.21,1997.46,3438.25,1191.76,4480.24,4098.86
693342459319881984,2020-04,38.02,1878.28,1744.07,3148.66,-3244.85,854.01
693342459319881984,2020-05,5328.15,2234.28,1826.4,5141.36,-221.09,632.92
693342459319881984,2020-06,3236.37,7511.05,3047.9,1871.8,-3098.58,-2465.66
693342459319881984,2020-07,911.88,5310.15,1825.59,3570.81,-6143.49,-8609.15
693342459319881984,2020-08,4705.42,8634.56,3200.48,3427.7,-4156.36,-12765.51
693342459319881984,2020-09,1093.15,3861.67,1715.93,410.89,-1463.48,-14228.99
693342459319881984,2020-10,1241.11,1865.22,1600.81,3626.6,-2649.9,-16878.89
693342459319881984,2020-11,1430.51,6620.13,3814.04,3823.06,-5198.64,-22077.53
693342459319881984,2020-12,0,1671.09,4215.57,1415.03,1129.45,-20948.08
693493188904664704,2020-01,3044.62,0,2260.49,1535.79,3769.32,3769.32
693493188904664704,2020-02,1740.32,1076.83,1497.97,1144.09,1017.37,4786.69
693493188904664704,2020-03,3048.82,1840.75,3099.93,5196.77,-888.77,3897.92
693493188904664704,2020-04,251.05,5178.54,3049.9,3288.79,-5166.38,-1268.46
693493188904664704,2020-05,2506.25,0,543.68,1581.75,1468.18,199.72
693493188904664704,2020-06,3074.12,0,1751.85,1788.45,3037.52,3237.24
693493188904664704,2020-07,312.93,1744.73,0,2883.55,-4315.35,-1078.11
693493188904664704,2020-08,863.14,2035.52,1179.62,2146.69,-2139.45,-3217.56
693493188904664704,2020-09,183.14,0,4864.73,2776.38,2271.49,-946.07
693493188904664704,2020-10,2564.58,1873.76,4625.16,361.2,4954.78,4008.71
693493188904664704,2020-11,1960.24,827.27,0,3210.74,-2077.77,1930.94
693493188904664704,2020-12,2223.47,707.91,3221.45,939.4,3797.61,5728.55
693585709608895744,2020-01,4714.32,3416.88,5736.48,1774.5,5259.42,5259.42
693585709608895744,2020-02,6859.76,1956.18,766.5,5736.15,-66.07,5193.35
693585709608895744,2020-03,1492.79,8993.75,3808.31,714.66,-4407.31,786.04
693585709608895744,2020-04,3023.58,2370.55,3753.07,2753.15,1652.95,2438.99
693585709608895744,2020-05,5609.71,5464.85,1572.87,6652.65,-4934.92,-2495.93
693585709608895744,2020-06,2563,7150.15,4232.74,5061.75,-5416.16,-7912.09
693585709608895744,2020-07,5285.44,1631.34,3127.44,494.68,6286.86,-1625.23
693585709608895744,2020-08,1854.22,6009.03,1719.49,2900.18,-5335.5,-6960.73
693585709608895744,2020-09,3712.25,791.55,2562.98,4831.79,651.89,-6308.84
693585709608895744,2020-10,5369.9,0,4020.02,2833.9,6556.02,247.18
693585709608895744,2020-11,611.05,3222.92,2128.5,5652.38,-6135.75,-5888.57
693585709608895744,2020-12,2010.98,8971.89,3961.74,2734.42,-5733.59,-11622.16
694077523980517120,2020-02,326.93,1537.37,0,1714.87,-2925.31,-2925.31
694077523980517120,2020-04,0,815.54,229.69,0,-585.85,-3511.16
694077523980517120,2020-05,0,131.74,1640.65,1619.64,-110.73,-3621.89
694077523980517120,2020-06,0,2216.29,0,2401.57,-4617.86,-8239.75
694077523980517120,2020-07,1065.62,0,0,0,1065.62,-7174.13
694077523980517120,2020-09,0,1035.51,0,151.84,-1187.35,-8361.48
694077523980517120,2020-11,958.68,0,0,0,958.68,-7402.8
694077523980517120,2020-12,1713.1,0,0,0,1713.1,-5689.7
694463778388758016,2020-01,1605.06,1968.58,1180.39,0,816.87,816.87
694463778388758016,2020-02,1186.34,1854.96,2261.73,0,1593.11,2409.98
694463778388758016,2020-03,3508.28,1319.96,1180.52,1796.95,1571.89,3981.87
694463778388758016,2020-04,1022.29,0,1007.75,0,2030.04,6011.91
694463778388758016,2020-05,5156.55,0,0,560.07,4596.48,10608.39
694463778388758016,2020-06,3029.08,646.57,518.69,2773.85,127.35,10735.74
694463778388758016,2020-07,318.04,2687.94,3617.22,3543.91,-2296.59,8439.15
694463778388758016,2020-08,1269.79,0,1579.98,660.24,2189.53,10628.68
694463778388758016,2020-09,374.38,2871.42,0,1441.32,-3938.36,6690.32
694463778388758016,2020-12,2172.93,1235.08,0,371.06,566.79,7257.11
694666488686648832,2020-01,1482.57,3405.6,2138.16,1110.76,-895.63,-895.63
694666488686648832,2020-02,1545.6,0,2636.84,0,4182.44,3286.81
694666488686648832,2020-03,2059.71,1957.38,4587.12,3638.06,1051.39,4338.2
694666488686648832,2020-04,2360.2,1113.72,4871.37,2367.82,3750.03,8088.23
694666488686648832,2020-05,2267.97,3773.08,948.81,757.22,-1313.52,6774.71
694666488686648832,2020-06,1055.83,1820.38,2923.01,5450.18,-3291.72,3482.99
694666488686648832,2020-07,0,1245.22,3918.43,1431.49,1241.72,4724.71
694666488686648832,2020-08,4755.29,505.94,3193.93,1889.7,5553.58,10278.29
694666488686648832,2020-09,3429.41,2006.59,3258.94,2311.77,2369.99,12648.28
694666488686648832,2020-10,2045.82,1082.97,540.05,3758.67,-2255.77,10392.51
694666488686648832,2020-11,2396.34,1332.53,2798.72,3722.08,140.45,10532.96
694666488686648832,2020-12,1492.2,3420.78,905.04,2167.77,-3191.31,7341.65
694681738349465088,2020-01,0,6272.94,3269.78,0,-3003.16,-3003.16
694681738349465088,2020-02,0,1569.49,3881.81,443.47,1868.85,-1134.31
694681738349465088,2020-03,1805.27,481.72,1378.34,2637.55,64.34,-1069.97
694681738349465088,2020-04,171.4,1449.43,0,1091.45,-2369.48,-3439.45
694681738349465088,2020-05,511.11,0,1321.75,1697.15,135.71,-3303.74
694681738349465088,2020-06,5100.11,1212.77,1212.64,1374.96,3725.02,421.28
694681738349465088,2020-07,3139.99,3246.17,1565.37,3806.4,-2347.21,-1925.93
694681738349465088,2020-08,2197.24,2607.57,2489.83,2809.94,-730.44,-2656.37
694681738349465088,2020-09,0,774.29,3183.51,1407.18,1002.04,-1654.33
694681738349465088,2020-10,2346.41,2761.23,1881.8,7354.74,-5887.76,-7542.09
694681738349465088,2020-11,691.81,2704.88,1897.67,5598.88,-5714.28,-13256.37
694681738349465088,2020-12,259.43,2799.39,75.67,2713.16,-5177.45,-18433.82
694760055415614080,2020-01,8932.75,3331.41,4424.71,2820.01,7206.04,7206.04
694760055415614080,2020-02,7400.19,4973.07,225.91,12384.01,-9730.98,-2524.94
694760055415614080,2020-03,1582.12,5107.88,4840.17,5776.7,-4462.29,-6987.23
694760055415614080,2020-04,2730.32,1885.55,5182.56,10628.4,-4601.07,-11588.3
694760055415614080,2020-05,4190.42,5626.05,2697.67,5792.3,-4530.26,-16118.56
694760055415614080,2020-06,4959.28,1271.94,5506.9,840.19,8354.05,-7764.51
694760055415614080,2020-07,1319.13,3702.17,5136.62,4378.21,-1624.63,-9389.14
694760055415614080,2020-08,4446.34,0,2421.14,3917.42,2950.06,-6439.08
694760055415614080,2020-09,5543.46,6719.38,2072.23,1593.69,-697.38,-7136.46
694760055415614080,2020-10,6396.03,4479.52,4022.55,3764.2,2174.86,-4961.6
694760055415614080,2020-11,3669.86,1489.52,570.95,4921.74,-2170.45,-7132.05
694760055415614080,2020-12,5395.05,7647.68,3358.83,5949.56,-4843.36,-11975.41
696003923944149632,2020-01,3700.36,3207.89,1423.43,7280.18,-5364.28,-5364.28
696003923944149632,2020-02,6421,404.07,3313.25,4746.66,4583.52,-780.76
696003923944149632,2020-03,7413.27,3278.96,4385.49,6041.36,2478.44,1697.68
696003923944149632,2020-04,2930.06,4077.94,11374.55,1963.2,8263.47,9961.15
696003923944149632,2020-05,4885.21,2631.46,3299.56,1336.81,4216.5,14177.65
696003923944149632,2020-06,2174.99,753.76,1365.05,2183.69,602.59,14780.24
696003923944149632,2020-07,2426.99,5649.42,1958.46,8075.78,-9339.75,5440.49
696003923944149632,2020-08,3495.5,5016.48,6222.46,2630.52,2070.96,7511.45
696003923944149632,2020-09,3848.81,2255.67,2685.23,2743.05,1535.32,9046.77
696003923944149632,2020-10,3207.14,3725.11,1752.67,527.99,706.71,9753.48
696003923944149632,2020-11,3300.02,7088.94,1152.32,4454.55,-7091.15,2662.33
696003923944149632,2020-12,1828.77,2715.27,8828.53,1844.88,6097.15,8759.48
697095339087468672,2020-05,0,1218.46,0,0,-1218.46,-1218.46
697095339087468672,2020-12,0,2917.26,57.35,0,-2859.91,-4078.37
697674230333567744,2020-01,1947.09,9043.14,1056.48,0,-6039.57,-6039.57
697674230333567744,2020-02,2482.17,4981.22,0,3104.81,-5603.86,-11643.43
697674230333567744,2020-03,2330.12,1395.01,870.79,401.91,1403.99,-10239.44
697674230333567744,2020-04,1074.85,2198.59,6831.83,1124.34,4583.75,-5655.69
697674230333567744,2020-05,1133.72,2403.53,3070.83,2823.8,-1022.78,-6678.47
697674230333567744,2020-06,8831,4170.69,3934.64,3415.19,5179.76,-1498.71
697674230333567744,2020-07,0,2216.91,2187.35,2139.02,-2168.58,-3667.29
697674230333567744,2020-08,2620.81,1310.97,325.23,0,1635.07,-2032.22
697674230333567744,2020-09,1259.17,3267.49,1583.7,2704.13,-3128.75,-5160.97
697674230333567744,2020-10,1542.18,3025.08,393.96,2127.12,-3216.06,-8377.03
697674230333567744,2020-11,1509.69,2879.76,1216.15,2707.3,-2861.22,-11238.25
697674230333567744,2020-12,2254.4,835.29,3423.27,0,4842.38,-6395.87
698535771630118272,2020-01,3605.77,0,6439.45,2634.89,7410.33,7410.33
698535771630118272,2020-02,1806.94,2398.13,5309.63,0,4718.44,12128.77
698535771630118272,2020-03,1769,3134.39,119.53,2407.99,-3653.85,8474.92
698535771630118272,2020-04,1033.79,864.75,0,2612.4,-2443.36,6031.56
698535771630118272,2020-05,1848.4,1473.46,2723.06,2814.46,283.54,6315.1
698535771630118272,2020-06,1814.36,2062.29,1927.43,1737.55,-58.05,6257.05
698535771630118272,2020-07,1715.24,4028.03,1515.62,1474.71,-2271.88,3985.17
698535771630118272,2020-08,2195.13,0,1677.08,3739.26,132.95,4118.12
698535771630118272,2020-09,3276.41,398.07,3667.29,405.52,6140.11,10258.23
698535771630118272,2020-10,0,2982.39,1694.55,1261.86,-2549.7,7708.53
698535771630118272,2020-11,2007.16,0,0,2823.25,-816.09,6892.44
698535771630118272,2020-12,2943.42,3996.63,3344.6,0,2291.39,9183.83
699205498931354240,2020-01,2397.75,2957.99,1308.31,3946.8,-3198.73,-3198.73
699205498931354240,2020-02,296.62,0,1819.33,1021.88,1094.07,-2104.66
699205498931354240,2020-03,2582.45,0,3227,1676.15,4133.3,2028.64
699205498931354240,2020-04,4282.54,850.43,0,4054.93,-622.82,1405.82
699205498931354240,2020-05,3319.58,5284.97,560.69,0,-1404.7,1.12
699205498931354240,2020-06,3122.51,1804.69,3910.99,93.73,5135.08,5136.2
699205498931354240,2020-07,2726.07,2290,1317.95,1237.35,516.67,5652.87
699205498931354240,2020-08,4912.82,4179.84,2508.36,4437.47,-1196.13,4456.74
699205498931354240,2020-09,4666.64,0,942.81,1782.78,3826.67,8283.41
699205498931354240,2020-10,5229.12,382.75,0,1109.57,3736.8,12020.21
699205498931354240,2020-11,2152.22,0,3118.31,2011.99,3258.54,15278.75
699205498931354240,2020-12,1190.67,3770.01,1763.32,1442.09,-2258.11,13020.64
701176207953859456,2020-01,1180.74,2837.29,3744.07,3312.95,-1225.43,-1225.43
701176207953859456,2020-02,2508.25,3803.54,2886.93,3969.8,-2378.16,-3603.59
701176207953859456,2020-03,5039.37,1209.74,2311.96,2449.89,3691.7,88.11
701176207953859456,2020-04,2059.12,4658.27,739.3,0,-1859.85,-1771.74
701176207953859456,2020-05,219.55,2165.12,2076.18,2842.63,-2712.02,-4483.76
701176207953859456,2020-06,2156.72,4829.06,0,2084.37,-4756.71,-9240.47
701176207953859456,2020-07,2685.88,3102.55,5124.92,837.68,3870.57,-5369.9
701176207953859456,2020-08,7118.19,2796.56,1889.53,2271.06,3940.1,-1429.8
701176207953859456,2020-09,4929.27,3043.85,4756.01,0,6641.43,5211.63
701176207953859456,2020-10,2630.94,69.75,1944.5,6668.98,-2163.29,3048.34
701176207953859456,2020-11,2782.04,4931.43,2137.64,1044.89,-1056.64,1991.7
701176207953859456,2020-12,301.79,1674.95,1900.8,3493.48,-2965.84,-974.14
701370497844170496,2020-03,0,370.58,0,0,-370.58,-370.58
701370497844170496,2020-04,0,1477.56,1651.23,0,173.67,-196.91
701370497844170496,2020-05,0,344.88,178.4,856.96,-1023.44,-1220.35
701370497844170496,2020-06,0,1719.49,0,0,-1719.49,-2939.84
701370497844170496,2020-08,1292.67,0,0,0,1292.67,-1647.17
701370497844170496,2020-09,0,746.82,0,2063.68,-2810.5,-4457.67
701370497844170496,2020-10,367.87,1660.76,0,823.61,-2116.5,-6574.17
701370497844170496,2020-11,1495.65,0,0,0,1495.65,-5078.52
701370497844170496,2020-12,1504.53,0,0,1968.37,-463.84,-5542.36
701652049175591552,2020-01,2021.18,306.48,583.63,1060.64,1237.69,1237.69
701652049175591552,2020-02,1259.48,936.59,0,0,322.89,1560.58
701652049175591552,2020-03,0,719.96,0,1990.79,-2710.75,-1150.17
701652049175591552,2020-04,0,457.1,2984.67,324.61,2202.96,1052.79
701652049175591552,2020-06,599.92,704.06,551.68,2218.46,-1770.92,-718.13
701652049175591552,2020-07,1839.45,460.28,1663.21,0,3042.38,2324.25
701652049175591552,2020-08,1314.17,3397.28,720.18,0,-1362.93,961.32
701652049175591552,2020-09,4362.84,1858.98,0,0,2503.86,3465.18
701652049175591552,2020-10,1948.39,1482.55,476.64,1661.51,-719.03,2746.15
701652049175591552,2020-11,3161.75,2120.12,1882.71,1920.28,1004.06,3750.21
701652049175591552,2020-12,0,1099.22,1137.96,3217.06,-3178.32,571.89
702966300249772672,2020-01,31.29,0,1115.34,5027.23,-3880.6,-3880.6
702966300249772672,2020-02,256.27,2987.7,3707.6,1823.28,-847.11,-4727.71
702966300249772672,2020-03,1605.48,1684.58,1521.05,6536.05,-5094.1,-9821.81
702966300249772672,2020-04,2118.6,0,554.15,3036.95,-364.2,-10186.01
702966300249772672,2020-05,696.04,997.8,0,2775.04,-3076.8,-13262.81
702966300249772672,2020-06,0,1324.09,3358.42,3054.83,-1020.5,-14283.31
702966300249772672,2020-07,2713.24,0,0,1294.01,1419.23,-12864.08
702966300249772672,2020-08,3318.92,3176.95,2469.56,0,2611.53,-10252.55
702966300249772672,2020-09,3559.75,0,4059.35,431.17,7187.93,-3064.62
702966300249772672,2020-10,1704.95,843.62,1716.19,2472.51,105.01,-2959.61
702966300249772672,2020-11,1203.14,0,982.87,74.54,2111.47,-848.14
702966300249772672,2020-12,4008.21,757.23,0,2517.53,733.45,-114.69
703026034448604416,2020-01,4024.85,2836.55,5751.27,2404.59,4534.98,4534.98
703026034448604416,2020-02,2724.33,7985.81,3517.79,2489.6,-4233.29,301.69
703026034448604416,2020-03,2429.25,0,111.45,3382.61,-841.91,-540.22
703026034448604416,2020-04,5751.46,5362.98,6490.54,1514.72,5364.3,4824.08
703026034448604416,2020-05,5147.27,4855.43,4333.13,4394.67,230.3,5054.38
703026034448604416,2020-06,5309.17,7927.21,3268.45,1983.74,-1333.33,3721.05
703026034448604416,2020-07,5788.84,6677.27,3665.81,715.25,2062.13,5783.18
703026034448604416,2020-08,3888.6,1876.63,2732.41,5354.52,-610.14,5173.04
703026034448604416,2020-09,7628.77,6448.43,7290.29,3124.21,5346.42,10519.46
703026034448604416,2020-10,3065.13,5117.1,3785.89,979.45,754.47,11273.93
703026034448604416,2020-11,2224.98,2082.85,5992.44,3161.91,2972.66,14246.59
703026034448604416,2020-12,7411.32,6103.27,1801.09,1215.79,1893.35,16139.94
704357549421242880,2020-02,625.16,0,0,1653.28,-1028.12,-1028.12
704357549421242880,2020-04,1820.4,990.61,98.43,0,928.22,-99.9
704357549421242880,2020-05,0,1135.64,1987.12,0,851.48,751.58
704357549421242880,2020-06,0,1534.18,1593.33,1097.08,-1037.93,-286.35
704357549421242880,2020-07,720.93,1978.51,775.97,0,-481.61,-767.96
704357549421242880,2020-08,3552.39,0,1184.13,180.91,4555.61,3787.65
704357549421242880,2020-11,1043.19,0,0,34.78,1008.41,4796.06
704357549421242880,2020-12,665.22,278.74,1858.22,1274.08,970.62,5766.68
705462371472353408,2020-02,1653.09,0,1220.44,0,2873.53,2873.53
705462371472353408,2020-03,675.75,0,0,0,675.75,3549.28
705462371472353408,2020-05,0,606.24,0,1957.3,-2563.54,985.74
705462371472353408,2020-11,103.67,0,0,0,103.67,1089.41
705462371472353408,2020-12,0,1724.79,165.99,0,-1558.8,-469.39
705529638180029440,2020-01,2028.76,1065.91,1274.52,281.84,1955.53,1955.53
705529638180029440,2020-02,0,1528.19,145.14,3270.24,-4653.29,-2697.76
705529638180029440,2020-03,2373.2,1982.88,0,557.44,-167.12,-2864.88
705529638180029440,2020-04,0,2717.67,621.27,1475.34,-3571.74,-6436.62
705529638180029440,2020-05,1074.76,4167.68,0,1883.81,-4976.73,-11413.35
705529638180029440,2020-06,0,2892.71,1990.81,1068.26,-1970.16,-13383.51
705529638180029440,2020-07,1606.87,383.13,1393.2,1950.47,666.47,-12717.04
705529638180029440,2020-08,2094.78,0,879.55,0,2974.33,-9742.71
705529638180029440,2020-09,2423.84,1303.69,565.51,0,1685.66,-8057.05
705529638180029440,2020-10,0,575.78,3224.59,411.85,2236.96,-5820.09
705529638180029440,2020-11,2084.05,1321.06,4424.82,0,5187.81,-632.28
705529638180029440,2020-12,0,2629.98,3736.95,1398.67,-291.7,-923.98
707011733787379840,2020-02,613.1,2555.66,0,898.31,-2840.87,-2840.87
707011733787379840,2020-03,0,2652.51,1303.44,1727.74,-3076.81,-5917.68
707011733787379840,2020-04,74.63,1186.37,550.58,1371.74,-1932.9,-7850.58
707011733787379840,2020-05,2433.16,2218.5,2837.91,1507.01,1545.56,-6305.02
707011733787379840,2020-06,4195.14,3596.18,0,1332.52,-733.56,-7038.58
707011733787379840,2020-07,0,1344.46,1653.02,782.83,-474.27,-7512.85
707011733787379840,2020-08,3092.52,2787.58,83.44,1358.45,-970.07,-8482.92
707011733787379840,2020-09,3621.61,171.37,0,2264.18,1186.06,-7296.86
707011733787379840,2020-10,1774.48,209.11,1091.43,0,2656.8,-4640.06
707011733787379840,2020-12,0,5242.24,1748.44,1888.65,-5382.45,-10022.51
707173912190081920,2020-01,7663.13,3547.19,3770.89,6024.83,1862,1862
707173912190081920,2020-02,2827.42,1717.03,1321.61,1131.02,1300.98,3162.98
707173912190081920,2020-03,3041.27,4538.91,4613.61,6583.83,-3467.86,-304.88
707173912190081920,2020-04,4471.48,6491.1,3317.03,8908.37,-7610.96,-7915.84
707173912190081920,2020-05,4606.4,4092.21,6559.53,5088.47,1985.25,-5930.59
707173912190081920,2020-06,8692.72,4706.24,2819.65,7876.07,-1069.94,-7000.53
707173912190081920,2020-07,4703.71,6804.41,2116.53,5402.23,-5386.4,-12386.93
707173912190081920,2020-08,5064.86,3198.42,4108.19,6315.05,-340.42,-12727.35
707173912190081920,2020-09,5288.07,9079.72,3801.81,4196.58,-4186.42,-16913.77
707173912190081920,2020-10,3134.15,6941.21,5839.68,7551.91,-5519.29,-22433.06
707173912190081920,2020-11,4192.36,8035.58,9166.18,7003.18,-1680.22,-24113.28
707173912190081920,2020-12,1465.54,8632,6082.8,3086.27,-4169.93,-28283.21
707947719280790016,2020-10,944.43,0,0,0,944.43,944.43
707947719280790016,2020-11,1016.14,0,0,0,1016.14,1960.57
709045409898619776,2020-01,1435.81,639.52,1997.16,915.32,1878.13,1878.13
709045409898619776,2020-02,208.05,0,1688.89,565.37,1331.57,3209.7
709045409898619776,2020-03,3122.93,0,0,2754.49,368.44,3578.14
709045409898619776,2020-04,3172.99,1681.72,1257.91,2259.66,489.52,4067.66
709045409898619776,2020-05,3595.3,355.31,1821.24,2831.07,2230.16,6297.82
709045409898619776,2020-06,1113.67,1583.21,1755.46,1971.93,-686.01,5611.81
709045409898619776,2020-07,2355.25,2537.45,1169.59,1702.18,-714.79,4897.02
709045409898619776,2020-08,2545.87,1306.69,1927.19,2295.26,871.11,5768.13
709045409898619776,2020-09,265.83,2090.83,4392.79,3293.17,-725.38,5042.75
709045409898619776,2020-10,5800.63,2032.66,3524.07,0,7292.04,12334.79
709045409898619776,2020-11,1956.07,2849.91,1438.78,3277.87,-2732.93,9601.86
709045409898619776,2020-12,3857.62,2670.06,2431.61,0,3619.17,13221.03
709091492889603584,2020-01,1839.33,0,605.84,1477.15,968.02,968.02
709091492889603584,2020-02,5628.8,2820.06,1370,680.34,3498.4,4466.42
709091492889603584,2020-03,1952.98,1880.92,3930.45,3350.65,651.86,5118.28
709091492889603584,2020-04,0,1530.9,0,3750.48,-5281.38,-163.1
709091492889603584,2020-05,1229.64,2135.7,4945.3,1581.96,2457.28,2294.18
709091492889603584,2020-06,1549.7,1468.39,1600.86,1516.29,165.88,2460.06
709091492889603584,2020-07,2938.87,1902.5,4978.72,2346.59,3668.5,6128.56
709091492889603584,2020-08,2341.22,1184.41,6903.71,2436.41,5624.11,11752.67
709091492889603584,2020-09,3223.65,4616.41,3326.22,6146.87,-4213.41,7539.26
709091492889603584,2020-10,2981.15,1710.79,5531.6,1969.13,4832.83,12372.09
709091492889603584,2020-11,0,4125.9,1239.85,1241.83,-4127.88,8244.21
709091492889603584,2020-12,2496.75,4793.42,3033.89,0,737.22,8981.43
710639843307943936,2020-01,2692.97,717.93,1665.98,1792.73,1848.29,1848.29
710639843307943936,2020-02,135.8,5451.7,2293.83,1172.76,-4194.83,-2346.54
710639843307943936,2020-03,1632.78,906.94,1778.22,3059.22,-555.16,-2901.7
710639843307943936,2020-04,1691.12,3025.06,1819.66,957.22,-471.5,-3373.2
710639843307943936,2020-05,3428.31,0,2862.8,3961.93,2329.18,-1044.02
710639843307943936,2020-06,1083.62,4388.96,0,2464.97,-5770.31,-6814.33
710639843307943936,2020-07,5257.3,5805.74,0,2228.83,-2777.27,-9591.6
710639843307943936,2020-08,1402.5,3248.22,490.35,0,-1355.37,-10946.97
710639843307943936,2020-09,2677.67,0,3204.04,418.23,5463.48,-5483.49
710639843307943936,2020-10,550.36,2254.62,4916.62,1152.25,2060.11,-3423.38
710639843307943936,2020-11,4076.56,3066.65,147.48,5003.97,-3846.58,-7269.96
710639843307943936,2020-12,1890.71,1808.85,14.39,145.28,-49.03,-7318.99
710709077922151424,2020-01,2746.94,2881.79,1212.58,5691.95,-4614.22,-4614.22
710709077922151424,2020-02,950.74,3506.64,114.08,4362.04,-6803.86,-11418.08
710709077922151424,2020-03,95.08,3428.34,332.35,5996.75,-8997.66,-20415.74
710709077922151424,2020-04,1334.41,75.99,2455.68,5434.38,-1720.28,-22136.02
710709077922151424,2020-05,2494.89,1326.38,0,6993.35,-5824.84,-27960.86
710709077922151424,2020-06,2510.43,4819.72,3317.41,0,1008.12,-26952.74
710709077922151424,2020-07,5326.16,2083.39,3699.28,3372.95,3569.1,-23383.64
710709077922151424,2020-08,3817.48,1213.56,41.24,5713.93,-3068.77,-26452.41
710709077922151424,2020-09,2510.19,3787.37,3887.43,0,2610.25,-23842.16
710709077922151424,2020-10,461.09,1780.46,7221.54,2390.7,3511.47,-20330.69
710709077922151424,2020-11,3871.13,2449.8,5115.55,7894.03,-1357.15,-21687.84
710709077922151424,2020-12,3752.95,2554.99,3938.83,3813.71,1323.08,-20364.76
712730710203085696,2020-01,1700.32,2279.45,1831.68,1522.89,-270.34,-270.34
712730710203085696,2020-02,5600.57,489.15,8180.91,7118.3,6174.03,5903.69
712730710203085696,2020-03,5075.08,3670.26,4766.64,195.65,5975.81,11879.5
712730710203085696,2020-04,5646.31,4707.66,5043.01,2919.11,3062.55,14942.05
712730710203085696,2020-05,5302.58,783.91,1724.49,2379.5,3863.66,18805.71
712730710203085696,2020-06,848.99,3741,6188.36,1932.57,1363.78,20169.49
712730710203085696,2020-07,1946.04,1583.49,3054.68,0,3417.23,23586.72
712730710203085696,2020-08,2581.27,3739.15,4956.92,4187,-387.96,23198.76
712730710203085696,2020-09,3449.2,4027.86,4276.93,2119.38,1578.89,24777.65
712730710203085696,2020-10,7249.75,4841.46,5529.23,2074.36,5863.16,30640.81
712730710203085696,2020-11,4660.89,2778.87,6875.18,2980.62,5776.58,36417.39
712730710203085696,2020-12,1844.62,907.11,4534.46,7661.15,-2189.18,34228.21
713557314832514304,2020-01,4407.29,440.91,2590.82,0,6557.2,6557.2
713557314832514304,2020-03,1246.76,1317.04,0,0,-70.28,6486.92
713557314832514304,2020-04,0,1236.1,0,931.94,-2168.04,4318.88
713557314832514304,2020-05,1585.8,3391.7,0,1602.89,-3408.79,910.09
713557314832514304,2020-06,1382.5,0,2161.4,0,3543.9,4453.99
713557314832514304,2020-07,840.14,0,1566.85,1323.91,1083.08,5537.07
713557314832514304,2020-08,1160.15,0,0,1585.8,-425.65,5111.42
713557314832514304,2020-09,0,890.37,1066.95,0,176.58,5288
713557314832514304,2020-10,0,367.86,390.7,1642.98,-1620.14,3667.86
713557314832514304,2020-11,814.45,575.62,1256.44,4610.03,-3114.76,553.1
713557314832514304,2020-12,2772.65,2117.85,2795.7,3737.04,-286.54,266.56
713734166754053760,2020-01,3792.58,3555.81,1359.22,903.24,692.75,692.75
713734166754053760,2020-02,2857.07,704.5,6567.26,6952.56,1767.27,2460.02
713734166754053760,2020-03,5487.93,5616.27,4837.5,5871.46,-1162.3,1297.72
713734166754053760,2020-04,1231.07,3730.47,2868.86,2030.23,-1660.77,-363.05
713734166754053760,2020-05,9598.79,2428.05,6192.35,2700.02,10663.07,10300.02
713734166754053760,2020-06,8212.99,6863.4,1642.2,6932.83,-3941.04,6358.98
713734166754053760,2020-07,2386.08,6207.42,4769.83,2160.3,-1211.81,5147.17
713734166754053760,2020-08,6685.3,3148.34,7984.97,1761.84,9760.09,14907.26
713734166754053760,2020-09,4446.79,6077.23,3094.74,6438.89,-4974.59,9932.67
713734166754053760,2020-10,2911.7,2140.81,7033,2152.47,5651.42,15584.09
713734166754053760,2020-11,2581.8,2472.9,8701.24,2204.81,6605.33,22189.42
713734166754053760,2020-12,7603.92,2718.47,4466.99,3999.44,5353,27542.42
714821153104610176,2020-01,2753.34,6489.79,4809.6,0,1073.15,1073.15
714821153104610176,2020-02,4907.24,3880.75,7760.14,2188.01,6598.62,7671.77
714821153104610176,2020-03,3361.27,542.13,2823.25,1154.67,4487.72,12159.49
714821153104610176,2020-04,48.38,2273.27,3549.76,865.65,459.22,12618.71
714821153104610176,2020-05,3125.34,3524.95,2276.89,628.76,1248.52,13867.23
714821153104610176,2020-06,2930.68,2073.26,2941.54,3417.81,381.15,14248.38
714821153104610176,2020-07,2034.4,3144.5,3948.29,339.57,2498.62,16747
714821153104610176,2020-08,4887.16,5381.23,4560.85,2865.16,1201.62,17948.62
714821153104610176,2020-09,3405.6,300.98,5967.22,1868.18,7203.66,25152.28
714821153104610176,2020-10,3272.13,2434.99,3203.98,6119.55,-2078.43,23073.85
714821153104610176,2020-11,0,3707.39,6105.35,1390.23,1007.73,24081.58
714821153104610176,2020-12,1245.07,823.03,4263.79,0,4685.83,28767.41
714993664078567296,2020-01,5921.09,7478.61,656.83,418.51,-1319.2,-1319.2
714993664078567296,2020-02,1280.95,4450.52,85,1247.46,-4332.03,-5651.23
714993664078567296,2020-03,3273.17,1668.99,3717.28,3123.89,2197.57,-3453.66
714993664078567296,2020-04,0,4617.91,5312.94,0,695.03,-2758.63
714993664078567296,2020-05,2766.25,0,4133.11,3461.6,3437.76,679.13
714993664078567296,2020-06,2791.46,1312.23,1692.18,4476.43,-1305.02,-625.89
714993664078567296,2020-07,1471.6,2445,9462.32,6663.32,1825.6,1199.71
714993664078567296,2020-08,4356.59,5970.37,6167.94,1441.46,3112.7,4312.41
714993664078567296,2020-09,8236.82,3815.57,3499.76,3570.52,4350.49,8662.9
714993664078567296,2020-10,2894.75,3896.44,4769.75,3271.69,496.37,9159.27
714993664078567296,2020-11,4318.72,1141.7,2297.7,6483.37,-1008.65,8150.62
714993664078567296,2020-12,5017.8,2129.03,3692.1,1275.07,5305.8,13456.42
715112727925731328,2020-01,2086.42,450.91,1627.85,1255.69,2007.67,2007.67
715112727925731328,2020-02,1974.19,0,0,797.46,1176.73,3184.4
715112727925731328,2020-03,1971.24,2992.93,1199.15,992.58,-815.12,2369.28
715112727925731328,2020-04,2312.86,2439.43,1755.95,295.64,1333.74,3703.02
715112727925731328,2020-05,5289.36,953.68,1634.38,3251.15,2718.91,6421.93
715112727925731328,2020-06,3276.44,1983.16,1919.4,80.24,3132.44,9554.37
715112727925731328,2020-07,2314.77,3417.85,3097.19,2902.54,-908.43,8645.94
715112727925731328,2020-08,3806.16,1441.36,1988.09,2790.13,1562.76,10208.7
715112727925731328,2020-09,1298.28,0,1327.45,0,2625.73,12834.43
715112727925731328,2020-10,1541.37,0,3532.46,2271.44,2802.39,15636.82
715112727925731328,2020-12,2652.36,2281.55,1672,2156.94,-114.13,15522.69
716959943085868544,2020-01,1803.17,0,1441.19,1802.17,1442.19,1442.19
716959943085868544,2020-02,868.67,2248.31,1367.83,1635.16,-1646.97,-204.78
716959943085868544,2020-03,1402.33,2212.53,1631.04,2182.17,-1361.33,-1566.11
716959943085868544,2020-04,704.41,1046.04,515.4,3437.5,-3263.73,-4829.84
716959943085868544,2020-06,2121.3,1447.22,2331.83,2013.93,991.98,-3837.86
716959943085868544,2020-07,0,97.94,0,158.26,-256.2,-4094.06
716959943085868544,2020-08,837.37,3560.09,0,2768.88,-5491.6,-9585.66
716959943085868544,2020-09,5142.41,702.55,0,1142.77,3297.09,-6288.57
716959943085868544,2020-10,1662.44,5439.7,424.27,4011.1,-7364.09,-13652.66
716959943085868544,2020-11,1967.38,1940.19,1456.71,99.69,1384.21,-12268.45
716959943085868544,2020-12,1246.79,0,827.6,0,2074.39,-10194.06
717171127207134464,2020-01,3929.76,4560.35,6109.57,2116.74,3362.24,3362.24
717171127207134464,2020-02,1416.67,3543.07,1632.84,2836.76,-3330.32,31.92
717171127207134464,2020-03,6648.62,2847.25,4942.4,3074.91,5668.86,5700.78
717171127207134464,2020-04,3716.95,0,4624.41,5010.51,3330.85,9031.63
717171127207134464,2020-05,2963.67,0,2920.01,4495.92,1387.76,10419.39
717171127207134464,2020-06,3730.7,3875.96,3518.71,765.62,2607.83,13027.22
717171127207134464,2020-07,4231.81,1582.12,3982.15,8151.39,-1519.55,11507.67
717171127207134464,2020-08,2911.52,3343.49,3705.64,0,3273.67,14781.34
717171127207134464,2020-09,3544.54,8893.37,6001.11,2483.6,-1831.32,12950.02
717171127207134464,2020-10,1761.68,1738.9,1087.38,1921.73,-811.57,12138.45
717171127207134464,2020-11,1943.52,22.08,2726.94,4066.78,581.6,12720.05
717171127207134464,2020-12,752.12,4060.75,2407.51,1639.91,-2541.03,10179.02
717341410938017664,2020-01,4948.73,2835.16,602.25,1293.84,1421.98,1421.98
717341410938017664,2020-02,4264.46,2103.21,648.89,5231.91,-2421.77,-999.79
717341410938017664,2020-03,3980.21,3165.56,1975.8,1194.66,1595.79,596
717341410938017664,2020-04,5575.23,0,1258.81,4154.57,2679.47,3275.47
717341410938017664,2020-05,379.07,2515.86,2296.1,3242.54,-3083.23,192.24
717341410938017664,2020-06,0,3975.05,8195.52,8176.12,-3955.65,-3763.41
717341410938017664,2020-07,1111.07,6011.76,445.66,3245.11,-7700.14,-11463.55
717341410938017664,2020-08,2712.33,999.61,5373.4,4997.93,2088.19,-9375.36
717341410938017664,2020-09,3342.55,5906.04,3798.12,377.13,857.5,-8517.86
717341410938017664,2020-10,4112.76,3416.58,8600.8,2724.88,6572.1,-1945.76
717341410938017664,2020-11,4602.93,3492.73,4170.24,5596.23,-315.79,-2261.55
717341410938017664,2020-12,5768,5451.63,2471.08,8773.6,-5986.15,-8247.7
717844862944145920,2020-01,5619.93,3723.85,6418.01,2764.46,5549.63,5549.63
717844862944145920,2020-02,3833.05,0,9128.83,4987.13,7974.75,13524.38
717844862944145920,2020-03,4183.6,613.62,3125.44,1569.15,5126.27,18650.65
717844862944145920,2020-04,1718.95,2699.77,723.18,933.75,-1191.39,17459.26
717844862944145920,2020-05,2404.04,5015.9,987.09,4095.66,-5720.43,11738.83
717844862944145920,2020-07,2951.14,5314.13,4926.09,7028.49,-4465.39,7273.44
717844862944145920,2020-08,3451.31,4001.78,4718.94,5299.87,-1131.4,6142.04
717844862944145920,2020-09,1482.22,5750.64,3631.46,1179.07,-1816.03,4326.01
717844862944145920,2020-10,2909.05,4764.66,599.72,4736.91,-5992.8,-1666.79
717844862944145920,2020-11,1343.96,2188.54,8678.12,8327.29,-493.75,-2160.54
717844862944145920,2020-12,5480.77,614.3,1116.72,3543.5,2439.69,279.15
718025656490742912,2020-08,0,921.57,0,0,-921.57,-921.57
718030748973347200,2020-01,0,2364.75,1306.71,29.03,-1087.07,-1087.07
718030748973347200,2020-02,2440.64,5172.22,1865.35,1741.07,-2607.3,-3694.37
718030748973347200,2020-03,736.59,945.64,0,314.26,-523.31,-4217.68
718030748973347200,2020-04,4081.71,1514.13,643.56,171.03,3040.11,-1177.57
718030748973347200,2020-05,112.12,1891.78,3031.63,4582.49,-3330.52,-4508.09
718030748973347200,2020-06,0,936.7,0,190.78,-1127.48,-5635.57
718030748973347200,2020-07,2024.95,1359.71,5959.08,1804.86,4819.46,-816.11
718030748973347200,2020-08,1922.21,420.45,0,2208.12,-706.36,-1522.47
718030748973347200,2020-09,34.38,227.47,1532.85,2227.08,-887.32,-2409.79
718030748973347200,2020-10,0,4408.21,1552,2007.81,-4864.02,-7273.81
718030748973347200,2020-11,1552.2,2604.62,1997.88,2728.55,-1783.09,-9056.9
718030748973347200,2020-12,2941.29,0,0,0,2941.29,-6115.61
718438191978871424,2020-01,1047.13,5538.95,6122.17,3114.47,-1484.12,-1484.12
718438191978871424,2020-02,1330.8,1297.22,3522.65,1979.62,1576.61,92.49
718438191978871424,2020-03,3676.47,2308.79,6634.29,3784.8,4217.17,4309.66
718438191978871424,2020-04,675.02,4982.86,3989.29,3111.31,-3429.86,879.8
718438191978871424,2020-05,4977.58,1321.22,3167.5,5138.26,1685.6,2565.4
718438191978871424,2020-06,3286.4,4304.87,3441.16,4433.27,-2010.58,554.82
718438191978871424,2020-07,7543.99,5100.33,3553.29,894.1,5102.85,5657.67
718438191978871424,2020-08,1096.25,4875.61,2182.61,1765.81,-3362.56,2295.11
718438191978871424,2020-09,3862.88,4626.3,9634.64,3893.61,4977.61,7272.72
718438191978871424,2020-10,2047.99,4782,3977.19,6721.51,-5478.33,1794.39
718438191978871424,2020-11,6768.65,1831.23,6949.97,6125.13,5762.26,7556.65
718438191978871424,2020-12,4430.85,1454.14,2319.46,3809.3,1486.87,9043.52
718453369016993152,2020-01,0,4210.04,1173.48,1655.07,-4691.63,-4691.63
718453369016993152,2020-02,1472.62,4666.26,1227.72,2973.16,-4939.08,-9630.71
718453369016993152,2020-03,2269.41,975.51,0,1477.02,-183.12,-9813.83
718453369016993152,2020-04,0,1535.36,1454.44,1426.32,-1507.24,-11321.07
718453369016993152,2020-05,774.44,1811.76,0,3509.07,-4546.39,-15867.46
718453369016993152,2020-06,1395.05,1082.68,904.88,1598.78,-381.53,-16248.99
718453369016993152,2020-07,3452.69,0,1410.47,897.21,3965.95,-12283.04
718453369016993152,2020-08,850.13,1926.05,1006.8,1528.15,-1597.27,-13880.31
718453369016993152,2020-09,1789.81,2977.41,605.09,0,-582.51,-14462.82
718453369016993152,2020-10,901.76,1534.89,2084.06,387.35,1063.58,-13399.24
718453369016993152,2020-11,2547.68,2574.49,2220.04,0,2193.23,-11206.01
718453369016993152,2020-12,832.98,1019.08,0,1328.78,-1514.88,-12720.89
718675424353606144,2020-01,3976.97,1979.33,0,1668.46,329.18,329.18
718675424353606144,2020-02,3466.83,1235.57,0,0,2231.26,2560.44
718675424353606144,2020-03,0,2296.89,398.26,1816.3,-3714.93,-1154.49
718675424353606144,2020-04,2714.15,2715.23,1233.76,2191.68,-959,-2113.49
718675424353606144,2020-05,1237.88,743.91,1041.16,2029.46,-494.33,-2607.82
718675424353606144,2020-06,438.44,2443.41,3574.49,57.91,1511.61,-1096.21
718675424353606144,2020-07,0,1968.19,0,1849.35,-3817.54,-4913.75
718675424353606144,2020-08,2144.13,1587.97,0,4443.88,-3887.72,-8801.47
718675424353606144,2020-09,0,3569.21,4246.27,0,677.06,-8124.41
718675424353606144,2020-10,3436.71,2349.1,2310.17,267.23,3130.55,-4993.86
718675424353606144,2020-11,1723.73,0,1231.39,1196.1,1759.02,-3234.84
718675424353606144,2020-12,414.13,3216.38,2265.19,3680.1,-4217.16,-7452
718970524310659712,2020-01,948.79,1089.68,2495.91,0,2355.02,2355.02
718970524310659712,2020-02,1252.15,70.34,1110.63,0,2292.44,4647.46
718970524310659712,2020-03,322.73,0,727.14,1312.38,-262.51,4384.95
718970524310659712,2020-06,1867.38,0,0,3768.13,-1900.75,2484.2
718970524310659712,2020-07,0,2914.06,1523.99,1386.56,-2776.63,-292.43
718970524310659712,2020-08,1207.26,784.24,2757.9,4.66,3176.26,2883.83
718970524310659712,2020-09,0,1532.82,2181.75,771.32,-122.39,2761.44
718970524310659712,2020-10,0,3713.45,0,259.7,-3973.15,-1211.71
718970524310659712,2020-11,1139.55,795.26,0,0,344.29,-867.42
718970524310659712,2020-12,125.01,0,0,0,125.01,-742.41
719896901802843392,2020-01,306.41,830.37,318.58,0,-205.38,-205.38
719896901802843392,2020-02,1528.03,0,0,1963.16,-435.13,-640.51
719896901802843392,2020-03,1357.51,446.26,0,3710.51,-2799.26,-3439.77
719896901802843392,2020-04,787.88,2078.84,3326.04,2942.11,-907.03,-4346.8
719896901802843392,2020-05,4745.15,3966.6,1532.02,4943.7,-2633.13,-6979.93
719896901802843392,2020-06,0,6757.94,0,0,-6757.94,-13737.87
719896901802843392,2020-07,0,2453.22,1446.5,0,-1006.72,-14744.59
719896901802843392,2020-08,1051.26,3210.13,3514.13,65.38,1289.88,-13454.71
719896901802843392,2020-10,4143.8,0,2801.26,5369.48,1575.58,-11879.13
719896901802843392,2020-11,1488.94,0,762.03,1217.65,1033.32,-10845.81
720368805145772928,2020-01,785.29,1123.1,3013.5,507.36,2168.33,2168.33
720368805145772928,2020-02,344.57,5956.75,0,2074.86,-7687.04,-5518.71
720368805145772928,2020-03,6085.1,405.11,0,2855.53,2824.46,-2694.25
720368805145772928,2020-04,1446.9,2849.16,678.25,5858.89,-6582.9,-9277.15
720368805145772928,2020-05,0,1718.74,2110.09,2850.33,-2458.98,-11736.13
720368805145772928,2020-06,3347.49,3821.6,223.41,1663.08,-1913.78,-13649.91
720368805145772928,2020-07,0,1480.3,1874.05,5910.3,-5516.55,-19166.46
720368805145772928,2020-08,2949.18,2300.04,633.29,1049.19,233.24,-18933.22
720368805145772928,2020-09,1901.57,1027,2145.18,519.03,2500.72,-16432.5
720368805145772928,2020-10,4237.05,4830.7,1867.35,3798.82,-2525.12,-18957.62
720368805145772928,2020-11,1225.98,4372.95,0,2421.02,-5567.99,-24525.61
720368805145772928,2020-12,908.25,347.13,6590.93,1815.27,5336.78,-19188.83
722844326440873856,2020-04,0,374.21,0,0,-374.21,-374.21
722844326440873856,2020-05,0,1244.62,0,0,-1244.62,-1618.83
722844326440873856,2020-08,1541.1,2845.67,1922.86,0,618.29,-1000.54
722844326440873856,2020-11,88.16,0,0,27.65,60.51,-940.03
722844326440873856,2020-12,948.92,1562.44,0,1497.7,-2111.22,-3051.25
723495850082556800,2020-01,3602.27,1099.68,1828.19,1808.23,2522.55,2522.55
723495850082556800,2020-02,2330.14,2962.19,6880.34,0,6248.29,8770.84
723495850082556800,2020-03,1105.66,0,0,361.27,744.39,9515.23
723495850082556800,2020-05,3617.56,337.13,4200.75,647.36,6833.82,16349.05
723495850082556800,2020-06,3588.29,1910.01,1524.84,1284.83,1918.29,18267.34
723495850082556800,2020-07,0,2113.85,432.55,3386.22,-5067.52,13199.82
723495850082556800,2020-08,1489.61,987.77,12.1,762.46,-248.52,12951.3
723495850082556800,2020-09,7649.74,1988.77,2686.43,2678.72,5668.68,18619.98
723495850082556800,2020-10,0,4589.74,2026.54,1903.8,-4467,14152.98
723495850082556800,2020-11,2985.35,1248.25,1588.91,0,3326.01,17478.99
723495850082556800,2020-12,1843.73,4782.55,0,0,-2938.82,14540.17
725099692053653376,2020-02,2719.48,2629.26,112.53,1810.46,-1607.71,-1607.71
725099692053653376,2020-03,1457.83,0,1939.05,0,3396.88,1789.17
725099692053653376,2020-04,849.43,1009.57,0,976.39,-1136.53,652.64
725099692053653376,2020-05,1322.95,3725.3,3370.01,994.34,-26.68,625.96
725099692053653376,2020-06,0,50.52,2298.24,0,2247.72,2873.68
725099692053653376,2020-07,0,1118.1,725.56,3178.83,-3571.37,-697.69
725099692053653376,2020-08,2533.89,441.45,1863.45,0,3955.89,3258.2
725099692053653376,2020-09,3042.99,0,0,0,3042.99,6301.19
725099692053653376,2020-10,0,1460.89,155.04,819.47,-2125.32,4175.87
725099692053653376,2020-11,1509.07,1589.89,1340.18,1298.74,-39.38,4136.49
725099692053653376,2020-12,1120.15,353.39,1166.84,451.23,1482.37,5618.86
725530279216655872,2020-01,3892.4,3587.82,5157.71,4706.06,756.23,756.23
725530279216655872,2020-02,0,3441.5,4164.11,3965.22,-3242.61,-2486.38
725530279216655872,2020-03,11852.96,2315.66,3082.49,3116.63,9503.16,7016.78
725530279216655872,2020-04,7919.97,1559.6,1587.42,3940.79,4007,11023.78
725530279216655872,2020-05,2027.59,4694.58,4762.07,5714.25,-3619.17,7404.61
725530279216655872,2020-06,1383.35,3678.48,1514.92,3532.67,-4312.88,3091.73
725530279216655872,2020-07,5841.35,2531.54,8046.97,4961.78,6395,9486.73
725530279216655872,2020-08,7033.42,2148.44,5417.3,3718.69,6583.59,16070.32
725530279216655872,2020-09,2624.27,3286.85,0,2295.68,-2958.26,13112.06
725530279216655872,2020-10,6909.85,3682.42,4468.01,3533.67,4161.77,17273.83
725530279216655872,2020-11,2892.92,1556.01,3552.32,1796.75,3092.48,20366.31
725530279216655872,2020-12,3468.89,564.68,2715.24,1804.95,3814.5,24180.81
726055126778387328,2020-01,4601.18,3261.34,2899.2,2871.71,1367.33,1367.33
726055126778387328,2020-02,5906.74,2644.2,2341.19,1465.63,4138.1,5505.43
726055126778387328,2020-03,3037.49,4332.12,1544.79,1523.7,-1273.54,4231.89
726055126778387328,2020-04,2435.95,0,0,1224.48,1211.47,5443.36
726055126778387328,2020-05,725.65,6126.88,837.38,2444.5,-7008.35,-1564.99
726055126778387328,2020-06,2343.8,1497,5068.27,0,5915.07,4350.08
726055126778387328,2020-07,2352.83,2741.06,2985.83,1227.93,1369.67,5719.75
726055126778387328,2020-08,2009.97,5574.17,0,3946.22,-7510.42,-1790.67
726055126778387328,2020-09,2309.02,4527.19,5194.35,862.01,2114.17,323.5
726055126778387328,2020-10,3551.67,344.42,2466.19,1734.84,3938.6,4262.1
726055126778387328,2020-11,3736.78,2785.19,4055.53,9476.1,-4468.98,-206.88
726055126778387328,2020-12,1965.07,4352.19,7625.88,976.91,4261.85,4054.97
727751989319650048,2020-01,1351.33,0,4538.83,1798.44,4091.72,4091.72
727751989319650048,2020-02,0,307.22,2822.63,52.91,2462.5,6554.22
727751989319650048,2020-03,0,2255.36,0,1077.77,-3333.13,3221.09
727751989319650048,2020-04,2984.8,1163.74,4565.48,1819.6,4566.94,7788.03
727751989319650048,2020-05,2051.08,1851.57,2933.81,1923.67,1209.65,8997.68
727751989319650048,2020-07,3559.31,3183,1214.94,650.41,940.84,9938.52
727751989319650048,2020-08,0,2880,4772,1468.3,423.7,10362.22
727751989319650048,2020-09,4123.17,606.96,0,0,3516.21,13878.43
727751989319650048,2020-10,765.1,0,2069.2,1803.76,1030.54,14908.97
727751989319650048,2020-11,0,3605.29,2275.19,2198.03,-3528.13,11380.84
727751989319650048,2020-12,3664.74,441.53,0,1966.64,1256.57,12637.41
729136325544644480,2020-01,5320.64,3357.32,3317.66,522.59,4758.39,4758.39
729136325544644480,2020-02,0,936.02,550.7,0,-385.32,4373.07
729136325544644480,2020-03,2600.92,1786.5,1854.43,2204.09,464.76,4837.83
729136325544644480,2020-04,1900.04,2169.52,0,1771.35,-2040.83,2797
729136325544644480,2020-05,4344.13,803.46,746.96,910.89,3376.74,6173.74
729136325544644480,2020-06,1098.24,883.53,2165.35,492.12,1887.94,8061.68
729136325544644480,2020-07,1965.16,2921.1,0,1943.59,-2899.53,5162.15
729136325544644480,2020-08,6380.97,2583.39,958.07,469.39,4286.26,9448.41
729136325544644480,2020-09,1877.16,0,0,334.44,1542.72,10991.13
729136325544644480,2020-10,787.6,1402.51,1373.62,5523.32,-4764.61,6226.52
729136325544644480,2020-11,2744.82,1999.86,1652.42,4353.84,-1956.46,4270.06
729136325544644480,2020-12,778.79,1158.31,0,2654.46,-3033.98,1236.08
729743911458304512,2020-01,10493.13,5979.65,3116.69,2474.58,5155.59,5155.59
729743911458304512,2020-02,512.82,3011.9,5558,3233.11,-174.19,4981.4
729743911458304512,2020-03,1651.06,0,1645.17,3907.54,-611.31,4370.09
729743911458304512,2020-04,3553.18,4380.06,5094.62,3346.21,921.53,5291.62
729743911458304512,2020-05,937.77,6116.52,3463.47,2752.06,-4467.34,824.28
729743911458304512,2020-06,4154.95,2530.73,5277.25,7560.23,-658.76,165.52
729743911458304512,2020-07,713.01,1477.36,1972.48,2210.94,-1002.81,-837.29
729743911458304512,2020-08,1389.39,3294.73,4370.12,4024.2,-1559.42,-2396.71
729743911458304512,2020-09,1945.77,358.33,2286.28,1183.87,2689.85,293.14
729743911458304512,2020-10,4748.07,3643.44,3264.78,629.15,3740.26,4033.4
729743911458304512,2020-11,4382.87,5124.39,1912.26,729.45,441.29,4474.69
729743911458304512,2020-12,2318.1,6415.96,976.55,5878.73,-9000.04,-4525.35
730033184470169984,2020-01,5626.42,3881.38,3189.15,8838.87,-3904.68,-3904.68
730033184470169984,2020-02,3746.21,1393.99,4866.42,782.26,6436.38,2531.7
730033184470169984,2020-03,5745.32,3625.5,5683.15,1591.5,6211.47,8743.17
730033184470169984,2020-04,5409.27,3850.63,2106.19,1747.21,1917.62,10660.79
730033184470169984,2020-05,976.53,2052.26,1890.84,1993.07,-1177.96,9482.83
730033184470169984,2020-06,5227.51,57.51,3185.35,0,8355.35,17838.18
730033184470169984,2020-07,5345.47,4696.47,3218.1,7205.2,-3338.1,14500.08
730033184470169984,2020-08,1349.98,4289.45,2841.28,4787.8,-4885.99,9614.09
730033184470169984,2020-09,2716.97,3273.72,1600.75,1709.97,-665.97,8948.12
730033184470169984,2020-10,4776.53,658.87,2244.55,3056.65,3305.56,12253.68
730033184470169984,2020-11,1233.16,9573.27,2484.32,5272.9,-11128.69,1124.99
730033184470169984,2020-12,5495.71,3074.23,554.81,6577.66,-3601.37,-2476.38
730830034244448384,2020-01,1019.86,1141.78,3585.41,1672.36,1791.13,1791.13
730830034244448384,2020-03,2989.68,3190.87,2276.44,2552.13,-476.88,1314.25
730830034244448384,2020-04,585.97,3388.66,2739.54,2458.91,-2522.06,-1207.81
730830034244448384,2020-05,444,3441.45,0,507.82,-3505.27,-4713.08
730830034244448384,2020-06,1058.72,3517.51,1759.14,1032.8,-1732.45,-6445.53
730830034244448384,2020-07,944.16,0,1051.48,5033.79,-3038.15,-9483.68
730830034244448384,2020-08,2804.36,2448.52,6844.22,0,7200.06,-2283.62
730830034244448384,2020-09,1401.83,82.64,0,2422.21,-1103.02,-3386.64
730830034244448384,2020-10,1412.07,541.64,2713.44,5557.98,-1974.11,-5360.75
730830034244448384,2020-11,0,1099.26,3162.91,2703.25,-639.6,-6000.35
730830034244448384,2020-12,1173.79,2263.46,1532.54,2183.04,-1740.17,-7740.52
731124262021013888,2020-01,1078.84,4318.86,1640.4,712.11,-2311.73,-2311.73
731124262021013888,2020-02,362.58,44.56,1313.95,532.5,1099.47,-1212.26
731124262021013888,2020-03,2248.18,1977.74,417.54,6804.42,-6116.44,-7328.7
731124262021013888,2020-04,1784.77,7266.52,3128.15,0,-2353.6,-9682.3
731124262021013888,2020-05,951.84,529.93,2316.82,1192.99,1545.74,-8136.56
731124262021013888,2020-06,435.45,3162.37,2414.14,2022.11,-2334.89,-10471.45
731124262021013888,2020-07,2700.28,4490.66,1906.16,1914.68,-1798.9,-12270.35
731124262021013888,2020-08,1180.94,5266.44,2897.41,555.27,-1743.36,-14013.71
731124262021013888,2020-09,2260.03,2715.22,5993.24,1680,3858.05,-10155.66
731124262021013888,2020-10,3211.32,2040.48,1486.66,2354.1,303.4,-9852.26
731124262021013888,2020-11,3783.68,1011.28,168.97,1743.3,1198.07,-8654.19
731124262021013888,2020-12,2358.26,405.01,2950.27,3340.61,1562.91,-7091.28
731221557640518144,2020-01,0,1766.7,336.55,298.46,-1728.61,-1728.61
731221557640518144,2020-02,2436.75,1444.92,114.72,0,1106.55,-622.06
731221557640518144,2020-03,4011.23,1883.12,1496.16,3764.13,-139.86,-761.92
731221557640518144,2020-04,58.14,3544.3,0,3619.32,-7105.48,-7867.4
731221557640518144,2020-05,2520.2,518.31,9375.52,0,11377.41,3510.01
731221557640518144,2020-06,1632.51,417.16,3893.99,0,5109.34,8619.35
731221557640518144,2020-07,3459.9,3036.02,4998.94,1870.46,3552.36,12171.71
731221557640518144,2020-08,516.38,2688.13,1921.99,4949.45,-5199.21,6972.5
731221557640518144,2020-09,2680.6,5300.69,976.79,6348.48,-7991.78,-1019.28
731221557640518144,2020-10,1928.7,3038.8,1754.53,2637.07,-1992.64,-3011.92
731221557640518144,2020-11,2935.72,1178.77,3012.43,4164.78,604.6,-2407.32
731221557640518144,2020-12,1835.53,67.36,810.65,2631.05,-52.23,-2459.55
732490194248998400,2020-01,0,2262.86,0,0,-2262.86,-2262.86
732490194248998400,2020-02,1930.79,0,0,0,1930.79,-332.07
732490194248998400,2020-04,0,1864.44,0,718.5,-2582.94,-2915.01
732490194248998400,2020-05,654.68,0,0,1176.18,-521.5,-3436.51
732490194248998400,2020-07,1600.44,3267.31,1758.18,0,91.31,-3345.2
732490194248998400,2020-08,1289.89,522.33,877.34,1463.44,181.46,-3163.74
732490194248998400,2020-09,0,1739.83,1130.99,0,-608.84,-3772.58
732490194248998400,2020-10,2381.82,590.8,0,0,1791.02,-1981.56
732490194248998400,2020-11,1278.43,0,756.64,0,2035.07,53.51
732490194248998400,2020-12,0,2783.3,578.34,1699.11,-3904.07,-3850.56
732912686504289024,2020-01,2115.45,3789.37,6925.34,4958.99,292.43,292.43
732912686504289024,2020-02,3226.4,6866.27,3859.94,1576.28,-1356.21,-1063.78
732912686504289024,2020-03,4444.27,4477.07,1128.29,6214.19,-5118.7,-6182.48
732912686504289024,2020-04,7279.27,5173.41,1588.87,10330.18,-6635.45,-12817.93
732912686504289024,2020-05,3391.74,1196.94,5039.09,6685.24,548.65,-12269.28
732912686504289024,2020-06,3945.9,2624.79,5964.63,4632.2,2653.54,-9615.74
732912686504289024,2020-07,3919.44,8997.94,6476.74,4503.08,-3104.84,-12720.58
732912686504289024,2020-08,1882.6,5360.89,1786.78,2652.48,-4343.99,-17064.57
732912686504289024,2020-09,7900.65,2927.05,1731,6944.55,-239.95,-17304.52
732912686504289024,2020-10,4823.92,7154.05,3573.49,3386.87,-2143.51,-19448.03
732912686504289024,2020-11,1810.44,6418.5,4699.92,2460.44,-2368.58,-21816.61
732912686504289024,2020-12,2644.97,5513.3,5967.55,1124.42,1974.8,-19841.81
732946381469145728,2020-01,1327.74,6074,12048.07,3624.12,3677.69,3677.69
732946381469145728,2020-02,8091.01,2898.19,3875.2,3165.89,5902.13,9579.82
732946381469145728,2020-03,4984.75,24.7,5060.55,7522.63,2497.97,12077.79
732946381469145728,2020-04,6118.61,1940.32,3108.82,8408.06,-1120.95,10956.84
732946381469145728,2020-05,1726.65,6196.79,4397.26,4686.3,-4759.18,6197.66
732946381469145728,2020-06,2021.48,1832.5,5104.25,1542.75,3750.48,9948.14
732946381469145728,2020-07,3355.68,5644.01,7434.39,2872.41,2273.65,12221.79
732946381469145728,2020-08,4711.55,1339.85,1424.66,10227.93,-5431.57,6790.22
732946381469145728,2020-09,4493.05,4895.85,5752.18,6935.67,-1586.29,5203.93
732946381469145728,2020-10,5253.92,3976.09,3944.21,2266.81,2955.23,8159.16
732946381469145728,2020-11,8185.57,9761.02,4049.38,3625.21,-1151.28,7007.88
732946381469145728,2020-12,7099.68,3203.69,7306.31,2196.12,9006.18,16014.06
733280641557225600,2020-01,1844.39,5121.16,7982.81,5012.7,-306.66,-306.66
733280641557225600,2020-02,3754.7,0,3103.76,3601.68,3256.78,2950.12
733280641557225600,2020-03,5971.15,4550.53,5107.92,4579.07,1949.47,4899.59
733280641557225600,2020-04,2137.61,6121.46,8005.15,7661.65,-3640.35,1259.24
733280641557225600,2020-05,1667.73,1041,2148.19,1913.94,860.98,2120.22
733280641557225600,2020-06,175.3,5985.08,2790.35,2880.39,-5899.82,-3779.6
733280641557225600,2020-07,1860.5,3206,4518.98,1340.5,1832.98,-1946.62
733280641557225600,2020-08,4754.12,5337.14,7923.43,2004.12,5336.29,3389.67
733280641557225600,2020-09,5147.09,4721.92,7900.29,3542.3,4783.16,8172.83
733280641557225600,2020-10,5153.52,743.38,4778.98,2695.96,6493.16,14665.99
733280641557225600,2020-11,1503.6,3221.63,1001.73,6570.44,-7286.74,7379.25
733280641557225600,2020-12,1740.6,3118.03,2207.7,8500.33,-7670.06,-290.81
733445147968564352,2020-03,0,1787.49,0,1931.07,-3718.56,-3718.56
733445147968564352,2020-05,1755.75,0,1764.82,0,3520.57,-197.99
733445147968564352,2020-06,1571.15,543.55,0,0,1027.6,829.61
733445147968564352,2020-09,1645.16,0,0,0,1645.16,2474.77
733445147968564352,2020-10,0,838.41,462.35,0,-376.06,2098.71
734008028088581888,2020-01,157.99,0,129.3,3229.48,-2942.19,-2942.19
734008028088581888,2020-02,1348.79,1753.35,0,0,-404.56,-3346.75
734008028088581888,2020-03,0,1775.12,0,504.71,-2279.83,-5626.58
734008028088581888,2020-04,893.15,0,0,3335.62,-2442.47,-8069.05
734008028088581888,2020-05,2308.58,2518.32,1771.6,105.92,1455.94,-6613.11
734008028088581888,2020-06,96.81,1642.74,0,0,-1545.93,-8159.04
734008028088581888,2020-08,2158.29,1616.44,2616.99,1890.42,1268.42,-6890.62
734008028088581888,2020-09,516.12,893.8,929.56,2520.9,-1969.02,-8859.64
734008028088581888,2020-10,1964.38,3220.31,0,640.3,-1896.23,-10755.87
734008028088581888,2020-11,1552.31,1948.45,1030.23,244.38,389.71,-10366.16
734008028088581888,2020-12,90.17,0,0,1620.4,-1530.23,-11896.39
734066197148106752,2020-01,0,1138.77,0,0,-1138.77,-1138.77
734066197148106752,2020-02,0,348.7,0,0,-348.7,-1487.47
734066197148106752,2020-04,3779.47,1894.23,491.95,0,2377.19,889.72
734066197148106752,2020-05,656.32,998.71,464.16,0,121.77,1011.49
734066197148106752,2020-06,0,674.44,1665.29,1467.18,-476.33,535.16
734066197148106752,2020-07,315.8,0,36.46,1334.67,-982.41,-447.25
734066197148106752,2020-08,1119.22,0,0,1237.86,-118.64,-565.89
734066197148106752,2020-09,883.99,0,1218.53,0,2102.52,1536.63
734066197148106752,2020-10,0,1760.55,0,0,-1760.55,-223.92
734066197148106752,2020-11,1390.63,1941.4,0,1853.45,-2404.22,-2628.14
734066197148106752,2020-12,0,1401.24,1872.63,0,471.39,-2156.75
734746636787840128,2020-01,4888.89,1922.36,2303.42,4940.28,329.67,329.67
734746636787840128,2020-02,3970.53,1409.93,5650.68,4322.09,3889.19,4218.86
734746636787840128,2020-03,0,2360.32,5373.53,13139.61,-10126.4,-5907.54
734746636787840128,2020-04,4668.06,4467.32,5161.18,5654.7,-292.78,-6200.32
734746636787840128,2020-05,2304.7,956.23,5021.33,1497.82,4871.98,-1328.34
734746636787840128,2020-06,1475.35,3869.35,3794,1393.88,6.12,-1322.22
734746636787840128,2020-07,0,720.88,3998.08,4304.93,-1027.73,-2349.95
734746636787840128,2020-08,3844.89,5549.71,856.57,219.68,-1067.93,-3417.88
734746636787840128,2020-09,6002.29,1422.63,693.19,2405.13,2867.72,-550.16
734746636787840128,2020-10,4196.35,2264.49,1954.7,6876.07,-2989.51,-3539.67
734746636787840128,2020-11,734.39,1689.63,4094.48,4449.78,-1310.54,-4850.21
734746636787840128,2020-12,7567.36,3133.01,2290.87,3050.08,3675.14,-1175.07
735774129656159360,2020-01,0,1978.49,0,1199.05,-3177.54,-3177.54
735774129656159360,2020-04,1733.43,0,0,0,1733.43,-1444.11
735774129656159360,2020-06,0,854.03,0,0,-854.03,-2298.14
735774129656159360,2020-08,2661.17,1123.21,0,0,1537.96,-760.18
735774129656159360,2020-09,0,840.59,0,0,-840.59,-1600.77
735774129656159360,2020-12,0,1759.53,0,1832.59,-3592.12,-5192.89
736177247324779136,2020-01,631.05,2441.32,2497.22,5505.37,-4818.42,-4818.42
736177247324779136,2020-02,4651.1,3092.76,955.75,3022.73,-508.64,-5327.06
736177247324779136,2020-03,3850.35,4513.07,4815.19,717.67,3434.8,-1892.26
736177247324779136,2020-04,361.86,269.55,4547.39,2229.02,2410.68,518.42
736177247324779136,2020-05,1738.24,3061.46,7439.63,4413.95,1702.46,2220.88
736177247324779136,2020-06,2219.53,1149.82,1831.77,2653.31,248.17,2469.05
736177247324779136,2020-07,7406.32,3959.84,2581.04,6662.61,-635.09,1833.96
736177247324779136,2020-08,2752.78,923.14,4090.9,3070.65,2849.89,4683.85
736177247324779136,2020-09,1386.14,4511.53,3004.24,4020.11,-4141.26,542.59
736177247324779136,2020-10,6783.23,2293.88,2997.51,1227.81,6259.05,6801.64
736177247324779136,2020-11,5764.48,5618.65,3649.27,2263.73,1531.37,8333.01
736177247324779136,2020-12,6167.22,4919.64,2420.88,3076.53,591.93,8924.94
737480257183053440,2020-01,4099.33,4859.22,1321.3,4871.62,-4310.21,-4310.21
737480257183053440,2020-02,1240.49,2935.35,3219.1,3101.51,-1577.27,-5887.48
737480257183053440,2020-03,1473.9,2015.85,6800.9,2130.56,4128.39,-1759.09
737480257183053440,2020-04,2386.36,2749.73,2649.08,1750.31,535.4,-1223.69
737480257183053440,2020-05,584.46,4535.57,0,232.22,-4183.33,-5407.02
737480257183053440,2020-06,756.11,2776.85,212.21,0,-1808.53,-7215.55
737480257183053440,2020-07,766.19,79.05,3657.7,2208.88,2135.96,-5079.59
737480257183053440,2020-08,4994.33,2192.34,2545.12,1127.86,4219.25,-860.34
737480257183053440,2020-09,6138.97,2813.98,4065.56,3821.56,3568.99,2708.65
737480257183053440,2020-10,2263.57,3277.03,16.85,4190.44,-5187.05,-2478.4
737480257183053440,2020-11,1670.19,1663.3,2856.72,3445.33,-581.72,-3060.12
737480257183053440,2020-12,0,1408.89,3526.06,1596.32,520.85,-2539.27
737521200708247936,2020-01,4289.61,1056.67,5590.85,3129.21,5694.58,5694.58
737521200708247936,2020-02,194.01,3476.3,3730.69,2394.39,-1945.99,3748.59
737521200708247936,2020-03,4304.94,2665.25,1937.75,4346.73,-769.29,2979.3
737521200708247936,2020-04,2783.5,1523.71,4150.12,1818.97,3590.94,6570.24
737521200708247936,2020-05,2665.05,1348.84,4384.73,4233.85,1467.09,8037.33
737521200708247936,2020-06,3876.23,2868.6,5383.37,311.62,6079.38,14116.71
737521200708247936,2020-07,1642.49,2602.59,5188.79,1967.56,2261.13,16377.84
737521200708247936,2020-08,1081.25,2659.96,3357.88,0,1779.17,18157.01
737521200708247936,2020-09,2749.72,1205.85,5011.65,3429.07,3126.45,21283.46
737521200708247936,2020-10,5614.2,859.84,0,768.45,3985.91,25269.37
737521200708247936,2020-11,2442.6,1583.83,2075.51,0,2934.28,28203.65
737521200708247936,2020-12,3873.82,3509.1,3223.54,2722.4,865.86,29069.51
738012352090950016,2020-01,5977.34,5844.67,5313.39,3411.54,2034.52,2034.52
738012352090950016,2020-02,5345.13,4213.16,2680.92,5249.35,-1436.46,598.06
738012352090950016,2020-03,3188.72,5970.18,1225.28,6670.65,-8226.83,-7628.77
738012352090950016,2020-04,5833.45,3250.65,1409.54,4699.55,-707.21,-8335.98
738012352090950016,2020-05,4561.47,4727.29,3824.03,5970.16,-2311.95,-10647.93
738012352090950016,2020-06,8647.5,3833.01,2972.39,3854.7,3932.18,-6715.75
738012352090950016,2020-07,6711.78,1817,5129.43,2939.22,7084.99,369.24
738012352090950016,2020-08,8167.47,3922.99,2220.44,1127.96,5336.96,5706.2
738012352090950016,2020-09,4677.17,2108.6,2248.71,5008.98,-191.7,5514.5
738012352090950016,2020-10,5810.11,6842.48,4570.29,4069.78,-531.86,4982.64
738012352090950016,2020-11,3333.07,6088.86,4475.66,8892.42,-7172.55,-2189.91
738012352090950016,2020-12,6058.85,8583.36,7026.63,1094.75,3407.37,1217.46
738017502593482880,2020-01,1549.19,6500.11,5569.12,3388.44,-2770.24,-2770.24
738017502593482880,2020-02,2989.8,1838.21,1835.83,2288.33,699.09,-2071.15
738017502593482880,2020-03,2975.96,560.52,5317.75,9493.11,-1759.92,-3831.07
738017502593482880,2020-04,4471.4,901.16,3105.34,4596.72,2078.86,-1752.21
738017502593482880,2020-05,1960.57,4438.89,2282.84,4127.06,-4322.54,-6074.75
738017502593482880,2020-06,709.54,6644.71,1748.05,0,-4187.12,-10261.87
738017502593482880,2020-07,0,2626.23,2052.26,1857.74,-2431.71,-12693.58
738017502593482880,2020-08,2365.3,6051.2,5700.58,2860.46,-845.78,-13539.36
738017502593482880,2020-09,598.94,2650.91,1067.32,6266.7,-7251.35,-20790.71
738017502593482880,2020-10,8212.76,3421.95,1781.78,5642.5,930.09,-19860.62
738017502593482880,2020-11,3176.26,5036.94,2297.46,1626.25,-1189.47,-21050.09
738017502593482880,2020-12,2105.75,1397.79,3026.05,3419.84,314.17,-20735.92
738722732766321920,2020-05,0,890.87,429.23,0,-461.64,-461.64
738722732766321920,2020-06,1707.88,1448.2,420.02,1539.65,-859.95,-1321.59
738722732766321920,2020-07,80.75,0,0,0,80.75,-1240.84
740333848914241280,2020-01,772.51,2502.76,10317.73,4699.52,3887.96,3887.96
740333848914241280,2020-02,3076.6,4261.87,3424.91,5337.04,-3097.4,790.56
740333848914241280,2020-03,1480.76,8951.43,440.6,5800.12,-12830.19,-12039.63
740333848914241280,2020-04,1508.05,4911.02,3267.53,4097.94,-4233.38,-16273.01
740333848914241280,2020-05,4501.73,4634.43,1633.52,6235.09,-4734.27,-21007.28
740333848914241280,2020-06,725.04,3904.24,1544.92,1814.52,-3448.8,-24456.08
740333848914241280,2020-07,337.38,1399.57,2300.74,4176.24,-2937.69,-27393.77
740333848914241280,2020-08,1739.14,8.46,3535.57,2138.65,3127.6,-24266.17
740333848914241280,2020-09,5036.71,2948.62,4282.36,4660.1,1710.35,-22555.82
740333848914241280,2020-10,6473.53,2769.93,3578.92,3419,3863.52,-18692.3
740333848914241280,2020-11,2738.14,1908.09,11053.07,1366.81,10516.31,-8175.99
740333848914241280,2020-12,3616.17,6388.92,4684.06,2754.42,-843.11,-9019.1
740624279742617088,2020-01,0,207.06,2878.96,1563.06,1108.84,1108.84
740624279742617088,2020-02,777.29,1987.4,3515.18,0,2305.07,3413.91
740624279742617088,2020-03,39.31,163.19,3590.08,2270.36,1195.84,4609.75
740624279742617088,2020-04,3143.7,3592.33,2759.02,0,2310.39,6920.14
740624279742617088,2020-05,3150.22,5237.45,617.65,2664.72,-4134.3,2785.84
740624279742617088,2020-06,3128.31,4357.94,1876.07,4681.09,-4034.65,-1248.81
740624279742617088,2020-07,2192.45,3241.34,928.8,2491.23,-2611.32,-3860.13
740624279742617088,2020-08,2123.42,4192.19,1594.79,427.66,-901.64,-4761.77
740624279742617088,2020-09,4694.73,0,4468.63,3166.86,5996.5,1234.73
740624279742617088,2020-10,2056.44,8636.61,0,3960.24,-10540.41,-9305.68
740624279742617088,2020-11,1264.33,2328.36,2249.26,3450.15,-2264.92,-11570.6
740624279742617088,2020-12,1673.26,4005.51,1327.02,740.54,-1745.77,-13316.37
743389578385811456,2020-01,3775.94,0,1321.62,1636.17,3461.39,3461.39
743389578385811456,2020-02,2763.68,779.72,1477.37,974.4,2486.93,5948.32
743389578385811456,2020-03,1835.78,0,5145.58,4040.51,2940.85,8889.17
743389578385811456,2020-04,4819.61,1841.86,1982.87,2216.46,2744.16,11633.33
743389578385811456,2020-05,2737.11,631.85,1743.19,868.46,2979.99,14613.32
743389578385811456,2020-06,1756.03,5164.51,858.6,1133.97,-3683.85,10929.47
743389578385811456,2020-07,838.82,4510.6,7071.62,6407.48,-3007.64,7921.83
743389578385811456,2020-08,4823.28,726.73,1792.67,0,5889.22,13811.05
743389578385811456,2020-09,2032.93,1557.28,854.65,818.28,512.02,14323.07
743389578385811456,2020-10,2100.01,1130.78,0,1125.01,-155.78,14167.29
743389578385811456,2020-11,2702.92,554.95,0,1375.95,772.02,14939.31
743389578385811456,2020-12,2625.28,3213.06,1074.33,6038.91,-5552.36,9386.95
743581014868784000,2020-01,3704.57,5649.07,3601.86,2575.72,-918.36,-918.36
743581014868784000,2020-02,4660.95,4779.11,4634.28,3997.79,518.33,-400.03
743581014868784000,2020-03,3172.57,7852.84,5196.19,3396.63,-2880.71,-3280.74
743581014868784000,2020-04,5716.29,5584.79,2789.52,3995.99,-1074.97,-4355.71
743581014868784000,2020-05,3706.62,3209.95,8294.76,3353.17,5438.26,1082.55
743581014868784000,2020-06,3616.45,4485.16,4469.41,3902.03,-301.33,781.22
743581014868784000,2020-07,3038.89,8171.5,6400.44,3770.81,-2502.98,-1721.76
743581014868784000,2020-08,3660.44,1009.29,2822.26,4311.67,1161.74,-560.02
743581014868784000,2020-09,6153.19,4398.65,4749.7,5640.07,864.17,304.15
743581014868784000,2020-10,2566.32,7255,6029.72,7473.45,-6132.41,-5828.26
743581014868784000,2020-11,1198.27,2513.32,3723.49,1758.13,650.31,-5177.95
743581014868784000,2020-12,5723.89,2752.06,3471.56,1749.53,4693.86,-484.09
744272774934078848,2020-01,357.2,1551.33,9093.87,4424.12,3475.62,3475.62
744272774934078848,2020-02,1234.46,5232.06,2459.99,3624.16,-5161.77,-1686.15
744272774934078848,2020-03,1641.16,1048.56,5090.04,1651.37,4031.27,2345.12
744272774934078848,2020-04,3787,1938.86,5832.98,1321.72,6359.4,8704.52
744272774934078848,2020-05,3444.73,1719.42,3345.97,5634.1,-562.82,8141.7
744272774934078848,2020-06,1072.64,3242.27,4613.87,3485.86,-1041.62,7100.08
744272774934078848,2020-07,3572.29,7490.11,4260.81,3687.15,-3344.16,3755.92
744272774934078848,2020-08,1846.23,3113.68,5621.91,7278.4,-2923.94,831.98
744272774934078848,2020-09,5425.87,2530.12,1476.93,8221.24,-3848.56,-3016.58
744272774934078848,2020-10,6133.06,4890.11,3526.82,1774.68,2995.09,-21.49
744272774934078848,2020-11,5828.8,3387.26,5264.47,4112.93,3593.08,3571.59
744272774934078848,2020-12,5225.36,0,8266.08,8214.58,5276.86,8848.45
745679385393998720,2020-01,0,2172.66,0,0,-2172.66,-2172.66
745679385393998720,2020-04,1261.67,0,0,0,1261.67,-910.99
745679385393998720,2020-07,0,650.95,902.22,0,251.27,-659.72
745679385393998720,2020-08,167.08,0,0,1902.18,-1735.1,-2394.82
745679385393998720,2020-09,0,978.77,1888.45,0,909.68,-1485.14
745679385393998720,2020-10,997.31,0,0,868.83,128.48,-1356.66
745679385393998720,2020-11,0,98.14,0,0,-98.14,-1454.8
745921517904069888,2020-01,4382.91,2637.15,8755.13,3098.12,7402.77,7402.77
745921517904069888,2020-02,2397.46,5405.65,2766.43,6703.2,-6944.96,457.81
745921517904069888,2020-03,6614.24,5089.11,2361.26,2699.21,1187.18,1644.99
745921517904069888,2020-04,2887.7,3575.93,3542.65,6453.8,-3599.38,-1954.39
745921517904069888,2020-05,1482.57,3522.99,1858.25,2765.35,-2947.52,-4901.91
745921517904069888,2020-06,2467.91,5244.06,5576.54,5473.06,-2672.67,-7574.58
745921517904069888,2020-07,4402.76,7078.22,7543.91,0,4868.45,-2706.13
745921517904069888,2020-08,10700.04,3955.58,3947.45,1197.27,9494.64,6788.51
745921517904069888,2020-09,2301.95,3621.58,885.2,4797.33,-5231.76,1556.75
745921517904069888,2020-10,3863.44,5490.47,4290.35,0,2663.32,4220.07
745921517904069888,2020-11,3213.64,5824.01,555.79,0,-2054.58,2165.49
745921517904069888,2020-12,0,4120.27,1828.48,669.26,-2961.05,-795.56
746461240827666944,2020-01,2932.84,1924.32,573.47,6868.98,-5286.99,-5286.99
746461240827666944,2020-02,1129.73,4008.75,2831.7,0,-47.32,-5334.31
746461240827666944,2020-03,3524.16,5997.81,3419.24,756.59,189,-5145.31
746461240827666944,2020-04,1653.39,39.71,4102.17,5337.93,377.92,-4767.39
746461240827666944,2020-05,6457.29,2557.9,2162.39,3949.11,2112.67,-2654.72
746461240827666944,2020-06,1686.28,7665.09,788.98,3845.97,-9035.8,-11690.52
746461240827666944,2020-07,1058.19,8653.37,2751.98,4382.1,-9225.3,-20915.82
746461240827666944,2020-08,3210.26,3094.78,1874.68,2851.5,-861.34,-21777.16
746461240827666944,2020-09,4649.43,5170.49,3523,2004.63,997.31,-20779.85
746461240827666944,2020-10,1057.85,4246.47,1999.23,6269.09,-7458.48,-28238.33
746461240827666944,2020-11,4253.09,3612.11,3388.86,2545.45,1484.39,-26753.94
746461240827666944,2020-12,2535.78,5386.2,4487.03,5328.65,-3692.04,-30445.98
746687278186803456,2020-03,1322.35,0,681.97,0,2004.32,2004.32
746687278186803456,2020-07,527.44,0,0,0,527.44,2531.76
746687278186803456,2020-10,0,1027.48,0,0,-1027.48,1504.28
746687278186803456,2020-11,0,1665.79,0,0,-1665.79,-161.51
748129350032235264,2020-01,6004.3,3463.96,5867.64,5223.89,3184.09,3184.09
748129350032235264,2020-02,3912.09,4737.75,2852.72,6212.27,-4185.21,-1001.12
748129350032235264,2020-03,3377.42,3657.15,6345.3,7714.58,-1649.01,-2650.13
748129350032235264,2020-04,5347.43,3335.9,1580.02,5252.51,-1660.96,-4311.09
748129350032235264,2020-05,12100.73,4986.08,6452.48,744.31,12822.82,8511.73
748129350032235264,2020-06,1063.94,2492,1144.66,1238.73,-1522.13,6989.6
748129350032235264,2020-07,3661.71,2928.94,2584.72,2118.28,1199.21,8188.81
748129350032235264,2020-08,5601.79,4348.42,4187.78,4143.65,1297.5,9486.31
748129350032235264,2020-09,4875.18,4609.47,6139.62,1816.78,4588.55,14074.86
748129350032235264,2020-10,3475.88,6796.64,4830.06,3715.81,-2206.51,11868.35
748129350032235264,2020-11,7342.79,2294.87,1666.7,5931.85,782.77,12651.12
748129350032235264,2020-12,3733.35,175.89,3409.57,4453.66,2513.37,15164.49
748451798680840064,2020-01,1834.31,5461.12,1337.28,3399.38,-5688.91,-5688.91
748451798680840064,2020-02,2136.09,10501.22,4645.76,4804.7,-8524.07,-14212.98
748451798680840064,2020-03,14381.5,6374.83,4575.74,5632.91,6949.5,-7263.48
748451798680840064,2020-04,5851.44,3505.87,2447.24,1197.3,3595.51,-3667.97
748451798680840064,2020-05,3080.18,2291.83,2654.22,9016.4,-5573.83,-9241.8
748451798680840064,2020-06,4418.97,10111.35,7215.49,6720.98,-5197.87,-14439.67
748451798680840064,2020-07,4540.7,4923.12,5970.72,6548.18,-959.88,-15399.55
748451798680840064,2020-08,7288.87,469.09,8444.03,5245.46,10018.35,-5381.2
748451798680840064,2020-09,5954.83,11567.74,5096.76,5638.64,-6154.79,-11535.99
748451798680840064,2020-10,3779.25,1942.03,882.48,3534.06,-814.36,-12350.35
748451798680840064,2020-11,2428.38,9604.63,5577.55,5429.16,-7027.86,-19378.21
748451798680840064,2020-12,4647.43,7498.02,1903.82,2780.93,-3727.7,-23105.91
748529245375948928,2020-01,4111.72,3400.34,6751.62,3855.33,3607.67,3607.67
748529245375948928,2020-02,2910.76,2757.82,3568.72,5614.72,-1893.06,1714.61
748529245375948928,2020-03,2379.29,9491.54,2474.9,3340.37,-7977.72,-6263.11
748529245375948928,2020-04,4053.67,2264.95,835.88,3004.59,-379.99,-6643.1
748529245375948928,2020-05,957.53,1037.54,5060.13,3803.34,1176.78,-5466.32
748529245375948928,2020-06,4414.97,2304.32,4049.38,3356.57,2803.46,-2662.86
748529245375948928,2020-07,3841.32,7834.9,2620.39,4640.87,-6014.06,-8676.92
748529245375948928,2020-08,2813.25,2189.83,3364.65,2498.03,1490.04,-7186.88
748529245375948928,2020-09,489.96,3367.56,4585.39,5174.98,-3467.19,-10654.07
748529245375948928,2020-10,5442.96,3242.28,1340.82,2694.82,846.68,-9807.39
748529245375948928,2020-11,3596.34,2603.99,3858.97,2889.53,1961.79,-7845.6
748529245375948928,2020-12,386.93,515.07,2547.47,158.19,2261.14,-5584.46
749949900287471616,2020-01,1298.82,3446.19,1577.37,3218.88,-3788.88,-3788.88
749949900287471616,2020-02,2760.19,3003.1,2816.41,5724.17,-3150.67,-6939.55
749949900287471616,2020-03,1169.13,2554.29,6259.72,8619.27,-3744.71,-10684.26
749949900287471616,2020-04,2580.77,3410.71,3610,1217.45,1562.61,-9121.65
749949900287471616,2020-05,2958.31,3898.28,1654.98,2322.41,-1607.4,-10729.05
749949900287471616,2020-06,4063.11,363.61,3485.82,2341.53,4843.79,-5885.26
749949900287471616,2020-07,858.57,0,6358.42,549.37,6667.62,782.36
749949900287471616,2020-08,2136.31,995.38,1590.98,245.17,2486.74,3269.1
749949900287471616,2020-09,3694.94,981.45,1027.2,8660.51,-4919.82,-1650.72
749949900287471616,2020-10,3968.02,2690.21,2016.25,4926.72,-1632.66,-3283.38
749949900287471616,2020-11,3115.56,2885.15,1362.66,2811.69,-1218.62,-4502
749949900287471616,2020-12,5139.4,2168.73,2381.54,1094.7,4257.51,-244.49
751378265562031616,2020-01,0,1079.48,1341.48,478.14,-216.14,-216.14
751378265562031616,2020-02,1877.7,1415.01,0,1179.72,-717.03,-933.17
751378265562031616,2020-03,0,1852.82,0,1464.85,-3317.67,-4250.84
751378265562031616,2020-04,281.46,1294.19,1508.24,1368.26,-872.75,-5123.59
751378265562031616,2020-05,1593.18,0,308.6,0,1901.78,-3221.81
751378265562031616,2020-06,0,2667.69,631.97,0,-2035.72,-5257.53
751378265562031616,2020-07,1442.38,0,685.51,179.99,1947.9,-3309.63
751378265562031616,2020-08,0,1179.99,0,0,-1179.99,-4489.62
751378265562031616,2020-11,1928.8,1099.24,0,0,829.56,-3660.06
751378265562031616,2020-12,1894.56,1550.4,0,0,344.16,-3315.9
753308410838408704,2020-01,1644.54,0,1253.72,0,2898.26,2898.26
753308410838408704,2020-04,0,343.62,0,0,-343.62,2554.64
753308410838408704,2020-06,0,487.03,1400.91,0,913.88,3468.52
753308410838408704,2020-08,704.65,0,0,1511.57,-806.92,2661.6
753308410838408704,2020-10,0,88.19,0,0,-88.19,2573.41
753308410838408704,2020-12,0,385.68,0,0,-385.68,2187.73
754080377407111680,2020-01,840.69,3223.07,1026.15,2428.74,-3784.97,-3784.97
754080377407111680,2020-02,82.54,0,2584.01,836.11,1830.44,-1954.53
754080377407111680,2020-03,5365.43,1143.03,4364.01,3686.17,4900.24,2945.71
754080377407111680,2020-04,1943.72,0,2360.61,2582.87,1721.46,4667.17
754080377407111680,2020-05,1577.32,4520.89,0,7556.39,-10499.96,-5832.79
754080377407111680,2020-06,322.48,965.99,3073.02,1469.62,959.89,-4872.9
754080377407111680,2020-07,1842.72,3364.8,2176.68,1218.53,-563.93,-5436.83
754080377407111680,2020-08,1546.56,2537.11,2332.59,2488.38,-1146.34,-6583.17
754080377407111680,2020-09,1910.53,2599.37,6324.86,1955.54,3680.48,-2902.69
754080377407111680,2020-10,4429.58,79.75,1091.62,1274.97,4166.48,1263.79
754080377407111680,2020-11,3378.09,2025.71,4641.32,5310.87,682.83,1946.62
754080377407111680,2020-12,5223.41,2506.24,1130.35,2210.52,1637,3583.62
754632306820363392,2020-01,5596.22,4362.53,1591.51,2807.05,18.15,18.15
754632306820363392,2020-02,3637.21,2317.56,1662.72,1381.02,1601.35,1619.5
754632306820363392,2020-03,4626.52,6887.17,852.36,4273.74,-5682.03,-4062.53
754632306820363392,2020-04,675.2,619.56,346.56,3192.3,-2790.1,-6852.63
754632306820363392,2020-05,392.7,4417.13,370.19,5167.87,-8822.11,-15674.74
754632306820363392,2020-06,1966.18,2588.19,4702.56,2541.14,1539.41,-14135.33
754632306820363392,2020-07,2420.14,2391.54,1019.84,3325.02,-2276.58,-16411.91
754632306820363392,2020-08,1941.94,4660.9,2733.13,977.83,-963.66,-17375.57
754632306820363392,2020-09,4584.14,3967.27,1850.24,3883.9,-1416.79,-18792.36
754632306820363392,2020-10,3694.11,4829.53,819.84,2395.75,-2711.33,-21503.69
754632306820363392,2020-11,1484.23,0,2704.51,708.72,3480.02,-18023.67
754632306820363392,2020-12,257.45,2291.53,2288.86,3342.69,-3087.91,-21111.58
756298696466097152,2020-01,4971.45,5896.82,3366.47,3985.97,-1544.87,-1544.87
756298696466097152,2020-02,3173.06,3569.59,1218.17,2631.83,-1810.19,-3355.06
756298696466097152,2020-03,6182.41,3221.56,4651.79,2709.5,4903.14,1548.08
756298696466097152,2020-04,2265.69,3937.37,1358,8936,-9249.68,-7701.6
756298696466097152,2020-05,2701.45,1926.22,2595.45,2874.6,496.08,-7205.52
756298696466097152,2020-06,2568.04,3840.94,4086.47,1741.75,1071.82,-6133.7
756298696466097152,2020-07,949.99,2830.43,2915.03,2298.72,-1264.13,-7397.83
756298696466097152,2020-08,8899.58,8456.7,2148.24,2903.08,-311.96,-7709.79
756298696466097152,2020-09,1595.94,596.22,1501,2493.76,6.96,-7702.83
756298696466097152,2020-10,2203.78,1931.73,5249.19,2903.85,2617.39,-5085.44
756298696466097152,2020-11,4057.62,1564.22,6114.29,3270.05,5337.64,252.2
756298696466097152,2020-12,3371.26,1887.49,6249.91,3063.48,4670.2,4922.4
756403032749129856,2020-01,0,1962.58,0,494.44,-2457.02,-2457.02
756403032749129856,2020-02,0,2815.76,3149.85,691.17,-357.08,-2814.1
756403032749129856,2020-03,1510.76,902.98,0,1593.85,-986.07,-3800.17
756403032749129856,2020-04,0,3394.79,473.73,2491.67,-5412.73,-9212.9
756403032749129856,2020-05,0,2278.52,506.84,1526.03,-3297.71,-12510.61
756403032749129856,2020-06,818.68,0,338.15,1933.38,-776.55,-13287.16
756403032749129856,2020-07,71.16,0,0,0,71.16,-13216
756403032749129856,2020-08,1615.97,4284.15,5690.43,0,3022.25,-10193.75
756403032749129856,2020-09,786.29,1014.56,0,541.18,-769.45,-10963.2
756403032749129856,2020-10,385.41,0,89.75,3216.81,-2741.65,-13704.85
757254104918697344,2020-01,1943.67,1377.72,0,2249.96,-1684.01,-1684.01
757254104918697344,2020-02,4989.21,2132.06,6223.37,5087.86,3992.66,2308.65
757254104918697344,2020-03,2591.47,2292.03,7119.65,4805.94,2613.15,4921.8
757254104918697344,2020-04,2057,2592.11,2024.2,37.65,1451.44,6373.24
757254104918697344,2020-05,0,1683.01,3147.91,1564.33,-99.43,6273.81
757254104918697344,2020-06,702.98,2122.59,970,1525.84,-1975.45,4298.36
757254104918697344,2020-07,1578.96,3171.09,1000,0,-592.13,3706.23
757254104918697344,2020-08,1227.77,0,3354.26,1797.26,2784.77,6491
757254104918697344,2020-09,1259.05,1983.53,2340.98,908.82,707.68,7198.68
757254104918697344,2020-10,489.14,5074.78,1812.15,3765.21,-6538.7,659.98
757254104918697344,2020-11,1649,1067.11,4561.1,2556.51,2586.48,3246.46
757254104918697344,2020-12,2241.44,3755.91,3429.62,4714.26,-2799.11,447.35
757335542249200512,2020-01,1523.41,565.59,1382.1,0,2339.92,2339.92
757335542249200512,2020-02,0,727.7,1771.54,0,1043.84,3383.76
757335542249200512,2020-04,907.13,0,1625.05,0,2532.18,5915.94
757335542249200512,2020-05,79.53,1486,3465.98,2269.82,-210.31,5705.63
757335542249200512,2020-06,1752.01,0,1574.93,1681.6,1645.34,7350.97
757335542249200512,2020-07,0,188.24,0,0,-188.24,7162.73
757335542249200512,2020-08,0,628.92,1421.4,1615.57,-823.09,6339.64
757335542249200512,2020-09,3100.99,0,1067.59,0,4168.58,10508.22
757335542249200512,2020-10,3928.55,3027.44,1061.64,0,1962.75,12470.97
757335542249200512,2020-12,1653.73,1712.11,793.46,1651.46,-916.38,11554.59
757456619713070080,2020-01,7873.95,9815,6846.67,9689.18,-4783.56,-4783.56
757456619713070080,2020-02,4481.44,1786,4366.18,2379.56,4682.06,-101.5
757456619713070080,2020-03,5204.22,5691.33,4524.71,1901.21,2136.39,2034.89
757456619713070080,2020-04,3893.71,2438.74,7832.03,6718.68,2568.32,4603.21
757456619713070080,2020-05,7550.24,9196.95,5068.95,2039.73,1382.51,5985.72
757456619713070080,2020-06,1755.8,8743.33,3115.8,4309.59,-8181.32,-2195.6
757456619713070080,2020-07,6362.91,5595.05,4621.48,8067.78,-2678.44,-4874.04
757456619713070080,2020-08,3096.71,5419.36,2831.29,6578.26,-6069.62,-10943.66
757456619713070080,2020-09,5987.11,5710.27,327.62,7352.16,-6747.7,-17691.36
757456619713070080,2020-10,2121.46,4606.37,6876.4,1872.16,2519.33,-15172.03
757456619713070080,2020-11,1311.17,2080.88,3713.44,195.84,2747.89,-12424.14
757456619713070080,2020-12,2012.63,3056.1,1397.81,3990.59,-3636.25,-16060.39
758118866890671616,2020-01,3029.22,3238.74,5155.76,1980.46,2965.78,2965.78
758118866890671616,2020-02,2703.32,3352.83,4864.38,7223.33,-3008.46,-42.68
758118866890671616,2020-03,2964.36,3293.81,4023.29,2436.01,1257.83,1215.15
758118866890671616,2020-04,6499.58,0,1088.9,2239.88,5348.6,6563.75
758118866890671616,2020-05,4309.57,5575.16,1964.26,2768.71,-2070.04,4493.71
758118866890671616,2020-06,4142.28,4137.23,3822.37,4935.6,-1108.18,3385.53
758118866890671616,2020-07,4652.37,1366.03,4420.29,3436.26,4270.37,7655.9
758118866890671616,2020-08,5477.85,1904.49,3175.08,6185.96,562.48,8218.38
758118866890671616,2020-09,7559.02,1424.63,3668.46,1810.15,7992.7,16211.08
758118866890671616,2020-10,7726.42,5688.18,5236.93,4782.94,2492.23,18703.31
758118866890671616,2020-11,7544.78,5891.16,6891.08,3035.86,5508.84,24212.15
758118866890671616,2020-12,4040.29,7819.29,3970.96,0,191.96,24404.11
759825256206921728,2020-06,1265.71,0,0,0,1265.71,1265.71
759905162151811328,2020-01,2010.12,0,595.19,3459.88,-854.57,-854.57
759905162151811328,2020-02,3231.49,3734.96,2824.11,849.96,1470.68,616.11
759905162151811328,2020-03,456.33,1708.53,1883.77,16.51,615.06,1231.17
759905162151811328,2020-04,2876.66,996.27,1996.67,0,3877.06,5108.23
759905162151811328,2020-05,2569.74,0,3988.59,1392.15,5166.18,10274.41
759905162151811328,2020-06,0,251.07,685.06,1991.56,-1557.57,8716.84
759905162151811328,2020-07,0,1288.9,0,2281.02,-3569.92,5146.92
759905162151811328,2020-08,1665.13,2034.39,1885.2,470.42,1045.52,6192.44
759905162151811328,2020-09,1287.83,0,2030.89,368.96,2949.76,9142.2
759905162151811328,2020-10,1194.02,0,0,0,1194.02,10336.22
759905162151811328,2020-11,3504.81,0,3727.55,1299.16,5933.2,16269.42
759905162151811328,2020-12,0,376.06,0,416.89,-792.95,15476.47
760324396661973760,2020-01,945.05,2957.35,559.64,954.91,-2407.57,-2407.57
760324396661973760,2020-02,0,325.94,641.27,0,315.33,-2092.24
760324396661973760,2020-03,0,1603.68,0,0,-1603.68,-3695.92
760324396661973760,2020-04,0,1924.97,0,4.79,-1929.76,-5625.68
760324396661973760,2020-06,1672.98,0,1377.23,0,3050.21,-2575.47
760324396661973760,2020-07,628.05,0,1149.54,0,1777.59,-797.88
760324396661973760,2020-08,2324.31,2549.45,0,0,-225.14,-1023.02
760324396661973760,2020-10,76.12,1459.81,0,0,-1383.69,-2406.71
760324396661973760,2020-12,1188.13,0,1261.51,0,2449.64,42.93
760511231025007488,2020-01,3239.1,1327.94,16.26,2699,-771.58,-771.58
760511231025007488,2020-02,879.35,1349.19,0,3027.6,-3497.44,-4269.02
760511231025007488,2020-03,2501.72,4187.68,2277.45,2900,-2308.51,-6577.53
760511231025007488,2020-04,2618.83,5756.58,2218.24,4695.49,-5615,-12192.53
760511231025007488,2020-05,4876.49,1604.52,3586.44,1569.26,5289.15,-6903.38
760511231025007488,2020-06,1844.83,3851.03,7925.07,157.22,5761.65,-1141.73
760511231025007488,2020-07,1683.43,4041.49,1273.15,0,-1084.91,-2226.64
760511231025007488,2020-08,1811.05,2180.62,5103.22,3345.71,1387.94,-838.7
760511231025007488,2020-09,1774.59,967.07,521.53,4806.45,-3477.4,-4316.1
760511231025007488,2020-10,3648.28,986.94,0,5564.53,-2903.19,-7219.29
760511231025007488,2020-11,2391.16,3778.68,3763.97,1077.13,1299.32,-5919.97
760511231025007488,2020-12,2489.53,4360.44,5435.41,7592.07,-4027.57,-9947.54
760705245457254144,2020-01,4547.61,1541.84,1966.97,3611.39,1361.35,1361.35
760705245457254144,2020-02,3061.11,2885.31,8770.82,8276.93,669.69,2031.04
760705245457254144,2020-03,4591.35,2555.82,11518.39,3085.61,10468.31,12499.35
760705245457254144,2020-04,2902.05,2874.72,3370.07,1046.95,2350.45,14849.8
760705245457254144,2020-05,3029.11,3156.07,3474.92,1075.91,2272.05,17121.85
760705245457254144,2020-06,852.51,6072.09,3849.64,3911.73,-5281.67,11840.18
760705245457254144,2020-07,1667.61,0,6081.11,1148.32,6600.4,18440.58
760705245457254144,2020-08,5906.15,1630.64,439.53,0,4715.04,23155.62
760705245457254144,2020-09,5949.82,2401.91,0,7.89,3540.02,26695.64
760705245457254144,2020-10,4587,1428.67,6624.33,3945.1,5837.56,32533.2
760705245457254144,2020-11,3475.9,3397.76,7277.15,1771.12,5584.17,38117.37
760705245457254144,2020-12,634.86,17.16,0,337.25,280.45,38397.82
761595328694611072,2020-01,1135.7,0,4502.64,3346.21,2292.13,2292.13
761595328694611072,2020-02,4524.17,6502.31,1296.08,1039.07,-1721.13,571
761595328694611072,2020-03,2483.33,1029.25,1209.06,4676.8,-2013.66,-1442.66
761595328694611072,2020-04,816.79,3502.41,1756.19,6604.22,-7533.65,-8976.31
761595328694611072,2020-05,0,2556.62,3796.08,2547.25,-1307.79,-10284.1
761595328694611072,2020-06,3623.05,2979.7,0,2603.98,-1960.63,-12244.73
761595328694611072,2020-07,600.19,5483.15,1307.94,4835.14,-8410.16,-20654.89
761595328694611072,2020-08,8091.31,991.7,717.44,8694.17,-877.12,-21532.01
761595328694611072,2020-09,5464.06,1263.09,3609.67,1289.7,6520.94,-15011.07
761595328694611072,2020-10,2550.74,0,3182.94,0,5733.68,-9277.39
761595328694611072,2020-11,0,3174.81,5941.84,1760.73,1006.3,-8271.09
761595328694611072,2020-12,2634.92,2031.65,2056.25,3346.01,-686.49,-8957.58
764158323647692544,2020-01,11.68,1566.98,6616.32,2500.49,2560.53,2560.53
764158323647692544,2020-02,3203.89,4431.42,2821.58,74.69,1519.36,4079.89
764158323647692544,2020-03,3405.14,4442,326.45,0,-710.41,3369.48
764158323647692544,2020-04,1604.6,0,758.32,3093.23,-730.31,2639.17
764158323647692544,2020-05,2404.75,1419.09,1447.25,3887.77,-1454.86,1184.31
764158323647692544,2020-06,1431.22,3624.1,4118.96,81.08,1845,3029.31
764158323647692544,2020-07,0,131.6,9280.58,3379.22,5769.76,8799.07
764158323647692544,2020-08,2179.29,4426.99,1267.21,3489.73,-4470.22,4328.85
764158323647692544,2020-09,1153.24,2017.81,1306.94,1629.41,-1187.04,3141.81
764158323647692544,2020-10,1063.28,333.06,0,6271.93,-5541.71,-2399.9
764158323647692544,2020-11,600.03,478.16,0,1586.01,-1464.14,-3864.04
764158323647692544,2020-12,197.6,5704.75,1156.35,1176.52,-5527.32,-9391.36
764566103275770112,2020-01,2171.64,1762.75,3057.59,4003.66,-537.18,-537.18
764566103275770112,2020-02,3987.28,4123.2,3425.13,1102.92,2186.29,1649.11
764566103275770112,2020-03,1422.67,4524.55,2003.95,363.62,-1461.55,187.56
764566103275770112,2020-04,472.29,469.62,1331.26,458.07,875.86,1063.42
764566103275770112,2020-05,1714.81,3241.69,3952.76,92.06,2333.82,3397.24
764566103275770112,2020-06,1468.55,4020.42,127.08,1128.68,-3553.47,-156.23
764566103275770112,2020-07,1295.9,1604.37,884.23,408.92,166.84,10.61
764566103275770112,2020-08,183.57,1801.59,2233.81,1479.06,-863.27,-852.66
764566103275770112,2020-09,7364.82,3497.21,261.89,1432.72,2696.78,1844.12
764566103275770112,2020-10,3078.4,2392.09,6080.16,1326.07,5440.4,7284.52
764566103275770112,2020-11,386.28,5990.4,1823.44,2122.91,-5903.59,1380.93
764566103275770112,2020-12,1804.52,6042.75,1343.28,3355.83,-6250.78,-4869.85
765212116127631872,2020-01,11203.2,4310.88,1366.27,445.15,7813.44,7813.44
765212116127631872,2020-02,5200,2629.41,3427.14,6024.18,-26.45,7786.99
765212116127631872,2020-03,4709.49,8406.67,10620.34,4760.03,2163.13,9950.12
765212116127631872,2020-04,1722.64,6125.23,3425.45,6248.86,-7226,2724.12
765212116127631872,2020-05,1353.14,657.73,3583.56,4833.92,-554.95,2169.17
765212116127631872,2020-06,3529.79,7175.02,4287.18,0,641.95,2811.12
765212116127631872,2020-07,4572.1,5790.43,1724.1,5329.86,-4824.09,-2012.97
765212116127631872,2020-08,1109.48,2169.2,911.66,4010.81,-4158.87,-6171.84
765212116127631872,2020-09,8381.59,5057.54,2626.22,7197.41,-1247.14,-7418.98
765212116127631872,2020-10,1581.11,1138.27,8837.6,1941.03,7339.41,-79.57
765212116127631872,2020-11,618.55,4571.12,6571.32,4994.83,-2376.08,-2455.65
765212116127631872,2020-12,5006.8,1401.23,4176.85,5753.41,2029.01,-426.64
765522015217612288,2020-01,4983.36,5454.32,3596.31,660.64,2464.71,2464.71
765522015217612288,2020-02,2015.71,4078.68,184.09,2433.75,-4312.63,-1847.92
765522015217612288,2020-03,4827.48,3570.68,4478.51,1855.86,3879.45,2031.53
765522015217612288,2020-04,3342.54,1480.15,3265.6,2406.5,2721.49,4753.02
765522015217612288,2020-05,6905.69,4851.12,1522.25,7606.78,-4029.96,723.06
765522015217612288,2020-06,4644.61,4669.38,7482.82,8095.83,-637.78,85.28
765522015217612288,2020-07,3567.82,2950.08,8673.33,3574.08,5716.99,5802.27
765522015217612288,2020-08,3227.61,3810.4,4104.19,3338.88,182.52,5984.79
765522015217612288,2020-09,4912.21,3413.55,3041.87,3810.32,730.21,6715
765522015217612288,2020-10,5326.27,5474.8,4930.08,2515.45,2266.1,8981.1
765522015217612288,2020-11,8097.49,1804.32,0,4758.75,1534.42,10515.52
765522015217612288,2020-12,4443.01,1622.73,770.91,6714.44,-3123.25,7392.27
765555790911549440,2020-01,6731,2512.98,2796.36,2201.8,4812.58,4812.58
765555790911549440,2020-02,2606.1,2912.47,382.7,4148.89,-4072.56,740.02
765555790911549440,2020-03,7745.95,5406.36,2097.62,5225.75,-788.54,-48.52
765555790911549440,2020-04,2393.52,3290.49,1995.17,4322.7,-3224.5,-3273.02
765555790911549440,2020-05,2227.61,2537,4816.31,2195.46,2311.46,-961.56
765555790911549440,2020-06,972.4,4283.97,4005.97,1979.87,-1285.47,-2247.03
765555790911549440,2020-07,1110.17,1302.56,4027.2,1904.8,1930.01,-317.02
765555790911549440,2020-08,1570.84,6459.36,4158.46,1982.55,-2712.61,-3029.63
765555790911549440,2020-09,2408.09,5517.53,6190.31,3880.6,-799.73,-3829.36
765555790911549440,2020-10,5484.74,1666.44,188.96,4728.12,-720.86,-4550.22
765555790911549440,2020-11,258.97,3566.91,4662.64,1789.57,-434.87,-4985.09
765555790911549440,2020-12,2860.75,2215.76,2655.74,4067.62,-766.89,-5751.98
767261737942179968,2020-01,0,1504.15,2589.43,4237.26,-3151.98,-3151.98
767261737942179968,2020-02,1539.18,0,3206.64,0,4745.82,1593.84
767261737942179968,2020-03,876.99,1983.7,27.79,368.82,-1447.74,146.1
767261737942179968,2020-05,2388.09,1519.81,0,1233.3,-365.02,-218.92
767261737942179968,2020-07,85.14,1878.8,0,2477.53,-4271.19,-4490.11
767261737942179968,2020-08,0,3072.61,0,0,-3072.61,-7562.72
767261737942179968,2020-09,0,2256.86,964.59,1964.82,-3257.09,-10819.81
767261737942179968,2020-11,2127.57,3245.72,2509.64,0,1391.49,-9428.32
767261737942179968,2020-12,1250.89,0,554.28,0,1805.17,-7623.15
767311790461027456,2020-01,1917.14,3789.45,9359.09,4158.6,3328.18,3328.18
767311790461027456,2020-02,5655.14,5581.42,4808.66,3580.04,1302.34,4630.52
767311790461027456,2020-03,7380.82,5011.94,8238.48,8192.7,2414.66,7045.18
767311790461027456,2020-04,0,1173.55,2598.64,7404.4,-5979.31,1065.87
767311790461027456,2020-05,7444.67,1470.39,1243.02,4211.19,3006.11,4071.98
767311790461027456,2020-06,5924.55,3978.42,9163.94,4658.87,6451.2,10523.18
767311790461027456,2020-07,3055.51,9101.06,5361.11,8047.54,-8731.98,1791.2
767311790461027456,2020-08,10450.24,2215.02,1165.04,4023.12,5377.14,7168.34
767311790461027456,2020-09,3117.36,1986.39,2821.1,11700.29,-7748.22,-579.88
767311790461027456,2020-10,5132.51,1696.1,5002.83,3971.64,4467.6,3887.72
767311790461027456,2020-11,7631.43,4194.4,1970.42,10022.9,-4615.45,-727.73
767311790461027456,2020-12,2970.2,4035.77,1857.51,6103.35,-5311.41,-6039.14
767605981806250752,2020-01,0,2456.92,2693.41,3150.93,-2914.44,-2914.44
767605981806250752,2020-02,0,1158.24,1745.05,0,586.81,-2327.63
767605981806250752,2020-03,1693.13,1872.56,1641.88,0,1462.45,-865.18
767605981806250752,2020-04,1997.17,276.94,1053.56,3957.19,-1183.4,-2048.58
767605981806250752,2020-05,387.12,0,2088.42,2728.9,-253.36,-2301.94
767605981806250752,2020-06,1033.53,0,0,3701.89,-2668.36,-4970.3
767605981806250752,2020-07,2943.69,0,2941.26,2378.19,3506.76,-1463.54
767605981806250752,2020-08,461.61,5958.08,2270.76,2539.2,-5764.91,-7228.45
767605981806250752,2020-09,1303.5,2376.02,1483.48,4288.72,-3877.76,-11106.21
767605981806250752,2020-10,0,4468.26,1665.86,511.91,-3314.31,-14420.52
767605981806250752,2020-12,4415.89,1493.6,2870.24,1114.25,4678.28,-9742.24
769583591793024000,2020-01,2713.39,2606.13,11001.54,4417.02,6691.78,6691.78
769583591793024000,2020-02,1781.17,4611.62,902.09,6901.38,-8829.74,-2137.96
769583591793024000,2020-03,5135.05,4003.01,2912.22,794.55,3249.71,1111.75
769583591793024000,2020-04,6528.81,3085.03,4925.98,1135.78,7233.98,8345.73
769583591793024000,2020-05,4183.85,430.6,4435.93,6734.46,1454.72,9800.45
769583591793024000,2020-06,3335.44,5865.47,2932.89,5285.92,-4883.06,4917.39
769583591793024000,2020-07,7490.94,5120.13,2554.81,2621.82,2303.8,7221.19
769583591793024000,2020-08,5450.06,1988.95,1660.53,4028.93,1092.71,8313.9
769583591793024000,2020-09,535.31,5796.28,1805.19,1028.62,-4484.4,3829.5
769583591793024000,2020-10,3002.68,1054.7,3114.82,1837,3225.8,7055.3
769583591793024000,2020-11,6953.04,1077.44,4528.99,3560.21,6844.38,13899.68
769583591793024000,2020-12,5812.51,5142.13,4746.26,5950.59,-533.95,13365.73
772341399566237312,2020-01,321.97,0,4499.29,186.59,4634.67,4634.67
772341399566237312,2020-02,1509.83,2933.78,945.12,4020.68,-4499.51,135.16
772341399566237312,2020-03,0,2267.05,3106.78,1337.28,-497.55,-362.39
772341399566237312,2020-04,682.02,3323.75,1938.63,0,-703.1,-1065.49
772341399566237312,2020-05,1500.09,2797.71,3545.07,4228.98,-1981.53,-3047.02
772341399566237312,2020-06,1537.74,2211.74,217.94,130.53,-586.59,-3633.61
772341399566237312,2020-07,1678.39,0,2029.59,0,3707.98,74.37
772341399566237312,2020-08,908.55,0,1205.9,2289.98,-175.53,-101.16
772341399566237312,2020-10,4439.3,2410.81,1680.89,3075.93,633.45,532.29
772341399566237312,2020-11,1489.76,0,1714.9,853.01,2351.65,2883.94
772341399566237312,2020-12,1452.2,1211.93,1219.36,3701.52,-2241.89,642.05
772424399784047232,2020-01,2082.52,210.77,2602.29,4217.28,256.76,256.76
772424399784047232,2020-02,120.3,2505.15,1264.14,4690.64,-5811.35,-5554.59
772424399784047232,2020-03,6026.44,2478.99,5684.98,4027.25,5205.18,-349.41
772424399784047232,2020-04,4711.27,0,646.4,6419.74,-1062.07,-1411.48
772424399784047232,2020-05,5461.28,3976.33,4933.06,4275.82,2142.19,730.71
772424399784047232,2020-06,274.72,4205.74,1552.98,6558.14,-8936.18,-8205.47
772424399784047232,2020-07,4678.33,5171.92,1429.44,594.4,341.45,-7864.02
772424399784047232,2020-08,6417.84,1586.6,5407.09,6447.99,3790.34,-4073.68
772424399784047232,2020-09,3300.26,2350.23,3311.67,6506.99,-2245.29,-6318.97
772424399784047232,2020-10,443.19,3489.55,1780.48,3370.03,-4635.91,-10954.88
772424399784047232,2020-11,4605.91,4771.47,6996.09,2749.41,4081.12,-6873.76
772424399784047232,2020-12,1581.89,1486.36,5647.61,7130.54,-1387.4,-8261.16
773244687517781120,2020-01,1780.69,0,0,0,1780.69,1780.69
773244687517781120,2020-04,1617.56,0,0,0,1617.56,3398.25
773244687517781120,2020-09,546.79,0,0,0,546.79,3945.04
773445616044898176,2020-01,333.57,496.6,2623.43,2281.06,179.34,179.34
773445616044898176,2020-02,2898.37,1687.47,0,5845.31,-4634.41,-4455.07
773445616044898176,2020-03,2646.1,0,2602.87,2842.15,2406.82,-2048.25
773445616044898176,2020-04,967.28,0,1534.19,0,2501.47,453.22
773445616044898176,2020-05,6476.54,3077.12,0,75.85,3323.57,3776.79
773445616044898176,2020-06,1695.33,2139.2,1975.9,271.08,1260.95,5037.74
773445616044898176,2020-07,1547.73,1795.68,4230.7,7554.03,-3571.28,1466.46
773445616044898176,2020-08,2662.76,695.84,1562.57,983.48,2546.01,4012.47
773445616044898176,2020-09,1861.68,0,851.6,3220.25,-506.97,3505.5
773445616044898176,2020-10,1317.49,555.24,0,0,762.25,4267.75
773445616044898176,2020-11,1419.38,453.96,1661.61,1982.64,644.39,4912.14
773445616044898176,2020-12,0,1199.87,3103.29,993.12,910.3,5822.44
773641702715558016,2020-01,5974.28,4532.47,5439.62,3445.81,3435.62,3435.62
773641702715558016,2020-02,1713.11,4571.74,6446.49,3586.41,1.45,3437.07
773641702715558016,2020-03,735.26,6705.85,5233.89,3674.96,-4411.66,-974.59
773641702715558016,2020-04,11064.2,0,3641.15,6344.97,8360.38,7385.79
773641702715558016,2020-05,2019.9,8426.3,3620.22,4565,-7351.18,34.61
773641702715558016,2020-06,6485.04,7258.22,6250.23,5483.62,-6.57,28.04
773641702715558016,2020-07,8359.46,7959.24,2634.07,1810.45,1223.84,1251.88
773641702715558016,2020-08,6816,858.5,3761,2862.1,6856.4,8108.28
773641702715558016,2020-09,5105.92,7493.25,4167.46,4592.22,-2812.09,5296.19
773641702715558016,2020-10,808.54,4552.28,1914.55,1436.81,-3266,2030.19
773641702715558016,2020-11,4476.06,6195.74,1699.99,3826.35,-3846.04,-1815.85
773641702715558016,2020-12,1878.8,2955.4,3814.66,3476.14,-738.08,-2553.93
774055979380049152,2020-01,4520.6,1813.93,3239.85,10186.48,-4239.96,-4239.96
774055979380049152,2020-02,2908.39,1601.89,3146.39,5383.93,-931.04,-5171
774055979380049152,2020-03,4641.24,2509.58,160.89,3860.19,-1567.64,-6738.64
774055979380049152,2020-04,3455.31,2190.68,3523.23,0,4787.86,-1950.78
774055979380049152,2020-05,917.58,3971.19,1332.44,3185.24,-4906.41,-6857.19
774055979380049152,2020-06,2680.69,1315.51,6600.59,0,7965.77,1108.58
774055979380049152,2020-07,3935.83,6019.04,2283.97,827.44,-626.68,481.9
774055979380049152,2020-08,5062.53,4937.55,4032.9,2940.45,1217.43,1699.33
774055979380049152,2020-09,2353.43,4286,0,4600.11,-6532.68,-4833.35
774055979380049152,2020-10,5084.99,2813.43,6462.23,4313.06,4420.73,-412.62
774055979380049152,2020-11,4038.53,6349.64,5895.75,5047.76,-1463.12,-1875.74
774055979380049152,2020-12,1253.39,1790.78,3601.36,2273.66,790.31,-1085.43
774273501545208320,2020-01,3755.28,1578.39,1217.79,1828.41,1566.27,1566.27
774273501545208320,2020-02,6199.9,4576.35,10730.07,4751.26,7602.36,9168.63
774273501545208320,2020-03,5602.51,3808.45,3067.22,1531.56,3329.72,12498.35
774273501545208320,2020-04,700.83,7465.52,7267.15,3365.39,-2862.93,9635.42
774273501545208320,2020-05,1221.43,6077.85,4671.26,1191.49,-1376.65,8258.77
774273501545208320,2020-06,5034.96,3817.89,3917.07,2206.38,2927.76,11186.53
774273501545208320,2020-07,522.33,6656.15,2181.62,8868.37,-12820.57,-1634.04
774273501545208320,2020-08,2851.42,4705.56,1941.79,3495.94,-3408.29,-5042.33
774273501545208320,2020-09,7154.12,2889.17,2042.58,3916.76,2390.77,-2651.56
774273501545208320,2020-10,4175.61,5446.01,1204.79,4636.96,-4702.57,-7354.13
774273501545208320,2020-11,7039.39,1061.72,4187.16,3406.64,6758.19,-595.94
774273501545208320,2020-12,616.6,6333.74,253.95,5849.08,-11312.27,-11908.21
775371303850435456,2020-01,1369.56,2007.19,687.21,0,49.58,49.58
775371303850435456,2020-02,1960.69,1576.33,1146.68,1994.85,-463.81,-414.23
775371303850435456,2020-03,47.04,1.52,2301.76,1426.31,920.97,506.74
775371303850435456,2020-04,3283.03,1989.31,219.86,2896.31,-1382.73,-875.99
775371303850435456,2020-05,0,1989.62,1367.21,154.68,-777.09,-1653.08
775371303850435456,2020-06,2588.54,831.3,2368.63,1151.96,2973.91,1320.83
775371303850435456,2020-07,2921.59,2627.9,2446.28,1582.75,1157.22,2478.05
775371303850435456,2020-08,2635.66,1160.84,415.95,965.38,925.39,3403.44
775371303850435456,2020-09,1012.32,1050.33,1395.95,553.31,804.63,4208.07
775371303850435456,2020-10,3663.97,1851.62,4279.21,642.48,5449.08,9657.15
775371303850435456,2020-11,2548.53,1629.9,1186.49,569.37,1535.75,11192.9
775371303850435456,2020-12,587.9,317.57,1044.6,0,1314.93,12507.83
775758710112437632,2020-03,172.22,2730.6,1574.37,0,-984.01,-984.01
775758710112437632,2020-04,94.94,1474.07,0,0,-1379.13,-2363.14
775758710112437632,2020-05,1917.98,1403.38,0,0,514.6,-1848.54
775758710112437632,2020-06,1608.14,0,1585.96,1022.49,2171.61,323.07
775758710112437632,2020-07,0,1658.86,0,1221.66,-2880.52,-2557.45
775758710112437632,2020-08,3166.67,365.23,1143.55,1802.03,2142.96,-414.49
775758710112437632,2020-09,0,3327.82,0,2765.99,-6093.81,-6508.3
775758710112437632,2020-10,3798.51,1211.98,2753.91,858.52,4481.92,-2026.38
775758710112437632,2020-12,0,1308.21,0,2986.11,-4294.32,-6320.7
777729106338456320,2020-01,1407.49,3023.77,1993.18,4993.64,-4616.74,-4616.74
777729106338456320,2020-02,2282.22,2183.4,2197.68,3255.65,-959.15,-5575.89
777729106338456320,2020-03,1355.33,1820.27,1337.89,2981.5,-2108.55,-7684.44
777729106338456320,2020-04,1173.27,3724.09,0,4281.03,-6831.85,-14516.29
777729106338456320,2020-05,3362.11,2666.28,2475.44,4765.12,-1593.85,-16110.14
777729106338456320,2020-06,618.18,3850.73,2962.73,3419.7,-3689.52,-19799.66
777729106338456320,2020-07,3675.03,364.87,1052.07,2087.5,2274.73,-17524.93
777729106338456320,2020-08,0,4883.66,2955.42,5822.35,-7750.59,-25275.52
777729106338456320,2020-09,5360.48,321.35,2423.03,1023.53,6438.63,-18836.89
777729106338456320,2020-10,5651.39,2863.98,1984.42,842.75,3929.08,-14907.81
777729106338456320,2020-11,1609.25,2174.77,902.38,4048.55,-3711.69,-18619.5
777729106338456320,2020-12,5424.11,2520.36,536.95,4970.95,-1530.25,-20149.75
778430384694242944,2020-03,0,927.44,0,0,-927.44,-927.44
778430384694242944,2020-04,865.79,0,0,0,865.79,-61.65
778430384694242944,2020-05,0,24.61,0,678.29,-702.9,-764.55
778430384694242944,2020-06,2223.9,0,0,0,2223.9,1459.35
778430384694242944,2020-11,0,1785.78,482.54,0,-1303.24,156.11
778430384694242944,2020-12,0,867.96,0,0,-867.96,-711.85
778564521831666048,2020-01,3163.15,2164.79,0,272.52,725.84,725.84
778564521831666048,2020-02,0,1548.29,0,508.85,-2057.14,-1331.3
778564521831666048,2020-03,1411.26,0,0,0,1411.26,79.96
778564521831666048,2020-05,2571.99,1582.66,0,0,989.33,1069.29
778564521831666048,2020-07,0,379.71,1149.02,1050.17,-280.86,788.43
778564521831666048,2020-08,270.31,588.13,1703.24,0,1385.42,2173.85
778564521831666048,2020-09,925.76,0,369.09,1904.13,-609.28,1564.57
778564521831666048,2020-10,4647.41,993.68,1288.75,1838.28,3104.2,4668.77
778564521831666048,2020-11,2314.16,167,0,3409.52,-1262.36,3406.41
779152819793169536,2020-01,2771.63,6033.82,1359.98,3001.63,-4903.84,-4903.84
779152819793169536,2020-02,5846.1,5796.09,3020.31,6889,-3818.68,-8722.52
779152819793169536,2020-03,1894.92,4644.42,3754.18,5806.89,-4802.21,-13524.73
779152819793169536,2020-04,3321.93,4311.49,6047.67,2817.7,2240.41,-11284.32
779152819793169536,2020-05,5113.07,4771.68,7539.39,3621.56,4259.22,-7025.1
779152819793169536,2020-06,4270.44,3205.19,7637.58,7992.31,710.52,-6314.58
779152819793169536,2020-07,4254.18,4628.45,1692.97,4362.49,-3043.79,-9358.37
779152819793169536,2020-08,3965.94,3331.19,2083.05,9347.3,-6629.5,-15987.87
779152819793169536,2020-09,2750.47,8009.18,3956.43,3086.44,-4388.72,-20376.59
779152819793169536,2020-10,4589.95,6944.13,5829.19,3586.78,-111.77,-20488.36
779152819793169536,2020-11,3131.6,3260.83,2968.32,4870.62,-2031.53,-22519.89
779152819793169536,2020-12,1311.91,7215.28,8552.68,3928.45,-1279.14,-23799.03
779411067201061504,2020-01,3963.62,1326.59,763.79,1147.47,2253.35,2253.35
779411067201061504,2020-02,1692.77,3849.84,446.9,1562.8,-3272.97,-1019.62
779411067201061504,2020-03,9.3,1867.14,1675.76,2138.69,-2320.77,-3340.39
779411067201061504,2020-04,704.07,1445.92,2790.51,1843.23,205.43,-3134.96
779411067201061504,2020-05,1665.21,2769.16,355.64,602.37,-1350.68,-4485.64
779411067201061504,2020-06,2293.4,1239.06,0,2023.78,-969.44,-5455.08
779411067201061504,2020-07,3204.91,3338.68,2085.84,1952.65,-0.58,-5455.66
779411067201061504,2020-08,1613.86,4924.5,3730.6,0,419.96,-5035.7
779411067201061504,2020-09,1273.99,1421.91,1538.32,1643.02,-252.62,-5288.32
779411067201061504,2020-10,1076.82,301.44,7382.05,2482.46,5674.97,386.65
779411067201061504,2020-11,1121.75,0,1862.25,4354.11,-1370.11,-983.46
779411067201061504,2020-12,1915.45,0,868.61,1555.57,1228.49,245.03
781796853262498176,2020-01,12701.64,4592.51,4849.1,2890.83,10067.4,10067.4
781796853262498176,2020-02,9535.5,4910.78,9855.47,4279.54,10200.65,20268.05
781796853262498176,2020-03,8182.62,4818.35,6012.09,2836,6540.36,26808.41
781796853262498176,2020-04,4812.99,1080.68,5914.64,7358.03,2288.92,29097.33
781796853262498176,2020-05,9743.41,2228.01,6520.5,3559.44,10476.46,39573.79
781796853262498176,2020-06,4380.94,8249.23,3861.41,2402.34,-2409.22,37164.57
781796853262498176,2020-07,4064.69,8473.96,3679.78,6152.62,-6882.11,30282.46
781796853262498176,2020-08,4810.8,4448.72,3532.87,4730.26,-835.31,29447.15
781796853262498176,2020-09,1947.82,1277.48,5758.51,3186.46,3242.39,32689.54
781796853262498176,2020-10,3120.1,1948.2,2204.06,4388.12,-1012.16,31677.38
781796853262498176,2020-11,3826.52,330.22,2213.48,9946.7,-4236.92,27440.46
781796853262498176,2020-12,2557,1380.96,3895.96,5417.43,-345.43,27095.03
782106914370577408,2020-01,1385.04,38.93,3186.03,4771.89,-239.75,-239.75
782106914370577408,2020-02,1353.82,3072.32,594.54,2766.16,-3890.12,-4129.87
782106914370577408,2020-03,3237.74,348.06,0,4769.14,-1879.46,-6009.33
782106914370577408,2020-04,1903.3,3772.45,0,0,-1869.15,-7878.48
782106914370577408,2020-05,783.91,2312.68,2924.91,0,1396.14,-6482.34
782106914370577408,2020-06,3849.39,684.15,1015.87,1109.22,3071.89,-3410.45
782106914370577408,2020-07,599.33,0,597.22,0,1196.55,-2213.9
782106914370577408,2020-08,0,5339.67,4860.16,5112.84,-5592.35,-7806.25
782106914370577408,2020-09,1792.49,4923.75,1990.97,0,-1140.29,-8946.54
782106914370577408,2020-10,4298.9,2118,1399.36,23.04,3557.22,-5389.32
782106914370577408,2020-11,21.32,2028.73,1213.19,2869.45,-3663.67,-9052.99
782106914370577408,2020-12,984.66,0,1676.45,83.68,2577.43,-6475.56
784062356160499968,2020-01,106.79,1781.86,291.99,4308.31,-5691.39,-5691.39
784062356160499968,2020-02,0,912.37,0,826.67,-1739.04,-7430.43
784062356160499968,2020-03,4483.67,0,82.79,1566.93,2999.53,-4430.9
784062356160499968,2020-04,2098.56,0,1655.27,1841.97,1911.86,-2519.04
784062356160499968,2020-05,1617.03,830.66,0,0,786.37,-1732.67
784062356160499968,2020-06,1198.63,0,2362.88,0,3561.51,1828.84
784062356160499968,2020-07,3221.86,2911.22,1671.52,2661.48,-679.32,1149.52
784062356160499968,2020-08,0,1496.25,5870.87,0,4374.62,5524.14
784062356160499968,2020-09,2903.33,358.61,264.41,2716.04,93.09,5617.23
784062356160499968,2020-10,1929.91,3846.16,362.58,1249.89,-2803.56,2813.67
784062356160499968,2020-11,0,695.64,1361.12,90.32,575.16,3388.83
784062356160499968,2020-12,3189.43,1910.21,0,3367.23,-2088.01,1300.82
784886030034259712,2020-01,6120.63,10703.92,8444.93,7633.47,-3771.83,-3771.83
784886030034259712,2020-02,5394.98,6895.51,2751.13,7873.57,-6622.97,-10394.8
784886030034259712,2020-03,3204,5924.97,5143.75,3042.74,-619.96,-11014.76
784886030034259712,2020-04,4256.64,3514.57,6737.98,5619.75,1860.3,-9154.46
784886030034259712,2020-05,3935.23,1732.02,6603.68,4222.68,4584.21,-4570.25
784886030034259712,2020-06,3183.78,3306.5,379.31,4245.63,-3989.04,-8559.29
784886030034259712,2020-07,2268.18,3994.36,5176.8,2536.2,914.42,-7644.87
784886030034259712,2020-08,2660.04,5473.76,4025.43,7231.32,-6019.61,-13664.48
784886030034259712,2020-09,2326.27,2853.5,7685.42,4442.51,2715.68,-10948.8
784886030034259712,2020-10,7607.29,4778.64,5834.74,2425.35,6238.04,-4710.76
784886030034259712,2020-11,6014.94,0,3769.27,5567.33,4216.88,-493.88
784886030034259712,2020-12,3386.04,6638.44,5587.48,6842.95,-4507.87,-5001.75
786586457854453120,2020-01,1521.63,0,1340.86,0,2862.49,2862.49
786586457854453120,2020-02,189,0,478.01,319.65,347.36,3209.85
786586457854453120,2020-03,196.56,350.46,0,0,-153.9,3055.95
786586457854453120,2020-04,506.48,0,0,239.29,267.19,3323.14
786586457854453120,2020-06,0,1735.44,0,0,-1735.44,1587.7
786586457854453120,2020-07,0,1236.62,860.43,0,-376.19,1211.51
786586457854453120,2020-09,0,359.62,853.54,0,493.92,1705.43
786586457854453120,2020-10,1846.45,0,531.7,1776.44,601.71,2307.14
786586457854453120,2020-11,1123.28,0,0,1228.25,-104.97,2202.17
786586457854453120,2020-12,260.52,0,223.51,750.53,-266.5,1935.67
786800567092027264,2020-01,4982.94,216.7,5947.28,3458.58,7254.94,7254.94
786800567092027264,2020-02,2158.05,0,0,3236.81,-1078.76,6176.18
786800567092027264,2020-03,2043.22,4175.18,808.12,0,-1323.84,4852.34
786800567092027264,2020-04,1716.76,1656.51,1255.47,3843.97,-2528.25,2324.09
786800567092027264,2020-05,1446.22,2468.87,1541.28,0,518.63,2842.72
786800567092027264,2020-06,938.23,1809.05,353.47,505.24,-1022.59,1820.13
786800567092027264,2020-07,886.6,2064.5,0,1655.44,-2833.34,-1013.21
786800567092027264,2020-08,785.72,4808.66,2304.46,6242.46,-7960.94,-8974.15
786800567092027264,2020-09,3046.32,0,4181.52,1894.47,5333.37,-3640.78
786800567092027264,2020-10,6779.34,309.19,400.27,2118.42,4752,1111.22
786800567092027264,2020-11,3598.8,2666.55,1399.18,810.18,1521.25,2632.47
786800567092027264,2020-12,2181.16,2459.98,1701.88,3343.87,-1920.81,711.66
787475164782158976,2020-01,1788.66,860.97,2652.55,3910.49,-330.25,-330.25
787475164782158976,2020-02,1350.84,2500.67,2901.01,7387.49,-5636.31,-5966.56
787475164782158976,2020-03,1172.21,2304.49,4688.24,6465.63,-2909.67,-8876.23
787475164782158976,2020-04,2265.68,3656.35,7461.81,2104.05,3967.09,-4909.14
787475164782158976,2020-05,2085.05,1454.35,5797.46,901.63,5526.53,617.39
787475164782158976,2020-06,3968.36,778.68,3156.87,782.73,5563.82,6181.21
787475164782158976,2020-07,2992.33,1711.41,3626.72,1914.78,2992.86,9174.07
787475164782158976,2020-08,6436.89,3969.7,4737.95,2485.7,4719.44,13893.51
787475164782158976,2020-09,1760.87,4539.03,529.26,2717.93,-4966.83,8926.68
787475164782158976,2020-10,2598.31,8577.18,1900.78,6228.65,-10306.74,-1380.06
787475164782158976,2020-11,2642.9,3482.56,4554.89,2843.35,871.88,-508.18
787475164782158976,2020-12,247.3,1946.44,5466.98,11020.91,-7253.07,-7761.25
787829574479583488,2020-01,5623.11,3161.27,451.42,521.2,2392.06,2392.06
787829574479583488,2020-02,5556.35,5140.92,2193.58,4081.33,-1472.32,919.74
787829574479583488,2020-03,1091.85,1112,1954.1,5873.73,-3939.78,-3020.04
787829574479583488,2020-04,5044.72,1399.62,6877.12,1967.5,8554.72,5534.68
787829574479583488,2020-05,831.67,6911.13,4195.61,5547.06,-7430.91,-1896.23
787829574479583488,2020-06,5790.53,8767.53,633.32,6212.5,-8556.18,-10452.41
787829574479583488,2020-07,6013.75,5005.08,4152.94,3351.78,1809.83,-8642.58
787829574479583488,2020-08,774.64,8207.1,3327.34,2982.33,-7087.45,-15730.03
787829574479583488,2020-09,3172.71,8527.84,9366.34,3891.78,119.43,-15610.6
787829574479583488,2020-10,10008.07,8797.94,5598.8,5997.75,811.18,-14799.42
787829574479583488,2020-11,1951.64,2937.87,2926.93,4715.67,-2774.97,-17574.39
787829574479583488,2020-12,5814.94,4273.33,977.48,3634.85,-1115.76,-18690.15
790408432252743680,2020-01,4018.36,2588.6,6493.88,1740.91,6182.73,6182.73
790408432252743680,2020-02,3638.02,10158.9,7785.43,5670.92,-4406.37,1776.36
790408432252743680,2020-03,5938.65,7650.91,3830.92,5518.8,-3400.14,-1623.78
790408432252743680,2020-04,5346.55,7764.98,161.72,1423.8,-3680.51,-5304.29
790408432252743680,2020-05,6352.27,2675.4,4207.3,7881.43,2.74,-5301.55
790408432252743680,2020-06,4578.34,6689.71,7692.47,4563.91,1017.19,-4284.36
790408432252743680,2020-07,3648.52,5172.37,1859.66,3479.98,-3144.17,-7428.53
790408432252743680,2020-08,2913.46,5738.5,5359.33,3786.26,-1251.97,-8680.5
790408432252743680,2020-09,3181.13,8192.68,2753.13,2563.78,-4822.2,-13502.7
790408432252743680,2020-10,0,3359.92,3024.74,2986.7,-3321.88,-16824.58
790408432252743680,2020-11,4758.24,5032.64,3892.42,1797.35,1820.67,-15003.91
790408432252743680,2020-12,6910.46,3411.6,4733.58,10444.78,-2212.34,-17216.25
792545925480858880,2020-01,3770,4978.72,3797.31,3232.28,-643.69,-643.69
792545925480858880,2020-02,2616.94,536.97,1953.16,7415.75,-3382.62,-4026.31
792545925480858880,2020-03,3329.4,2192.3,5402.72,3387.64,3152.18,-874.13
792545925480858880,2020-04,923.03,4351.03,1564.12,1385.8,-3249.68,-4123.81
792545925480858880,2020-05,2206.77,2750.23,410.12,3668.29,-3801.63,-7925.44
792545925480858880,2020-06,2781.28,2832.34,1205.65,6977.84,-5823.25,-13748.69
792545925480858880,2020-07,0,1702.4,2940.51,5103.5,-3865.39,-17614.08
792545925480858880,2020-08,3254.49,2516.58,2989.26,3554.24,172.93,-17441.15
792545925480858880,2020-09,6278.5,359.61,936.28,2550.01,4305.16,-13135.99
792545925480858880,2020-10,3651.04,3221.89,2144.28,2306.19,267.24,-12868.75
792545925480858880,2020-11,2839.41,1116.87,3311.44,4809.19,224.79,-12643.96
792545925480858880,2020-12,2538.06,4458.18,2653.96,5535.67,-4801.83,-17445.79
793483669592082304,2020-01,3588,3419.14,5167.96,505.24,4831.58,4831.58
793483669592082304,2020-02,1631.63,2271.87,4956.44,4570.18,-253.98,4577.6
793483669592082304,2020-03,4665.8,4847.38,1726.45,3297.93,-1753.06,2824.54
793483669592082304,2020-04,2757.98,8944.96,4185.64,6187.66,-8189,-5364.46
793483669592082304,2020-05,3584.57,4765.81,4779.63,709.86,2888.53,-2475.93
793483669592082304,2020-06,1145.3,1791.72,10435.8,5569.96,4219.42,1743.49
793483669592082304,2020-07,3036.83,0,4626.85,1841.7,5821.98,7565.47
793483669592082304,2020-08,4974.99,1122,2861.35,9172.88,-2458.54,5106.93
793483669592082304,2020-09,7835.54,1942.61,2204.34,6476.39,1620.88,6727.81
793483669592082304,2020-10,893.61,5880.77,2673.61,4052.61,-6366.16,361.65
793483669592082304,2020-11,3233.78,4719.51,3895.84,6859.62,-4449.51,-4087.86
793483669592082304,2020-12,3644.97,4897.86,4882.61,6601.45,-2971.73,-7059.59
794285174314797824,2020-01,9263.83,3543.65,3100.14,5332.04,3488.28,3488.28
794285174314797824,2020-02,9377.66,4077.2,4616.52,3114,6802.98,10291.26
794285174314797824,2020-03,5619.85,6193.64,4102.94,2256.83,1272.32,11563.58
794285174314797824,2020-04,3062.23,5975.31,6178.42,4343.98,-1078.64,10484.94
794285174314797824,2020-05,2524.22,3448,7863.2,4311.82,2627.6,13112.54
794285174314797824,2020-06,4408.13,4146.1,331.29,3058.72,-2465.4,10647.14
794285174314797824,2020-07,3396.05,8750.76,7470.51,4071.11,-1955.31,8691.83
794285174314797824,2020-08,4740.17,3852.04,7419.32,3595.65,4711.8,13403.63
794285174314797824,2020-09,5868.93,4415.22,4404.83,3571.64,2286.9,15690.53
794285174314797824,2020-10,4793.23,6082.32,3838.81,8624.11,-6074.39,9616.14
794285174314797824,2020-11,5456.18,3706.34,2278.53,1590.65,2437.72,12053.86
794285174314797824,2020-12,5323.9,9470.95,1516.01,8089.35,-10720.39,1333.47
794453141975416960,2020-01,7925.93,1744.16,6567.68,1579.34,11170.11,11170.11
794453141975416960,2020-02,6394.81,3322.55,507.99,4745.6,-1165.35,10004.76
794453141975416960,2020-03,2575.44,7744.95,2259.67,3798.13,-6707.97,3296.79
794453141975416960,2020-04,3655.24,5570.84,982.9,3864.68,-4797.38,-1500.59
794453141975416960,2020-05,2767.69,2509.87,4020.81,2373.18,1905.45,404.86
794453141975416960,2020-06,2392.67,4365.33,7023.59,3248.87,1802.06,2206.92
794453141975416960,2020-07,4673.78,4174.39,3937.88,6741.47,-2304.2,-97.28
794453141975416960,2020-08,2103.47,2056.98,1447.76,5441.33,-3947.08,-4044.36
794453141975416960,2020-09,4474.33,1702.45,1593.15,3511.4,853.63,-3190.73
794453141975416960,2020-10,6423.82,3420.56,1920.99,3519.17,1405.08,-1785.65
794453141975416960,2020-11,7028.38,4727.36,1818.07,3669.57,449.52,-1336.13
794453141975416960,2020-12,2234.37,5021.85,8180.45,5351.41,41.56,-1294.57
794761416816497536,2020-01,3089.27,4161.99,667.08,0,-405.64,-405.64
794761416816497536,2020-02,3780.52,1388.91,2946.37,3912.18,1425.8,1020.16
794761416816497536,2020-03,3474.03,5474.87,2261.61,1744.53,-1483.76,-463.6
794761416816497536,2020-04,8661.09,2688.28,6855.8,1474.67,11353.94,10890.34
794761416816497536,2020-05,3301.48,6474.61,2141.2,3748.19,-4780.12,6110.22
794761416816497536,2020-06,1229.52,3212.67,4425.39,1336.1,1106.14,7216.36
794761416816497536,2020-07,3188.71,5686.95,7133.65,2598.61,2036.8,9253.16
794761416816497536,2020-08,175.02,4020.41,6794.71,1198.05,1751.27,11004.43
794761416816497536,2020-09,579.47,1920.49,2707.79,5511.85,-4145.08,6859.35
794761416816497536,2020-10,3496.63,0,5355.67,3099.14,5753.16,12612.51
794761416816497536,2020-11,5466.03,2107.19,5183.23,8030.86,511.21,13123.72
794761416816497536,2020-12,1695.11,7395.49,5424.81,7102.35,-7377.92,5745.8
796748300082290944,2020-01,303.15,1412.34,2309.4,514.25,685.96,685.96
796748300082290944,2020-02,841.53,1220.74,998.11,2274.18,-1655.28,-969.32
796748300082290944,2020-03,4235.42,5373.37,4586.54,3517.15,-68.56,-1037.88
796748300082290944,2020-04,1449.55,3558.17,3026.46,1105.29,-187.45,-1225.33
796748300082290944,2020-05,5416.57,3536.47,0,3192.92,-1312.82,-2538.15
796748300082290944,2020-06,5890.11,0,0,0,5890.11,3351.96
796748300082290944,2020-07,3001.22,658.94,3424.66,4205.58,1561.36,4913.32
796748300082290944,2020-08,2165.24,5340.69,2760.98,2385.32,-2799.79,2113.53
796748300082290944,2020-09,916.33,5268.94,838,4886.87,-8401.48,-6287.95
796748300082290944,2020-10,1011.4,1971.49,3268.98,587.61,1721.28,-4566.67
796748300082290944,2020-11,0,4383.98,2227.27,2072,-4228.71,-8795.38
796748300082290944,2020-12,3335.32,0,3330.31,1325.45,5340.18,-3455.2
797280182025766272,2020-01,422.85,1993.59,1422.27,1573.74,-1722.21,-1722.21
797280182025766272,2020-02,312.3,403.82,1237.61,452.08,694.01,-1028.2
797280182025766272,2020-03,4158.43,1204.48,2663.63,0,5617.58,4589.38
797280182025766272,2020-04,409.45,4831.37,1593.86,628.74,-3456.8,1132.58
797280182025766272,2020-05,1098.74,3673.66,2719.21,0,144.29,1276.87
797280182025766272,2020-06,0,1925.67,1590.63,0,-335.04,941.83
797280182025766272,2020-07,1709.08,2305.38,5214.28,1135.81,3482.17,4424
797280182025766272,2020-08,1915.35,3024.18,4281.7,1176.96,1995.91,6419.91
797280182025766272,2020-09,1988.83,324.69,3158.72,1684.43,3138.43,9558.34
797280182025766272,2020-10,312.59,2441.45,4768.93,3357.59,-717.52,8840.82
797280182025766272,2020-11,5116.7,0,1025.63,902.58,5239.75,14080.57
797280182025766272,2020-12,777.77,4.88,2816.11,1080.47,2508.53,16589.1
797972434461558656,2020-01,947.09,1863.67,4540.33,6573.83,-2950.08,-2950.08
797972434461558656,2020-02,4399.04,1485.15,400.78,2567.72,746.95,-2203.13
797972434461558656,2020-03,3409.26,1812.63,1793.33,667.33,2722.63,519.5
797972434461558656,2020-04,2038.01,3260.32,0,0,-1222.31,-702.81
797972434461558656,2020-05,0,566.6,3430.93,1097.53,1766.8,1063.99
797972434461558656,2020-06,3579.46,5041.18,3743.52,3778.23,-1496.43,-432.44
797972434461558656,2020-07,2242.19,368.66,1377.09,2343.74,906.88,474.44
797972434461558656,2020-08,2236.98,3467.23,3000.68,1560.53,209.9,684.34
797972434461558656,2020-09,2350.05,0,0,585.61,1764.44,2448.78
797972434461558656,2020-10,0,479.51,2443.17,2000.06,-36.4,2412.38
797972434461558656,2020-11,0,495.07,1722.15,0,1227.08,3639.46
797972434461558656,2020-12,0,2299.48,0,3422.27,-5721.75,-2082.29
798047348606268160,2020-01,3909.89,3037.6,1607.08,1533.18,946.19,946.19
798047348606268160,2020-02,5801.49,4652.4,1018.04,4090.19,-1923.06,-976.87
798047348606268160,2020-03,1609.63,0,341.05,245.69,1704.99,728.12
798047348606268160,2020-04,3652.03,2598.96,6230.04,3062.7,4220.41,4948.53
798047348606268160,2020-05,302.46,3211.19,5802.5,0,2893.77,7842.3
798047348606268160,2020-06,2226.29,4697.76,3317.64,2492.54,-1646.37,6195.93
798047348606268160,2020-07,3692.21,6323.29,4241.4,8422.81,-6812.49,-616.56
798047348606268160,2020-08,1403.42,761.58,4470.64,3807.77,1304.71,688.15
798047348606268160,2020-09,1243.06,6180.71,2499.91,1150.07,-3587.81,-2899.66
798047348606268160,2020-10,2721.9,1211.68,1851.09,4665.03,-1303.72,-4203.38
798047348606268160,2020-11,6370.64,8080.43,3031.07,1140.4,180.88,-4022.5
798047348606268160,2020-12,3391.23,7581.7,4737.22,752,-205.25,-4227.75
799163625661275904,2020-01,4064.14,3792.83,2222.73,4608.85,-2114.81,-2114.81
799163625661275904,2020-02,4481.68,4317.74,7962.02,5818.28,2307.68,192.87
799163625661275904,2020-03,3702.05,3600.26,3167.35,8313.92,-5044.78,-4851.91
799163625661275904,2020-04,2643.15,1964.68,1721.41,4263.5,-1863.62,-6715.53
799163625661275904,2020-05,6061.57,2244.12,4924.29,6435.31,2306.43,-4409.1
799163625661275904,2020-06,7337.39,5579.83,6187.22,5157.98,2786.8,-1622.3
799163625661275904,2020-07,4383.74,7783.12,3946.38,9205.98,-8658.98,-10281.28
799163625661275904,2020-08,6229.83,9579.93,7355.05,2503.23,1501.72,-8779.56
799163625661275904,2020-09,5685.78,3441.22,5786.44,5440.68,2590.32,-6189.24
799163625661275904,2020-10,168.58,1195.6,5028.33,2211.69,1789.62,-4399.62
799163625661275904,2020-11,4386.86,3184.53,8166.82,2835.27,6533.88,2134.26
799163625661275904,2020-12,4265.14,4342.35,5009.28,8683.57,-3751.5,-1617.24
800080602080922624,2020-01,2160.04,3416.35,3228.6,2827.05,-854.76,-854.76
800080602080922624,2020-02,5556.53,4163.48,4920.39,2416.96,3896.48,3041.72
800080602080922624,2020-03,7278.51,2246.88,4686.53,7347.23,2370.93,5412.65
800080602080922624,2020-04,2157.37,3027.6,2832.56,6382.62,-4420.29,992.36
800080602080922624,2020-05,2462.32,5287.4,4084.2,2029.86,-770.74,221.62
800080602080922624,2020-06,5636.68,1660.26,2121.5,1307.92,4790,5011.62
800080602080922624,2020-07,2164.72,3620.51,2281.36,2859.01,-2033.44,2978.18
800080602080922624,2020-08,3834.19,3041.01,3050.48,1055.07,2788.59,5766.77
800080602080922624,2020-09,1478.41,1014.4,2681.82,2735.72,410.11,6176.88
800080602080922624,2020-10,1546.33,3110.82,1408.6,107.1,-262.99,5913.89
800080602080922624,2020-11,5287.29,3138.2,3082.37,2995.78,2235.68,8149.57
800080602080922624,2020-12,6031.62,2441.63,4611.11,3460.58,4740.52,12890.09
800525709893971968,2020-01,1963.67,1691.74,4484.04,1026.93,3729.04,3729.04
800525709893971968,2020-02,1081.72,1941.78,1856.93,4350.46,-3353.59,375.45
800525709893971968,2020-03,3477.69,28.53,0,1942.34,1506.82,1882.27
800525709893971968,2020-04,1372.2,3778.12,5307.54,4548.13,-1646.51,235.76
800525709893971968,2020-05,1623.91,6191.16,5838.37,5015.13,-3744.01,-3508.25
800525709893971968,2020-06,3315.11,4305.79,2058.02,4514.41,-3447.07,-6955.32
800525709893971968,2020-07,5916.89,3228.08,7524.6,4166.28,6047.13,-908.19
800525709893971968,2020-08,4295.45,3790.48,3402.2,3717.77,189.4,-718.79
800525709893971968,2020-09,3236.25,3638.55,2262.18,1506.13,353.75,-365.04
800525709893971968,2020-10,5066.09,1441.51,3286.67,6491.28,419.97,54.93
800525709893971968,2020-11,4276.24,5369.76,3347.99,856.48,1397.99,1452.92
800525709893971968,2020-12,3893.39,2083.9,3282.82,2165.24,2927.07,4379.99
800544032000933632,2020-01,3375.7,260.92,3898.61,2987.99,4025.4,4025.4
800544032000933632,2020-02,2963.08,6665.21,4678.43,803.63,172.67,4198.07
800544032000933632,2020-03,3014.74,4017.1,1433.64,1183.67,-752.39,3445.68
800544032000933632,2020-04,6572.69,9329.68,749.16,5152.71,-7160.54,-3714.86
800544032000933632,2020-05,3345.72,3990.37,2996.51,7068.87,-4717.01,-8431.87
800544032000933632,2020-06,5496.6,2953.23,7924.26,3921.36,6546.27,-1885.6
800544032000933632,2020-07,1304.84,4822.55,1628.17,6908.17,-8797.71,-10683.31
800544032000933632,2020-08,2229.32,3296.42,962.32,2836.57,-2941.35,-13624.66
800544032000933632,2020-09,3874.93,4041.08,1189.06,345.01,677.9,-12946.76
800544032000933632,2020-10,5565.01,5708.01,789.12,83.9,562.22,-12384.54
800544032000933632,2020-11,4561.21,739.24,3075.42,4654.56,2242.83,-10141.71
800544032000933632,2020-12,1577.83,7996.27,6272.3,2766.97,-2913.11,-13054.82
801746948999264640,2020-01,759.8,8099.99,1475.01,0,-5865.18,-5865.18
801746948999264640,2020-02,4901.39,815,2938.73,2568.08,4457.04,-1408.14
801746948999264640,2020-03,4305.46,1607.37,2878.59,2907.59,2669.09,1260.95
801746948999264640,2020-04,464.93,2990.09,3785.02,4347.82,-3087.96,-1827.01
801746948999264640,2020-05,788.33,3038.32,2658.36,1321.79,-913.42,-2740.43
801746948999264640,2020-06,1477.67,3516.6,2736.84,3901.18,-3203.27,-5943.7
801746948999264640,2020-07,1896.55,4827.83,4350.48,1039.22,379.98,-5563.72
801746948999264640,2020-08,5633.28,2299.35,1833.51,1414.38,3753.06,-1810.66
801746948999264640,2020-09,1309.88,9771.64,3312.87,0,-5148.89,-6959.55
801746948999264640,2020-10,465.55,4705.7,6326.03,8506.05,-6420.17,-13379.72
801746948999264640,2020-11,1812.58,3221.15,752.35,4106.36,-4762.58,-18142.3
801746948999264640,2020-12,2344.95,0,0,3490.27,-1145.32,-19287.62
804514320464360832,2020-01,564.81,1960.69,0,1931.99,-3327.87,-3327.87
804514320464360832,2020-02,1131.88,777.69,1491.81,0,1846,-1481.87
804514320464360832,2020-04,38.58,380.73,1231.96,1039.19,-149.38,-1631.25
804514320464360832,2020-05,325.02,183.2,0,1958.69,-1816.87,-3448.12
804514320464360832,2020-06,2342.89,2517.07,1592.69,911.66,506.85,-2941.27
804514320464360832,2020-10,1571.44,0,738.74,0,2310.18,-631.09
804514320464360832,2020-12,1025,1618.92,730.81,2293.67,-2156.78,-2787.87
805828309851122816,2020-01,6559.1,1959.59,1957.2,3763.33,2793.38,2793.38
805828309851122816,2020-02,0,2371.76,3326.27,0,954.51,3747.89
805828309851122816,2020-03,2904.56,6813.5,5851.57,5159.02,-3216.39,531.5
805828309851122816,2020-04,5103.13,5731.15,5897.84,1079,4190.82,4722.32
805828309851122816,2020-05,3915.86,4121.48,3017.13,2738.66,72.85,4795.17
805828309851122816,2020-06,1911.86,2214.82,3726.67,519.76,2903.95,7699.12
805828309851122816,2020-07,1837.82,6776.87,1299.84,4335.29,-7974.5,-275.38
805828309851122816,2020-08,1947.87,5028.74,611.71,7118.25,-9587.41,-9862.79
805828309851122816,2020-09,4529.3,3927.87,5966.13,5374.56,1193,-8669.79
805828309851122816,2020-10,3631.84,7852.39,1771.54,3136.93,-5585.94,-14255.73
805828309851122816,2020-11,6812.28,2991.23,5024.29,3753.74,5091.6,-9164.13
805828309851122816,2020-12,4166.46,1381.87,3101.85,1436.73,4449.71,-4714.42
806889141407536512,2020-01,0,826.75,0,1904.76,-2731.51,-2731.51
806889141407536512,2020-03,5335.78,320.15,1488.5,0,6504.13,3772.62
806889141407536512,2020-04,1691.34,1389.06,0,2138.38,-1836.1,1936.52
806889141407536512,2020-07,0,1315.94,599.63,1288.42,-2004.73,-68.21
806889141407536512,2020-08,0,3036.09,2382.66,0,-653.43,-721.64
806889141407536512,2020-09,804.52,0,917.14,795.75,925.91,204.27
806889141407536512,2020-10,2772.86,1658.08,0,827.13,287.65,491.92
806889141407536512,2020-11,894.71,0,0,0,894.71,1386.63
806889141407536512,2020-12,233.13,2937.48,2798.81,349.76,-255.3,1131.33
807160825150759808,2020-01,1714,2948.83,4915.72,1248.43,2432.46,2432.46
807160825150759808,2020-02,7724.94,4302.57,6788.48,2676.07,7534.78,9967.24
807160825150759808,2020-03,822.03,1369.06,7489.74,6337.9,604.81,10572.05
807160825150759808,2020-04,2835.92,4924.12,8545.68,0,6457.48,17029.53
807160825150759808,2020-05,6747.64,7058.6,2402.45,2730.6,-639.11,16390.42
807160825150759808,2020-06,5446.53,3343.12,5807.59,2396.45,5514.55,21904.97
807160825150759808,2020-07,344.3,2913.34,8525.28,3749.22,2207.02,24111.99
807160825150759808,2020-08,6343.97,1510.42,3696.92,4214.96,4315.51,28427.5
807160825150759808,2020-09,6540.57,1371.49,2990.15,5152.07,3007.16,31434.66
807160825150759808,2020-10,5868.08,1356.23,1562.44,3854.93,2219.36,33654.02
807160825150759808,2020-11,4217,4232.38,6474.44,2696.26,3762.8,37416.82
807160825150759808,2020-12,5087.73,6872.11,3454.65,3490.55,-1820.28,35596.54
807178531319893504,2020-01,3117.62,662.04,7088.12,5103.77,4439.93,4439.93
807178531319893504,2020-02,1272.98,5184.17,4731.94,2059.56,-1238.81,3201.12
807178531319893504,2020-03,4370.83,3467.57,6494.14,5120.52,2276.88,5478
807178531319893504,2020-04,3058.74,7934.89,5264.02,3908.95,-3521.08,1956.92
807178531319893504,2020-05,4431.18,7009.48,1238.41,4113.54,-5453.43,-3496.51
807178531319893504,2020-06,2846.8,9834.12,4861.82,3744.57,-5870.07,-9366.58
807178531319893504,2020-07,2959.87,5479.69,4624.22,2660.84,-556.44,-9923.02
807178531319893504,2020-08,7603.55,6887.79,11541.82,10604.93,1652.65,-8270.37
807178531319893504,2020-09,96.38,4745.58,4050.66,6068.1,-6666.64,-14937.01
807178531319893504,2020-10,6610.96,3917.79,5362.79,6520.13,1535.83,-13401.18
807178531319893504,2020-11,5528.44,2142.65,7741.66,8587.18,2540.27,-10860.91
807178531319893504,2020-12,3631.3,6479.37,1812.2,5097.96,-6133.83,-16994.74
807327583117044992,2020-01,5066.76,585.36,0,1168.28,3313.12,3313.12
807327583117044992,2020-02,917.12,0,1212.71,468.38,1661.45,4974.57
807327583117044992,2020-03,0,330.91,346.34,2692.84,-2677.41,2297.16
807327583117044992,2020-04,3371.04,4477.49,0,2197.09,-3303.54,-1006.38
807327583117044992,2020-05,0,1008.25,1517.04,1311.49,-802.7,-1809.08
807327583117044992,2020-06,1172.12,1052.05,0,1498.38,-1378.31,-3187.39
807327583117044992,2020-07,3003.04,0,1633.28,1242.74,3393.58,206.19
807327583117044992,2020-08,4327.59,0,1869.64,0,6197.23,6403.42
807327583117044992,2020-09,2838.37,0,489.7,5457.27,-2129.2,4274.22
807327583117044992,2020-10,3297.57,2261.51,1265.14,1608.76,692.44,4966.66
807327583117044992,2020-11,0,2242.87,1494.71,0,-748.16,4218.5
807327583117044992,2020-12,2512.51,4163.85,3787.59,4918.05,-2781.8,1436.7
807558889925166976,2020-01,4424.31,4347.09,1570.92,1378.34,269.8,269.8
807558889925166976,2020-02,1030.01,7091.37,1709,2951.06,-7303.42,-7033.62
807558889925166976,2020-03,1914.4,4769.62,9032.64,2436.61,3740.81,-3292.81
807558889925166976,2020-04,4105.38,577.22,1268.42,3693.23,1103.35,-2189.46
807558889925166976,2020-05,1484.47,3297.36,3524.34,3560.48,-1849.03,-4038.49
807558889925166976,2020-06,3492.25,2944.72,2208.81,3209.22,-452.88,-4491.37
807558889925166976,2020-07,675.83,9607.33,1487.14,3489.42,-10933.78,-15425.15
807558889925166976,2020-08,1401.08,4966.92,1667.31,1292.85,-3191.38,-18616.53
807558889925166976,2020-09,8059.09,1781.16,9954.76,1961.3,14271.39,-4345.14
807558889925166976,2020-10,4079.7,5144.84,5515.9,0,4450.76,105.62
807558889925166976,2020-11,4475.59,5449.88,2719.68,1314.48,430.91,536.53
807558889925166976,2020-12,1210.91,4490.9,3293.47,1839.21,-1825.73,-1289.2
807763776051749248,2020-04,862.92,0,0,0,862.92,862.92
808015811424624640,2020-01,1545.82,1666.88,621.24,332.79,167.39,167.39
808015811424624640,2020-02,1637.83,2986.66,0,0,-1348.83,-1181.44
808015811424624640,2020-03,614.52,0,0,0,614.52,-566.92
808015811424624640,2020-05,1008.13,0,0,0,1008.13,441.21
808015811424624640,2020-06,0,677.14,1472.15,0,795.01,1236.22
808015811424624640,2020-07,0,1009.91,192.93,0,-816.98,419.24
808015811424624640,2020-09,443.03,1894.04,941.82,0,-509.19,-89.95
808015811424624640,2020-10,0,1515.65,0,0,-1515.65,-1605.6
808015811424624640,2020-11,0,3478.72,0,0,-3478.72,-5084.32
808015811424624640,2020-12,0,1670.48,0,0,-1670.48,-6754.8
808498324844720896,2020-01,1390.01,1468.7,221.76,2797.33,-2654.26,-2654.26
808498324844720896,2020-02,1259.99,897.62,0,3417.14,-3054.77,-5709.03
808498324844720896,2020-03,2094.12,5285.43,4198.6,2343.56,-1336.27,-7045.3
808498324844720896,2020-04,1322.75,0,1704.51,1741.38,1285.88,-5759.42
808498324844720896,2020-05,4434.99,3225.25,1808.26,3799.13,-781.13,-6540.55
808498324844720896,2020-06,3743.84,2758.66,832.92,1898.47,-80.37,-6620.92
808498324844720896,2020-07,4821.07,4358.54,5069.63,2368.1,3164.06,-3456.86
808498324844720896,2020-08,4827.38,659.8,2086.81,4235.39,2019,-1437.86
808498324844720896,2020-09,6734.96,0,1327.29,3393.13,4669.12,3231.26
808498324844720896,2020-10,0,2187.28,3278.11,2666.95,-1576.12,1655.14
808498324844720896,2020-11,2405.48,1452.67,412.36,2703.34,-1338.17,316.97
808498324844720896,2020-12,2615.93,1989.42,2083.11,0,2709.62,3026.59
808651712361454720,2020-01,3063.07,3778.95,1166.17,1267.36,-817.07,-817.07
808651712361454720,2020-02,2485.09,3716.77,1662.12,555.14,-124.7,-941.77
808651712361454720,2020-03,3072,1932.6,2483.56,3547.03,75.93,-865.84
808651712361454720,2020-04,1029.94,607.99,2691.36,716.7,2396.61,1530.77
808651712361454720,2020-05,529.33,3997.29,2829.83,2354.96,-2993.09,-1462.32
808651712361454720,2020-06,3061.13,5573.44,2103.3,0,-409.01,-1871.33
808651712361454720,2020-07,0,962.01,4428.65,3106.27,360.37,-1510.96
808651712361454720,2020-08,5347.98,1564.92,222.91,3108.25,897.72,-613.24
808651712361454720,2020-09,630.14,577.99,1148.86,0,1201.01,587.77
808651712361454720,2020-10,2448.55,3069.24,1056.46,359.22,76.55,664.32
808651712361454720,2020-11,2209.1,3473.71,1097.57,2224.91,-2391.95,-1727.63
808651712361454720,2020-12,1743.98,1171.08,1746.84,1249.69,1070.05,-657.58
809265085214191232,2020-01,3906.29,2079.68,792.97,4591.86,-1972.28,-1972.28
809265085214191232,2020-02,4310.31,5210.92,0,1077.22,-1977.83,-3950.11
809265085214191232,2020-03,5394.44,1869.09,2549.99,7702.94,-1627.6,-5577.71
809265085214191232,2020-04,5919.92,4240.7,1723.05,5374.7,-1972.43,-7550.14
809265085214191232,2020-05,1616.27,1036.8,1643.53,1507.36,715.64,-6834.5
809265085214191232,2020-06,1623.03,3948.26,117.84,6970.04,-9177.43,-16011.93
809265085214191232,2020-07,3479.52,2526.91,2053.14,3091.93,-86.18,-16098.11
809265085214191232,2020-08,331.71,2953,3149.22,9932.99,-9405.06,-25503.17
809265085214191232,2020-09,2714.94,1599.59,749.48,4733.71,-2868.88,-28372.05
809265085214191232,2020-10,6507.78,1030.87,2797.03,3916.53,4357.41,-24014.64
809265085214191232,2020-11,1989.84,3143.59,5314.2,2610.29,1550.16,-22464.48
809265085214191232,2020-12,5006.13,5059.56,3129.54,1153.53,1922.58,-20541.9
810376401983708672,2020-01,1415.87,0,1084.55,3445.01,-944.59,-944.59
810376401983708672,2020-02,3330.02,0,0,3084.62,245.4,-699.19
810376401983708672,2020-03,3324.21,4468.01,157.76,911.71,-1897.75,-2596.94
810376401983708672,2020-04,1942.3,1919.21,1724.16,0,1747.25,-849.69
810376401983708672,2020-05,113.45,3083.06,1542.37,1790,-3217.24,-4066.93
810376401983708672,2020-06,3166.52,0,2247.32,0,5413.84,1346.91
810376401983708672,2020-07,1656.02,1709.51,1383.68,1146.48,183.71,1530.62
810376401983708672,2020-08,0,1820.63,1328.19,122.34,-614.78,915.84
810376401983708672,2020-09,0,1515.91,3610.78,1640.23,454.64,1370.48
810376401983708672,2020-10,1671.29,2298.44,538.13,0,-89.02,1281.46
810376401983708672,2020-11,2237.52,4670.96,2553.78,308.34,-188,1093.46
810376401983708672,2020-12,1393.86,1385.16,2419.04,623.99,1803.75,2897.21
810591653002068864,2020-01,3562.45,1871.78,3689.44,1999.53,3380.58,3380.58
810591653002068864,2020-02,0,2150.08,3874.77,1009.75,714.94,4095.52
810591653002068864,2020-03,2197.46,4641.15,2341.77,2424.53,-2526.45,1569.07
810591653002068864,2020-04,2519.93,835.1,5069.09,4258.77,2495.15,4064.22
810591653002068864,2020-05,3540.64,4567.5,4909.01,2272.98,1609.17,5673.39
810591653002068864,2020-06,2941.83,5045.36,2574.58,3434.82,-2963.77,2709.62
810591653002068864,2020-07,3837.21,4456.74,1563.86,4011.34,-3067.01,-357.39
810591653002068864,2020-08,0,2817.9,5349.41,390.73,2140.78,1783.39
810591653002068864,2020-09,3526.23,1363.44,1049.21,0,3212,4995.39
810591653002068864,2020-10,598.25,1652.95,3157.21,2642.45,-539.94,4455.45
810591653002068864,2020-11,747.89,5354.7,4704.82,3813.13,-3715.12,740.33
810591653002068864,2020-12,4405.7,2693.36,3571.45,2972.48,2311.31,3051.64
811254662953508096,2020-01,3875.95,3102.64,3613.65,1680.77,2706.19,2706.19
811254662953508096,2020-02,1226.24,0,1489.63,2657.09,58.78,2764.97
811254662953508096,2020-03,3015.52,1254.18,0,2579.72,-818.38,1946.59
811254662953508096,2020-04,3925.28,1991.52,750.58,3874.75,-1190.41,756.18
811254662953508096,2020-05,604,0,2363.82,647.09,2320.73,3076.91
811254662953508096,2020-06,1173.09,0,1094.07,2951.21,-684.05,2392.86
811254662953508096,2020-07,1655.08,1706.18,7234.82,3578.78,3604.94,5997.8
811254662953508096,2020-08,2012.69,469.62,1919.2,0,3462.27,9460.07
811254662953508096,2020-09,3221.24,2745.63,0,5137.62,-4662.01,4798.06
811254662953508096,2020-10,4852.39,4130.03,1799.18,2566.89,-45.35,4752.71
811254662953508096,2020-11,0,259.21,1615.83,0,1356.62,6109.33
811254662953508096,2020-12,6172.82,3135.3,1210.04,2597.7,1649.86,7759.19
812335774122482560,2020-03,0,1363.45,1398.49,697.73,-662.69,-662.69
812335774122482560,2020-05,0,770.65,1217.73,1970.39,-1523.31,-2186
812335774122482560,2020-07,510.16,1329.07,1990.26,0,1171.35,-1014.65
812335774122482560,2020-08,944.48,0,0,0,944.48,-70.17
812335774122482560,2020-09,1677.12,0,1139.18,0,2816.3,2746.13
812858695838049408,2020-01,1933.3,0,0,0,1933.3,1933.3
812858695838049408,2020-06,0,119.05,1039.47,0,920.42,2853.72
812858695838049408,2020-07,0,975.19,0,0,-975.19,1878.53
814267770380684800,2020-04,1675.28,0,0,0,1675.28,1675.28
814267770380684800,2020-06,0,401.82,0,0,-401.82,1273.46
814542022729201408,2020-03,0,1337.66,0,0,-1337.66,-1337.66
814542022729201408,2020-04,1196.87,0,0,0,1196.87,-140.79
814542022729201408,2020-05,0,460.6,0,227.16,-687.76,-828.55
814542022729201408,2020-11,1750.85,0,0,0,1750.85,922.3
817237184265784448,2020-01,502,224.52,0,0,277.48,277.48
817237184265784448,2020-02,1643.28,658.78,0,1168.33,-183.83,93.65
817237184265784448,2020-04,0,504.58,0,0,-504.58,-410.93
817237184265784448,2020-05,297.87,3339.69,1541.11,1979.92,-3480.63,-3891.56
817237184265784448,2020-06,1872.41,0,1608.29,0,3480.7,-410.86
817237184265784448,2020-07,457.19,837.87,2094.53,757.02,956.83,545.97
817237184265784448,2020-08,980.11,4427.37,1664.69,790.53,-2573.1,-2027.13
817237184265784448,2020-10,1696.87,2102.57,1910.41,2437.38,-932.67,-2959.8
817237184265784448,2020-11,2918.75,0,59.87,4303.5,-1324.88,-4284.68
817237184265784448,2020-12,3870.07,0,0,2333.87,1536.2,-2748.48
817284815175444992,2020-01,433.78,1212.25,1168.87,1900.67,-1510.27,-1510.27
817284815175444992,2020-02,1828.53,3056.53,1951.92,0,723.92,-786.35
817284815175444992,2020-03,1781.19,1581.09,541.43,77.86,663.67,-122.68
817284815175444992,2020-04,1761.23,1008.47,0,0,752.76,630.08
817284815175444992,2020-05,1989.57,728.65,2042.13,210.45,3092.6,3722.68
817284815175444992,2020-06,3810.16,2946.99,1872.98,2341.97,394.18,4116.86
817284815175444992,2020-07,1549.44,1749.67,0,0,-200.23,3916.63
817284815175444992,2020-08,0,249.91,359.22,461.65,-352.34,3564.29
817284815175444992,2020-09,1502.21,0,1684.23,2981.23,205.21,3769.5
817284815175444992,2020-10,1908.56,130.12,2359.62,2233.81,1904.25,5673.75
817284815175444992,2020-11,1982.92,0,0,0,1982.92,7656.67
817284815175444992,2020-12,90.9,1060.46,0,0,-969.56,6687.11
817759855268692736,2020-01,1382.37,808.38,2910.21,3767.48,-283.28,-283.28
817759855268692736,2020-02,1920.87,1809.87,2163.71,7510.65,-5235.94,-5519.22
817759855268692736,2020-03,4335.1,0,3296.48,2899.3,4732.28,-786.94
817759855268692736,2020-04,4738.91,8520.92,1220.11,5363.26,-7925.16,-8712.1
817759855268692736,2020-05,6076.87,1930.69,3408.65,8834.59,-1279.76,-9991.86
817759855268692736,2020-06,4339.81,0,2402.76,8059.2,-1316.63,-11308.49
817759855268692736,2020-07,5311.71,6151.89,4158.11,7341.81,-4023.88,-15332.37
817759855268692736,2020-08,979.99,10782.87,2983.32,1584.07,-8403.63,-23736
817759855268692736,2020-09,3329.02,1716.22,6118.73,2637.64,5093.89,-18642.11
817759855268692736,2020-10,1033.43,4170.97,4174.89,2343.51,-1306.16,-19948.27
817759855268692736,2020-11,5306.3,4426.58,6927.71,2900.76,4906.67,-15041.6
817759855268692736,2020-12,3336.83,1570.25,863.11,4681.44,-2051.75,-17093.35
818751506247356928,2020-03,0,3084.7,0,0,-3084.7,-3084.7
818751506247356928,2020-04,0,1195.86,808.89,0,-386.97,-3471.67
818751506247356928,2020-05,1563.56,0,0,0,1563.56,-1908.11
818751506247356928,2020-07,1707.41,1290.25,0,0,417.16,-1490.95
818751506247356928,2020-12,0,312.3,0,3304.04,-3616.34,-5107.29
820063086775679104,2020-01,2067.59,3998.13,6207.77,2965.39,1311.84,1311.84
820063086775679104,2020-02,2661.18,2307.83,142.8,5399.64,-4903.49,-3591.65
820063086775679104,2020-03,4757.38,2191.53,6174.81,3506.12,5234.54,1642.89
820063086775679104,2020-04,2990.74,564.28,1699.55,2889.64,1236.37,2879.26
820063086775679104,2020-05,0,5062.25,4070.08,3241.49,-4233.66,-1354.4
820063086775679104,2020-06,4594.3,4314.76,4514.16,4060.01,733.69,-620.71
820063086775679104,2020-07,3889.81,2879.99,2655.5,4832.3,-1166.98,-1787.69
820063086775679104,2020-08,2288.11,4239.24,803.33,1675.6,-2823.4,-4611.09
820063086775679104,2020-09,1498.63,3364.95,4685.91,1470.16,1349.43,-3261.66
820063086775679104,2020-10,287.73,884.38,5054.89,3278.33,1179.91,-2081.75
820063086775679104,2020-11,5034.35,0,262.3,852.77,4443.88,2362.13
820063086775679104,2020-12,3042.47,3599.63,3734.98,3554.1,-376.28,1985.85
822182566504342656,2020-01,1505.05,0,0,0,1505.05,1505.05
822182566504342656,2020-02,1782.16,2676.52,799.7,0,-94.66,1410.39
822182566504342656,2020-06,1420.29,0,0,0,1420.29,2830.68
822182566504342656,2020-08,1066.03,1208.06,2994.82,514.6,2338.19,5168.87
822182566504342656,2020-09,1720.82,0,0,0,1720.82,6889.69
822182566504342656,2020-10,0,1742.22,0,0,-1742.22,5147.47
822451288466786048,2020-01,1364.36,1726.24,1668.5,0,1306.62,1306.62
822451288466786048,2020-02,578.44,2827.78,7440.36,3187.91,2003.11,3309.73
822451288466786048,2020-03,1979.48,0,1312.99,726.95,2565.52,5875.25
822451288466786048,2020-04,3006.15,2834.14,47.63,0,219.64,6094.89
822451288466786048,2020-05,2986.31,0,1646.97,0,4633.28,10728.17
822451288466786048,2020-06,1108.74,2549.98,3330.37,0,1889.13,12617.3
822451288466786048,2020-07,0,3708.94,478.75,0,-3230.19,9387.11
822451288466786048,2020-08,1344.1,0,3065.62,0,4409.72,13796.83
822451288466786048,2020-09,6812.37,546.93,3131.77,1940.7,7456.51,21253.34
822451288466786048,2020-10,4336.85,1465.07,1830.05,512.82,4189.01,25442.35
822451288466786048,2020-11,0,1220.56,435.65,1340.25,-2125.16,23317.19
822451288466786048,2020-12,0,1724.53,2817.17,1393.54,-300.9,23016.29
822825806885579520,2020-03,0,923.79,0,0,-923.79,-923.79
822825806885579520,2020-04,0,1321.72,0,0,-1321.72,-2245.51
822825806885579520,2020-06,0,466.19,0,0,-466.19,-2711.7
822825806885579520,2020-08,1944.58,0,0,2933.61,-989.03,-3700.73
823091791899143680,2020-01,5780.85,8537.59,407.52,6869.85,-9219.07,-9219.07
823091791899143680,2020-02,2019.78,3941.14,2327.01,3806.31,-3400.66,-12619.73
823091791899143680,2020-03,4143.64,3178.31,1770.42,9374.39,-6638.64,-19258.37
823091791899143680,2020-04,2549.68,6450.92,3379.61,6213.64,-6735.27,-25993.64
823091791899143680,2020-05,8317.59,1953.03,5219.68,9027.21,2557.03,-23436.61
823091791899143680,2020-06,7847.24,6711.62,6782.43,4186.15,3731.9,-19704.71
823091791899143680,2020-07,4747.44,4437.77,3227.85,1989.48,1548.04,-18156.67
823091791899143680,2020-08,2823.75,4705.04,4173.82,0,2292.53,-15864.14
823091791899143680,2020-09,4433.91,2175.32,3759.29,1912.52,4105.36,-11758.78
823091791899143680,2020-10,1977.1,2788.66,3512.8,4231.81,-1530.57,-13289.35
823091791899143680,2020-11,9218.94,3094.24,4540.67,2459.7,8205.67,-5083.68
823091791899143680,2020-12,4377.57,4960.5,9041.74,3868.17,4590.64,-493.04
823876801617850496,2020-01,4798.38,3587.46,3038.96,1689.6,2560.28,2560.28
823876801617850496,2020-02,177.92,1983.96,2071.22,2284.54,-2019.36,540.92
823876801617850496,2020-03,1397.83,2616.27,2382.36,1467.24,-303.32,237.6
823876801617850496,2020-04,3315.35,2375.59,3330.9,417.73,3852.93,4090.53
823876801617850496,2020-05,662.34,4793.83,3800.94,2143.58,-2474.13,1616.4
823876801617850496,2020-06,0,2744.34,2728.45,2702.76,-2718.65,-1102.25
823876801617850496,2020-07,1270.61,2984.67,1396.96,0,-317.1,-1419.35
823876801617850496,2020-08,1911.57,3416.51,1549.35,2098.44,-2054.03,-3473.38
823876801617850496,2020-09,3134.01,3744.85,1102.76,408.71,83.21,-3390.17
823876801617850496,2020-10,2946.89,432.55,5460,2576.52,5397.82,2007.65
823876801617850496,2020-11,2942.26,3255.47,996.41,1766.78,-1083.58,924.07
823876801617850496,2020-12,2356.18,252.36,2241.51,4900.1,-554.77,369.3
824451297266537728,2020-01,0,937.2,0,957.06,-1894.26,-1894.26
824451297266537728,2020-03,1291.26,0,0,1013.51,277.75,-1616.51
824451297266537728,2020-05,0,1100.32,0,0,-1100.32,-2716.83
824451297266537728,2020-08,0,14.1,0,1508.09,-1522.19,-4239.02
824451297266537728,2020-09,90.53,0,709.09,0,799.62,-3439.4
824451297266537728,2020-10,2594.07,1826.4,0,0,767.67,-2671.73
824451297266537728,2020-11,1045.08,83.01,1715.79,0,2677.86,6.13
824451297266537728,2020-12,0,2471.5,0,1501.46,-3972.96,-3966.83
824620842039930240,2020-01,0,1786.41,1283.01,0,-503.4,-503.4
824620842039930240,2020-02,0,1100.37,0,0,-1100.37,-1603.77
824620842039930240,2020-03,447.17,1339.87,0,804.58,-1697.28,-3301.05
824620842039930240,2020-04,0,1965.57,0,0,-1965.57,-5266.62
824620842039930240,2020-06,243.33,0,0,2295.68,-2052.35,-7318.97
824620842039930240,2020-08,0,1413.16,2004.82,410.34,181.32,-7137.65
824620842039930240,2020-09,0,1284.67,663.32,0,-621.35,-7759
825321942843683200,2020-01,4132.08,2964.43,3945.07,5018.84,93.88,93.88
825321942843683200,2020-02,1174.27,1393.35,0,0,-219.08,-125.2
825321942843683200,2020-03,1458.51,7868.24,1870.15,1858.08,-6397.66,-6522.86
825321942843683200,2020-04,1087.87,497.18,4321.17,2790.25,2121.61,-4401.25
825321942843683200,2020-05,1331.47,5183.76,3841.24,3677.52,-3688.57,-8089.82
825321942843683200,2020-06,2160.55,282.59,6089.12,2063.96,5903.12,-2186.7
825321942843683200,2020-07,2173.24,0,362.84,32.98,2503.1,316.4
825321942843683200,2020-08,3786.05,2092.39,4842.15,0,6535.81,6852.21
825321942843683200,2020-09,1490.07,1994.71,240.03,0,-264.61,6587.6
825321942843683200,2020-10,5598.67,1655.53,4728.14,721.96,7949.32,14536.92
825321942843683200,2020-11,3463.45,1519.54,3340.07,0,5283.98,19820.9
825321942843683200,2020-12,4822.74,3668.62,1095.5,3181.14,-931.52,18889.38
827330050348975616,2020-01,245.67,1432.4,0,3614.49,-4801.22,-4801.22
827330050348975616,2020-02,302.59,0,2619.01,0,2921.6,-1879.62
827330050348975616,2020-04,1528.05,0,0,0,1528.05,-351.57
827330050348975616,2020-05,0,388.2,428.8,0,40.6,-310.97
827330050348975616,2020-07,100.11,1009.72,0,0,-909.61,-1220.58
827330050348975616,2020-10,0,1423.17,0,1041.36,-2464.53,-3685.11
827330050348975616,2020-11,1413.1,0,984.54,0,2397.64,-1287.47
828725110962096768,2020-01,5752.02,3907.75,2357.3,10832.07,-6630.5,-6630.5
828725110962096768,2020-02,8111.51,3747.67,2321.99,10173.48,-3487.65,-10118.15
828725110962096768,2020-03,3207,6136.7,7316.94,1596.63,2790.61,-7327.54
828725110962096768,2020-04,7538.45,2791.08,2954.63,614.49,7087.51,-240.03
828725110962096768,2020-05,2663.01,4468.72,6586.91,3974.99,806.21,566.18
828725110962096768,2020-06,7311.55,9215.67,5514.36,4847.06,-1236.82,-670.64
828725110962096768,2020-07,5341.21,7131.95,6324.48,2952.87,1580.87,910.23
828725110962096768,2020-08,2230.71,3035.06,10898.42,5213.09,4880.98,5791.21
828725110962096768,2020-09,1527.98,2549.19,2823.7,1855.72,-53.23,5737.98
828725110962096768,2020-10,6855.27,5049.24,4639.48,7220.58,-775.07,4962.91
828725110962096768,2020-11,12297.54,3720.05,2847.44,3949.62,7475.31,12438.22
828725110962096768,2020-12,3259.87,3217.17,8363.97,4661.2,3745.47,16183.69
829310617708447104,2020-01,4005.35,0,3884.14,1870.35,6019.14,6019.14
829310617708447104,2020-02,3870.2,4358.1,3098.1,7057.72,-4447.52,1571.62
829310617708447104,2020-03,3939.84,2433.44,6292.34,5218.09,2580.65,4152.27
829310617708447104,2020-04,4596.18,4718.94,1862.44,2464.66,-724.98,3427.29
829310617708447104,2020-05,4058.75,1239.39,6668.11,2204.38,7283.09,10710.38
829310617708447104,2020-06,5252.79,3837.79,1826.99,2200.99,1041,11751.38
829310617708447104,2020-07,3230.78,1124.84,2828.76,2618.62,2316.08,14067.46
829310617708447104,2020-08,3150.27,5559.84,0,3846.01,-6255.58,7811.88
829310617708447104,2020-09,1519.68,4508.37,5182.17,4946.32,-2752.84,5059.04
829310617708447104,2020-10,580.53,7172.05,1009.9,1677.84,-7259.46,-2200.42
829310617708447104,2020-11,5815.16,5257.64,12584.4,4170.3,8971.62,6771.2
829310617708447104,2020-12,3240.55,5953.89,7904.93,4752.09,439.5,7210.7
831441602750951168,2020-01,2765.29,782.06,5981.67,4191.94,3772.96,3772.96
831441602750951168,2020-02,5598.52,3381.58,1067.95,427.73,2857.16,6630.12
831441602750951168,2020-03,8375.58,466.61,3169.92,473.32,10605.57,17235.69
831441602750951168,2020-04,1972.78,676.46,2022.47,4930.28,-1611.49,15624.2
831441602750951168,2020-05,2229.21,0,1093.75,572.79,2750.17,18374.37
831441602750951168,2020-06,6230.73,1285.41,5922.91,352.48,10515.75,28890.12
831441602750951168,2020-07,1377.31,6222.98,1135.17,3321.11,-7031.61,21858.51
831441602750951168,2020-08,3600.66,30.67,8126.58,2032.08,9664.49,31523
831441602750951168,2020-09,1119.29,1830.21,3085.26,4557.72,-2183.38,29339.62
831441602750951168,2020-10,2250.99,2186.53,5088.48,3615.25,1537.69,30877.31
831441602750951168,2020-11,2081.44,600.72,3458.69,0,4939.41,35816.72
831441602750951168,2020-12,3324.96,2541.16,2180.29,0,2964.09,38780.81
831695498091549056,2020-01,3424.44,1380.42,3484.73,3680.77,1847.98,1847.98
831695498091549056,2020-03,1481.03,1337,2411.44,0,2555.47,4403.45
831695498091549056,2020-04,1732.88,659.84,0,2972.49,-1899.45,2504
831695498091549056,2020-05,962.14,3.72,0,0,958.42,3462.42
831695498091549056,2020-06,313.26,0,8360.22,3298.32,5375.16,8837.58
831695498091549056,2020-07,941.09,76.73,1444.35,1641.37,667.34,9504.92
831695498091549056,2020-08,631.4,0,1436.5,0,2067.9,11572.82
831695498091549056,2020-09,737.67,0,3587.15,1079.65,3245.17,14817.99
831695498091549056,2020-10,0,2792.2,2662.07,0,-130.13,14687.86
831695498091549056,2020-11,477.6,179.75,1656.45,1007.01,947.29,15635.15
831695498091549056,2020-12,0,1136.67,1624.37,3312.08,-2824.38,12810.77
831737422987640192,2020-01,1693.46,0,0,0,1693.46,1693.46
831737422987640192,2020-02,1415.89,1203.71,0,0,212.18,1905.64
831737422987640192,2020-04,1816.55,849.42,463.81,0,1430.94,3336.58
831737422987640192,2020-06,569.88,1437.04,0,1219.63,-2086.79,1249.79
831737422987640192,2020-07,0,2440.09,0,202.7,-2642.79,-1393
831737422987640192,2020-08,907.46,0,1387.41,919.57,1375.3,-17.7
831737422987640192,2020-09,918.75,3048.18,0,0,-2129.43,-2147.13
831737422987640192,2020-10,1784.29,1955.36,0,558.2,-729.27,-2876.4
831737422987640192,2020-11,1190.13,1870.07,0,1441.63,-2121.57,-4997.97
831737422987640192,2020-12,0,1275.64,1040.84,0,-234.8,-5232.77
833346080574503424,2020-01,0,3561.1,661.89,0,-2899.21,-2899.21
833346080574503424,2020-02,1896.71,1158.34,0,611.02,127.35,-2771.86
833346080574503424,2020-03,521.72,489.04,3736.91,1093.59,2676,-95.86
833346080574503424,2020-04,3724.51,1388.59,0,771.45,1564.47,1468.61
833346080574503424,2020-05,2593.42,1266.68,0,0,1326.74,2795.35
833346080574503424,2020-06,0,2038.23,0,1074.23,-3112.46,-317.11
833346080574503424,2020-07,1710.62,0,2814.95,136.41,4389.16,4072.05
833346080574503424,2020-08,157.54,1764.17,402.55,2797.33,-4001.41,70.64
833346080574503424,2020-09,1232.55,251.39,0,0,981.16,1051.8
833346080574503424,2020-10,2017.58,2282.29,0,2474.51,-2739.22,-1687.42
833346080574503424,2020-11,1233.6,726.45,2338.22,1979.71,865.66,-821.76
833346080574503424,2020-12,1994.35,0,1049.79,1994.23,1049.91,228.15
835023530806342784,2020-01,2574.24,4534.71,0,2679.19,-4639.66,-4639.66
835023530806342784,2020-02,2521.31,3287.24,568.21,916.68,-1114.4,-5754.06
835023530806342784,2020-03,1554.2,1537.51,1931.73,1881.43,66.99,-5687.07
835023530806342784,2020-04,2670.28,2842.78,2781.78,1141.47,1467.81,-4219.26
835023530806342784,2020-05,2089.3,0,1033.41,721.72,2400.99,-1818.27
835023530806342784,2020-06,1477.83,4636.03,1812.23,2972.5,-4318.47,-6136.74
835023530806342784,2020-07,1910.94,7882.66,1908.35,3524.37,-7587.74,-13724.48
835023530806342784,2020-08,2711.65,3723.39,4845.08,752.44,3080.9,-10643.58
835023530806342784,2020-09,4434.64,1640.14,1239.25,5223.89,-1190.14,-11833.72
835023530806342784,2020-10,3541.81,889.49,2224.79,4139.06,738.05,-11095.67
835023530806342784,2020-11,2952.29,4935.74,1186.74,2564.6,-3361.31,-14456.98
835023530806342784,2020-12,1496.5,5976.14,4132.01,4211.55,-4559.18,-19016.16
835913763440225792,2020-01,2159.32,5929.39,1687.67,4164.25,-6246.65,-6246.65
835913763440225792,2020-02,2082.83,3539.54,395.52,2809.12,-3870.31,-10116.96
835913763440225792,2020-03,1569.61,1856.86,344.88,0,57.63,-10059.33
835913763440225792,2020-04,6598.92,3433.63,0,965.57,2199.72,-7859.61
835913763440225792,2020-05,0,3347.2,1410.26,1916.47,-3853.41,-11713.02
835913763440225792,2020-06,3023.9,1834.58,3706.29,1575.28,3320.33,-8392.69
835913763440225792,2020-07,0,3475.2,3074.36,1935.98,-2336.82,-10729.51
835913763440225792,2020-08,3197.79,1588,2582.39,0,4192.18,-6537.33
835913763440225792,2020-09,8363.88,2295.85,234.09,3683.34,2618.78,-3918.55
835913763440225792,2020-10,8694.66,0,1104.85,2890.28,6909.23,2990.68
835913763440225792,2020-11,516.53,1856.91,4887.06,851.99,2694.69,5685.37
835913763440225792,2020-12,6651.13,4288.39,1005.73,2145.7,1222.77,6908.14
836603195334803200,2020-01,3361.88,4733.85,3155.79,2675.44,-891.62,-891.62
836603195334803200,2020-02,5577.51,3166.92,562.59,3158.09,-184.91,-1076.53
836603195334803200,2020-03,5310.99,3698.61,3972.87,1438.28,4146.97,3070.44
836603195334803200,2020-04,8138.2,5348.4,9187.39,1973.67,10003.52,13073.96
836603195334803200,2020-05,135.54,4348.73,4233.59,2541.27,-2520.87,10553.09
836603195334803200,2020-06,2703.93,3058.19,259.39,6882.23,-6977.1,3575.99
836603195334803200,2020-07,703.01,10172.64,1657.16,3728.95,-11541.42,-7965.43
836603195334803200,2020-08,5281.25,2410.89,2746.65,1186.39,4430.62,-3534.81
836603195334803200,2020-09,4285.97,3963.89,969.53,4173.84,-2882.23,-6417.04
836603195334803200,2020-10,5288.51,2175.18,3362.46,4260.01,2215.78,-4201.26
836603195334803200,2020-11,4347.37,1606.72,7417.63,9877.96,280.32,-3920.94
836603195334803200,2020-12,1486.72,10661.02,1728.36,1303.92,-8749.86,-12670.8
836718358035638144,2020-01,156.09,1047.84,0,0,-891.75,-891.75
836718358035638144,2020-02,1141.39,679.52,475.22,4714.78,-3777.69,-4669.44
836718358035638144,2020-03,4434.2,2628.75,2852.3,0,4657.75,-11.69
836718358035638144,2020-05,873.93,0,1006.31,1536.96,343.28,331.59
836718358035638144,2020-06,1282.34,4131.99,1034.76,0,-1814.89,-1483.3
836718358035638144,2020-07,1813.36,780.71,0,0,1032.65,-450.65
836718358035638144,2020-08,2940.9,4098.9,0,0,-1158,-1608.65
836718358035638144,2020-09,0,58.44,1300.39,1117.94,124.01,-1484.64
836718358035638144,2020-10,0,892.49,696.94,4389.87,-4585.42,-6070.06
836718358035638144,2020-11,1002.51,4582.64,1299.23,2499.09,-4779.99,-10850.05
836718358035638144,2020-12,179.44,1044.34,1708.65,226.04,617.71,-10232.34
838787167493137536,2020-01,6178.71,3216.38,7980.34,3208.6,7734.07,7734.07
838787167493137536,2020-02,5733.29,1342.78,4191.75,2370.65,6211.61,13945.68
838787167493137536,2020-03,3817.55,6498.87,3602.68,1987.84,-1066.48,12879.2
838787167493137536,2020-04,5387.15,929.13,2681.11,3440.01,3699.12,16578.32
838787167493137536,2020-05,0,3218.69,3603.44,4553.01,-4168.26,12410.06
838787167493137536,2020-06,2771.52,2961.54,453.51,3289.66,-3026.17,9383.89
838787167493137536,2020-07,3650.84,0,2145.9,394.05,5402.69,14786.58
838787167493137536,2020-08,1700.14,1629.18,124.34,4281.98,-4086.68,10699.9
838787167493137536,2020-09,3469.6,3944.88,1010.18,168.11,366.79,11066.69
838787167493137536,2020-10,2513.84,0,5346.44,1587.52,6272.76,17339.45
838787167493137536,2020-11,5264.03,2256.54,3287.52,3336.03,2958.98,20298.43
838787167493137536,2020-12,1649,6638.99,926.99,3345.37,-7408.37,12890.06
838886776300500992,2020-01,0,1346.44,0,0,-1346.44,-1346.44
838886776300500992,2020-02,828.31,0,0,0,828.31,-518.13
838886776300500992,2020-03,0,2755.33,0,1242.88,-3998.21,-4516.34
838886776300500992,2020-04,424.31,36.13,118.25,3353.67,-2847.24,-7363.58
838886776300500992,2020-05,0,1417.08,1596.3,0,179.22,-7184.36
838886776300500992,2020-08,1623.5,0,0,64.68,1558.82,-5625.54
838886776300500992,2020-09,1753.06,163.11,0,0,1589.95,-4035.59
838886776300500992,2020-10,1067.66,0,1536.39,974.5,1629.55,-2406.04
840320131514316288,2020-01,407.03,40.37,315.42,0,682.08,682.08
840320131514316288,2020-02,1500.13,2820.44,0,559.37,-1879.68,-1197.6
840320131514316288,2020-03,0,51.97,2306.77,784.72,1470.08,272.48
840320131514316288,2020-04,2529.71,1434.87,1143.12,1152.25,1085.71,1358.19
840320131514316288,2020-05,0,697.43,1164.15,0,466.72,1824.91
840320131514316288,2020-06,122.03,0,3542.03,1883.58,1780.48,3605.39
840320131514316288,2020-08,158.67,1548.17,1974.52,1753.39,-1168.37,2437.02
840320131514316288,2020-09,4049.18,272.81,0,0,3776.37,6213.39
840320131514316288,2020-10,0,1148.05,0,1019.07,-2167.12,4046.27
840320131514316288,2020-11,544.2,734.03,0,1576.42,-1766.25,2280.02
840320131514316288,2020-12,1797.92,356.56,0,2456.29,-1014.93,1265.09
840700176735201408,2020-01,2813.12,4950.67,2032.8,4666.35,-4771.1,-4771.1
840700176735201408,2020-02,6694.55,0,4709.28,6759.39,4644.44,-126.66
840700176735201408,2020-03,2632.38,1487.94,3983.68,7305.45,-2177.33,-2303.99
840700176735201408,2020-04,1255.46,5150.02,3550.44,8032.57,-8376.69,-10680.68
840700176735201408,2020-05,3704.69,7520.22,2091.72,2403.83,-4127.64,-14808.32
840700176735201408,2020-06,3747.49,1383.31,3405.16,3283.96,2485.38,-12322.94
840700176735201408,2020-07,6110.4,8916.06,4983.57,4429.9,-2251.99,-14574.93
840700176735201408,2020-08,2911.93,1650.56,4877.23,4661.75,1476.85,-13098.08
840700176735201408,2020-09,6768.76,2694.51,6882.29,193.28,10763.26,-2334.82
840700176735201408,2020-10,1006.37,4668.62,5073.46,5154.3,-3743.09,-6077.91
840700176735201408,2020-11,8403.87,2134.02,5373.14,6518.6,5124.39,-953.52
840700176735201408,2020-12,2608.1,3775.62,5434.59,7561.11,-3294.04,-4247.56
840949922531156224,2020-01,4716.65,1391.7,2697.71,5337.85,684.81,684.81
840949922531156224,2020-02,2825.38,3267.12,6655.77,5625.47,588.56,1273.37
840949922531156224,2020-03,0,3496.1,3554.95,6787,-6728.15,-5454.78
840949922531156224,2020-04,2171.78,2663.33,3604.19,3407.04,-294.4,-5749.18
840949922531156224,2020-05,10772.35,7834.72,5944.45,3926.93,4955.15,-794.03
840949922531156224,2020-06,657.39,3997.37,5880.44,5934.97,-3394.51,-4188.54
840949922531156224,2020-07,9116.3,2765.08,1409.11,1623.8,6136.53,1947.99
840949922531156224,2020-08,1856.9,5620.63,3972.87,1095.04,-885.9,1062.09
840949922531156224,2020-09,1359.4,1294.09,7613.02,3302.72,4375.61,5437.7
840949922531156224,2020-10,3243.2,6098.62,1283,3869.76,-5442.18,-4.48
840949922531156224,2020-11,3992.3,7682.8,4656.8,4781.13,-3814.83,-3819.31
840949922531156224,2020-12,4366.63,2050.24,5181.48,1989.56,5508.31,1689
843350730200778240,2020-05,504.21,820.91,0,0,-316.7,-316.7
843350730200778240,2020-09,207.85,0,0,1540.72,-1332.87,-1649.57
843350730200778240,2020-10,1301.92,0,1834.47,0,3136.39,1486.82
843350730200778240,2020-11,255.06,0,0,0,255.06,1741.88
844569314120436224,2020-01,0,343.22,1226.25,1335.73,-452.7,-452.7
844569314120436224,2020-02,3133.46,743.03,3852.1,0,6242.53,5789.83
844569314120436224,2020-03,3099.7,1468.18,466.42,2241.22,-143.28,5646.55
844569314120436224,2020-04,0,3042.73,0,3188.56,-6231.29,-584.74
844569314120436224,2020-05,3722.74,982.58,0,3238.37,-498.21,-1082.95
844569314120436224,2020-06,413.44,357.35,3045,5221.98,-2120.89,-3203.84
844569314120436224,2020-07,3922.23,0,1595.85,78.07,5440.01,2236.17
844569314120436224,2020-08,3347.76,85.41,3484.13,2443.6,4302.88,6539.05
844569314120436224,2020-09,4185.59,2348.16,2889.28,2546.9,2179.81,8718.86
844569314120436224,2020-10,3040.91,269.43,4113.41,2069.31,4815.58,13534.44
844569314120436224,2020-11,2140.62,1715.98,0,2138.22,-1713.58,11820.86
844569314120436224,2020-12,3701.63,1671.56,2129.87,310.97,3848.97,15669.83
844646219165192576,2020-01,1984.79,2776.43,1854.18,0,1062.54,1062.54
844646219165192576,2020-03,1965.42,3282.67,2301.72,1691.17,-706.7,355.84
844646219165192576,2020-04,3381.29,1303.96,0,1048.46,1028.87,1384.71
844646219165192576,2020-05,1115.04,0,0,0,1115.04,2499.75
844646219165192576,2020-06,1134.81,0,0,1486.84,-352.03,2147.72
844646219165192576,2020-07,2239.71,146.25,1097.49,0,3190.95,5338.67
844646219165192576,2020-08,4039.29,2069.3,5353.25,1772.34,5550.9,10889.57
844646219165192576,2020-09,1952.05,0,258.91,4179.48,-1968.52,8921.05
844646219165192576,2020-10,0,3508.73,0,0,-3508.73,5412.32
844646219165192576,2020-11,2039.67,0,0,2869.72,-830.05,4582.27
844646219165192576,2020-12,2723.93,1526.15,4168.31,245.7,5120.39,9702.66
845725533712694016,2020-01,3150.54,4910.52,1972.02,1792.71,-1580.67,-1580.67
845725533712694016,2020-02,8719.09,7686.12,1458.43,5682.07,-3190.67,-4771.34
845725533712694016,2020-03,3606.81,5676.48,5487.8,4043.8,-625.67,-5397.01
845725533712694016,2020-04,13028.75,2363.55,2371.97,1765.91,11271.26,5874.25
845725533712694016,2020-05,4395.52,5207.65,6332.54,9292.58,-3772.17,2102.08
845725533712694016,2020-06,5775.59,5438.37,3652.16,769.18,3220.2,5322.28
845725533712694016,2020-07,2411.66,9852.35,8677.3,6081.91,-4845.3,476.98
845725533712694016,2020-08,1362.56,4693.47,6089.89,5358.93,-2599.95,-2122.97
845725533712694016,2020-09,4907.6,1895.99,2127.72,5260.17,-120.84,-2243.81
845725533712694016,2020-10,5161.11,4070.7,3181.89,5516.67,-1244.37,-3488.18
845725533712694016,2020-11,2478.04,10812.14,2650.66,2407.9,-8091.34,-11579.52
845725533712694016,2020-12,2165.16,3310.93,1339.33,9438.33,-9244.77,-20824.29
846191883387294592,2020-01,871.49,0,0,0,871.49,871.49
846191883387294592,2020-02,1028.64,1917.93,1788.98,212.91,686.78,1558.27
846191883387294592,2020-03,3654.24,1788.27,0,82.47,1783.5,3341.77
846191883387294592,2020-04,1830.71,0,1212.92,0,3043.63,6385.4
846191883387294592,2020-05,412.16,4610.48,777.89,0,-3420.43,2964.97
846191883387294592,2020-06,1329.68,1406.84,0,2365.31,-2442.47,522.5
846191883387294592,2020-08,1166.87,0,0,615.75,551.12,1073.62
846191883387294592,2020-09,0,2989.17,4625.29,2012,-375.88,697.74
846191883387294592,2020-10,706.84,1473.91,1648.91,1017.05,-135.21,562.53
846191883387294592,2020-11,1621.26,3912.65,0,1948.65,-4240.04,-3677.51
846191883387294592,2020-12,0,4126.26,3628.6,0,-497.66,-4175.17
846651292508728576,2020-01,8571.48,4616.43,4407.1,2986.32,5375.83,5375.83
846651292508728576,2020-02,3759.65,6714.2,2363.32,1695.07,-2286.3,3089.53
846651292508728576,2020-03,1849.48,8072.59,441.26,3973.31,-9755.16,-6665.63
846651292508728576,2020-04,2773.26,1079.03,1830.53,4102.97,-578.21,-7243.84
846651292508728576,2020-05,986.66,3223.96,4217.06,11415.96,-9436.2,-16680.04
846651292508728576,2020-06,981.08,2750.12,4927.86,3723.22,-564.4,-17244.44
846651292508728576,2020-07,3739.09,4874.71,5935.8,4060.04,740.14,-16504.3
846651292508728576,2020-08,10088.59,3835.15,10760.24,1847.9,15165.78,-1338.52
846651292508728576,2020-09,6119.65,3730.91,1737.43,9665,-5538.83,-6877.35
846651292508728576,2020-10,5682.02,2210.61,3483.2,3437.41,3517.2,-3360.15
846651292508728576,2020-11,893.27,1571.28,8050.82,6368.13,1004.68,-2355.47
846651292508728576,2020-12,2238.94,2753.48,3925.16,6049.63,-2639.01,-4994.48
847214469029116800,2020-01,7272.78,3419.38,3831.78,0,7685.18,7685.18
847214469029116800,2020-02,2598.18,5590.95,1902.4,2198.26,-3288.63,4396.55
847214469029116800,2020-03,8521.08,2918.15,0,2100.27,3502.66,7899.21
847214469029116800,2020-04,1899.32,4343.88,2939.67,1919.27,-1424.16,6475.05
847214469029116800,2020-05,0,1349.87,0,4057.9,-5407.77,1067.28
847214469029116800,2020-06,1648.52,2254.42,1159.65,2442.46,-1888.71,-821.43
847214469029116800,2020-07,1517.82,122.97,764.3,2162.32,-3.17,-824.6
847214469029116800,2020-08,2032.55,0,5907.44,1999.8,5940.19,5115.59
847214469029116800,2020-09,1104.88,5311.76,427.58,210.39,-3989.69,1125.9
847214469029116800,2020-10,4342.8,2378.59,957.54,5395.94,-2474.19,-1348.29
847214469029116800,2020-11,2757.38,4488.16,1964.35,7710.97,-7477.4,-8825.69
847214469029116800,2020-12,3070.96,2432.25,2481.54,0,3120.25,-5705.44
847277650007245056,2020-01,1017.69,0,3336.92,0,4354.61,4354.61
847277650007245056,2020-02,0,877.84,0,1428.9,-2306.74,2047.87
847277650007245056,2020-06,2491.1,1559.29,255.09,1036.77,150.13,2198
847277650007245056,2020-07,0,1472.3,0,1231.02,-2703.32,-505.32
847277650007245056,2020-10,281.32,0,0,1818.47,-1537.15,-2042.47
847277650007245056,2020-11,0,84.42,1999.9,0,1915.48,-126.99
847277650007245056,2020-12,703.38,1783.93,349.9,0,-730.65,-857.64
847726562367296896,2020-01,1822.56,7592,2768.48,9080.91,-12081.87,-12081.87
847726562367296896,2020-02,2385.78,1018.29,4852.62,4450,1770.11,-10311.76
847726562367296896,2020-03,4898.66,5637.09,1978.84,4564.33,-3323.92,-13635.68
847726562367296896,2020-04,8673.81,2991.1,4771.92,4964.93,5489.7,-8145.98
847726562367296896,2020-05,7024.97,1484.82,3747.51,1137.43,8150.23,4.25
847726562367296896,2020-06,5158.5,4028.67,1813.21,5600.45,-2657.41,-2653.16
847726562367296896,2020-07,2221.67,3354.61,6050.11,1774.51,3142.66,489.5
847726562367296896,2020-08,6332.97,4305.86,3978.04,0,6005.15,6494.65
847726562367296896,2020-09,4102.31,2119.69,4902.52,360.77,6524.37,13019.02
847726562367296896,2020-10,6286.59,5680.09,1841.96,4498.75,-2050.29,10968.73
847726562367296896,2020-11,983.2,6286.59,4620.3,1817.98,-2501.07,8467.66
847726562367296896,2020-12,2979.58,2936.14,1517.58,3583.7,-2022.68,6444.98
848108612688102528,2020-02,1986.2,0,137.45,1966.11,157.54,157.54
848108612688102528,2020-06,1035.72,208.62,735.98,0,1563.08,1720.62
848108612688102528,2020-07,0,1135.5,0,0,-1135.5,585.12
848108612688102528,2020-09,0,154.31,0,368.18,-522.49,62.63
848108612688102528,2020-10,0,494.29,480.35,801.3,-815.24,-752.61
848108612688102528,2020-12,0,1681.95,0,0,-1681.95,-2434.56
849004909239240576,2020-01,3260.98,10301.21,3749.4,5400.46,-8691.29,-8691.29
849004909239240576,2020-02,475.81,1854.96,4105.17,1088.65,1637.37,-7053.92
849004909239240576,2020-03,7255.98,2454.94,3928.16,9313.18,-583.98,-7637.9
849004909239240576,2020-04,2248.12,2594.93,1774.48,1380.09,47.58,-7590.32
849004909239240576,2020-05,2565.53,2635.98,2209.67,1961.4,177.82,-7412.5
849004909239240576,2020-06,2293.4,1469.56,1889.62,2883.33,-169.87,-7582.37
849004909239240576,2020-07,6620.95,4555.44,4769.39,4914.04,1920.86,-5661.51
849004909239240576,2020-08,5332.05,6428.94,5747.3,5640.78,-990.37,-6651.88
849004909239240576,2020-09,1383.24,9473.66,672.81,487.02,-7904.63,-14556.51
849004909239240576,2020-10,5300.73,3373.32,2485.34,1698.82,2713.93,-11842.58
849004909239240576,2020-11,4286,5641.62,6201.43,3704.14,1141.67,-10700.91
849004909239240576,2020-12,1341.45,2136.47,2167.15,6770.39,-5398.26,-16099.17
849504698897201536,2020-01,5507.79,1757.28,948.85,6289.81,-1590.45,-1590.45
849504698897201536,2020-02,3897.88,2020.38,0,2866.05,-988.55,-2579
849504698897201536,2020-03,1933.92,737.73,2682.3,1387.54,2490.95,-88.05
849504698897201536,2020-04,2391.64,4939.87,0,658.63,-3206.86,-3294.91
849504698897201536,2020-05,1762.86,2578.23,2004.45,3536.38,-2347.3,-5642.21
849504698897201536,2020-06,4563.52,0,0,1975.47,2588.05,-3054.16
849504698897201536,2020-07,3470.45,4360.12,6468.88,3234.91,2344.3,-709.86
849504698897201536,2020-08,1841.67,5725.99,796.61,2323.76,-5411.47,-6121.33
849504698897201536,2020-09,1403.44,6953.56,1931.74,3363.65,-6982.03,-13103.36
849504698897201536,2020-10,737.94,3203.34,0,601.95,-3067.35,-16170.71
849504698897201536,2020-12,1840.86,1643.83,5022.71,2709.85,2509.89,-13660.82
851382960571063552,2020-01,1785.85,1868.52,4002.81,2183.54,1736.6,1736.6
851382960571063552,2020-02,1464.7,1690.79,2042.57,0,1816.48,3553.08
851382960571063552,2020-03,3367.38,1289.31,0,0,2078.07,5631.15
851382960571063552,2020-04,367.88,0,2282.76,1259.91,1390.73,7021.88
851382960571063552,2020-05,3122.5,811.62,0,0,2310.88,9332.76
851382960571063552,2020-06,561.35,0,0,0,561.35,9894.11
851382960571063552,2020-07,1339.06,34.21,295.08,1016.77,583.16,10477.27
851382960571063552,2020-08,185.36,569.67,0,705.54,-1089.85,9387.42
851382960571063552,2020-09,458.81,1385.59,0,1248.73,-2175.51,7211.91
851382960571063552,2020-10,4354.69,414.14,0,1742.36,2198.19,9410.1
851382960571063552,2020-11,543.86,4381.38,1801.54,612.55,-2648.53,6761.57
851382960571063552,2020-12,408.64,99.79,2703.69,0,3012.54,9774.11
852669475855622528,2020-01,2753.99,4557.35,4040.19,4692.04,-2455.21,-2455.21
852669475855622528,2020-02,4360.72,3922.92,1694.86,1367.28,765.38,-1689.83
852669475855622528,2020-03,6523.35,6482.67,2081.31,8001.5,-5879.51,-7569.34
852669475855622528,2020-04,2757.68,6497.77,685.76,1375.06,-4429.39,-11998.73
852669475855622528,2020-05,4893.75,3974.46,4020.35,2215.83,2723.81,-9274.92
852669475855622528,2020-06,4192.38,8803.22,6867.17,5787.82,-3531.49,-12806.41
852669475855622528,2020-07,3994.02,8844.04,6610.15,1795.98,-35.85,-12842.26
852669475855622528,2020-08,6517.28,5590.92,6092.73,142.63,6876.46,-5965.8
852669475855622528,2020-09,4961.88,4707.32,3716.09,1888.42,2082.23,-3883.57
852669475855622528,2020-10,5739.27,7612.41,2137.42,4583.97,-4319.69,-8203.26
852669475855622528,2020-11,1834.5,5493.06,10556.06,3350.2,3547.3,-4655.96
852669475855622528,2020-12,7044.91,2824.03,6329.99,3515.31,7035.56,2379.6
853048388439420288,2020-01,2750.62,8251.63,4675.25,1803.89,-2629.65,-2629.65
853048388439420288,2020-02,4988.18,4457.83,6420.72,0,6951.07,4321.42
853048388439420288,2020-03,5659.44,4488.84,16209.45,3119.62,14260.43,18581.85
853048388439420288,2020-04,0,3480.9,2492.22,8427.42,-9416.1,9165.75
853048388439420288,2020-05,6109.86,4111.21,6067.36,5176.33,2889.68,12055.43
853048388439420288,2020-06,6618.22,7324.07,4024.79,3715.04,-396.1,11659.33
853048388439420288,2020-07,3042.39,1606.31,2071.86,2841.59,666.35,12325.68
853048388439420288,2020-08,3369.72,11050.36,3742.23,3011.8,-6950.21,5375.47
853048388439420288,2020-09,2068.65,3737.44,4814.67,2067.19,1078.69,6454.16
853048388439420288,2020-10,8346.62,5499.52,4776.2,2044.22,5579.08,12033.24
853048388439420288,2020-11,7080.2,3463.43,3270.81,2413.63,4473.95,16507.19
853048388439420288,2020-12,4138.78,3989.49,1425.82,2467.38,-892.27,15614.92
853096884325979392,2020-01,1433.63,3819.37,2109.89,1992.18,-2268.03,-2268.03
853096884325979392,2020-02,776.9,3228.56,1402.84,1275.6,-2324.42,-4592.45
853096884325979392,2020-03,3788.4,4795.98,0,1573.58,-2581.16,-7173.61
853096884325979392,2020-04,1372.2,3918.53,1682.08,4861.71,-5725.96,-12899.57
853096884325979392,2020-05,1618.06,2143.45,2558.82,2827.15,-793.72,-13693.29
853096884325979392,2020-06,1224.65,626.01,8198.73,0,8797.37,-4895.92
853096884325979392,2020-07,1257.69,5926.4,5159.65,4225.03,-3734.09,-8630.01
853096884325979392,2020-08,2894.2,503.73,2336.11,5295.57,-568.99,-9199
853096884325979392,2020-09,3702.23,3273.12,2219.13,4240.63,-1592.39,-10791.39
853096884325979392,2020-10,4447.18,3753.12,875.25,1501.7,67.61,-10723.78
853096884325979392,2020-11,3506.99,5764.96,7855.13,2864.77,2732.39,-7991.39
853096884325979392,2020-12,3565.07,2601.46,1890.81,3299.46,-445.04,-8436.43
853171602745079296,2020-01,1889.28,2984.51,3596.68,576.04,1925.41,1925.41
853171602745079296,2020-02,2399.01,3396.7,1603.22,811.97,-206.44,1718.97
853171602745079296,2020-03,0,1612.52,4449.31,931.49,1905.3,3624.27
853171602745079296,2020-04,1895.77,4139.74,1950.81,3012.27,-3305.43,318.84
853171602745079296,2020-05,3121.65,1348.57,0,282.65,1490.43,1809.27
853171602745079296,2020-06,982.39,6084.23,1705.53,659.92,-4056.23,-2246.96
853171602745079296,2020-07,2414.14,2278.92,0,5250.18,-5114.96,-7361.92
853171602745079296,2020-08,1272.6,1551.8,1852.04,0,1572.84,-5789.08
853171602745079296,2020-09,3638.61,3641.83,0,0,-3.22,-5792.3
853171602745079296,2020-10,0,1242.91,0,0,-1242.91,-7035.21
853171602745079296,2020-11,3473.89,3533.48,0,0,-59.59,-7094.8
853171602745079296,2020-12,0,2453.82,2206.77,3024.33,-3271.38,-10366.18
854436602376429440,2020-01,1907.54,0,2279.43,0,4186.97,4186.97
854436602376429440,2020-02,1523.07,0,0,3194.77,-1671.7,2515.27
854436602376429440,2020-03,735.03,655.03,0,0,80,2595.27
854436602376429440,2020-04,0,1750,0,0,-1750,845.27
854436602376429440,2020-05,0,2730.1,2.52,818,-3545.58,-2700.31
854436602376429440,2020-06,0,1154.6,0,2421.88,-3576.48,-6276.79
854436602376429440,2020-07,4390.84,0,0,0,4390.84,-1885.95
854436602376429440,2020-08,0,1457.16,3094,774.4,862.44,-1023.51
854436602376429440,2020-09,563.12,2253.23,1411.85,0,-278.26,-1301.77
854436602376429440,2020-10,1508.74,1042.31,1744.97,0,2211.4,909.63
854436602376429440,2020-12,2597.24,4073.8,589.37,0,-887.19,22.44
855289068931519360,2020-01,2316.31,796.53,1926.18,1748.17,1697.79,1697.79
855289068931519360,2020-02,2785.71,6588.92,9427.87,5817.35,-192.69,1505.1
855289068931519360,2020-03,2767.2,1368.66,511.53,2220.48,-310.41,1194.69
855289068931519360,2020-04,4521.79,945.34,1076.99,1030.04,3623.4,4818.09
855289068931519360,2020-05,2021.93,1270.85,6920.41,1799.74,5871.75,10689.84
855289068931519360,2020-06,4610.37,1648.73,2566.35,1435.31,4092.68,14782.52
855289068931519360,2020-07,4343.35,7709.9,2717.39,4239.12,-4888.28,9894.24
855289068931519360,2020-08,6750.94,0,2866.25,1652.31,7964.88,17859.12
855289068931519360,2020-09,5574.26,6718.75,2168.04,3464.13,-2440.58,15418.54
855289068931519360,2020-10,1862.16,387.23,4378.75,2567.31,3286.37,18704.91
855289068931519360,2020-11,3568.8,5592.51,3241.87,168.39,1049.77,19754.68
855289068931519360,2020-12,0,3320.81,4036.61,5524.18,-4808.38,14946.3
856243380685361792,2020-02,0,1661.94,3558.46,278.17,1618.35,1618.35
856243380685361792,2020-03,0,1598.6,2573.8,536.85,438.35,2056.7
856243380685361792,2020-04,850.03,0,975.02,0,1825.05,3881.75
856243380685361792,2020-05,4455.74,0,0,2095.4,2360.34,6242.09
856243380685361792,2020-06,2861.45,0,281.21,1858.89,1283.77,7525.86
856243380685361792,2020-07,4668.96,1366.5,1782.76,217.53,4867.69,12393.55
856243380685361792,2020-08,1952.18,2871.02,0,0,-918.84,11474.71
856243380685361792,2020-09,1049.96,2159.98,2843.72,0,1733.7,13208.41
856243380685361792,2020-10,3439.44,1878.24,0,0,1561.2,14769.61
856243380685361792,2020-11,810.87,48.01,3346.09,0,4108.95,18878.56
856243380685361792,2020-12,706.02,4036.53,752.68,2304.18,-4882.01,13996.55
856843504284750976,2020-01,854.14,1220.32,0,0,-366.18,-366.18
856843504284750976,2020-06,0,420.32,0,0,-420.32,-786.5
856843504284750976,2020-11,0,963.54,0,0,-963.54,-1750.04
857268213496642688,2020-01,4576.08,713.01,2665.44,1083.95,5444.56,5444.56
857268213496642688,2020-02,1836.9,7983.51,1212.47,3610.74,-8544.88,-3100.32
857268213496642688,2020-03,4361.45,5554.88,2410.54,6360.28,-5143.17,-8243.49
857268213496642688,2020-04,3971.51,8415.81,4241.93,5799.05,-6001.42,-14244.91
857268213496642688,2020-05,752.43,0,5852.34,11993.43,-5388.66,-19633.57
857268213496642688,2020-06,2269.89,4439.55,2338.8,1292.68,-1123.54,-20757.11
857268213496642688,2020-07,3145.5,3128.66,1576.23,2066.73,-473.66,-21230.77
857268213496642688,2020-08,1608.36,1925.85,5199.79,2636.69,2245.61,-18985.16
857268213496642688,2020-09,4884.18,3946.1,3820.37,5336.96,-578.51,-19563.67
857268213496642688,2020-10,1372.74,1055.17,2055.77,3514.25,-1140.91,-20704.58
857268213496642688,2020-11,12056.95,1777.7,3697.78,721.06,13255.97,-7448.61
857268213496642688,2020-12,1159.3,1400.17,4087.75,2779.22,1067.66,-6380.95
857530663498499456,2020-01,1187.28,3830.85,5515.39,5047.01,-2175.19,-2175.19
857530663498499456,2020-02,4558,9614.24,5224.39,4306.79,-4138.64,-6313.83
857530663498499456,2020-03,5460.47,5868.63,5709.77,3513.44,1788.17,-4525.66
857530663498499456,2020-04,2678.99,4413.78,5847.93,5966.65,-1853.51,-6379.17
857530663498499456,2020-05,3828.24,2488.15,845.05,4143.64,-1958.5,-8337.67
857530663498499456,2020-06,1843.93,3810.23,1919.97,2430.01,-2476.34,-10814.01
857530663498499456,2020-07,4791.85,1133.62,5229.54,0,8887.77,-1926.24
857530663498499456,2020-08,5240.74,4440.44,3667.19,4074.8,392.69,-1533.55
857530663498499456,2020-09,6440.53,6378.94,7541.64,5426.65,2176.58,643.03
857530663498499456,2020-10,5577.33,4753.67,7216.55,4021.65,4018.56,4661.59
857530663498499456,2020-11,2266.43,5852.56,2823.87,7218.12,-7980.38,-3318.79
857530663498499456,2020-12,1519.46,2628.19,7580.14,10203.3,-3731.89,-7050.68
858708002023436288,2020-01,696.12,1559.14,2132.42,0,1269.4,1269.4
858708002023436288,2020-02,1648.85,2715.29,1215.91,2498.83,-2349.36,-1079.96
858708002023436288,2020-03,1198.63,720.7,2800.95,1718.37,1560.51,480.55
858708002023436288,2020-04,1586.1,151.52,2563.17,0,3997.75,4478.3
858708002023436288,2020-05,1946.31,0,2632.53,314.58,4264.26,8742.56
858708002023436288,2020-06,558.27,336.55,1608.19,1667.12,162.79,8905.35
858708002023436288,2020-07,0,127.91,766.14,0,638.23,9543.58
858708002023436288,2020-09,2997.2,1653.65,4908.25,1242.55,5009.25,14552.83
858708002023436288,2020-10,1008.69,1701.63,1380.99,4256.73,-3568.68,10984.15
858708002023436288,2020-11,1385.47,600.44,4963.83,0,5748.86,16733.01
859323285322375808,2020-01,704.08,0,0,0,704.08,704.08
859323285322375808,2020-03,2784.63,0,4483.24,790.68,6477.19,7181.27
859323285322375808,2020-05,1630.47,1915.64,0,1515.17,-1800.34,5380.93
859323285322375808,2020-06,0,742.83,310.51,661.58,-1093.9,4287.03
859323285322375808,2020-07,0,1852.24,532.19,0,-1320.05,2966.98
859323285322375808,2020-09,1943.52,1977.81,242.38,1395.37,-1187.28,1779.7
859323285322375808,2020-10,90.7,1032.83,1808.9,0,866.77,2646.47
859323285322375808,2020-11,0,580.58,0,0,-580.58,2065.89
860683428027023360,2020-01,3839.68,1036.81,2540.6,3094.73,2248.74,2248.74
860683428027023360,2020-02,0,3442.7,3472.79,226.99,-196.9,2051.84
860683428027023360,2020-03,258.08,1128.69,2453.13,1634.95,-52.43,1999.41
860683428027023360,2020-04,3261.62,2955.59,2118.23,2062.38,361.88,2361.29
860683428027023360,2020-05,2950.69,3927.64,0,1029.16,-2006.11,355.18
860683428027023360,2020-06,2414.71,0,1892.14,0,4306.85,4662.03
860683428027023360,2020-07,2320.94,1593.48,1361.43,4330.89,-2242,2420.03
860683428027023360,2020-08,3557.36,3889.34,2622.91,1014.19,1276.74,3696.77
860683428027023360,2020-09,3031.7,6306.86,705.01,2265.04,-4835.19,-1138.42
860683428027023360,2020-10,2503.86,1710.59,6285.35,1754.11,5324.51,4186.09
860683428027023360,2020-11,2354.65,2706.28,0,1809.78,-2161.41,2024.68
860683428027023360,2020-12,4873.41,1309.6,277.84,1216.25,2625.4,4650.08
862028686180857088,2020-01,5922.18,4191.39,1970.59,6052.28,-2350.9,-2350.9
862028686180857088,2020-02,2862.15,2182.4,794.97,1815.79,-341.07,-2691.97
862028686180857088,2020-03,3187.54,2463.22,2710.41,3261.69,173.04,-2518.93
862028686180857088,2020-04,2633.19,5231.75,5799.88,3751.95,-550.63,-3069.56
862028686180857088,2020-05,6031.03,3908.04,2820.93,2347.01,2596.91,-472.65
862028686180857088,2020-06,3051.37,197.92,3723.81,5016.93,1560.33,1087.68
862028686180857088,2020-07,4761.74,3471.14,2271.79,7437.96,-3875.57,-2787.89
862028686180857088,2020-08,459.92,3342.51,4237.32,2935.99,-1581.26,-4369.15
862028686180857088,2020-09,3386.81,2752.89,2788.58,0,3422.5,-946.65
862028686180857088,2020-10,0,4818,6235.4,1405.47,11.93,-934.72
862028686180857088,2020-11,1505.6,1999.01,6033.64,2936.27,2603.96,1669.24
862028686180857088,2020-12,5376.03,6355.64,4042.57,460.91,2602.05,4271.29
863861660636230656,2020-01,2352.98,0,1634.75,440.39,3547.34,3547.34
863861660636230656,2020-02,1760.51,1079.88,0,0,680.63,4227.97
863861660636230656,2020-04,1486.61,0,98.83,349.78,1235.66,5463.63
863861660636230656,2020-05,2646.14,2551,1772.57,0,1867.71,7331.34
863861660636230656,2020-07,0,3561.8,0,0,-3561.8,3769.54
863861660636230656,2020-08,175.14,655.93,1958.43,894.73,582.91,4352.45
863861660636230656,2020-09,3678.74,0,0,0,3678.74,8031.19
863861660636230656,2020-10,766.05,1269.53,1688.13,3218.41,-2033.76,5997.43
863861660636230656,2020-12,0,421.47,0,0,-421.47,5575.96
865574014151973760,2020-01,5650.56,3349.84,3088.25,581.56,4807.41,4807.41
865574014151973760,2020-02,2934.88,1759.01,3198.67,732.59,3641.95,8449.36
865574014151973760,2020-03,3003.59,1755.86,1495.35,2408.02,335.06,8784.42
865574014151973760,2020-04,897.83,2174.42,904.57,5042.38,-5414.4,3370.02
865574014151973760,2020-05,0,1441.55,3966.47,713.19,1811.73,5181.75
865574014151973760,2020-06,3620.64,1167.76,1429.52,3863.43,18.97,5200.72
865574014151973760,2020-07,99.07,612.33,3636.91,2135.36,988.29,6189.01
865574014151973760,2020-08,3973.47,1909.63,4834.41,996.22,5902.03,12091.04
865574014151973760,2020-09,362.12,2359.36,0,3867.98,-5865.22,6225.82
865574014151973760,2020-10,3544.81,3594.55,0,843.74,-893.48,5332.34
865574014151973760,2020-11,4393.55,6417.06,3472.16,0,1448.65,6780.99
865574014151973760,2020-12,2652.69,0,1154.51,5722.86,-1915.66,4865.33
866264167144314624,2020-01,0,1477.47,0,0,-1477.47,-1477.47
866264167144314624,2020-02,0,1455.84,0,0,-1455.84,-2933.31
866264167144314624,2020-04,0,92.83,0,0,-92.83,-3026.14
866264167144314624,2020-07,0,1488.52,0,1550.39,-3038.91,-6065.05
866264167144314624,2020-10,1355.71,0,1255.32,0,2611.03,-3454.02
866546615147791360,2020-01,1337.37,1751.41,3172.8,1889.73,869.03,869.03
866546615147791360,2020-02,2307.4,4479.5,2294.57,3635.12,-3512.65,-2643.62
866546615147791360,2020-03,2261.72,7678.68,2026.55,3941.69,-7332.1,-9975.72
866546615147791360,2020-04,2281.62,5756.24,2767.6,466.57,-1173.59,-11149.31
866546615147791360,2020-05,579.29,3607.13,2232.58,3540.21,-4335.47,-15484.78
866546615147791360,2020-06,4249.47,1112.38,2162.54,3952.28,1347.35,-14137.43
866546615147791360,2020-07,2011.39,4256.6,1817.18,1685.33,-2113.36,-16250.79
866546615147791360,2020-08,4453.5,3367.82,2603.02,6494.62,-2805.92,-19056.71
866546615147791360,2020-09,5406.04,6333.29,3698.65,2253.51,517.89,-18538.82
866546615147791360,2020-11,1934.35,1650.2,3930.59,5715.7,-1500.96,-20039.78
866546615147791360,2020-12,3310.4,5069.88,6177.24,66.72,4351.04,-15688.74
869114561842049664,2020-01,1148.54,180.06,0,1753.99,-785.51,-785.51
869114561842049664,2020-02,0,1505,0,1039.71,-2544.71,-3330.22
869114561842049664,2020-04,425.06,0,875.64,911.03,389.67,-2940.55
869114561842049664,2020-08,1190.26,1914.3,556.45,1691.7,-1859.29,-4799.84
869114561842049664,2020-10,1206.57,2037.92,435.41,1041.48,-1437.42,-6237.26
869114561842049664,2020-11,1372.51,1786.24,2841.84,3445.21,-1017.1,-7254.36
869114561842049664,2020-12,0,800.73,0,0,-800.73,-8055.09
869398206226709376,2020-01,2660.76,4557.34,5145.15,8865.32,-5616.75,-5616.75
869398206226709376,2020-02,5300.27,4386.92,4277.89,3276.72,1914.52,-3702.23
869398206226709376,2020-03,5791.89,3557.3,3078.69,682.88,4630.4,928.17
869398206226709376,2020-04,6105.56,1792.24,5888.63,5103.39,5098.56,6026.73
869398206226709376,2020-05,8640.55,6014.12,4418.55,4234.59,2810.39,8837.12
869398206226709376,2020-06,6223.66,7258.16,3375.93,2718.88,-377.45,8459.67
869398206226709376,2020-07,3293.15,8210.39,2998.48,8897.38,-10816.14,-2356.47
869398206226709376,2020-08,4312.81,3852.68,1143.45,2614.61,-1011.03,-3367.5
869398206226709376,2020-09,5697.23,5896.92,7256.1,3431.49,3624.92,257.42
869398206226709376,2020-10,4938.79,4730.18,399.37,7335.15,-6727.17,-6469.75
869398206226709376,2020-11,4699.78,7866.01,5572.69,2045.33,361.13,-6108.62
869398206226709376,2020-12,8844.38,2599.1,7627.36,3669.61,10203.03,4094.41
870954702739721472,2020-01,1709.57,1160.97,581.98,0,1130.58,1130.58
870954702739721472,2020-03,1280.39,1109.94,2199.93,2188.4,181.98,1312.56
870954702739721472,2020-04,1357.75,0,0,2712.81,-1355.06,-42.5
870954702739721472,2020-05,1193.35,586.38,0,3132.35,-2525.38,-2567.88
870954702739721472,2020-06,0,1577.44,1920.56,2933.06,-2589.94,-5157.82
870954702739721472,2020-07,1513.57,4778.96,1828.2,0,-1437.19,-6595.01
870954702739721472,2020-08,900.88,0,3882.25,1870.59,2912.54,-3682.47
870954702739721472,2020-09,1555.24,0,3016.01,2378.99,2192.26,-1490.21
870954702739721472,2020-10,3338.26,0,4404.32,0,7742.58,6252.37
870954702739721472,2020-11,1543.24,0,624.85,0,2168.09,8420.46
870954702739721472,2020-12,820.3,1652.18,1623.7,5352.73,-4560.91,3859.55
872380546199156480,2020-01,0,910.59,0,0,-910.59,-910.59
872380546199156480,2020-03,10.59,0,0,0,10.59,-900
872380546199156480,2020-04,900.14,888.41,0,947.1,-935.37,-1835.37
872380546199156480,2020-06,139.21,744.59,0,0,-605.38,-2440.75
872380546199156480,2020-07,1249.18,1714.61,747.26,0,281.83,-2158.92
872380546199156480,2020-08,291.35,0,0,0,291.35,-1867.57
872380546199156480,2020-09,671.4,1320.11,0,0,-648.71,-2516.28
872380546199156480,2020-11,1455.23,0,0,0,1455.23,-1061.05
872491703615377664,2020-01,2395.53,1593.54,3135.67,0,3937.66,3937.66
872491703615377664,2020-02,2815,436.33,585.5,1036.06,1928.11,5865.77
872491703615377664,2020-03,5988.14,0,2580.38,3956.3,4612.22,10477.99
872491703615377664,2020-04,1444.08,3452.98,149.28,3104.38,-4964,5513.99
872491703615377664,2020-05,3451.34,1536.29,824.36,1365.28,1374.13,6888.12
872491703615377664,2020-06,686.69,4952.21,4330.22,3102.6,-3037.9,3850.22
872491703615377664,2020-07,1093.28,6892.11,3687.13,1053.52,-3165.22,685
872491703615377664,2020-08,0,5377.21,9877.32,0,4500.11,5185.11
872491703615377664,2020-09,6914.09,1652.37,3561.09,0,8822.81,14007.92
872491703615377664,2020-10,6329.23,5611.38,485.82,1110.17,93.5,14101.42
872491703615377664,2020-11,1740.21,1032.3,3038.61,5374.71,-1628.19,12473.23
872491703615377664,2020-12,2465.94,1347.47,1095.93,2795.62,-581.22,11892.01
873018103534720512,2020-01,4502,2896.9,5551.73,3354.29,3802.54,3802.54
873018103534720512,2020-02,299.42,1919.66,755,5270.34,-6135.58,-2333.04
873018103534720512,2020-03,9168.07,10403.4,1590.1,2447.27,-2092.5,-4425.54
873018103534720512,2020-04,3755.01,2187,1711.11,3255.72,23.4,-4402.14
873018103534720512,2020-05,4657.48,2675.16,1641.4,5951.24,-2327.52,-6729.66
873018103534720512,2020-06,4150.51,2625.66,7757.14,3805.36,5476.63,-1253.03
873018103534720512,2020-07,3176.89,6588.41,4719.23,3522.45,-2214.74,-3467.77
873018103534720512,2020-08,2931.81,6487.8,2599.37,2185.08,-3141.7,-6609.47
873018103534720512,2020-09,3385.15,3574.11,8701.47,4567.24,3945.27,-2664.2
873018103534720512,2020-10,6307.18,3457.7,4598.12,380.12,7067.48,4403.28
873018103534720512,2020-11,3956.48,5245.11,2915.92,3294.47,-1667.18,2736.1
873018103534720512,2020-12,5363.27,3182.73,1973.98,9921.01,-5766.49,-3030.39
873480639580287360,2020-01,49.3,3931.09,2611.14,851.76,-2122.41,-2122.41
873480639580287360,2020-02,2338.68,3670.05,4264.1,0,2932.73,810.32
873480639580287360,2020-03,0,1803.41,946.92,0,-856.49,-46.17
873480639580287360,2020-04,2932.19,832.02,2014.52,1348.79,2765.9,2719.73
873480639580287360,2020-05,3960.74,1648.37,3110.93,2350.43,3072.87,5792.6
873480639580287360,2020-06,3013.23,925.15,247.34,2047.88,287.54,6080.14
873480639580287360,2020-07,241.63,2833.99,2071.47,1777.45,-2298.34,3781.8
873480639580287360,2020-08,3826.76,1627.57,5146.9,103.12,7242.97,11024.77
873480639580287360,2020-09,1466.3,0,5193.98,2947.51,3712.77,14737.54
873480639580287360,2020-10,1679.3,0,3717.79,956.14,4440.95,19178.49
873480639580287360,2020-11,2357.89,1730.09,3625.11,314.14,3938.77,23117.26
873480639580287360,2020-12,1969.72,3890.87,2463.44,1158.65,-616.36,22500.9
875325500482563968,2020-01,2865.48,5622.68,6202.23,7001.8,-3556.77,-3556.77
875325500482563968,2020-02,6357.19,3300.72,7222.85,8555.75,1723.57,-1833.2
875325500482563968,2020-03,5935.19,10323.4,766.18,0,-3622.03,-5455.23
875325500482563968,2020-04,4647,2924.9,6628.13,5208.24,3141.99,-2313.24
875325500482563968,2020-05,1234.86,1802.99,5014.52,10840.79,-6394.4,-8707.64
875325500482563968,2020-06,10594.45,3888.82,3790.59,11093.9,-597.68,-9305.32
875325500482563968,2020-07,1778.52,4728.33,5479.2,5420.33,-2890.94,-12196.26
875325500482563968,2020-08,6707.78,1658.55,7700.2,4380.73,8368.7,-3827.56
875325500482563968,2020-09,4120.14,6976.05,6031.78,4253.55,-1077.68,-4905.24
875325500482563968,2020-10,0,7793.09,3941.14,9623.77,-13475.72,-18380.96
875325500482563968,2020-11,4135.79,4809.57,5309,3472.71,1162.51,-17218.45
875325500482563968,2020-12,3246.71,6108.47,5750.49,8774.68,-5885.95,-23104.4
875486607508016000,2020-01,2487.36,3975.47,7636.1,2433.84,3714.15,3714.15
875486607508016000,2020-02,5.21,3118.8,1965.52,2361.41,-3509.48,204.67
875486607508016000,2020-03,5145.07,9638.29,3679,5973.97,-6788.19,-6583.52
875486607508016000,2020-04,1441.84,1495.45,7331.25,3751.85,3525.79,-3057.73
875486607508016000,2020-05,7346.36,5623.32,6934.35,3009.08,5648.31,2590.58
875486607508016000,2020-06,7646.77,6233.26,6340.82,4130.95,3623.38,6213.96
875486607508016000,2020-07,656.02,2904.79,4386.21,4571.99,-2434.55,3779.41
875486607508016000,2020-08,5330.1,12511.92,5329.69,5842.26,-7694.39,-3914.98
875486607508016000,2020-09,5962.86,4592.1,7523.15,2944.84,5949.07,2034.09
875486607508016000,2020-10,5767.58,5946.62,8243.89,4565.48,3499.37,5533.46
875486607508016000,2020-11,2643.37,3386.53,3039.4,2734.96,-438.72,5094.74
875486607508016000,2020-12,0,2583.69,7204.83,4895.81,-274.67,4820.07
875930593409470208,2020-01,3015.95,2059.13,2234,3361.64,-170.82,-170.82
875930593409470208,2020-02,2177.93,2303.58,4982.94,9299.43,-4442.14,-4612.96
875930593409470208,2020-03,2073.15,3136.94,5564.59,5439.25,-938.45,-5551.41
875930593409470208,2020-04,6484.71,7684.08,1788.02,2538.68,-1950.03,-7501.44
875930593409470208,2020-05,2500.73,2170.39,41.11,2490.65,-2119.2,-9620.64
875930593409470208,2020-06,4486.17,4852.33,4860.88,1196.38,3298.34,-6322.3
875930593409470208,2020-07,4347.17,3405.32,2525.72,2658.78,808.79,-5513.51
875930593409470208,2020-08,6957.34,4011.44,6344.05,5969.99,3319.96,-2193.55
875930593409470208,2020-09,3625.12,2600.24,3654.59,5735.14,-1055.67,-3249.22
875930593409470208,2020-10,1733.54,4144.75,2055.68,1432.58,-1788.11,-5037.33
875930593409470208,2020-11,2694.35,3675.34,3441.28,4385.55,-1925.26,-6962.59
875930593409470208,2020-12,4953.28,4359.93,2980.03,3752.11,-178.73,-7141.32
877726799700215808,2020-01,125.03,1053.71,2801.95,5123.45,-3250.18,-3250.18
877726799700215808,2020-02,3448.45,0,2336.88,238.13,5547.2,2297.02
877726799700215808,2020-03,722.46,900.72,4429.95,1983.87,2267.82,4564.84
877726799700215808,2020-04,4218.26,2653.02,3751.98,0,5317.22,9882.06
877726799700215808,2020-05,2876.37,3346.57,4176.29,3477.17,228.92,10110.98
877726799700215808,2020-06,2128.06,1846.78,2236.93,2583.91,-65.7,10045.28
877726799700215808,2020-07,3771.56,2177.83,488.94,0,2082.67,12127.95
877726799700215808,2020-08,354.88,1323.85,3232.71,6466.1,-4202.36,7925.59
877726799700215808,2020-09,4543.15,0,1275.8,3830.84,1988.11,9913.7
877726799700215808,2020-10,784.83,3374.02,791.49,0,-1797.7,8116
877726799700215808,2020-11,0,471.31,0,0,-471.31,7644.69
877726799700215808,2020-12,4747.8,843.24,3096.44,3773.2,3227.8,10872.49
877955545917847296,2020-01,2470.88,3394.75,5047.32,482.96,3640.49,3640.49
877955545917847296,2020-02,1813.18,4551.11,6440.99,2340.71,1362.35,5002.84
877955545917847296,2020-03,0,900.58,3019.22,2345.03,-226.39,4776.45
877955545917847296,2020-04,751.95,1321.14,3843.42,2204.09,1070.14,5846.59
877955545917847296,2020-05,2565.73,3911.79,2519.85,2952.85,-1779.06,4067.53
877955545917847296,2020-06,4726.03,4563.99,4771.64,516.78,4416.9,8484.43
877955545917847296,2020-07,1775.36,4204.39,0,0,-2429.03,6055.4
877955545917847296,2020-08,2029.23,0,4039.67,5709.8,359.1,6414.5
877955545917847296,2020-09,0,437.97,1360.59,1523.8,-601.18,5813.32
877955545917847296,2020-10,2728.69,261.74,1255.7,240.75,3481.9,9295.22
877955545917847296,2020-11,2468.66,5318.05,907.12,4352.73,-6295,3000.22
877955545917847296,2020-12,5452,1495.88,4081.32,1780.13,6257.31,9257.53
878202617170483968,2020-01,712.8,4265.34,4169.79,1289.47,-672.22,-672.22
878202617170483968,2020-02,828.99,3158.24,4671.26,5015.86,-2673.85,-3346.07
878202617170483968,2020-03,4243.97,882.5,782.75,2029.36,2114.86,-1231.21
878202617170483968,2020-04,1573.29,1334.03,3169.73,3802.42,-393.43,-1624.64
878202617170483968,2020-05,6850.32,5091.13,4979.79,6495.43,243.55,-1381.09
878202617170483968,2020-06,741.82,3465.12,3488.82,4186.11,-3420.59,-4801.68
878202617170483968,2020-07,0,873.82,3492.76,2032.42,586.52,-4215.16
878202617170483968,2020-08,2316.68,3033.01,1585.29,3389.81,-2520.85,-6736.01
878202617170483968,2020-09,5182.24,1370.21,2747.44,2191.44,4368.03,-2367.98
878202617170483968,2020-10,0,2805.44,1685.75,2763.31,-3883,-6250.98
878202617170483968,2020-11,396.29,3899.05,1315.45,2356.02,-4543.33,-10794.31
878202617170483968,2020-12,3943.28,2357.17,2971.18,1845.91,2711.38,-8082.93
878819631503187584,2020-01,2009.39,5011.92,3214.15,1599.01,-1387.39,-1387.39
878819631503187584,2020-02,359.1,1168.85,2023.94,1647.45,-433.26,-1820.65
878819631503187584,2020-03,4876.32,3501.65,1074.09,4172.25,-1723.49,-3544.14
878819631503187584,2020-04,2664.7,1106.38,4087.49,2716.85,2928.96,-615.18
878819631503187584,2020-05,1314.73,750.63,3298.44,2857.64,1004.9,389.72
878819631503187584,2020-06,1779.35,944.12,928.77,6780.58,-5016.58,-4626.86
878819631503187584,2020-07,1756.12,1030.95,3152.51,3443.95,433.73,-4193.13
878819631503187584,2020-08,1877.26,1289.41,1427.99,2883.77,-867.93,-5061.06
878819631503187584,2020-09,2442.82,3176.79,2594.05,0,1860.08,-3200.98
878819631503187584,2020-10,0,4607.38,3029.19,1051.31,-2629.5,-5830.48
878819631503187584,2020-11,0,1682.57,1623.25,1491.37,-1550.69,-7381.17
878819631503187584,2020-12,1985.55,2962.27,0,5354.77,-6331.49,-13712.66
878849460399241856,2020-01,0,809.28,2407.71,467.24,1131.19,1131.19
878849460399241856,2020-02,4014.42,3497.57,292.03,1625.95,-817.07,314.12
878849460399241856,2020-05,0,3323.11,1872.22,0,-1450.89,-1136.77
878849460399241856,2020-06,3270.36,0,3566.24,2272.37,4564.23,3427.46
878849460399241856,2020-07,1133.53,0,878.22,0,2011.75,5439.21
878849460399241856,2020-08,2452.88,914.16,0,212.76,1325.96,6765.17
878849460399241856,2020-09,3580.69,0,1815.81,2406.72,2989.78,9754.95
878849460399241856,2020-10,786.86,0,1199.29,1431.84,554.31,10309.26
878849460399241856,2020-11,409.7,0,2315.6,1935.87,789.43,11098.69
878849460399241856,2020-12,1000.44,0,0,1188.24,-187.8,10910.89
879246807151018112,2020-01,3671.16,1503.9,2834.62,2321.27,2680.61,2680.61
879246807151018112,2020-02,312.59,5393.8,310.15,1551.24,-6322.3,-3641.69
879246807151018112,2020-03,517.34,1905.58,3060.76,1035.79,636.73,-3004.96
879246807151018112,2020-04,1858.01,4260.97,0,4062.43,-6465.39,-9470.35
879246807151018112,2020-05,1191.08,0,2022.31,2338.01,875.38,-8594.97
879246807151018112,2020-06,669.37,1162.94,2232.93,6143.85,-4404.49,-12999.46
879246807151018112,2020-07,915.06,2216.16,838.76,2623.19,-3085.53,-16084.99
879246807151018112,2020-08,5158.2,382.06,1739.32,1745.15,4770.31,-11314.68
879246807151018112,2020-09,5032.25,1509.54,6036.71,231.17,9328.25,-1986.43
879246807151018112,2020-10,2299.25,3572.8,4341.39,661.26,2406.58,420.15
879246807151018112,2020-11,1605.47,1880.4,1907.18,3338.95,-1706.7,-1286.55
879246807151018112,2020-12,2060.47,1852.14,0,1522.47,-1314.14,-2600.69
880608027850950400,2020-01,1682.64,2503.55,34.55,1555.39,-2341.75,-2341.75
880608027850950400,2020-02,2317.38,2356.68,2463.01,3628.27,-1204.56,-3546.31
880608027850950400,2020-03,0,1801.15,904.05,2323.79,-3220.89,-6767.2
880608027850950400,2020-04,1138.53,802.27,2456.8,3308.88,-515.82,-7283.02
880608027850950400,2020-05,1199.22,3694.79,211.25,1339.5,-3623.82,-10906.84
880608027850950400,2020-06,1987.23,262.21,0,0,1725.02,-9181.82
880608027850950400,2020-07,2738.06,4776.08,7340.98,3178.91,2124.05,-7057.77
880608027850950400,2020-08,2416.8,3991.98,446.68,3960.71,-5089.21,-12146.98
880608027850950400,2020-09,5512.1,2695.12,4807.54,3678.02,3946.5,-8200.48
880608027850950400,2020-10,2718.71,3725.83,1457.01,804.92,-355.03,-8555.51
880608027850950400,2020-11,6276.62,2531.66,1049.36,2737.83,2056.49,-6499.02
880608027850950400,2020-12,4907,5902.18,3708.45,2109.7,603.57,-5895.45
880713829515643264,2020-07,0,1429.89,0,0,-1429.89,-1429.89
881520991812314496,2020-01,10062.94,3465.65,3585.26,2903.21,7279.34,7279.34
881520991812314496,2020-02,5650.43,7058.25,3987.57,1766.96,812.79,8092.13
881520991812314496,2020-03,0,3638.17,5489,4070.14,-2219.31,5872.82
881520991812314496,2020-04,5471.7,1585.89,10459.85,4933.81,9411.85,15284.67
881520991812314496,2020-05,3294.76,3343.1,1341.56,2804.56,-1511.34,13773.33
881520991812314496,2020-06,1547.89,1920.47,3982.41,0,3609.83,17383.16
881520991812314496,2020-07,4829.91,2302.4,3770.02,5334.25,963.28,18346.44
881520991812314496,2020-08,7571.37,2062.57,6313.6,2227.19,9595.21,27941.65
881520991812314496,2020-09,4812.46,3437.6,8158.31,2807.33,6725.84,34667.49
881520991812314496,2020-10,3774.61,7056.05,8022.09,4910.3,-169.65,34497.84
881520991812314496,2020-11,5663.12,1532.97,7175.88,2179.66,9126.37,43624.21
881520991812314496,2020-12,5205.62,11044.78,3920.51,7669.98,-9588.63,34035.58
883313527838132864,2020-01,6390.23,1080.31,2636.24,2583.95,5362.21,5362.21
883313527838132864,2020-02,1561.44,1962.96,3763.46,6345.86,-2983.92,2378.29
883313527838132864,2020-03,5637.81,1643.11,3495.15,1876.91,5612.94,7991.23
883313527838132864,2020-04,6532.93,1808.51,1816.1,2171.49,4369.03,12360.26
883313527838132864,2020-05,4155.28,4789.47,2039.65,2761.08,-1355.62,11004.64
883313527838132864,2020-06,2402.12,4399.13,2849.21,5003.27,-4151.07,6853.57
883313527838132864,2020-07,5073.91,2098.31,3512.15,9475,-2987.25,3866.32
883313527838132864,2020-08,3043.88,961.96,2669.17,1931.66,2819.43,6685.75
883313527838132864,2020-09,2758.57,2858.68,4544.86,5037.63,-592.88,6092.87
883313527838132864,2020-10,2516.3,3021.42,671.6,3800.3,-3633.82,2459.05
883313527838132864,2020-11,4822.52,7705.57,4290.13,5371.05,-3963.97,-1504.92
883313527838132864,2020-12,3531.56,2451.21,1947.04,2057.11,970.28,-534.64
883498685148284544,2020-01,3832.28,3486.36,5794.32,1915.12,4225.12,4225.12
883498685148284544,2020-02,3398.99,4494.48,1246.07,3623.46,-3472.88,752.24
883498685148284544,2020-03,5878.94,0,2304.94,3073.89,5109.99,5862.23
883498685148284544,2020-04,2137.67,2341.11,2251.01,1436.74,610.83,6473.06
883498685148284544,2020-05,1236.32,6680.92,5533.17,5387.59,-5299.02,1174.04
883498685148284544,2020-06,2934.1,4251.38,1792.18,775.07,-300.17,873.87
883498685148284544,2020-07,1553.38,2946.84,4736.57,2408.67,934.44,1808.31
883498685148284544,2020-08,5948.78,6970.57,5808.78,2777.21,2009.78,3818.09
883498685148284544,2020-09,6446.67,3667.69,2172.8,7236.69,-2284.91,1533.18
883498685148284544,2020-10,5676.75,5348.91,2866.93,4255.93,-1061.16,472.02
883498685148284544,2020-11,5630.96,1781.14,7636.79,2827.4,8659.21,9131.23
883498685148284544,2020-12,2316.85,1881.4,2559.06,1151.91,1842.6,10973.83
883960559677549568,2020-01,4390.64,4723.85,1821.55,7153.07,-5664.73,-5664.73
883960559677549568,2020-02,3223.53,1807.75,8303.9,3853.13,5866.55,201.82
883960559677549568,2020-03,6915.99,4595.81,4998.43,2558.28,4760.33,4962.15
883960559677549568,2020-04,5374.77,5794.87,4155.96,5438.88,-1703.02,3259.13
883960559677549568,2020-05,3380.34,5161.06,3040.05,1437.58,-178.25,3080.88
883960559677549568,2020-06,3861.01,4320.71,4020,7143.6,-3583.3,-502.42
883960559677549568,2020-07,541.91,4722.64,7407.97,4787.24,-1560,-2062.42
883960559677549568,2020-08,4369.25,764.9,4166.56,3035.88,4735.03,2672.61
883960559677549568,2020-09,3945.85,3283.18,6019.99,1631.38,5051.28,7723.89
883960559677549568,2020-10,1828.33,1553.92,2131.95,4128.69,-1722.33,6001.56
883960559677549568,2020-11,7305.1,8898.01,5609.78,2493.87,1523,7524.56
883960559677549568,2020-12,3200.88,3655.55,4742.58,4304.62,-16.71,7507.85
885476634917380864,2020-01,5073.31,3377.37,3442.7,1827.59,3311.05,3311.05
885476634917380864,2020-02,1825.19,1611.3,2551.95,1113.57,1652.27,4963.32
885476634917380864,2020-03,1021.87,1240.87,1232.76,4920.07,-3906.31,1057.01
885476634917380864,2020-04,1238.35,2781.76,458.13,4369.07,-5454.35,-4397.34
885476634917380864,2020-05,1251.68,1238.51,2204.13,1675.5,541.8,-3855.54
885476634917380864,2020-06,1176.57,3641.87,2242.12,4238.53,-4461.71,-8317.25
885476634917380864,2020-07,2183.51,3426.25,1254.98,0,12.24,-8305.01
885476634917380864,2020-08,1724.41,3817.9,690.54,2446.48,-3849.43,-12154.44
885476634917380864,2020-09,5611.98,1907.29,1116.15,2357.06,2463.78,-9690.66
885476634917380864,2020-10,1733.97,5153.44,1907.37,0,-1512.1,-11202.76
885476634917380864,2020-11,0,3494.94,1013.65,3545.86,-6027.15,-17229.91
885476634917380864,2020-12,1834.45,1884.94,1446.44,4570.55,-3174.6,-20404.51
885777775016036224,2020-01,2634.35,1962.74,1026.48,835.47,862.62,862.62
885777775016036224,2020-02,2220.22,1616.84,0,1970.45,-1367.07,-504.45
885777775016036224,2020-03,2683.55,0,3575.37,1962.72,4296.2,3791.75
885777775016036224,2020-04,0,1819.12,310.37,1912.06,-3420.81,370.94
885777775016036224,2020-05,3285.86,0,1304.84,1343.58,3247.12,3618.06
885777775016036224,2020-06,0,1290.1,415.13,0,-874.97,2743.09
885777775016036224,2020-07,861.03,3655.38,2849.04,375.49,-320.8,2422.29
885777775016036224,2020-08,4131.74,2108.1,82.7,1282.24,824.1,3246.39
885777775016036224,2020-09,1509.2,364.82,3853.26,1694.85,3302.79,6549.18
885777775016036224,2020-10,950.03,345.65,0,375.28,229.1,6778.28
885777775016036224,2020-11,712.79,1504.46,0,2392.59,-3184.26,3594.02
885777775016036224,2020-12,1926.63,0,1398.31,3635.73,-310.79,3283.23
887546302810171776,2020-01,2457.24,6006.94,2394.61,2284.87,-3439.96,-3439.96
887546302810171776,2020-02,0,1589.53,1913.37,6863.87,-6540.03,-9979.99
887546302810171776,2020-03,3616.98,0,350.26,991.21,2976.03,-7003.96
887546302810171776,2020-04,0,4526.42,1458.49,1354.48,-4422.41,-11426.37
887546302810171776,2020-05,3969.39,2500.82,544.56,260.81,1752.32,-9674.05
887546302810171776,2020-06,3821.75,404.68,2111.26,1193.35,4334.98,-5339.07
887546302810171776,2020-07,1400.79,2882.1,1493.96,1136.29,-1123.64,-6462.71
887546302810171776,2020-08,3843,0,184.93,2581.14,1446.79,-5015.92
887546302810171776,2020-09,3762.34,0,0,3797.7,-35.36,-5051.28
887546302810171776,2020-10,470.46,2893.48,1772.43,3063.4,-3713.99,-8765.27
887546302810171776,2020-11,2725.03,1423.59,2000,2714.41,587.03,-8178.24
887546302810171776,2020-12,1834.81,1183.53,1480.85,2765.32,-633.19,-8811.43
889323019829510656,2020-01,3846.83,6377.32,3605.27,2892.77,-1817.99,-1817.99
889323019829510656,2020-02,1742.68,639.01,7753.51,1626.01,7231.17,5413.18
889323019829510656,2020-03,7381.51,5332.97,7287.94,4137.1,5199.38,10612.56
889323019829510656,2020-04,4509.09,2943.67,5888.35,4380.12,3073.65,13686.21
889323019829510656,2020-05,6143.83,6577,3346.95,4954.39,-2040.61,11645.6
889323019829510656,2020-06,7849.35,6781.68,1468.95,3747.67,-1211.05,10434.55
889323019829510656,2020-07,4212.9,7151.73,1185.25,3813.56,-5567.14,4867.41
889323019829510656,2020-08,1597.04,7565.06,1862.86,5833.26,-9938.42,-5071.01
889323019829510656,2020-09,6862.12,6332.57,5486.86,1528.47,4487.94,-583.07
889323019829510656,2020-10,8770.42,4863.65,384.65,9023.75,-4732.33,-5315.4
889323019829510656,2020-11,4539.84,4584.53,1307.74,5363.87,-4100.82,-9416.22
889323019829510656,2020-12,4408.48,5983.93,7626.07,3293.89,2756.73,-6659.49
889797537612451072,2020-01,0,1683.41,4976.62,0,3293.21,3293.21
889797537612451072,2020-03,0,591.47,0,0,-591.47,2701.74
889797537612451072,2020-04,1615.77,0,4626.18,0,6241.95,8943.69
889797537612451072,2020-06,2077.72,0,0,1060.18,1017.54,9961.23
889797537612451072,2020-09,1640.71,0,0,0,1640.71,11601.94
889797537612451072,2020-10,0,363.1,1402.89,0,1039.79,12641.73
889797537612451072,2020-11,0,2215.35,0,0,-2215.35,10426.38
889797537612451072,2020-12,1942.48,0,0,0,1942.48,12368.86
891012845611495040,2020-01,1701.19,1393.71,2075.72,2268.18,115.02,115.02
891012845611495040,2020-02,1299.75,1199.15,1255.92,1632.67,-276.15,-161.13
891012845611495040,2020-03,1979.27,2946.78,5421.81,2309.96,2144.34,1983.21
891012845611495040,2020-04,4392.19,2667.41,1671.33,5954.47,-2558.36,-575.15
891012845611495040,2020-05,8256.86,3350.25,4583.15,9255.75,234.01,-341.14
891012845611495040,2020-06,3702.7,3239.36,5930.26,1589.73,4803.87,4462.73
891012845611495040,2020-07,654.53,6265.03,5531.87,973.32,-1051.95,3410.78
891012845611495040,2020-08,5775.97,1079.36,2538.02,990.01,6244.62,9655.4
891012845611495040,2020-09,4319.48,6073.1,4221.93,2246.19,222.12,9877.52
891012845611495040,2020-10,527.82,4636.58,1545.65,5657.8,-8220.91,1656.61
891012845611495040,2020-11,4868.78,650.79,977.74,1965.41,3230.32,4886.93
891012845611495040,2020-12,3192.86,3217.53,3394.98,5375.69,-2005.38,2881.55
892028638635931264,2020-01,6116.04,1067.68,4251.25,4834.94,4464.67,4464.67
892028638635931264,2020-02,1045.85,3550.49,985.85,5789.77,-7308.56,-2843.89
892028638635931264,2020-03,5544.16,0,2367.04,1920.51,5990.69,3146.8
892028638635931264,2020-04,7298.29,1030.49,3901.55,4574.11,5595.24,8742.04
892028638635931264,2020-05,4958.22,3175.92,4401.24,5393.8,789.74,9531.78
892028638635931264,2020-06,2769.59,6070.32,5645.61,3696.77,-1351.89,8179.89
892028638635931264,2020-07,5601.96,4375.86,3742.93,2629.13,2339.9,10519.79
892028638635931264,2020-08,5662.18,2093.21,2004.39,8103.8,-2530.44,7989.35
892028638635931264,2020-09,5240.17,4201.46,7215.74,2301.17,5953.28,13942.63
892028638635931264,2020-10,3990.02,9909.4,1491.17,3189.58,-7617.79,6324.84
892028638635931264,2020-11,7230.5,130.92,3832.01,3971.74,6959.85,13284.69
892028638635931264,2020-12,2914.95,0,0,2134.03,780.92,14065.61
893388094452804352,2020-01,647.24,2434.53,1923.25,4522.81,-4386.85,-4386.85
893388094452804352,2020-02,1907.52,1242.44,3066.64,3653.23,78.49,-4308.36
893388094452804352,2020-03,3918.82,2220.49,4031.89,4258.71,1471.51,-2836.85
893388094452804352,2020-04,5421.88,1112.54,1693.45,7251.12,-1248.33,-4085.18
893388094452804352,2020-05,4521.53,1624.07,3122.24,2105.73,3913.97,-171.21
893388094452804352,2020-06,2503.03,3767.32,1868.62,1568.65,-964.32,-1135.53
893388094452804352,2020-07,6601.97,5850.87,6458.67,1699.07,5510.7,4375.17
893388094452804352,2020-08,4178.12,1795.9,3919.81,4239.7,2062.33,6437.5
893388094452804352,2020-09,116.21,8887.57,3564.72,2340.79,-7547.43,-1109.93
893388094452804352,2020-10,3113.49,761.1,4509.38,3449.05,3412.72,2302.79
893388094452804352,2020-11,608.67,3076.62,5125.36,1065.55,1591.86,3894.65
893388094452804352,2020-12,3861.45,4358.56,1669.7,1312.3,-139.71,3754.94
894110182404680576,2020-01,4668.47,0,677.05,1880.2,3465.32,3465.32
894110182404680576,2020-02,1511.67,0,82.79,840.39,754.07,4219.39
894110182404680576,2020-03,6211.6,3205.43,3130.38,1671.84,4464.71,8684.1
894110182404680576,2020-04,2815.23,6259.26,2753.86,7729.68,-8419.85,264.25
894110182404680576,2020-05,5081.61,4158.07,4340.58,7248.13,-1984.01,-1719.76
894110182404680576,2020-06,3178.17,0,2398.2,1445.62,4130.75,2410.99
894110182404680576,2020-07,3243.8,4173.15,1816.25,1189.85,-302.95,2108.04
894110182404680576,2020-08,4894.83,4500.54,5595.31,2228.03,3761.57,5869.61
894110182404680576,2020-09,119.76,3347.13,1293.91,7838.27,-9771.73,-3902.12
894110182404680576,2020-10,5089.8,2461.31,2855.2,4943.32,540.37,-3361.75
894110182404680576,2020-11,3074.69,3627.94,510.49,4438.77,-4481.53,-7843.28
894110182404680576,2020-12,2785.02,3293.82,1501.1,3348.51,-2356.21,-10199.49
894248497255069824,2020-01,1444.55,3326.4,0,0,-1881.85,-1881.85
894248497255069824,2020-02,0,2066.38,1179.7,0,-886.68,-2768.53
894248497255069824,2020-03,0,1370.61,0,0,-1370.61,-4139.14
894248497255069824,2020-04,2304.58,417.24,1879.96,2043.53,1723.77,-2415.37
894248497255069824,2020-06,1877.29,2405.9,0,685.65,-1214.26,-3629.63
894248497255069824,2020-07,1045.53,1343.47,318.3,194.13,-173.77,-3803.4
894248497255069824,2020-08,2202.78,45.37,0,0,2157.41,-1645.99
894248497255069824,2020-09,1257.23,2451.14,0,0,-1193.91,-2839.9
894248497255069824,2020-10,107.06,940.14,1382.65,0,549.57,-2290.33
894248497255069824,2020-11,0,380.68,290.74,39.61,-129.55,-2419.88
894248497255069824,2020-12,1906.77,0,449.68,1597.11,759.34,-1660.54
895276165910874240,2020-01,1979.15,0,3604.24,0,5583.39,5583.39
895276165910874240,2020-02,5001.01,4143.52,0,1528.9,-671.41,4911.98
895276165910874240,2020-03,2401.38,1697.63,1296.72,4578.75,-2578.28,2333.7
895276165910874240,2020-04,4534.39,0,4846.87,1569.7,7811.56,10145.26
895276165910874240,2020-05,1123.83,3428.92,3368.87,2459.89,-1396.11,8749.15
895276165910874240,2020-06,3224.47,7030.83,797.96,492.89,-3501.29,5247.86
895276165910874240,2020-07,3903.41,2120.68,234.97,940.21,1077.49,6325.35
895276165910874240,2020-08,2508.94,193.91,1747.96,6957.95,-2894.96,3430.39
895276165910874240,2020-09,7805.6,4373.13,1261.66,3946.42,747.71,4178.1
895276165910874240,2020-10,1478.14,1406.39,4213.51,1546.21,2739.05,6917.15
895276165910874240,2020-11,3700.2,1520.05,1998.22,442.84,3735.53,10652.68
895276165910874240,2020-12,4039.52,1833.82,5052.22,1330.57,5927.35,16580.03
896314166257328000,2020-01,6618.35,4068.61,5808.62,3216.58,5141.78,5141.78
896314166257328000,2020-02,901.72,2784.83,6217.02,4719.19,-385.28,4756.5
896314166257328000,2020-03,4184.52,2966.54,3818.98,3552.71,1484.25,6240.75
896314166257328000,2020-04,3713.5,3802.6,3228.15,7272.14,-4133.09,2107.66
896314166257328000,2020-05,8100.7,5459.11,3394.07,4860.94,1174.72,3282.38
896314166257328000,2020-06,2468.27,6059.06,5422.96,5046.85,-3214.68,67.7
896314166257328000,2020-07,0,3432.24,3333.46,4464.79,-4563.57,-4495.87
896314166257328000,2020-08,2050.52,2501.54,1823.4,1837.96,-465.58,-4961.45
896314166257328000,2020-09,5351.43,14304.78,4788.79,5216.17,-9380.73,-14342.18
896314166257328000,2020-10,3961.98,3697.07,2075.69,2142.42,198.18,-14144
896314166257328000,2020-11,2710.08,9533.62,2095.79,2659.14,-7386.89,-21530.89
896314166257328000,2020-12,3634.06,3046.66,2082.66,2191.7,478.36,-21052.53
896319645722297728,2020-01,1086.62,3479.82,0,301.04,-2694.24,-2694.24
896319645722297728,2020-02,0,871.72,0,1811.78,-2683.5,-5377.74
896319645722297728,2020-04,636.57,2022.33,1697.32,0,311.56,-5066.18
896319645722297728,2020-05,0,3596.88,3109.3,0,-487.58,-5553.76
896319645722297728,2020-06,1827.53,0,1170.41,1554.91,1443.03,-4110.73
896319645722297728,2020-07,0,1252.37,0,0,-1252.37,-5363.1
896319645722297728,2020-08,1119.33,944.92,0,0,174.41,-5188.69
896319645722297728,2020-09,1673.29,0,0,0,1673.29,-3515.4
896319645722297728,2020-10,1582.15,1419.25,1310.96,536.45,937.41,-2577.99
896319645722297728,2020-11,103.58,1078.38,1440.97,0,466.17,-2111.82
896319645722297728,2020-12,2351.08,670.1,0,1847.02,-166.04,-2277.86
896503709386724992,2020-01,8516.87,4569.84,3961.08,4245.83,3662.28,3662.28
896503709386724992,2020-02,4700.63,2004.99,2543.42,5641.95,-402.89,3259.39
896503709386724992,2020-03,2740.52,6522.51,6397.21,2107.4,507.82,3767.21
896503709386724992,2020-04,2394.23,2852.99,5807.63,6768.86,-1419.99,2347.22
896503709386724992,2020-05,7511.54,9723.09,7131.86,6347.61,-1427.3,919.92
896503709386724992,2020-06,7080.88,3981.43,2368.28,3636.44,1831.29,2751.21
896503709386724992,2020-07,6613.83,5335.19,5430.07,7844.59,-1135.88,1615.33
896503709386724992,2020-08,0,2036.79,4167.34,2343.44,-212.89,1402.44
896503709386724992,2020-09,6563.56,3819.77,6132.99,2873.82,6002.96,7405.4
896503709386724992,2020-10,3455.16,4370.18,6431.29,5249.07,267.2,7672.6
896503709386724992,2020-11,5433.51,2626.92,5099.66,5535.84,2370.41,10043.01
896503709386724992,2020-12,6992.51,827.02,6858.25,9134.9,3888.84,13931.85
897515055954444800,2020-01,0,3541.92,5722.31,3443.11,-1262.72,-1262.72
897515055954444800,2020-02,2944.35,1652.41,3168.88,1407.83,3052.99,1790.27
897515055954444800,2020-03,2837.68,3348.87,2197.96,1895.31,-208.54,1581.73
897515055954444800,2020-04,714.17,4317.52,0,845.24,-4448.59,-2866.86
897515055954444800,2020-05,4942.21,1963.11,1813.77,651.09,4141.78,1274.92
897515055954444800,2020-06,3212.41,4376.17,1470.92,6928.35,-6621.19,-5346.27
897515055954444800,2020-07,1006.44,4627.69,4151.32,411.45,118.62,-5227.65
897515055954444800,2020-08,4456.16,1445.5,1504.69,2944.24,1571.11,-3656.54
897515055954444800,2020-09,520.08,1922.55,5368.06,1757.64,2207.95,-1448.59
897515055954444800,2020-10,1369.38,0,2462.36,0,3831.74,2383.15
897515055954444800,2020-11,1209.25,0,1217.61,3237.41,-810.55,1572.6
897515055954444800,2020-12,80.39,0,3824.86,1875.24,2030.01,3602.61
897848199327341312,2020-02,1261.74,1055.53,0,0,206.21,206.21
897848199327341312,2020-04,1656.4,1773.05,0,0,-116.65,89.56
897848199327341312,2020-06,137.47,0,0,0,137.47,227.03
897848199327341312,2020-07,0,1591.26,558.1,0,-1033.16,-806.13
897848199327341312,2020-09,1623.94,0,0,0,1623.94,817.81
897848199327341312,2020-10,1582.18,0,486.13,1979.52,88.79,906.6
899327100340282112,2020-02,0,1616.35,0,0,-1616.35,-1616.35
899327100340282112,2020-05,68.07,0,0,0,68.07,-1548.28
899327100340282112,2020-06,0,1813.18,0,0,-1813.18,-3361.46
899327100340282112,2020-10,0,1872.34,0,0,-1872.34,-5233.8
899440079090559744,2020-01,5638.96,5172.99,689.65,1804.88,-649.26,-649.26
899440079090559744,2020-02,1265.36,846.42,1248.33,752.3,914.97,265.71
899440079090559744,2020-03,3360.41,1230.75,0,3719.33,-1589.67,-1323.96
899440079090559744,2020-04,651.29,1731.36,1201.11,2563.24,-2442.2,-3766.16
899440079090559744,2020-05,6131.31,3290.84,1520.61,1569.94,2791.14,-975.02
899440079090559744,2020-06,2323.77,504.4,643.01,1401.45,1060.93,85.91
899440079090559744,2020-07,292.11,985.21,1595.91,1545.98,-643.17,-557.26
899440079090559744,2020-08,1593.12,4108.42,3253.82,4180.99,-3442.47,-3999.73
899440079090559744,2020-09,8059.8,646.96,2266.29,1257.67,8421.46,4421.73
899440079090559744,2020-10,3073.26,2539.95,1170.29,7073.81,-5370.21,-948.48
899440079090559744,2020-11,2650.59,2843.81,1222.76,0,1029.54,81.06
899440079090559744,2020-12,1502.41,1760.01,2597.95,0,2340.35,2421.41
899491902900462336,2020-01,2357.07,8109.4,7383.9,2422.41,-790.84,-790.84
899491902900462336,2020-02,927.11,0,7120.83,1744.17,6303.77,5512.93
899491902900462336,2020-03,4412.51,5473.16,6034.38,7234.44,-2260.71,3252.22
899491902900462336,2020-04,6721.24,1001.92,4007.97,3183.27,6544.02,9796.24
899491902900462336,2020-05,510.47,0,2417.53,5988.99,-3060.99,6735.25
899491902900462336,2020-06,2369.48,1471.52,1895.34,1236.24,1557.06,8292.31
899491902900462336,2020-07,10230.03,914.49,1816.05,4186.61,6944.98,15237.29
899491902900462336,2020-08,4613.97,3651.14,4696,3756.79,1902.04,17139.33
899491902900462336,2020-09,6624.42,2038.83,4897.9,3298.26,6185.23,23324.56
899491902900462336,2020-10,2057.51,7467.7,6263.3,0,853.11,24177.67
899491902900462336,2020-11,5235.14,2323.23,458.81,3146.32,224.4,24402.07
899491902900462336,2020-12,1971.85,1238.45,2947.18,4677.1,-996.52,23405.55
899560135401107712,2020-01,5443.51,0,4767.1,0,10210.61,10210.61
899560135401107712,2020-02,1195.45,6709.53,3048.45,3234.17,-5699.8,4510.81
899560135401107712,2020-03,0,1948.31,1102.57,894.46,-1740.2,2770.61
899560135401107712,2020-04,0,2790.35,1374.77,2115.99,-3531.57,-760.96
899560135401107712,2020-07,480.39,2412.22,1387.07,1805.83,-2350.59,-3111.55
899560135401107712,2020-08,214.47,999.05,21.73,1381.27,-2144.12,-5255.67
899560135401107712,2020-09,1512.9,1705.84,2725.8,5045.08,-2512.22,-7767.89
899560135401107712,2020-10,0,1529.54,1325.03,2646.56,-2851.07,-10618.96
899560135401107712,2020-11,1070.9,648.29,3708.96,0,4131.57,-6487.39
899560135401107712,2020-12,4788.86,607.51,0,1263.82,2917.53,-3569.86
902735853673943424,2020-01,1941.87,1524.49,0,1123.82,-706.44,-706.44
902735853673943424,2020-02,4233.17,4424.85,1962.58,1817.16,-46.26,-752.7
902735853673943424,2020-03,2785.77,1677.5,3286.71,1571.49,2823.49,2070.79
902735853673943424,2020-04,1269.91,1468.24,279.43,4943.92,-4862.82,-2792.03
902735853673943424,2020-05,900.89,3877.61,3362.94,1677.46,-1291.24,-4083.27
902735853673943424,2020-06,194.13,1639.29,2797.35,3791.06,-2438.87,-6522.14
902735853673943424,2020-07,2038.58,6699.28,7541.16,0,2880.46,-3641.68
902735853673943424,2020-08,3099.32,0,1673.64,4932.76,-159.8,-3801.48
902735853673943424,2020-09,538.93,1425.39,1027.61,4083.59,-3942.44,-7743.92
902735853673943424,2020-10,5525.82,6414.42,6428.38,3161.69,2378.09,-5365.83
902735853673943424,2020-11,506.2,1703.76,5411.53,4294.37,-80.4,-5446.23
902735853673943424,2020-12,6156.76,1775.95,0,4577.93,-197.12,-5643.35
903416914643083904,2020-01,6580.73,2928.92,2210.72,10988.74,-5126.21,-5126.21
903416914643083904,2020-02,9348.43,7786.38,1739.32,3390.15,-88.78,-5214.99
903416914643083904,2020-03,5602.85,4162.51,3664.72,7428.2,-2323.14,-7538.13
903416914643083904,2020-04,4317.7,6601.79,4765.69,2434.76,46.84,-7491.29
903416914643083904,2020-05,2357.99,4238.61,8517.37,1832.06,4804.69,-2686.6
903416914643083904,2020-06,6307.13,6663.93,1926.77,3879.98,-2310.01,-4996.61
903416914643083904,2020-07,1163.53,5240.89,2504.69,3661.76,-5234.43,-10231.04
903416914643083904,2020-08,3345.26,3574.16,4342.57,8739.9,-4626.23,-14857.27
903416914643083904,2020-09,7879.45,7991.17,3588.29,4715.51,-1238.94,-16096.21
903416914643083904,2020-10,3596.35,6833.59,9012.24,3383.59,2391.41,-13704.8
903416914643083904,2020-11,2935.39,5582.9,2480.92,1836.11,-2002.7,-15707.5
903416914643083904,2020-12,3654.6,6289.43,1540.52,1550.64,-2644.95,-18352.45
903755268686218880,2020-01,1728.61,0,0,0,1728.61,1728.61
903755268686218880,2020-03,0,359.99,0,487.28,-847.27,881.34
903755268686218880,2020-04,1951.35,0,0,0,1951.35,2832.69
903755268686218880,2020-05,48.84,0,540.82,0,589.66,3422.35
903755268686218880,2020-06,1892.13,0,0,1309.54,582.59,4004.94
903755268686218880,2020-07,0,483.78,0,0,-483.78,3521.16
903755268686218880,2020-10,398.21,1327.29,1448.71,180.48,339.15,3860.31
903755268686218880,2020-12,1762.73,1646.42,760.49,0,876.8,4737.11
908913142039151872,2020-01,272.78,2907.24,4034.65,288.64,1111.55,1111.55
908913142039151872,2020-02,2079.33,5500.22,0,3453.14,-6874.03,-5762.48
908913142039151872,2020-03,2813.25,6384.14,3976.96,3468.3,-3062.23,-8824.71
908913142039151872,2020-04,5592.87,4692.62,5695.61,3830.84,2765.02,-6059.69
908913142039151872,2020-05,3249.66,0,901.92,1998,2153.58,-3906.11
908913142039151872,2020-06,4955.52,3827.61,3318.86,2630.8,1815.97,-2090.14
908913142039151872,2020-07,1682.95,1357.33,1177.51,1589.73,-86.6,-2176.74
908913142039151872,2020-08,3206.05,6336.78,0,7900.72,-11031.45,-13208.19
908913142039151872,2020-09,4286.8,4541.25,4393.22,2513.43,1625.34,-11582.85
908913142039151872,2020-10,5262.03,1792.15,2051.62,2234.25,3287.25,-8295.6
908913142039151872,2020-11,513.91,5754.55,2934.07,1398.08,-3704.65,-12000.25
908913142039151872,2020-12,1334.49,3295.65,6534.49,2309.18,2264.15,-9736.1
909866258011837440,2020-01,0,3574.24,5256.3,0,1682.06,1682.06
909866258011837440,2020-02,1271.8,8604.96,5635.4,457.75,-2155.51,-473.45
909866258011837440,2020-03,7685.22,3828.23,4161.7,3778.24,4240.45,3767
909866258011837440,2020-04,3607.34,350.97,3072.6,3320.52,3008.45,6775.45
909866258011837440,2020-05,3350.81,2641.92,1477.78,2112.24,74.43,6849.88
909866258011837440,2020-06,12892.73,6922.49,2943.37,5509,3404.61,10254.49
909866258011837440,2020-07,9062.93,4169.04,9143.28,8162.25,5874.92,16129.41
909866258011837440,2020-08,9962.23,8059.81,3687.28,3183.05,2406.65,18536.06
909866258011837440,2020-09,4099.42,3815.24,3352.18,3039.08,597.28,19133.34
909866258011837440,2020-10,7057.21,4481.57,129.08,1992.33,712.39,19845.73
909866258011837440,2020-11,7247.67,3710.43,1743.47,2027.84,3252.87,23098.6
909866258011837440,2020-12,3359.39,6917.09,5567.16,2261.85,-252.39,22846.21
910696677498169344,2020-01,2183.09,4020.37,2208.33,4098.83,-3727.78,-3727.78
910696677498169344,2020-02,2910.55,4527.16,7407.09,1081.98,4708.5,980.72
910696677498169344,2020-03,2312.24,5494.94,6707.02,2267.13,1257.19,2237.91
910696677498169344,2020-04,4989.52,5879.41,4595.77,3326.21,379.67,2617.58
910696677498169344,2020-05,9308.03,3505.8,5375.9,3181.43,7996.7,10614.28
910696677498169344,2020-06,4752.41,5175.08,3572.25,5498.43,-2348.85,8265.43
910696677498169344,2020-07,2916.43,5328.93,7747.58,4465.18,869.9,9135.33
910696677498169344,2020-08,6387.53,11164.92,4590.82,6383.14,-6569.71,2565.62
910696677498169344,2020-09,4241.94,3659.5,3133.54,4253.94,-537.96,2027.66
910696677498169344,2020-10,2808.35,1247.21,8187.08,6655.97,3092.25,5119.91
910696677498169344,2020-11,5213.75,2308.23,4229.96,10056.73,-2921.25,2198.66
910696677498169344,2020-12,5228.55,6776.75,5399.49,352.97,3498.32,5696.98
911350326467553664,2020-02,1817.45,227.59,2800.47,0,4390.33,4390.33
911350326467553664,2020-03,0,1845.46,1636.32,0,-209.14,4181.19
911350326467553664,2020-05,1111.28,3348.31,826.54,2119.32,-3529.81,651.38
911350326467553664,2020-06,585.36,102.23,0,0,483.13,1134.51
911350326467553664,2020-07,0,377.79,0,210.8,-588.59,545.92
911350326467553664,2020-09,0,511.24,495.36,1454.48,-1470.36,-924.44
911350326467553664,2020-11,1121.52,0,0,0,1121.52,197.08
913076741260488064,2020-01,3017.57,616.24,984.83,1983.91,1402.25,1402.25
913076741260488064,2020-02,3195.26,4692.75,1867.51,3504.7,-3134.68,-1732.43
913076741260488064,2020-03,1077.04,2776.46,1892.53,1402.68,-1209.57,-2942
913076741260488064,2020-04,793.09,617.46,3447.94,1750.55,1873.02,-1068.98
913076741260488064,2020-05,1551.99,214.6,1320.42,1135.44,1522.37,453.39
913076741260488064,2020-06,535.39,0,1496.81,2219.16,-186.96,266.43
913076741260488064,2020-07,3516.69,1036.5,1689.22,0,4169.41,4435.84
913076741260488064,2020-08,2319.55,4676.03,639.45,550.14,-2267.17,2168.67
913076741260488064,2020-09,2371.69,643.36,2492.81,64.52,4156.62,6325.29
913076741260488064,2020-10,2171.2,2102.25,2304.62,6283.04,-3909.47,2415.82
913076741260488064,2020-11,2613.4,619,1112.95,0,3107.35,5523.17
913076741260488064,2020-12,0,4193.58,690.75,1719.82,-5222.65,300.52
913347390020568064,2020-01,5074.21,8037.42,5994.7,5021.94,-1990.45,-1990.45
913347390020568064,2020-02,6100.42,2873.77,7937.06,7751.32,3412.39,1421.94
913347390020568064,2020-03,1467.37,286.68,2009.55,4612.87,-1422.63,-0.69
913347390020568064,2020-04,4555.25,6383.69,1589.5,3564.64,-3803.58,-3804.27
913347390020568064,2020-05,5819.1,3561.94,229.16,4099.86,-1613.54,-5417.81
913347390020568064,2020-06,6109,7149.08,4390.87,4178.87,-828.08,-6245.89
913347390020568064,2020-07,5139.59,8244.61,957.93,3932.54,-6079.63,-12325.52
913347390020568064,2020-08,3770.23,3722.83,4721.39,1048.98,3719.81,-8605.71
913347390020568064,2020-09,7574.44,1084.14,4975.86,6887.79,4578.37,-4027.34
913347390020568064,2020-10,1742.24,4019.96,2149.22,6494.48,-6622.98,-10650.32
913347390020568064,2020-11,1316.4,2772.82,3009.59,4388.3,-2835.13,-13485.45
913347390020568064,2020-12,10971.97,3712.7,2525.66,4310.45,5474.48,-8010.97
913427262172958464,2020-01,3844.79,2138.64,9307.38,0,11013.53,11013.53
913427262172958464,2020-02,1725.07,1914.92,0,4929.98,-5119.83,5893.7
913427262172958464,2020-03,1215.28,1433.11,691.35,2641.65,-2168.13,3725.57
913427262172958464,2020-04,1508.59,4012.82,980.3,5021.73,-6545.66,-2820.09
913427262172958464,2020-05,2274.19,5004.49,977.87,3259.3,-5011.73,-7831.82
913427262172958464,2020-06,730.84,1917.19,3435.43,4714.43,-2465.35,-10297.17
913427262172958464,2020-07,59.77,1775.15,727,772.56,-1760.94,-12058.11
913427262172958464,2020-08,7422.54,3510.32,258.78,2844.77,1326.23,-10731.88
913427262172958464,2020-09,1287.1,4842.01,1830.92,4931.19,-6655.18,-17387.06
913427262172958464,2020-10,0,5241.07,2510.26,6323.58,-9054.39,-26441.45
913427262172958464,2020-11,1191.95,1320.45,977.84,0,849.34,-25592.11
913427262172958464,2020-12,5561.86,168.08,2154.06,1792.39,5755.45,-19836.66
914067709272806784,2020-01,1525.92,1803.15,0,836.97,-1114.2,-1114.2
914067709272806784,2020-02,3253.48,0,0,0,3253.48,2139.28
914067709272806784,2020-03,2045.27,1154.38,3067.11,0,3958,6097.28
914067709272806784,2020-04,2474.84,652.74,268.29,653.6,1436.79,7534.07
914067709272806784,2020-05,0,1504.05,682.18,7506.24,-8328.11,-794.04
914067709272806784,2020-06,3983.02,1008.54,2790.27,1535.44,4229.31,3435.27
914067709272806784,2020-07,1852.09,574.16,2257.62,469.61,3065.94,6501.21
914067709272806784,2020-08,892.83,1081.09,2946.23,1188.87,1569.1,8070.31
914067709272806784,2020-09,1877.23,1259.82,1240.1,0,1857.51,9927.82
914067709272806784,2020-10,2010.07,5672.15,6400.36,5180.85,-2442.57,7485.25
914067709272806784,2020-11,3158.46,1724,1994.11,485.52,2943.05,10428.3
914067709272806784,2020-12,1123.48,2428.05,3704.95,2543.17,-142.79,10285.51
914271599541594496,2020-01,0,219.09,602.53,103.5,279.94,279.94
914271599541594496,2020-02,1806.27,3082.22,0,1646.3,-2922.25,-2642.31
914271599541594496,2020-03,473.12,502.78,2519.61,1750.17,739.78,-1902.53
914271599541594496,2020-04,3762.79,1908.7,5042.15,331.22,6565.02,4662.49
914271599541594496,2020-05,1569.1,3412.18,3349.82,1168.23,338.51,5001
914271599541594496,2020-06,165.92,3874.33,5836.86,2767.48,-639.03,4361.97
914271599541594496,2020-07,1688.28,2740.89,0,0,-1052.61,3309.36
914271599541594496,2020-08,0,834.07,4448.53,1342.76,2271.7,5581.06
914271599541594496,2020-09,1384.12,1386.84,5851.36,347.46,5501.18,11082.24
914271599541594496,2020-10,1381,0,327.25,1868.66,-160.41,10921.83
914271599541594496,2020-11,2868.86,1392.7,1202.59,0,2678.75,13600.58
914271599541594496,2020-12,0,327.24,2977.01,2753.02,-103.25,13497.33
914639867870986368,2020-01,0,1736.41,468.2,0,-1268.21,-1268.21
914639867870986368,2020-03,0,783.28,0,0,-783.28,-2051.49
914639867870986368,2020-05,577.57,0,0,0,577.57,-1473.92
914639867870986368,2020-07,0,61.21,0,0,-61.21,-1535.13
914639867870986368,2020-09,1041.17,0,0,0,1041.17,-493.96
914639867870986368,2020-12,0,1788.17,0,0,-1788.17,-2282.13
916262384882582656,2020-01,5954.44,8168.07,1749.33,1942.21,-2406.51,-2406.51
916262384882582656,2020-02,5066.84,1237.74,4028.24,3761.89,4095.45,1688.94
916262384882582656,2020-03,4262.57,7122.42,4951.88,3227.06,-1135.03,553.91
916262384882582656,2020-04,4810.16,7834.42,2420.18,2510.21,-3114.29,-2560.38
916262384882582656,2020-05,2233.61,1333.74,2981.73,5661.19,-1779.59,-4339.97
916262384882582656,2020-06,8737.82,6547.93,3460.57,5204.15,446.31,-3893.66
916262384882582656,2020-07,5900.67,3109.07,2323.05,1479.7,3634.95,-258.71
916262384882582656,2020-08,3981.65,1632.61,6755.66,5782.43,3322.27,3063.56
916262384882582656,2020-09,3295.92,7325.37,2263.72,6008.14,-7773.87,-4710.31
916262384882582656,2020-10,5593.27,5703.74,743.34,4080.14,-3447.27,-8157.58
916262384882582656,2020-11,1928.33,3883.67,2548.02,6028.06,-5435.38,-13592.96
916262384882582656,2020-12,5099.72,10630.36,10312.92,6295.5,-1513.22,-15106.18
916533140141049088,2020-01,2238.83,5655.51,2931.55,667.49,-1152.62,-1152.62
916533140141049088,2020-02,5461.03,591.81,1696.77,92.08,6473.91,5321.29
916533140141049088,2020-03,4055.75,7436.21,3484.08,1566.5,-1462.88,3858.41
916533140141049088,2020-04,2110.84,1626.73,1234.01,2425.92,-707.8,3150.61
916533140141049088,2020-05,5157.55,2490.93,4035.71,4516.26,2186.07,5336.68
916533140141049088,2020-06,3450.51,371.7,1245.7,1705.64,2618.87,7955.55
916533140141049088,2020-07,1328.07,3502.23,4297.12,1556.18,566.78,8522.33
916533140141049088,2020-08,2826.28,4221.46,2614.39,0,1219.21,9741.54
916533140141049088,2020-09,2914.26,1735.91,0,3081.79,-1903.44,7838.1
916533140141049088,2020-10,3440,1184.65,3701.47,5074.08,882.74,8720.84
916533140141049088,2020-11,4252.08,4634.2,4888.57,5272.44,-765.99,7954.85
916533140141049088,2020-12,2434.67,4487.32,3151.49,2819.88,-1721.04,6233.81
916820743475132800,2020-01,0,338.17,0,0,-338.17,-338.17
916820743475132800,2020-02,0,586.94,1016.79,1191.57,-761.72,-1099.89
916820743475132800,2020-05,0,1869.64,1199.17,0,-670.47,-1770.36
916820743475132800,2020-07,106.71,399.11,0,0,-292.4,-2062.76
916820743475132800,2020-09,615.47,0,0,0,615.47,-1447.29
916820743475132800,2020-10,0,677.33,0,0,-677.33,-2124.62
916820743475132800,2020-11,2738.96,1897.26,0,425.34,416.36,-1708.26
916820743475132800,2020-12,1662.35,1323.86,0,0,338.49,-1369.77
917100214960358400,2020-01,2463.87,6273.29,2880.56,1650.15,-2579.01,-2579.01
917100214960358400,2020-02,2101.69,1354.25,582.14,1386.33,-56.75,-2635.76
917100214960358400,2020-03,2935.6,1712.49,2269.13,1899.08,1593.16,-1042.6
917100214960358400,2020-04,1924.46,0,1757.58,0,3682.04,2639.44
917100214960358400,2020-05,4041.45,2269.7,1973.75,498.06,3247.44,5886.88
917100214960358400,2020-06,4554.84,1306.18,900.94,1469.97,2679.63,8566.51
917100214960358400,2020-07,1055.26,1973.84,0,7284.83,-8203.41,363.1
917100214960358400,2020-08,6220.13,266.93,3059.93,2582.92,6430.21,6793.31
917100214960358400,2020-09,6885.53,4088.75,1586.12,310.7,4072.2,10865.51
917100214960358400,2020-10,3924.6,3088.52,1464.5,1993.56,307.02,11172.53
917100214960358400,2020-11,1938.92,5192.91,1429.74,1532.05,-3356.3,7816.23
917100214960358400,2020-12,2397.75,6074.04,0,2970.72,-6647.01,1169.22
917419822172747264,2020-01,9377.04,3523.2,2246.8,8772.54,-671.9,-671.9
917419822172747264,2020-02,5179.95,2495.3,4437.87,2933.71,4188.81,3516.91
917419822172747264,2020-03,2052.09,3462.34,2434.3,2902.39,-1878.34,1638.57
917419822172747264,2020-04,2968.05,2679.37,5083.51,2155.06,3217.13,4855.7
917419822172747264,2020-05,6200.22,5074.13,8116.68,5102.65,4140.12,8995.82
917419822172747264,2020-06,4033,3578.48,1937.29,7017.05,-4625.24,4370.58
917419822172747264,2020-07,6993.76,2115.4,6124.71,5335.73,5667.34,10037.92
917419822172747264,2020-08,5097.33,4058.9,3851.7,4507.47,382.66,10420.58
917419822172747264,2020-09,1136.95,4914.88,2240.7,4643.57,-6180.8,4239.78
917419822172747264,2020-10,3474.65,8050.25,2733.4,5897.33,-7739.53,-3499.75
917419822172747264,2020-11,8658.88,4613.83,6154.02,4550.96,5648.11,2148.36
917419822172747264,2020-12,4783.76,7034.46,4678.38,7968.27,-5540.59,-3392.23
917633434823852032,2020-01,8303.14,3960.85,6385.6,0,10727.89,10727.89
917633434823852032,2020-02,3560.68,6001.83,4188.75,6700.09,-4952.49,5775.4
917633434823852032,2020-03,1969.35,3215.96,2158.41,8384.42,-7472.62,-1697.22
917633434823852032,2020-04,1776.77,3642.71,649.6,5105.83,-6322.17,-8019.39
917633434823852032,2020-05,5164.55,10455.24,10392.61,2986.81,2115.11,-5904.28
917633434823852032,2020-06,7901.24,6079.55,4040.12,1876.37,3985.44,-1918.84
917633434823852032,2020-07,7627.47,5716.51,5114.09,2366.28,4658.77,2739.93
917633434823852032,2020-08,1880.57,21.62,4206.1,5298.36,766.69,3506.62
917633434823852032,2020-09,3317.84,4130.06,2410.35,6362.74,-4764.61,-1257.99
917633434823852032,2020-10,2836.38,6763.99,4505.74,3746.02,-3167.89,-4425.88
917633434823852032,2020-11,7012.01,9364.87,3749.53,3499.41,-2102.74,-6528.62
917633434823852032,2020-12,6601.57,6157.58,2871.86,5792.27,-2476.42,-9005.04
919018532689109888,2020-04,0,89.24,0,0,-89.24,-89.24
919018532689109888,2020-05,1572.45,16.37,0,0,1556.08,1466.84
919018532689109888,2020-07,0,1489.37,0,0,-1489.37,-22.53
919018532689109888,2020-09,1038.62,0,1597.99,0,2636.61,2614.08
919018532689109888,2020-11,0,1977.46,87.58,1627.86,-3517.74,-903.66
919571265786116608,2020-01,1755.21,0,0,0,1755.21,1755.21
919571265786116608,2020-02,1962.78,0,423.91,0,2386.69,4141.9
919571265786116608,2020-03,0,3189.3,0,0,-3189.3,952.6
919571265786116608,2020-04,0,901.97,0,1189.71,-2091.68,-1139.08
919571265786116608,2020-05,0,3681.1,1815.92,0,-1865.18,-3004.26
919571265786116608,2020-06,1345.06,0,1055.81,736.73,1664.14,-1340.12
919571265786116608,2020-07,1740.76,0,2605.97,0,4346.73,3006.61
919571265786116608,2020-10,1130.55,157.27,1933.64,0,2906.92,5913.53
919571265786116608,2020-11,300.34,0,398.68,0,699.02,6612.55
923049701478002048,2020-01,467.41,2956.54,1716.84,4296.23,-5068.52,-5068.52
923049701478002048,2020-02,1820.44,4363.44,2671.81,812.44,-683.63,-5752.15
923049701478002048,2020-03,1386.62,2742.34,4601.94,4404.78,-1158.56,-6910.71
923049701478002048,2020-04,1153.86,1463.52,4167.66,4675.12,-817.12,-7727.83
923049701478002048,2020-05,2384.08,3721.32,2171.79,1458.87,-624.32,-8352.15
923049701478002048,2020-06,1640.74,255.26,4913.49,1606.12,4692.85,-3659.3
923049701478002048,2020-07,0,3613.17,5563.13,1533.2,416.76,-3242.54
923049701478002048,2020-08,2013.77,0,5216.22,5158.05,2071.94,-1170.6
923049701478002048,2020-09,228.29,1481.04,2681.94,3759.25,-2330.06,-3500.66
923049701478002048,2020-10,121.77,2561.74,2955.69,4197.48,-3681.76,-7182.42
923049701478002048,2020-11,1667.48,3157.13,1645.45,2435.88,-2280.08,-9462.5
923049701478002048,2020-12,2684.1,3698.18,415.09,2906.85,-3505.84,-12968.34
923240167931674752,2020-01,1072.81,7136.46,6765.61,8466.23,-7764.27,-7764.27
923240167931674752,2020-02,4437.38,5175.03,3494.81,1802.57,954.59,-6809.68
923240167931674752,2020-03,2960.78,3719.96,3389.54,4634,-2003.64,-8813.32
923240167931674752,2020-04,2940.98,4438.49,5626.45,1881.94,2247,-6566.32
923240167931674752,2020-05,6497.89,6250.12,4434.1,5280.3,-598.43,-7164.75
923240167931674752,2020-06,5094.22,2948.74,5043.06,3362.52,3826.02,-3338.73
923240167931674752,2020-07,3342.04,4907.27,2990.95,2626.63,-1200.91,-4539.64
923240167931674752,2020-08,2011.6,1795.83,13845.74,3624.57,10436.94,5897.3
923240167931674752,2020-09,6242.54,3049.84,3374.98,3731.68,2836,8733.3
923240167931674752,2020-10,4907.55,7376.82,2308.74,3247,-3407.53,5325.77
923240167931674752,2020-11,3206.68,3178.89,2000.02,4685.58,-2657.77,2668
923240167931674752,2020-12,4707.33,1847.14,8714.52,2342.72,9231.99,11899.99
923895908485622016,2020-01,7913.7,6783.24,1163.37,6287.81,-3993.98,-3993.98
923895908485622016,2020-02,2791.73,4035.45,3592.42,2219.85,128.85,-3865.13
923895908485622016,2020-03,4289.53,4594.07,1899.65,4100.5,-2505.39,-6370.52
923895908485622016,2020-04,1109.56,4339.87,5562.69,3203.03,-870.65,-7241.17
923895908485622016,2020-05,5113.81,1512.77,2199.91,1757.94,4043.01,-3198.16
923895908485622016,2020-06,4863.6,4972.88,3097.46,4334.61,-1346.43,-4544.59
923895908485622016,2020-07,121.7,1999.78,155.12,1355.39,-3078.35,-7622.94
923895908485622016,2020-08,5296.61,4404.33,4439.88,6939.04,-1606.88,-9229.82
923895908485622016,2020-09,3400.8,0,2786.14,10311.43,-4124.49,-13354.31
923895908485622016,2020-10,1165.14,1369.2,1128.28,6857.23,-5933.01,-19287.32
923895908485622016,2020-11,3058.09,2203.39,3533.15,1109.71,3278.14,-16009.18
923895908485622016,2020-12,2380.25,2652.09,3668.65,5876.59,-2479.78,-18488.96
924913617344237312,2020-01,2606.7,5131.15,947.63,713.09,-2289.91,-2289.91
924913617344237312,2020-02,307.78,0,0,1730.17,-1422.39,-3712.3
924913617344237312,2020-03,2160.48,0,3582,2195.76,3546.72,-165.58
924913617344237312,2020-04,1358.65,0,1398.26,623.43,2133.48,1967.9
924913617344237312,2020-05,217.83,0,1654.46,3341.75,-1469.46,498.44
924913617344237312,2020-06,0,1882.01,1552.4,0,-329.61,168.83
924913617344237312,2020-07,3169.61,581.49,2542.55,1548.98,3581.69,3750.52
924913617344237312,2020-08,0,4379.09,4930.37,1194.67,-643.39,3107.13
924913617344237312,2020-09,250.63,721.85,898.81,1430.14,-1002.55,2104.58
924913617344237312,2020-10,3704.52,1879.97,145.97,2529.35,-558.83,1545.75
924913617344237312,2020-11,4574.02,1949.23,222.53,0,2847.32,4393.07
924913617344237312,2020-12,2713.06,432.89,1890.06,2173.28,1996.95,6390.02
925899387578979072,2020-01,0,2625.94,509.94,1072.22,-3188.22,-3188.22
925899387578979072,2020-02,3524.04,518.96,1418,2649.99,1773.09,-1415.13
925899387578979072,2020-03,5650.02,1928.56,5640.01,1511.69,7849.78,6434.65
925899387578979072,2020-04,3080.69,140.19,6241,2268.44,6913.06,13347.71
925899387578979072,2020-05,2600.11,6963.52,926.11,0,-3437.3,9910.41
925899387578979072,2020-06,1682.8,773.87,3921.9,843.21,3987.62,13898.03
925899387578979072,2020-07,1929.93,1213.4,435.28,1188.01,-36.2,13861.83
925899387578979072,2020-08,6363.94,1844.49,357.57,2147.45,2729.57,16591.4
925899387578979072,2020-09,2084.95,3259.81,0,3735.82,-4910.68,11680.72
925899387578979072,2020-10,3388.39,295.63,2079.28,1209.55,3962.49,15643.21
925899387578979072,2020-11,0,3215.21,2023.01,1322.96,-2515.16,13128.05
925899387578979072,2020-12,1808.18,2342.5,157.95,47.9,-424.27,12703.78
926668058146664832,2020-01,4781.21,4043.36,3654.42,2922.4,1469.87,1469.87
926668058146664832,2020-02,3973,3141.75,5674.91,4915.04,1591.12,3060.99
926668058146664832,2020-03,471.07,3223.82,2616.44,5896.68,-6032.99,-2972
926668058146664832,2020-04,2678.1,3965.81,2006.01,2145.2,-1426.9,-4398.9
926668058146664832,2020-05,9571.77,4471.76,4573.11,2648.35,7024.77,2625.87
926668058146664832,2020-06,6385.93,5870.21,2082.94,1690.78,907.88,3533.75
926668058146664832,2020-07,5310.83,2942.57,6047.15,1747.04,6668.37,10202.12
926668058146664832,2020-08,3750.49,5755.73,641.77,4524.59,-5888.06,4314.06
926668058146664832,2020-09,0,3694.07,712.1,537.33,-3519.3,794.76
926668058146664832,2020-10,2396.08,5268.49,2663.1,2755.04,-2964.35,-2169.59
926668058146664832,2020-11,3350.3,4515.88,2619.64,720.4,733.66,-1435.93
926668058146664832,2020-12,6429.35,952.75,1420.39,2995.92,3901.07,2465.14
927370385741211648,2020-01,9925.99,6409.18,2168.42,4479.42,1205.81,1205.81
927370385741211648,2020-02,3654.3,6311.75,4097.78,4110.53,-2670.2,-1464.39
927370385741211648,2020-03,3721.01,347.98,2198.93,4009.71,1562.25,97.86
927370385741211648,2020-04,3557.92,2148.05,4934.17,1953.46,4390.58,4488.44
927370385741211648,2020-05,1664.9,1941.42,4123.2,1573.65,2273.03,6761.47
927370385741211648,2020-06,4114.49,4904.02,4412.39,1158.44,2464.42,9225.89
927370385741211648,2020-07,3401.13,3482.13,1607.61,3223.77,-1697.16,7528.73
927370385741211648,2020-08,4584.29,6349.22,9650.47,5361.66,2523.88,10052.61
927370385741211648,2020-09,251.79,3787.32,1165.52,5165.73,-7535.74,2516.87
927370385741211648,2020-10,9513.58,3929.05,6704.3,7327.72,4961.11,7477.98
927370385741211648,2020-11,5608.8,7532.92,4223.69,5417.03,-3117.46,4360.52
927370385741211648,2020-12,4698.23,3298.34,2664.63,1058.81,3005.71,7366.23
929207876865197824,2020-01,6749.65,1427.19,1917.08,3256.58,3982.96,3982.96
929207876865197824,2020-02,1905.51,0,2101.99,0,4007.5,7990.46
929207876865197824,2020-03,1705.89,1759.54,1622.4,2681.02,-1112.27,6878.19
929207876865197824,2020-04,1315.25,940.09,3161.94,2193.1,1344,8222.19
929207876865197824,2020-05,4228.33,4109.76,2412.75,1799.15,732.17,8954.36
929207876865197824,2020-06,1808.4,3338.61,879.23,2172.36,-2823.34,6131.02
929207876865197824,2020-07,2214.85,0,3632.33,977.59,4869.59,11000.61
929207876865197824,2020-08,3211.77,725.77,0,1269.72,1216.28,12216.89
929207876865197824,2020-09,3031.74,402.39,0,246.29,2383.06,14599.95
929207876865197824,2020-10,482.38,1699.57,3147.89,3608.36,-1677.66,12922.29
929207876865197824,2020-11,1635.26,3350.97,750.2,969.1,-1934.61,10987.68
929207876865197824,2020-12,1776.82,1435.73,1338.2,2959.7,-1280.41,9707.27
929232242034731648,2020-01,928.85,4984.25,3389.32,5225.51,-5891.59,-5891.59
929232242034731648,2020-02,1015.46,5134.16,5212.13,3946.2,-2852.77,-8744.36
929232242034731648,2020-03,4540.32,3041.46,4418.54,4389.3,1528.1,-7216.26
929232242034731648,2020-04,0,3632.76,1803.24,0,-1829.52,-9045.78
929232242034731648,2020-05,2246.91,4519.27,2405.83,2893.51,-2760.04,-11805.82
929232242034731648,2020-06,2191.01,2672.14,6073.92,1830.27,3762.52,-8043.3
929232242034731648,2020-07,493.53,2000.5,1541.43,3244.43,-3209.97,-11253.27
929232242034731648,2020-08,5883.76,1002.65,4833.95,1567.12,8147.94,-3105.33
929232242034731648,2020-09,112.51,6375.06,2252.91,518.71,-4528.35,-7633.68
929232242034731648,2020-10,1271.37,2166.4,5697.92,1514.29,3288.6,-4345.08
929232242034731648,2020-11,1693.72,4601.79,3653.64,113.78,631.79,-3713.29
929232242034731648,2020-12,6700.16,6002.95,1784.31,2493.97,-12.45,-3725.74
929403553320174592,2020-01,0,744.58,0,119.34,-863.92,-863.92
929403553320174592,2020-02,2295.75,1390.01,0,930.58,-24.84,-888.76
929403553320174592,2020-03,0,1576.96,0,2454.68,-4031.64,-4920.4
929403553320174592,2020-04,4275.84,0,1448.66,230.3,5494.2,573.8
929403553320174592,2020-05,674.36,0,3488.09,0,4162.45,4736.25
929403553320174592,2020-06,0,1500.89,0,1537.98,-3038.87,1697.38
929403553320174592,2020-07,0,3706.71,1150.09,0,-2556.62,-859.24
929403553320174592,2020-08,2878.07,74.89,1926.1,2762.74,1966.54,1107.3
929403553320174592,2020-11,584.64,218.06,0,1654.67,-1288.09,-180.79
929403553320174592,2020-12,0,2379,0,1792.44,-4171.44,-4352.23
929496070094623360,2020-06,0,782.2,0,0,-782.2,-782.2
929496070094623360,2020-12,1223.75,0,0,0,1223.75,441.55
929924883693355392,2020-01,1898.98,0,0,1827.05,71.93,71.93
929924883693355392,2020-02,0,977.95,0,1135.76,-2113.71,-2041.78
929924883693355392,2020-03,0,1872.39,0,0,-1872.39,-3914.17
929924883693355392,2020-04,104.7,1007.38,0,0,-902.68,-4816.85
929924883693355392,2020-05,0,3132.15,1872.91,171.07,-1430.31,-6247.16
929924883693355392,2020-06,2467.4,734.61,0,0,1732.79,-4514.37
929924883693355392,2020-08,0,232.18,919.97,1737.44,-1049.65,-5564.02
929924883693355392,2020-11,1157.23,0,0,1703.84,-546.61,-6110.63
930573191549283968,2020-01,1006.48,4376.54,965.57,2154.45,-4558.94,-4558.94
930573191549283968,2020-02,4571.69,2511.43,1831.58,1330.05,2561.79,-1997.15
930573191549283968,2020-03,5160.16,2674.41,5844.58,2900.39,5429.94,3432.79
930573191549283968,2020-04,3567.59,3863.67,4260.55,772.65,3191.82,6624.61
930573191549283968,2020-05,0,2363.98,5202.34,1878.46,959.9,7584.51
930573191549283968,2020-06,0,3523.29,1579.43,3139.82,-5083.68,2500.83
930573191549283968,2020-07,1573.81,3904.75,2800.26,2430.77,-1961.45,539.38
930573191549283968,2020-08,0,5128.49,2524.4,2048.71,-4652.8,-4113.42
930573191549283968,2020-09,2684.76,3356.93,4842.81,5406.51,-1235.87,-5349.29
930573191549283968,2020-10,3868.27,1805.4,883.84,1308.82,1637.89,-3711.4
930573191549283968,2020-11,1108.62,1671.13,7838.9,2546.12,4730.27,1018.87
930573191549283968,2020-12,4863.51,160.68,3472.76,1709.38,6466.21,7485.08
931101320556492800,2020-01,0,806.34,0,1314.51,-2120.85,-2120.85
931101320556492800,2020-02,0,3095.46,23.2,624.51,-3696.77,-5817.62
931101320556492800,2020-03,769.49,1805.46,1131.25,3039.45,-2944.17,-8761.79
931101320556492800,2020-04,531.5,3892.71,876.56,291.45,-2776.1,-11537.89
931101320556492800,2020-05,1592.71,17.74,645.23,1911.63,308.57,-11229.32
931101320556492800,2020-06,0,3612.28,0,0,-3612.28,-14841.6
931101320556492800,2020-07,3946.66,0,2649.67,1037.38,5558.95,-9282.65
931101320556492800,2020-08,862.1,1605.09,1973.99,1381.13,-150.13,-9432.78
931101320556492800,2020-09,442.53,0,586.42,0,1028.95,-8403.83
931101320556492800,2020-10,2768.95,1935.88,1962.03,0,2795.1,-5608.73
931101320556492800,2020-12,207.38,1110.11,3034.79,2234.97,-102.91,-5711.64
931345824574781824,2020-09,0,1556.6,0,0,-1556.6,-1556.6
931345824574781824,2020-11,669.69,0,0,652.65,17.04,-1539.56
931982956664958976,2020-01,7965.35,3827.85,1575.5,6755.2,-1042.2,-1042.2
931982956664958976,2020-02,3131.81,4888.85,2243.47,6874.85,-6388.42,-7430.62
931982956664958976,2020-03,4116.24,3440.07,1854.35,3468.66,-938.14,-8368.76
931982956664958976,2020-04,4153.55,7483.27,2345.08,1517.5,-2502.14,-10870.9
931982956664958976,2020-05,4376.64,3946.77,3393.3,3205.25,617.92,-10252.98
931982956664958976,2020-06,5831.04,1317.71,5879.23,5564.93,4827.63,-5425.35
931982956664958976,2020-07,4646.5,5324.23,2798.18,1278.06,842.39,-4582.96
931982956664958976,2020-08,3199.44,4093.56,4244.23,7144.05,-3793.94,-8376.9
931982956664958976,2020-09,3312.06,1286.99,4997.81,1573.16,5449.72,-2927.18
931982956664958976,2020-10,5216.69,2316.94,3598.88,5844.72,653.91,-2273.27
931982956664958976,2020-11,927.54,914.28,1364.03,4953.14,-3575.85,-5849.12
931982956664958976,2020-12,1247.64,5092.89,2048.97,6175.1,-7971.38,-13820.5
934563843065259264,2020-01,792.69,582.76,3307.77,0,3517.7,3517.7
934563843065259264,2020-02,451.56,1295.25,2352.21,4571,-3062.48,455.22
934563843065259264,2020-03,627.87,1493.23,1514.23,2361.64,-1712.77,-1257.55
934563843065259264,2020-04,3270.47,0,0,2420.46,850.01,-407.54
934563843065259264,2020-05,3305.58,1176.58,30.8,803.07,1356.73,949.19
934563843065259264,2020-06,12.05,6019.47,0,0,-6007.42,-5058.23
934563843065259264,2020-07,0,2275.08,2403.4,1377.13,-1248.81,-6307.04
934563843065259264,2020-08,1028.43,688.43,1354.57,0,1694.57,-4612.47
934563843065259264,2020-09,1584.15,4516.47,2627.12,487.75,-792.95,-5405.42
934563843065259264,2020-10,349.83,4353.56,1095.79,1649.37,-4557.31,-9962.73
934563843065259264,2020-11,833.43,281.81,580.52,4044.62,-2912.48,-12875.21
934563843065259264,2020-12,586.18,2313.09,0,3201.66,-4928.57,-17803.78
936279715235170944,2020-01,201.57,1455.38,404.93,4209.17,-5058.05,-5058.05
936279715235170944,2020-02,0,621.52,2395.35,0,1773.83,-3284.22
936279715235170944,2020-03,1955.1,2152.61,3767.48,941.89,2628.08,-656.14
936279715235170944,2020-04,354.01,1029.05,4361.88,0,3686.84,3030.7
936279715235170944,2020-06,1864.79,616.86,1448.76,0,2696.69,5727.39
936279715235170944,2020-07,0,546.15,0,563.99,-1110.14,4617.25
936279715235170944,2020-08,0,1072.49,372.45,0,-700.04,3917.21
936279715235170944,2020-09,182.48,0,0,0,182.48,4099.69
936279715235170944,2020-10,1345.24,887.71,578.41,511.8,524.14,4623.83
936279715235170944,2020-11,2181.63,2950.69,1403.76,2245.62,-1610.92,3012.91
936279715235170944,2020-12,92.62,2944.97,0,0,-2852.35,160.56
936338353803221760,2020-01,2895.33,0,2900,499.6,5295.73,5295.73
936338353803221760,2020-02,4594.97,2603.71,4001.61,1886.05,4106.82,9402.55
936338353803221760,2020-03,1022.88,1530.24,0,535.94,-1043.3,8359.25
936338353803221760,2020-04,4692.72,5377.63,2927.89,1322.4,920.58,9279.83
936338353803221760,2020-05,0,387.54,256.33,2058.22,-2189.43,7090.4
936338353803221760,2020-06,2397.23,995.25,1043.73,0,2445.71,9536.11
936338353803221760,2020-07,1813.23,3331.78,4407.14,5168.86,-2280.27,7255.84
936338353803221760,2020-08,13.94,2947.7,2715.72,3671.18,-3889.22,3366.62
936338353803221760,2020-09,5344.56,1362.14,4841.78,1466.96,7357.24,10723.86
936338353803221760,2020-10,3093.63,4485.09,4006.86,7174.78,-4559.38,6164.48
936338353803221760,2020-11,1212.8,1849.89,4169.53,4494.92,-962.48,5202
936338353803221760,2020-12,5063.86,5647.35,0,0,-583.49,4618.51
936615659675202944,2020-01,6869.95,10126.35,4590.88,2220.89,-886.41,-886.41
936615659675202944,2020-02,3366.86,4131.69,5033.25,1624.87,2643.55,1757.14
936615659675202944,2020-03,845.36,1156.4,7325.65,2608.33,4406.28,6163.42
936615659675202944,2020-04,4307.46,6221.74,4058.87,3803.57,-1658.98,4504.44
936615659675202944,2020-05,6932.17,2687.48,5255.91,2794.28,6706.32,11210.76
936615659675202944,2020-06,9417.78,751.59,5996.15,3662.61,10999.73,22210.49
936615659675202944,2020-07,2340.39,5172.98,3468.23,6065.81,-5430.17,16780.32
936615659675202944,2020-08,9822.3,5252.7,2042.94,5721.34,891.2,17671.52
936615659675202944,2020-09,3755.16,4138.43,4837.71,4407.09,47.35,17718.87
936615659675202944,2020-10,3958.09,4390.31,4728.33,2801.01,1495.1,19213.97
936615659675202944,2020-11,917.5,1688.78,3291.4,4326.48,-1806.36,17407.61
936615659675202944,2020-12,6336.51,5208.42,5215.98,9552.35,-3208.28,14199.33
936626657150739072,2020-01,3844.56,5756.49,2278.58,3079.35,-2712.7,-2712.7
936626657150739072,2020-02,1582.01,6430.48,399.63,1908.75,-6357.59,-9070.29
936626657150739072,2020-03,3270.14,6918.42,5666.65,3338.97,-1320.6,-10390.89
936626657150739072,2020-04,5330.48,3805.14,7440.33,219.62,8746.05,-1644.84
936626657150739072,2020-05,5385.81,3380.78,339.11,4724.77,-2380.63,-4025.47
936626657150739072,2020-06,2984.95,7312.86,4502.21,645.75,-471.45,-4496.92
936626657150739072,2020-07,0,1297.15,3350.78,2829.96,-776.33,-5273.25
936626657150739072,2020-08,1814.9,6675.64,4475.57,3987.22,-4372.39,-9645.64
936626657150739072,2020-09,8218.33,5015.64,2545.16,2721.5,3026.35,-6619.29
936626657150739072,2020-10,4930.14,2860.95,6017.79,1742.66,6344.32,-274.97
936626657150739072,2020-11,6687.83,2938.83,1642.43,0,5391.43,5116.46
936626657150739072,2020-12,5305.42,3720.61,279.89,9333.33,-7468.63,-2352.17
936883919113072640,2020-01,703.65,352.38,0,293,58.27,58.27
936883919113072640,2020-02,1430.96,0,839.96,1637.03,633.89,692.16
936883919113072640,2020-03,672.08,29.16,0,1582.2,-939.28,-247.12
936883919113072640,2020-04,5602.93,1475.22,895.47,0,5023.18,4776.06
936883919113072640,2020-05,2343.97,1321.14,1527.52,2621.85,-71.5,4704.56
936883919113072640,2020-06,2893.5,1865.88,0,1654.28,-626.66,4077.9
936883919113072640,2020-07,3291.32,898.43,4131.94,1618.77,4906.06,8983.96
936883919113072640,2020-08,1589.86,1144.98,0,0,444.88,9428.84
936883919113072640,2020-09,2785.94,1814.88,3042.73,846.77,3167.02,12595.86
936883919113072640,2020-10,0,894.36,2319.37,0,1425.01,14020.87
936883919113072640,2020-11,0,901.04,2628.57,2200.23,-472.7,13548.17
936883919113072640,2020-12,3470.48,3040.25,2638.53,1387.93,1680.83,15229
938506678720623104,2020-01,5867.52,3047.41,825.36,4414.09,-768.62,-768.62
938506678720623104,2020-02,6626.67,5731.53,7873.8,3993.56,4775.38,4006.76
938506678720623104,2020-03,4513.9,6516.22,4442.06,3104.67,-664.93,3341.83
938506678720623104,2020-04,7001.07,0,2062.96,4403.52,4660.51,8002.34
938506678720623104,2020-05,4272.21,10447.81,4408.13,941.45,-2708.92,5293.42
938506678720623104,2020-06,5112.5,5190.22,2510.39,4036.26,-1603.59,3689.83
938506678720623104,2020-07,2119.22,2783.86,1519.95,4620.14,-3764.83,-75
938506678720623104,2020-08,4486.67,3432.24,4197.37,3996.47,1255.33,1180.33
938506678720623104,2020-09,5128.51,3708.91,1124.21,8562.88,-6019.07,-4838.74
938506678720623104,2020-10,2686.28,4047.74,7588.63,560.89,5666.28,827.54
938506678720623104,2020-11,3560.62,2217.67,4155.9,4227.46,1271.39,2098.93
938506678720623104,2020-12,13162.8,1890.13,3121.42,5024.66,9369.43,11468.36
938559518834567680,2020-02,430.14,0,1548.98,0,1979.12,1979.12
938559518834567680,2020-06,1609.68,1994.53,0,0,-384.85,1594.27
938559518834567680,2020-08,0,462.6,1641.76,745.65,433.51,2027.78
938559518834567680,2020-09,1988.02,264.57,218.59,0,1942.04,3969.82
938559518834567680,2020-10,0,592.64,0,1888.05,-2480.69,1489.13
938559518834567680,2020-12,0,1958.12,3204.12,0,1246,2735.13
940325328642454912,2020-01,1584.91,3911.87,7128.94,1469.06,3332.92,3332.92
940325328642454912,2020-02,6318.39,2798.02,2385.5,2667.99,3237.88,6570.8
940325328642454912,2020-03,3626.91,4885.56,8930.77,5382.65,2289.47,8860.27
940325328642454912,2020-04,1356.62,5535.26,6587.43,3263.79,-855,8005.27
940325328642454912,2020-05,6889.12,2078.37,3573.03,0,8383.78,16389.05
940325328642454912,2020-06,4071.81,11087.17,5340.82,5978.24,-7652.78,8736.27
940325328642454912,2020-07,1879.7,906.3,5851.67,4455.67,2369.4,11105.67
940325328642454912,2020-08,7285.26,4219.75,6158.37,5447.94,3775.94,14881.61
940325328642454912,2020-09,2937.02,5239.19,5695.16,4643.64,-1250.65,13630.96
940325328642454912,2020-10,5869.04,2865.14,5600.7,4350.15,4254.45,17885.41
940325328642454912,2020-11,2249.99,6056.63,5526.18,4210.95,-2491.41,15394
940325328642454912,2020-12,1982.97,5682.11,2858.1,3972.74,-4813.78,10580.22
940459974548197632,2020-01,2992.56,1036.47,3670.34,1781.43,3845,3845
940459974548197632,2020-02,1089.49,4558.18,2486.1,7174.98,-8157.57,-4312.57
940459974548197632,2020-03,5076.68,2786.92,0,2560.26,-270.5,-4583.07
940459974548197632,2020-04,0,3973.15,3521.53,2406.17,-2857.79,-7440.86
940459974548197632,2020-05,786.85,2631.2,2141.49,2277.38,-1980.24,-9421.1
940459974548197632,2020-06,741.13,2647.68,3677.44,0,1770.89,-7650.21
940459974548197632,2020-07,941.17,5845.99,3030.99,6138.23,-8012.06,-15662.27
940459974548197632,2020-08,0,558.82,2018.12,5652.91,-4193.61,-19855.88
940459974548197632,2020-09,1859.97,488.08,1942.03,1746.81,1567.11,-18288.77
940459974548197632,2020-10,1867.64,1988.31,3593.03,429.19,3043.17,-15245.6
940459974548197632,2020-11,568.58,2987.7,478.19,1155.93,-3096.86,-18342.46
940459974548197632,2020-12,0,102.31,4211.4,0,4109.09,-14233.37
940491575691385728,2020-01,2203.16,2782.59,2031.74,3545.07,-2092.76,-2092.76
940491575691385728,2020-02,2262.07,1511.65,4678.43,0,5428.85,3336.09
940491575691385728,2020-03,3037.13,3603.2,1894.4,3624.22,-2295.89,1040.2
940491575691385728,2020-04,2074.46,4609.46,1852.32,1158.15,-1840.83,-800.63
940491575691385728,2020-05,1768.8,947.37,696.38,5254.38,-3736.57,-4537.2
940491575691385728,2020-06,1947.63,7013.33,2603.36,2459.92,-4922.26,-9459.46
940491575691385728,2020-07,0,5678.94,368.89,2221.72,-7531.77,-16991.23
940491575691385728,2020-08,943.13,2341.86,2070.03,0,671.3,-16319.93
940491575691385728,2020-09,2841.7,854.57,0,5195.72,-3208.59,-19528.52
940491575691385728,2020-10,1186.84,6716.94,5705.26,5387.25,-5212.09,-24740.61
940491575691385728,2020-11,2652.78,1573.6,1389.03,2934.29,-466.08,-25206.69
940491575691385728,2020-12,0,2049.22,967.83,1328.87,-2410.26,-27616.95
940584506958261760,2020-01,8388.74,2109.21,12258.85,5363.28,13175.1,13175.1
940584506958261760,2020-02,6509.48,1683.18,4030.27,5160.47,3696.1,16871.2
940584506958261760,2020-03,4170.01,6070.57,4929.7,3244.53,-215.39,16655.81
940584506958261760,2020-04,1055.91,2169.4,2368.28,8163.04,-6908.25,9747.56
940584506958261760,2020-05,2832.37,4939.7,6395.24,5282.99,-995.08,8752.48
940584506958261760,2020-06,7104.51,0,7111.46,4939.03,9276.94,18029.42
940584506958261760,2020-07,9593.03,2666.83,10280.24,4522.54,12683.9,30713.32
940584506958261760,2020-08,2493.52,4427.48,3550.72,6074.92,-4458.16,26255.16
940584506958261760,2020-09,4316.77,3843.09,5024.95,6794.98,-1296.35,24958.81
940584506958261760,2020-10,5476.46,7228.73,4539.46,3108.2,-321.01,24637.8
940584506958261760,2020-11,2974.71,4999.16,4093.86,2798.59,-729.18,23908.62
940584506958261760,2020-12,7788.29,5594.51,9317.16,2752.95,8757.99,32666.61
942492472658605568,2020-01,3363.36,2014.66,5294.37,2237.65,4405.42,4405.42
942492472658605568,2020-02,4016.68,1803.48,2663.95,0,4877.15,9282.57
942492472658605568,2020-03,3514.36,1299.42,6852.15,2029.41,7037.68,16320.25
942492472658605568,2020-04,479.58,6432.49,5596.14,3032,-3388.77,12931.48
942492472658605568,2020-05,0,5094.7,8921.31,2788.5,1038.11,13969.59
942492472658605568,2020-06,2225.43,1809.45,4294.05,3800.59,909.44,14879.03
942492472658605568,2020-07,3132.47,2854.96,0,4777.1,-4499.59,10379.44
942492472658605568,2020-08,3084.69,6344.06,2820.31,3768.77,-4207.83,6171.61
942492472658605568,2020-09,2751.91,3374.68,3261.62,6690.94,-4052.09,2119.52
942492472658605568,2020-10,5506.35,1790.03,3978,1026.61,6667.71,8787.23
942492472658605568,2020-11,4135.65,934.32,4354.77,868.54,6687.56,15474.79
942492472658605568,2020-12,475.84,3915.96,834.26,1333.91,-3939.77,11535.02
942804929525905664,2020-01,1396.01,6091.85,0,2936.09,-7631.93,-7631.93
942804929525905664,2020-02,2766.15,0,785.64,916.11,2635.68,-4996.25
942804929525905664,2020-03,1059.74,2098,2318.58,533.99,746.33,-4249.92
942804929525905664,2020-04,546.03,1829,0,1991.01,-3273.98,-7523.9
942804929525905664,2020-05,3230,1343.83,0,3678.39,-1792.22,-9316.12
942804929525905664,2020-06,465.76,1101.86,770.86,379.39,-244.63,-9560.75
942804929525905664,2020-07,3660.69,0,4086.91,582.47,7165.13,-2395.62
942804929525905664,2020-08,3111.14,4664.32,3204.74,6370.23,-4718.67,-7114.29
942804929525905664,2020-09,566.74,2090.56,1141.65,0,-382.17,-7496.46
942804929525905664,2020-10,3097.54,176.59,1165.43,2404.53,1681.85,-5814.61
942804929525905664,2020-12,0,1739.27,2707.64,2051.59,-1083.22,-6897.83
942891636501228288,2020-01,565.04,400.15,3457.87,799.01,2823.75,2823.75
942891636501228288,2020-02,0,3572.73,4105.53,2364.28,-1831.48,992.27
942891636501228288,2020-04,448.92,1336.22,1860.61,1493.59,-520.28,471.99
942891636501228288,2020-05,2328.35,2692.45,1978.22,3153.82,-1539.7,-1067.71
942891636501228288,2020-06,340.17,2004.77,3278.5,787.58,826.32,-241.39
942891636501228288,2020-07,717.68,2875.68,50.86,2019.61,-4126.75,-4368.14
942891636501228288,2020-08,661.5,0,0,1682.02,-1020.52,-5388.66
942891636501228288,2020-09,0,4574.2,3013.44,1733.68,-3294.44,-8683.1
942891636501228288,2020-10,0,694.69,1781.26,2753.25,-1666.68,-10349.78
942891636501228288,2020-11,533.34,0,1201.39,3363.22,-1628.49,-11978.27
942891636501228288,2020-12,3012.72,0,1851.56,2545.22,2319.06,-9659.21
942983680103115008,2020-01,2373.93,718.43,0,2290.84,-635.34,-635.34
942983680103115008,2020-02,200.85,0,1042.1,1609.74,-366.79,-1002.13
942983680103115008,2020-03,1891.91,0,0,0,1891.91,889.78
942983680103115008,2020-08,1330.44,0,2211.8,93.47,3448.77,4338.55
942983680103115008,2020-09,2765.03,2223.43,0,2810.01,-2268.41,2070.14
942983680103115008,2020-10,3334.07,4807.87,36.01,0,-1437.79,632.35
942983680103115008,2020-11,1627.66,3419.02,0,2463.08,-4254.44,-3622.09
942983680103115008,2020-12,2843.6,1695.38,1818.6,1125.53,1841.29,-1780.8
944591087401571968,2020-01,4611.12,3069.61,3650.95,2614.39,2578.07,2578.07
944591087401571968,2020-02,2525.82,4165.68,4457.29,3928.54,-1111.11,1466.96
944591087401571968,2020-03,4081.45,2169.74,3576.86,730.17,4758.4,6225.36
944591087401571968,2020-04,373.89,0,7765.82,4307.78,3831.93,10057.29
944591087401571968,2020-05,1335.73,576.02,833.54,2494.78,-901.53,9155.76
944591087401571968,2020-06,3343.7,1853.15,7064.9,4348.27,4207.18,13362.94
944591087401571968,2020-07,3900.13,7854.28,5116.66,950.73,211.78,13574.72
944591087401571968,2020-08,426.38,3326.68,1431.58,4483.16,-5951.88,7622.84
944591087401571968,2020-09,6753.9,2402.94,7106.54,2646.11,8811.39,16434.23
944591087401571968,2020-10,1831.27,1780.08,5840.98,1673.62,4218.55,20652.78
944591087401571968,2020-11,1772.18,1318.08,2092.26,4741.06,-2194.7,18458.08
944591087401571968,2020-12,1973.89,6726.09,586.38,3150.3,-7316.12,11141.96
944970994884400640,2020-01,6061.83,3359.47,0,3319.56,-617.2,-617.2
944970994884400640,2020-02,5101.19,1850.34,3225.61,5106.76,1369.7,752.5
944970994884400640,2020-03,4745.12,2048.23,712.84,864.65,2545.08,3297.58
944970994884400640,2020-04,1962.71,4999,1039.6,2115.78,-4112.47,-814.89
944970994884400640,2020-05,5314.02,3696.75,1930.36,2752.65,794.98,-19.91
944970994884400640,2020-06,3267.07,1421.53,569.96,3994.97,-1579.47,-1599.38
944970994884400640,2020-07,5600.78,5273.71,3727.4,4779.48,-725.01,-2324.39
944970994884400640,2020-08,5237,6726.34,1341.98,5537.66,-5685.02,-8009.41
944970994884400640,2020-09,2881.03,5369.07,583.34,6206.94,-8111.64,-16121.05
944970994884400640,2020-10,239.02,1296.82,3523.37,6679.87,-4214.3,-20335.35
944970994884400640,2020-11,2979.37,924.21,1367.64,3087.93,334.87,-20000.48
944970994884400640,2020-12,3329,2949.73,288.98,1139.67,-471.42,-20471.9
945658829492086272,2020-01,2164.78,2507.93,1966.31,0,1623.16,1623.16
945658829492086272,2020-02,0,2499.02,873.28,1444.34,-3070.08,-1446.92
945658829492086272,2020-03,0,1420.37,0,0,-1420.37,-2867.29
945658829492086272,2020-04,0,2646.28,0,749.03,-3395.31,-6262.6
945658829492086272,2020-06,1849.61,1588.1,1984.58,1176.23,1069.86,-5192.74
945658829492086272,2020-07,0,1242.19,1041.01,26.4,-227.58,-5420.32
945658829492086272,2020-08,1364.77,2999.07,1803.29,1739.76,-1570.77,-6991.09
945658829492086272,2020-09,1963.68,0,0,0,1963.68,-5027.41
945658829492086272,2020-10,0,1741.2,0,10.24,-1751.44,-6778.85
945658829492086272,2020-11,1493,3028.56,2633.63,0,1098.07,-5680.78
945658829492086272,2020-12,908.95,0,516.03,1738.67,-313.69,-5994.47
946339794877132544,2020-01,1493.8,469.6,111.89,701.7,434.39,434.39
946339794877132544,2020-03,1410.42,0,0,419.12,991.3,1425.69
946339794877132544,2020-04,0,828.95,0,0,-828.95,596.74
946339794877132544,2020-07,2552.94,0,0,1667.74,885.2,1481.94
946339794877132544,2020-09,1734.77,2446,0,0,-711.23,770.71
946339794877132544,2020-10,0,77.22,1153.66,0,1076.44,1847.15
946339794877132544,2020-12,646.99,1909.65,0,0,-1262.66,584.49
947201300336248704,2020-01,5038.2,2894.09,6820.71,2212.5,6752.32,6752.32
947201300336248704,2020-02,4751.95,3609.46,36.28,3541.79,-2363.02,4389.3
947201300336248704,2020-03,2968.93,1518.72,5394.45,6240.69,603.97,4993.27
947201300336248704,2020-04,2373.23,5870.62,4699,5187.65,-3986.04,1007.23
947201300336248704,2020-05,4625.73,3102.31,2357.5,2687,1193.92,2201.15
947201300336248704,2020-06,3861.71,1957.92,352.55,7566.27,-5309.93,-3108.78
947201300336248704,2020-07,1904.2,2415.77,4123.57,2169.34,1442.66,-1666.12
947201300336248704,2020-08,7798.23,5456.59,8752.74,8971.79,2122.59,456.47
947201300336248704,2020-09,2944.3,3235.88,5973.59,0,5682.01,6138.48
947201300336248704,2020-10,3545.69,3594.17,8760.8,3560.01,5152.31,11290.79
947201300336248704,2020-11,1775.39,12899.1,6252.82,2443,-7313.89,3976.9
947201300336248704,2020-12,4940.63,5586.81,2597.9,2927.61,-975.89,3001.01
947447526312558080,2020-01,67.44,0,0,0,67.44,67.44
947447526312558080,2020-06,1665.36,0,0,0,1665.36,1732.8
947447526312558080,2020-10,1591.7,0,0,0,1591.7,3324.5
948531051514719360,2020-01,6473.37,5580.01,1611.93,2707.93,-202.64,-202.64
948531051514719360,2020-02,3482.35,3567.44,1933.08,1779.05,68.94,-133.7
948531051514719360,2020-03,1358.6,4568.29,4364.34,340.91,813.74,680.04
948531051514719360,2020-04,2774.66,7537.02,2311.85,1222.42,-3672.93,-2992.89
948531051514719360,2020-05,3495.12,2161.78,2366.14,3003.76,695.72,-2297.17
948531051514719360,2020-06,3971.94,5509.42,4560.12,4627.1,-1604.46,-3901.63
948531051514719360,2020-07,1088.41,6183.64,1855.31,7977.96,-11217.88,-15119.51
948531051514719360,2020-08,3625.66,8455.9,4651.35,3597.44,-3776.33,-18895.84
948531051514719360,2020-09,5554.57,3081.73,4255.13,7489.19,-761.22,-19657.06
948531051514719360,2020-10,7537.2,5676.94,1853.15,2214.93,1498.48,-18158.58
948531051514719360,2020-11,3123.93,5440.88,2490.59,501.85,-328.21,-18486.79
948531051514719360,2020-12,2172.03,6229.36,3113.66,1609.46,-2553.13,-21039.92
948995570567424896,2020-01,3585.52,0,0,914.38,2671.14,2671.14
948995570567424896,2020-02,1677.94,0,1226.86,0,2904.8,5575.94
948995570567424896,2020-03,0,102.01,0,484.81,-586.82,4989.12
948995570567424896,2020-04,1632.07,1530.53,0,964.86,-863.32,4125.8
948995570567424896,2020-05,2678.65,2100.19,161.68,0,740.14,4865.94
948995570567424896,2020-06,297.8,1953.81,1478.76,1855.37,-2032.62,2833.32
948995570567424896,2020-07,1739.6,0,3812.73,1749.81,3802.52,6635.84
948995570567424896,2020-08,674.1,3257.56,109.98,2739.46,-5212.94,1422.9
948995570567424896,2020-09,3259.02,3743.36,700.41,0,216.07,1638.97
948995570567424896,2020-10,562.93,0,1813.61,0,2376.54,4015.51
948995570567424896,2020-11,1916.4,0,589.69,2459.8,46.29,4061.8
948995570567424896,2020-12,3419.75,3750.23,2688.79,1583.88,774.43,4836.23
950549094096300160,2020-01,4193.69,1734.72,882.25,4580.66,-1239.44,-1239.44
950549094096300160,2020-02,2690.37,2411.85,1031.6,0,1310.12,70.68
950549094096300160,2020-03,1235.7,0,1077.37,1611.23,701.84,772.52
950549094096300160,2020-04,121.42,1586.14,0,746.82,-2211.54,-1439.02
950549094096300160,2020-05,0,2261.31,3977.94,0,1716.63,277.61
950549094096300160,2020-06,1019.25,2894.43,2035.77,556.08,-395.49,-117.88
950549094096300160,2020-07,1304.31,1970.1,1696.74,1373.84,-342.89,-460.77
950549094096300160,2020-08,2612.27,1628.88,0,2499.46,-1516.07,-1976.84
950549094096300160,2020-09,4215.29,2420.7,887.05,2025.13,656.51,-1320.33
950549094096300160,2020-10,1058.7,1818.79,0,1000.97,-1761.06,-3081.39
950549094096300160,2020-11,1117.86,0,0,225.64,892.22,-2189.17
950549094096300160,2020-12,2689.36,1397.58,1365.29,1657.33,999.74,-1189.43
950809857869696256,2020-01,1048.59,0,2500.59,0,3549.18,3549.18
950809857869696256,2020-02,0,1407.12,0,1266.96,-2674.08,875.1
950809857869696256,2020-04,0,798.52,0,907.17,-1705.69,-830.59
950809857869696256,2020-05,0,455.01,2556.62,363.87,1737.74,907.15
950809857869696256,2020-06,0,369.44,168.45,0,-200.99,706.16
950809857869696256,2020-07,1615.49,1634.61,739.57,0,720.45,1426.61
950809857869696256,2020-08,1625.67,0,0,1193.89,431.78,1858.39
950809857869696256,2020-09,4742.59,0,0,0,4742.59,6600.98
950809857869696256,2020-10,0,682.46,463.74,4677.32,-4896.04,1704.94
950809857869696256,2020-11,849.62,984.17,0,2358.85,-2493.4,-788.46
950809857869696256,2020-12,832.22,0,1832.18,3604.02,-939.62,-1728.08
951215757488226176,2020-01,3203.31,2573.36,5122.97,5755.61,-2.69,-2.69
951215757488226176,2020-02,1620.86,5065.03,2816.81,2305.09,-2932.45,-2935.14
951215757488226176,2020-03,2431.11,4006.74,1697.94,2471.08,-2348.77,-5283.91
951215757488226176,2020-04,2996.21,2805.79,1141.68,2725.15,-1393.05,-6676.96
951215757488226176,2020-05,5605.47,316.92,2243.21,319.92,7211.84,534.88
951215757488226176,2020-06,1359.56,539.1,5982.93,1611.25,5192.14,5727.02
951215757488226176,2020-07,4109.19,469.6,168.95,4806.56,-998.02,4729
951215757488226176,2020-08,6524.19,1628.58,3087.73,897.37,7085.97,11814.97
951215757488226176,2020-09,2128.58,1256.61,2442.79,6443.36,-3128.6,8686.37
951215757488226176,2020-10,6470.35,2145.43,3025.5,3091.74,4258.68,12945.05
951215757488226176,2020-11,2120.39,1845.4,4098.62,0,4373.61,17318.66
951215757488226176,2020-12,914.06,3827.54,4152.99,5484.25,-4244.74,13073.92
952461673877439872,2020-01,3986.1,8973.7,1427.55,3176.79,-6736.84,-6736.84
952461673877439872,2020-02,5739.2,1069.57,3957.38,7159.83,1467.18,-5269.66
952461673877439872,2020-03,8322.42,3417.9,2960.03,3817.03,4047.52,-1222.14
952461673877439872,2020-04,2125.85,1742.12,3072.58,5118.67,-1662.36,-2884.5
952461673877439872,2020-05,3651.02,5458.26,1113.68,409.24,-1102.8,-3987.3
952461673877439872,2020-06,3073.72,2084.14,1360.27,996.49,1353.36,-2633.94
952461673877439872,2020-07,6002.1,11021.92,8321.79,7952.97,-4651,-7284.94
952461673877439872,2020-08,4451.2,5334.89,4226.35,7538.47,-4195.81,-11480.75
952461673877439872,2020-09,1766.63,3684.63,3724.78,2256.92,-450.14,-11930.89
952461673877439872,2020-10,1368.83,8669.98,3751.67,10237.28,-13786.76,-25717.65
952461673877439872,2020-11,2972.76,1809.51,6431.57,935.52,6659.3,-19058.35
952461673877439872,2020-12,3212.91,2696.26,4550.01,9282.65,-4215.99,-23274.34
953039428155438208,2020-02,0,429.41,0,0,-429.41,-429.41
953039428155438208,2020-04,511.37,0,0,0,511.37,81.96
953039428155438208,2020-05,1009.3,0,0,556.32,452.98,534.94
953039428155438208,2020-06,1689.56,0,1155.43,0,2844.99,3379.93
953039428155438208,2020-08,1045.06,0,0,0,1045.06,4424.99
955205254833968000,2020-01,4349.56,5994.64,4481.95,2069.92,766.95,766.95
955205254833968000,2020-02,1913.87,1960.75,1538.14,0,1491.26,2258.21
955205254833968000,2020-03,0,2592.4,3286.62,6086.01,-5391.79,-3133.58
955205254833968000,2020-04,2084.19,3654.08,1732.1,5638.64,-5476.43,-8610.01
955205254833968000,2020-05,3193.88,3120.21,132.66,2732.12,-2525.79,-11135.8
955205254833968000,2020-06,0,2882.14,6028.03,2726.81,419.08,-10716.72
955205254833968000,2020-07,6086.98,922.2,2324.14,0,7488.92,-3227.8
955205254833968000,2020-08,2300.1,3981.2,3730.71,3214.5,-1164.89,-4392.69
955205254833968000,2020-09,3095.44,2501.1,2575.91,2852.18,318.07,-4074.62
955205254833968000,2020-10,613.97,1639.27,2510.06,0,1484.76,-2589.86
955205254833968000,2020-11,1707.38,0,920.02,3505.12,-877.72,-3467.58
955205254833968000,2020-12,2760.13,2633.22,987.36,2520.43,-1406.16,-4873.74
955338973441200384,2020-01,227.69,0,481.7,2621.17,-1911.78,-1911.78
955338973441200384,2020-02,881.42,970.71,1676.3,596.33,990.68,-921.1
955338973441200384,2020-03,1870.41,0,0,2954.44,-1084.03,-2005.13
955338973441200384,2020-06,1414.18,0,2980.02,1972.29,2421.91,416.78
955338973441200384,2020-07,74.41,0,1455.38,0,1529.79,1946.57
955338973441200384,2020-08,0,2567.63,1483.77,0,-1083.86,862.71
955338973441200384,2020-09,36.34,450.49,398.37,1669.48,-1685.26,-822.55
955338973441200384,2020-12,1398.5,0,0,1268.98,129.52,-693.03
956706776503820928,2020-01,5938.46,300.91,2416.91,4553,3501.46,3501.46
956706776503820928,2020-02,3008.97,2133.9,3957.42,6326.35,-1493.86,2007.6
956706776503820928,2020-03,1912.65,2697.39,513.15,1100.61,-1372.2,635.4
956706776503820928,2020-04,566.1,4608.71,1948.34,2728.19,-4822.46,-4187.06
956706776503820928,2020-05,6816.91,2076.12,3886.36,6131.92,2495.23,-1691.83
956706776503820928,2020-06,6468.73,4302.28,3544.98,5654.04,57.39,-1634.44
956706776503820928,2020-07,2595.27,3600.75,2500.12,2981.35,-1486.71,-3121.15
956706776503820928,2020-08,9852.35,2756.6,4443.02,2636.36,8902.41,5781.26
956706776503820928,2020-09,4857.41,3656.66,3250.39,1790.43,2660.71,8441.97
956706776503820928,2020-10,4425.72,1646.38,443.79,2835.66,387.47,8829.44
956706776503820928,2020-11,4308.83,3814.27,2377.32,1162.19,1709.69,10539.13
956706776503820928,2020-12,6432.72,2183.02,2565.33,6588.85,226.18,10765.31
957494188757221760,2020-01,989.81,1388.73,0,1032.47,-1431.39,-1431.39
957494188757221760,2020-02,1475.92,0,666.19,854.51,1287.6,-143.79
957494188757221760,2020-03,1978.95,0,0,780.92,1198.03,1054.24
957494188757221760,2020-07,1446.2,1664.71,0,0,-218.51,835.73
957494188757221760,2020-09,0,3087.19,0,0,-3087.19,-2251.46
957494188757221760,2020-10,1833.33,1025.26,2058.57,0,2866.64,615.18
957494188757221760,2020-12,1569.92,2385.15,0,0,-815.23,-200.05
959225682501978624,2020-01,1842.92,68.1,1526.89,0,3301.71,3301.71
959225682501978624,2020-02,0,405.86,1387.34,289.62,691.86,3993.57
959225682501978624,2020-03,550.51,1074.31,0,6056.66,-6580.46,-2586.89
959225682501978624,2020-04,0,1206.02,1127.7,0,-78.32,-2665.21
959225682501978624,2020-05,375.07,1492.92,1765.28,0,647.43,-2017.78
959225682501978624,2020-06,542.32,1781.7,0,1064.52,-2303.9,-4321.68
959225682501978624,2020-08,3357.03,2878.34,0,239.32,239.37,-4082.31
959225682501978624,2020-09,111.2,0,2710.65,0,2821.85,-1260.46
959225682501978624,2020-10,376.19,0,3705.77,1393.43,2688.53,1428.07
959225682501978624,2020-12,3495.19,0,0,635.89,2859.3,4287.37
959659316261034880,2020-01,1818.9,0,0,878.73,940.17,940.17
959659316261034880,2020-02,0,667.95,0,1541.98,-2209.93,-1269.76
959659316261034880,2020-03,1854.4,0,0,896.72,957.68,-312.08
959659316261034880,2020-04,500.91,2778.43,1781.03,2126.66,-2623.15,-2935.23
959659316261034880,2020-05,0,1079.44,1184.23,479.22,-374.43,-3309.66
959659316261034880,2020-06,759.04,2777.2,0,0,-2018.16,-5327.82
959659316261034880,2020-07,0,1313.8,772.17,0,-541.63,-5869.45
959659316261034880,2020-08,932.13,0,3038.08,2028.16,1942.05,-3927.4
959659316261034880,2020-09,104.69,686.29,0,0,-581.6,-4509
959659316261034880,2020-10,1722.93,78.76,2519,0,4163.17,-345.83
959659316261034880,2020-11,1832.35,1469.93,0,0,362.42,16.59
959659316261034880,2020-12,0,1694.37,1476.85,0,-217.52,-200.93
960500885252638720,2020-01,0,3195.9,1450.36,1471.37,-3216.91,-3216.91
960500885252638720,2020-02,0,5009.52,1258.62,2565.61,-6316.51,-9533.42
960500885252638720,2020-03,1585.08,1972.02,2325.1,6368.35,-4430.19,-13963.61
960500885252638720,2020-04,2686.36,0,911.28,2547.64,1050,-12913.61
960500885252638720,2020-05,2404.65,1816.03,736.75,2718.69,-1393.32,-14306.93
960500885252638720,2020-06,1914.36,1992.08,1939.98,1702.55,159.71,-14147.22
960500885252638720,2020-07,4294.83,225.46,3889.47,1644.28,6314.56,-7832.66
960500885252638720,2020-08,4274.2,0,1572.98,1547.29,4299.89,-3532.77
960500885252638720,2020-09,1568.68,1478.24,1975.18,5879.31,-3813.69,-7346.46
960500885252638720,2020-10,5338.1,1968.22,4013.38,531.97,6851.29,-495.17
960500885252638720,2020-11,1130.41,4291.73,3332.95,0,171.63,-323.54
960500885252638720,2020-12,3439.45,1978.59,0,1950.72,-489.86,-813.4
960645195274571136,2020-01,6879.43,4530.34,2686.39,4914.04,121.44,121.44
960645195274571136,2020-02,8350.62,3607.8,3525.32,1417.02,6851.12,6972.56
960645195274571136,2020-03,3765.44,2386.23,8606.96,13003.73,-3017.56,3955
960645195274571136,2020-04,4811.31,5893.3,3878.29,6537.27,-3740.97,214.03
960645195274571136,2020-05,5636.17,5046.53,3096.15,5224.21,-1538.42,-1324.39
960645195274571136,2020-06,11389.93,3694.64,611.3,2459.36,5847.23,4522.84
960645195274571136,2020-07,3664.45,9907.6,4743.37,5305.6,-6805.38,-2282.54
960645195274571136,2020-08,8124.68,4159.66,5568.31,5505.05,4028.28,1745.74
960645195274571136,2020-09,1549.4,603.8,2489.37,5529.04,-2094.07,-348.33
960645195274571136,2020-10,4353.42,5407.27,1518.52,5563.21,-5098.54,-5446.87
960645195274571136,2020-11,4224.44,4664.01,4729.22,4672.1,-382.45,-5829.32
960645195274571136,2020-12,3872.3,4195.99,7703.51,4920.25,2459.57,-3369.75
960686432635835008,2020-01,584.02,0,46.84,1136.11,-505.25,-505.25
960686432635835008,2020-03,1518.81,0,1313.18,0,2831.99,2326.74
960686432635835008,2020-04,1055.28,0,0,0,1055.28,3382.02
960686432635835008,2020-06,0,1830.47,0,0,-1830.47,1551.55
960686432635835008,2020-07,0,916.79,0,0,-916.79,634.76
960686432635835008,2020-08,0,1860.13,0,0,-1860.13,-1225.37
960686432635835008,2020-10,981.19,0,0,1353.73,-372.54,-1597.91
960686432635835008,2020-12,1908.85,0,1546.53,0,3455.38,1857.47
961902381183523584,2020-02,0,2514.25,1158.35,0,-1355.9,-1355.9
961902381183523584,2020-03,2136.37,552.62,493.53,0,2077.28,721.38
961902381183523584,2020-04,3336.06,319.13,0,1314.34,1702.59,2423.97
961902381183523584,2020-05,0,1030.34,2292.41,0,1262.07,3686.04
961902381183523584,2020-06,0,2582.82,0,2178.01,-4760.83,-1074.79
961902381183523584,2020-07,136.54,1415.16,0,380.72,-1659.34,-2734.13
961902381183523584,2020-08,2326.55,0,2316.01,0,4642.56,1908.43
961902381183523584,2020-09,4736.28,0,0,445.88,4290.4,6198.83
961902381183523584,2020-10,1842.84,3081.89,0,1626.38,-2865.43,3333.4
961902381183523584,2020-11,0,732.55,1402.72,4421.54,-3751.37,-417.97
961902381183523584,2020-12,1424.68,160.35,0,743,521.33,103.36
962617508864483456,2020-01,229.17,1297.57,4304,5704.41,-2468.81,-2468.81
962617508864483456,2020-02,5038.7,3390.28,4282.28,5433.11,497.59,-1971.22
962617508864483456,2020-03,0,6342.51,3289.14,3385.89,-6439.26,-8410.48
962617508864483456,2020-04,5261.8,5133.75,654.46,2430.8,-1648.29,-10058.77
962617508864483456,2020-05,0,499.33,4626.15,2512.91,1613.91,-8444.86
962617508864483456,2020-06,6589.87,1268.18,0,4407.88,913.81,-7531.05
962617508864483456,2020-07,0,843.78,2781.51,8956.81,-7019.08,-14550.13
962617508864483456,2020-08,2934.13,3325.93,1515.53,2734.39,-1610.66,-16160.79
962617508864483456,2020-09,5374.29,2819.97,3193.86,3272.96,2475.22,-13685.57
962617508864483456,2020-10,1213.47,4532.2,2617.28,2864.17,-3565.62,-17251.19
962617508864483456,2020-11,2613.9,844.75,1090.7,2447.72,412.13,-16839.06
962617508864483456,2020-12,42.32,2658.75,3875.25,500.88,757.94,-16081.12
962672258846993664,2020-01,3970.16,5255.07,5990.07,2543.62,2161.54,2161.54
962672258846993664,2020-02,4620.67,2835.32,1805.16,2898.66,691.85,2853.39
962672258846993664,2020-03,2962.79,4725.07,9136.2,5776.58,1597.34,4450.73
962672258846993664,2020-04,2965.62,4369.88,2192.38,5220.2,-4432.08,18.65
962672258846993664,2020-05,8004.65,2544.15,1763.13,5648.42,1575.21,1593.86
962672258846993664,2020-06,3761.36,2000.12,9698.49,5649.89,5809.84,7403.7
962672258846993664,2020-07,6019.7,6109.97,5738.39,7361.51,-1713.39,5690.31
962672258846993664,2020-08,1764.91,7854.97,3220.14,11731.73,-14601.65,-8911.34
962672258846993664,2020-09,2190.25,6735.89,6244.8,4154.4,-2455.24,-11366.58
962672258846993664,2020-10,1062.61,3589.53,7443.44,6880.79,-1964.27,-13330.85
962672258846993664,2020-11,8860.67,5411.6,5697.24,2653.24,6493.07,-6837.78
962672258846993664,2020-12,3977.21,6946.02,3923.49,2359.81,-1405.13,-8242.91
962692748212221312,2020-01,411.35,4518.17,4500.34,6746.21,-6352.69,-6352.69
962692748212221312,2020-02,748.84,7060.71,2865.08,5125.18,-8571.97,-14924.66
962692748212221312,2020-03,3941.39,4245.5,4372.76,1104.41,2964.24,-11960.42
962692748212221312,2020-04,4992.14,1119.92,2715.21,2400.1,4187.33,-7773.09
962692748212221312,2020-05,1820.12,0,1475.71,1226.29,2069.54,-5703.55
962692748212221312,2020-06,3291.48,3065.69,2779.37,6372.91,-3367.75,-9071.3
962692748212221312,2020-07,1152.55,3846.16,4216.79,1977.05,-453.87,-9525.17
962692748212221312,2020-08,6021.39,3318.19,1966.09,2781.63,1887.66,-7637.51
962692748212221312,2020-09,3321.65,729.99,3128.38,6275.05,-555.01,-8192.52
962692748212221312,2020-10,4186.5,3052.99,2091.82,3691.05,-465.72,-8658.24
962692748212221312,2020-11,4918.95,7290.41,8004.06,4032.25,1600.35,-7057.89
962692748212221312,2020-12,1156.54,2589.92,566.36,2104.46,-2971.48,-10029.37
963955687788036096,2020-01,1139.38,1465.2,2356.85,2032.62,-1.59,-1.59
963955687788036096,2020-02,2232.79,2674.89,0,2963.91,-3406.01,-3407.6
963955687788036096,2020-03,5924.89,0,3206.83,583.66,8548.06,5140.46
963955687788036096,2020-04,6358.6,2507.08,0,893.5,2958.02,8098.48
963955687788036096,2020-05,5380.46,2136.37,2375.4,2642.14,2977.35,11075.83
963955687788036096,2020-06,2152.93,1366.18,0,1675.46,-888.71,10187.12
963955687788036096,2020-07,406.28,2931.2,4039.55,3030.88,-1516.25,8670.87
963955687788036096,2020-08,5101.24,5855.2,5253.84,3279.14,1220.74,9891.61
963955687788036096,2020-09,4063.34,4435.05,1302.61,3562.63,-2631.73,7259.88
963955687788036096,2020-10,1319.35,1373.87,2530.69,1218.66,1257.51,8517.39
963955687788036096,2020-11,3241.05,1564.82,4765.26,1566.65,4874.84,13392.23
963955687788036096,2020-12,2912.04,3804.1,3307.13,3242.57,-827.5,12564.73
965880633564624640,2020-01,5832.02,7401.67,3385.4,4037.92,-2222.17,-2222.17
965880633564624640,2020-02,2367.98,2079.45,6727.32,3520.46,3495.39,1273.22
965880633564624640,2020-03,3912.1,2807.53,1543.38,5162.32,-2514.37,-1241.15
965880633564624640,2020-04,2630.47,1902.79,5368.77,691.21,5405.24,4164.09
965880633564624640,2020-05,2281.33,6235.75,6816.1,4950.56,-2088.88,2075.21
965880633564624640,2020-06,2282.37,2672.21,8754.06,5385.11,2979.11,5054.32
965880633564624640,2020-07,3451.48,5710.7,5067.12,6575.09,-3767.19,1287.13
965880633564624640,2020-08,9155.11,8303.87,6384.56,0,7235.8,8522.93
965880633564624640,2020-09,3351.54,2832.03,8102.22,1106.94,7514.79,16037.72
965880633564624640,2020-10,6307.33,6253.08,6466.78,1465.82,5055.21,21092.93
965880633564624640,2020-11,3709.36,3117.91,6459.22,2880.08,4170.59,25263.52
965880633564624640,2020-12,717.13,7171.73,4712.63,5721.23,-7463.2,17800.32
966750888161922560,2020-01,2593.69,0,0,0,2593.69,2593.69
966750888161922560,2020-02,1864.64,69.93,360.33,0,2155.04,4748.73
966750888161922560,2020-04,0,1988.01,1244.2,0,-743.81,4004.92
966750888161922560,2020-05,1693.69,0,0,566.53,1127.16,5132.08
966750888161922560,2020-06,88.35,0,1130.36,0,1218.71,6350.79
966750888161922560,2020-07,0,920.12,0,0,-920.12,5430.67
966750888161922560,2020-08,1671.12,1334.64,1617.35,4370.91,-2417.08,3013.59
966750888161922560,2020-09,0,2054.53,1702.86,707.51,-1059.18,1954.41
966750888161922560,2020-10,651.24,2699.35,0,0,-2048.11,-93.7
966750888161922560,2020-11,0,1673.74,1501.8,0,-171.94,-265.64
966750888161922560,2020-12,0,194.85,0,0,-194.85,-460.49
967379012455922176,2020-10,828.53,0,0,1668.71,-840.18,-840.18
967490877325886208,2020-01,4425.11,3702.05,3667.66,1671.29,2719.43,2719.43
967490877325886208,2020-02,4636.78,2230.78,7010.66,3946.06,5470.6,8190.03
967490877325886208,2020-03,1291.78,3515.58,7092.92,3332.18,1536.94,9726.97
967490877325886208,2020-04,1195.61,6056.46,683.57,2598.35,-6775.63,2951.34
967490877325886208,2020-05,2563.15,3624.04,5783.99,1470.08,3253.02,6204.36
967490877325886208,2020-06,3584.34,6738.59,3807.58,2540.54,-1887.21,4317.15
967490877325886208,2020-07,3397.77,206.78,2289.63,4290.51,1190.11,5507.26
967490877325886208,2020-08,3046.02,7563.55,545.2,3470.65,-7442.98,-1935.72
967490877325886208,2020-09,3280.52,3755.89,6420.71,4005.85,1939.49,3.77
967490877325886208,2020-10,321.77,3943.78,4530.4,4984.39,-4076,-4072.23
967490877325886208,2020-11,5886.27,2981.47,7027.55,4969.4,4962.95,890.72
967490877325886208,2020-12,3489.96,2236.8,7910.23,1628.28,7535.11,8425.83
967848743515068544,2020-01,0,209.51,1626.17,1734.52,-317.86,-317.86
967848743515068544,2020-02,0,638.43,682.32,0,43.89,-273.97
967848743515068544,2020-03,0,1142.13,1864.62,0,722.49,448.52
967848743515068544,2020-04,1013.47,0,497.28,592.93,917.82,1366.34
967848743515068544,2020-05,1107.1,0,4112.46,0,5219.56,6585.9
967848743515068544,2020-06,0,1578.62,1485.78,3733.36,-3826.2,2759.7
967848743515068544,2020-07,2100.21,827.44,682.11,1835.13,119.75,2879.45
967848743515068544,2020-08,1884.46,207.53,1318.84,855.4,2140.37,5019.82
967848743515068544,2020-10,1138.2,0,4022.46,0,5160.66,10180.48
967848743515068544,2020-11,5050.63,1639.88,1559.75,2624.81,2345.69,12526.17
967848743515068544,2020-12,1148.24,701.32,0,0,446.92,12973.09
967850889380328320,2020-01,1486.07,0,629.75,0,2115.82,2115.82
967850889380328320,2020-03,3069.71,1266.53,0,0,1803.18,3919
967850889380328320,2020-04,0,922.98,411.38,1103.01,-1614.61,2304.39
967850889380328320,2020-05,1476.57,0,0,0,1476.57,3780.96
967850889380328320,2020-06,0,1818.06,0,0,-1818.06,1962.9
967850889380328320,2020-07,494.5,0,340.41,0,834.91,2797.81
967850889380328320,2020-08,547.94,0,36.39,0,584.33,3382.14
967850889380328320,2020-10,1862.02,1858.98,1045.66,0,1048.7,4430.84
967850889380328320,2020-11,1652.26,288.3,1558.97,124.07,2798.86,7229.7
967850889380328320,2020-12,546.25,0,0,0,546.25,7775.95
969695109722403456,2020-01,4545.97,0,1619.28,2021.33,4143.92,4143.92
969695109722403456,2020-02,3289.14,2469.06,5876.08,6809.02,-112.86,4031.06
969695109722403456,2020-03,2144.63,395.52,2567.11,3876.5,439.72,4470.78
969695109722403456,2020-04,0,2253.82,4018.85,1328.92,436.11,4906.89
969695109722403456,2020-05,2570.19,0,4192.97,5377.79,1385.37,6292.26
969695109722403456,2020-06,3887.99,1894.35,320.48,378.04,1936.08,8228.34
969695109722403456,2020-07,386.35,1876.13,327.32,0,-1162.46,7065.88
969695109722403456,2020-08,1872.49,872.14,1546.2,56.54,2490.01,9555.89
969695109722403456,2020-09,3435.4,2524.59,6625.86,2535.83,5000.84,14556.73
969695109722403456,2020-10,2426.74,4118.68,3547.85,1806.33,49.58,14606.31
969695109722403456,2020-11,628.35,1911.08,3923.84,3301.2,-660.09,13946.22
969695109722403456,2020-12,621.01,462.37,1640.43,414.26,1384.81,15331.03
969908245413090944,2020-01,3843.91,3064.65,5067.63,5872.69,-25.8,-25.8
969908245413090944,2020-02,2939.72,3856.39,3036.02,5138.23,-3018.88,-3044.68
969908245413090944,2020-03,4135.88,5696.62,3387.18,7701.25,-5874.81,-8919.49
969908245413090944,2020-04,7036.87,5057.08,987.43,1399.02,1568.2,-7351.29
969908245413090944,2020-05,3058.56,1632.28,4344.41,0,5770.69,-1580.6
969908245413090944,2020-06,5487.81,4518.45,1046.73,2171.82,-155.73,-1736.33
969908245413090944,2020-07,7079.62,2171.85,6708.58,876.98,10739.37,9003.04
969908245413090944,2020-08,6027.34,4045.52,5190.21,3027.93,4144.1,13147.14
969908245413090944,2020-09,3967.99,3883.37,5623.19,7658.89,-1951.08,11196.06
969908245413090944,2020-10,2397.84,7417.46,5306.87,6956.45,-6669.2,4526.86
969908245413090944,2020-11,2791.73,6106.22,2121.74,3206.88,-4399.63,127.23
969908245413090944,2020-12,2519.88,1382.66,8894.48,5076.66,4955.04,5082.27
970391555940094336,2020-01,2890.93,5059.48,1255.92,2465.91,-3378.54,-3378.54
970391555940094336,2020-02,1439.41,1514.73,568.79,4818.21,-4324.74,-7703.28
970391555940094336,2020-03,3708.64,4030.16,4813.43,5801.13,-1309.22,-9012.5
970391555940094336,2020-04,3724.01,0,4618.38,2124.34,6218.05,-2794.45
970391555940094336,2020-05,4267.76,4714.32,6094.05,4920.15,727.34,-2067.11
970391555940094336,2020-06,3085.54,488.6,3108.89,2356.68,3349.15,1282.04
970391555940094336,2020-07,2948.52,2152.36,4588.21,4502.39,881.98,2164.02
970391555940094336,2020-08,2843.23,3374.1,4023.99,1035.41,2457.71,4621.73
970391555940094336,2020-09,1205.08,4509.38,4208.37,2812.91,-1908.84,2712.89
970391555940094336,2020-10,4290.84,2894.8,419.03,2934.39,-1119.32,1593.57
970391555940094336,2020-11,3446.22,1738.29,2217.76,4546.67,-620.98,972.59
970391555940094336,2020-12,0,6805.03,4131.72,594.66,-3267.97,-2295.38
970763486026185856,2020-01,4204.23,745.05,2802.81,2495.38,3766.61,3766.61
970763486026185856,2020-02,3197.38,5176.37,957.52,5773.22,-6794.69,-3028.08
970763486026185856,2020-03,0,2437.59,3718.11,2449.75,-1169.23,-4197.31
970763486026185856,2020-04,4681.65,6177.15,1323.65,771.48,-943.33,-5140.64
970763486026185856,2020-05,62.38,2636.2,3289.07,2056.06,-1340.81,-6481.45
970763486026185856,2020-06,2879.5,1050.68,1104.23,6873.49,-3940.44,-10421.89
970763486026185856,2020-07,5541.47,2789.7,6180.84,5076.42,3856.19,-6565.7
970763486026185856,2020-08,3903.04,6322.64,799.18,2697.53,-4317.95,-10883.65
970763486026185856,2020-09,1350.84,1431.77,4533.87,4286.73,166.21,-10717.44
970763486026185856,2020-10,1558.73,3419.04,3600.74,3402.4,-1661.97,-12379.41
970763486026185856,2020-11,1787.64,13.02,2079.19,1926.62,1927.19,-10452.22
970763486026185856,2020-12,7178.88,2964.3,1450.13,7357.84,-1693.13,-12145.35
971665613651405056,2020-01,0,1772.48,0,1377.86,-3150.34,-3150.34
971665613651405056,2020-03,1110.17,0,0,0,1110.17,-2040.17
971665613651405056,2020-04,0,1625.96,0,0,-1625.96,-3666.13
971665613651405056,2020-08,0,566.1,0,0,-566.1,-4232.23
971665613651405056,2020-09,0,413.16,0,0,-413.16,-4645.39
972904800757769344,2020-01,1286.06,0,0,1317.14,-31.08,-31.08
972904800757769344,2020-02,1091.06,118.45,0,0,972.61,941.53
972904800757769344,2020-04,0,1024.75,0,0,-1024.75,-83.22
972904800757769344,2020-05,0,1311.37,0,1950.06,-3261.43,-3344.65
972904800757769344,2020-08,0,1065.95,231.36,0,-834.59,-4179.24
972904800757769344,2020-09,274.73,0,2968.14,0,3242.87,-936.37
972904800757769344,2020-12,1192.2,0,726.73,0,1918.93,982.56
973162903015849088,2020-01,820.37,1732.03,1181.04,2909.5,-2640.12,-2640.12
973162903015849088,2020-02,2326.95,3581.28,1449.74,4371.06,-4175.65,-6815.77
973162903015849088,2020-03,908.63,2502.33,2014.42,2790.09,-2369.37,-9185.14
973162903015849088,2020-04,1293.41,4812.86,3047.99,3914.64,-4386.1,-13571.24
973162903015849088,2020-05,2925.17,5218.18,6946.94,351.07,4302.86,-9268.38
973162903015849088,2020-06,4982.21,4021.47,1562.63,1670.74,852.63,-8415.75
973162903015849088,2020-07,3770.94,643.36,2614.06,1182.56,4559.08,-3856.67
973162903015849088,2020-08,1592.18,7241.9,4766.03,5053.52,-5937.21,-9793.88
973162903015849088,2020-09,1171.89,1525.27,3791.09,715.49,2722.22,-7071.66
973162903015849088,2020-10,0,1809.83,3485.17,75.47,1599.87,-5471.79
973162903015849088,2020-12,3302.78,2715.27,0,2182.79,-1595.28,-7067.07
973324258676081920,2020-01,5345.06,5151.74,10911.75,4471.79,6633.28,6633.28
973324258676081920,2020-02,5333.83,1693.7,4078.82,1797.62,5921.33,12554.61
973324258676081920,2020-03,8839.77,2818.12,0,2674.7,3346.95,15901.56
973324258676081920,2020-04,2862.47,7309.5,3154.64,2588.93,-3881.32,12020.24
973324258676081920,2020-05,10045.45,3982.73,8755.49,5800.97,9017.24,21037.48
973324258676081920,2020-06,6143.5,4194.75,7484.89,7146.48,2287.16,23324.64
973324258676081920,2020-07,4188.14,2882.68,6104.14,7968.86,-559.26,22765.38
973324258676081920,2020-08,4150.39,1124.49,3382.96,6283.92,124.94,22890.32
973324258676081920,2020-09,6932.34,3325.17,5490.35,43.25,9054.27,31944.59
973324258676081920,2020-10,3110.15,1109.74,6143.17,2756.5,5387.08,37331.67
973324258676081920,2020-11,6235.84,4733.99,5006.87,8864.68,-2355.96,34975.71
973324258676081920,2020-12,2456.48,3767.71,2460.57,5187.22,-4037.88,30937.83
976358478436350720,2020-06,0,1669.91,498.47,176.75,-1348.19,-1348.19
976358478436350720,2020-07,2322.57,0,0,410.2,1912.37,564.18
976358478436350720,2020-11,0,522.9,0,0,-522.9,41.28
976699354958408192,2020-01,1467.04,3760.61,680.46,5862.32,-7475.43,-7475.43
976699354958408192,2020-02,1382.29,3419.13,2548.06,1104.1,-592.88,-8068.31
976699354958408192,2020-03,4539.35,4768.56,3979.52,6849.74,-3099.43,-11167.74
976699354958408192,2020-04,2975.71,94.79,175.66,1359.81,1696.77,-9470.97
976699354958408192,2020-05,47.49,1269.21,1967.22,0,745.5,-8725.47
976699354958408192,2020-06,1498.34,527.68,3321.83,4356.86,-64.37,-8789.84
976699354958408192,2020-07,1458.09,176.32,3251.23,6091.15,-1558.15,-10347.99
976699354958408192,2020-08,1665.9,2449.92,1895.09,1387.51,-276.44,-10624.43
976699354958408192,2020-09,1062.34,39.07,2778.46,379.8,3421.93,-7202.5
976699354958408192,2020-10,3924.55,285.39,4479.55,659.78,7458.93,256.43
976699354958408192,2020-11,3174.38,5938.62,2926.95,1308.85,-1146.14,-889.71
976699354958408192,2020-12,1018.63,2368.32,2504.04,5022.86,-3868.51,-4758.22
977101574356204544,2020-01,3768.33,3055.35,4849.25,4335.94,1226.29,1226.29
977101574356204544,2020-02,5859.47,2146.45,1637.53,3093.73,2256.82,3483.11
977101574356204544,2020-03,4169.69,5171.27,3960.45,2317.64,641.23,4124.34
977101574356204544,2020-04,3093.47,4056.41,1286.56,2114.88,-1791.26,2333.08
977101574356204544,2020-05,3993.07,2709.73,3432.68,5157.53,-441.51,1891.57
977101574356204544,2020-06,1651.41,3808.35,4200,1277.28,765.78,2657.35
977101574356204544,2020-07,3990.45,7171.2,3881.75,274.04,426.96,3084.31
977101574356204544,2020-08,4418.15,4647.01,4358.02,5191.22,-1062.06,2022.25
977101574356204544,2020-09,4271.39,7009.43,2973.91,6135.86,-5899.99,-3877.74
977101574356204544,2020-10,5941.41,152.81,4506.13,3015.13,7279.6,3401.86
977101574356204544,2020-11,4041.1,1855.46,4156.47,2110.94,4231.17,7633.03
977101574356204544,2020-12,3498.27,7099.33,5107.07,5294.63,-3788.62,3844.41
977320071323042560,2020-04,0,877.54,0,0,-877.54,-877.54
977320071323042560,2020-10,1434.78,0,0,2253.64,-818.86,-1696.4
977805034027985152,2020-01,422.61,6701.33,3628.25,4856.82,-7507.29,-7507.29
977805034027985152,2020-02,3997.31,4826.57,718.06,4729.16,-4840.36,-12347.65
977805034027985152,2020-03,3620.77,3864.05,3892.09,4011.32,-362.51,-12710.16
977805034027985152,2020-04,7956.88,1977.76,1744.18,9815.94,-2092.64,-14802.8
977805034027985152,2020-05,7133.12,6494.52,5056.86,6962.84,-1267.38,-16070.18
977805034027985152,2020-06,1187.51,7387.87,11555.98,3269.25,2086.37,-13983.81
977805034027985152,2020-07,7379.2,3214.78,2354.65,4773.74,1745.33,-12238.48
977805034027985152,2020-08,5699.46,8179.72,4889.12,1450.41,958.45,-11280.03
977805034027985152,2020-09,6673.77,6655.9,1661.89,3060.61,-1380.85,-12660.88
977805034027985152,2020-10,2993.59,4369.44,2772.92,6900.48,-5503.41,-18164.29
977805034027985152,2020-11,5162.39,5524.36,2178.54,7262.72,-5446.15,-23610.44
977805034027985152,2020-12,6227.9,2130.35,2117.11,3833.03,2381.63,-21228.81
978897463710108800,2020-01,534.64,1153.68,0,2334.68,-2953.72,-2953.72
978897463710108800,2020-02,2944.32,111.82,3053.51,242.2,5643.81,2690.09
978897463710108800,2020-03,2154.38,1567.29,5506.51,4306.16,1787.44,4477.53
978897463710108800,2020-04,1066.87,1696.7,1671.01,2095.95,-1054.77,3422.76
978897463710108800,2020-05,780.9,2385.75,3783.19,4056.01,-1877.67,1545.09
978897463710108800,2020-06,1283.23,1040.68,1733.61,4884.25,-2908.09,-1363
978897463710108800,2020-07,2511.66,2134.57,2257.64,1819.13,815.6,-547.4
978897463710108800,2020-08,1827.85,3761.14,1780.11,1885.77,-2038.95,-2586.35
978897463710108800,2020-09,995.16,2829.66,1405.73,2232.24,-2661.01,-5247.36
978897463710108800,2020-10,0,687.72,0,542.66,-1230.38,-6477.74
978897463710108800,2020-11,3795.33,5371.25,3285.7,640.63,1069.15,-5408.59
978897463710108800,2020-12,440.17,2808.51,1868.78,2037.92,-2537.48,-7946.07
979126800254947072,2020-01,3319.1,4179.24,6629.12,2609.43,3159.55,3159.55
979126800254947072,2020-02,505.76,3045.56,3903.95,0,1364.15,4523.7
979126800254947072,2020-03,6580.29,991.43,2244.72,5636.4,2197.18,6720.88
979126800254947072,2020-04,5429.76,2251.13,2320.29,4254.66,1244.26,7965.14
979126800254947072,2020-05,3199.82,618.56,6533.96,2737.28,6377.94,14343.08
979126800254947072,2020-06,3355.46,3385.72,4397.54,3009.65,1357.63,15700.71
979126800254947072,2020-07,5752.71,4617.79,4125.28,7897.22,-2637.02,13063.69
979126800254947072,2020-08,3663.83,2837.86,2907.59,6397.64,-2664.08,10399.61
979126800254947072,2020-09,2544.92,1733.93,3722.75,0,4533.74,14933.35
979126800254947072,2020-10,3866.35,4014.03,5714.96,3010.4,2556.88,17490.23
979126800254947072,2020-11,0,3917.81,733.11,2941.99,-6126.69,11363.54
979126800254947072,2020-12,6640.22,3117.06,7596.15,1796.1,9323.21,20686.75
979359993212558080,2020-01,3094.46,5199.19,2255.22,1403.31,-1252.82,-1252.82
979359993212558080,2020-02,2462.21,934.32,779.42,1514.53,792.78,-460.04
979359993212558080,2020-03,3594.59,2171.67,3816.72,818.16,4421.48,3961.44
979359993212558080,2020-04,7116.64,1850.93,4033.34,3589.64,5709.41,9670.85
979359993212558080,2020-05,0,1261.89,2193.08,2034.92,-1103.73,8567.12
979359993212558080,2020-06,3538.3,1211.78,2333.65,636.46,4023.71,12590.83
979359993212558080,2020-07,5604.39,249.94,116.47,5168.41,302.51,12893.34
979359993212558080,2020-08,6836.42,5225.68,4033.07,6692.02,-1048.21,11845.13
979359993212558080,2020-09,4669.83,4877.45,1808.53,8046.05,-6445.14,5399.99
979359993212558080,2020-10,2762.23,4209.39,907.32,1647.38,-2187.22,3212.77
979359993212558080,2020-11,838.43,1826.44,1357.11,0,369.1,3581.87
979359993212558080,2020-12,4038.54,0,1209.75,3629.45,1618.84,5200.71
979924296469302912,2020-02,1090.39,0,1397.33,0,2487.72,2487.72
979924296469302912,2020-03,1495.15,518.66,0,0,976.49,3464.21
979924296469302912,2020-04,1238.2,5142.96,0,0,-3904.76,-440.55
979924296469302912,2020-05,1683.45,0,0,0,1683.45,1242.9
979924296469302912,2020-10,832.37,0,969.16,0,1801.53,3044.43
983187859571837952,2020-01,478.62,0,0,868.99,-390.37,-390.37
983187859571837952,2020-03,1425.45,3101.13,0,2611.09,-4286.77,-4677.14
983187859571837952,2020-04,0,2373.84,616.65,1687.84,-3445.03,-8122.17
983187859571837952,2020-06,1930.2,0,1970.43,256.37,3644.26,-4477.91
983187859571837952,2020-08,0,1277.03,1120.56,0,-156.47,-4634.38
983187859571837952,2020-09,0,1569.8,740.56,0,-829.24,-5463.62
983187859571837952,2020-10,1817.22,1117.79,0,0,699.43,-4764.19
983187859571837952,2020-11,1754.11,0,942.46,1896.16,800.41,-3963.78
983187859571837952,2020-12,3635.37,2712.39,0,0,922.98,-3040.8
983488431126715648,2020-01,1510.89,703.94,1969.08,0,2776.03,2776.03
983488431126715648,2020-03,0,2443.65,1002.96,0,-1440.69,1335.34
983488431126715648,2020-05,1275.96,1669.63,0,0,-393.67,941.67
983488431126715648,2020-06,3596.13,0,0,0,3596.13,4537.8
983488431126715648,2020-07,1314.91,0,0,1930.19,-615.28,3922.52
983488431126715648,2020-08,1959.48,0,397.42,0,2356.9,6279.42
983488431126715648,2020-11,1269.15,0,0,0,1269.15,7548.57
985591891019712512,2020-01,2234.49,210.17,6178.92,1757.62,6445.62,6445.62
985591891019712512,2020-02,3138.68,992.04,1727.98,0,3874.62,10320.24
985591891019712512,2020-03,2285.29,1474.07,117.86,0,929.08,11249.32
985591891019712512,2020-05,1459.11,1752.53,2374.78,0,2081.36,13330.68
985591891019712512,2020-06,0,1039.05,0,1406.9,-2445.95,10884.73
985591891019712512,2020-07,1003.49,1353.08,0,1189.98,-1539.57,9345.16
985591891019712512,2020-08,619.27,59.1,0,109.99,450.18,9795.34
985591891019712512,2020-09,137.76,2431.54,1326.17,0,-967.61,8827.73
985591891019712512,2020-10,1265.96,2878.42,565.16,5061.15,-6108.45,2719.28
985591891019712512,2020-11,1543.6,4752.04,1905.36,2645.72,-3948.8,-1229.52
985591891019712512,2020-12,0,1581.56,1800.17,611.05,-392.44,-1621.96
986076437730306688,2020-01,550.66,4417.55,2346.32,0,-1520.57,-1520.57
986076437730306688,2020-02,5437.84,897.31,1998.2,2841.49,3697.24,2176.67
986076437730306688,2020-03,0,3574.35,1837.2,2801.31,-4538.46,-2361.79
986076437730306688,2020-04,4189.07,2703.44,5351.25,3271.92,3564.96,1203.17
986076437730306688,2020-05,2562.21,1824.62,897.28,1595.76,39.11,1242.28
986076437730306688,2020-06,1837.39,361.73,4618.94,1815.82,4278.78,5521.06
986076437730306688,2020-07,968.84,1416.83,4761.34,3248.57,1064.78,6585.84
986076437730306688,2020-08,2298.07,4585.27,2514.83,1715.1,-1487.47,5098.37
986076437730306688,2020-09,2749.2,4811.41,644.7,0,-1417.51,3680.86
986076437730306688,2020-10,1977.26,4554.94,0,1106.04,-3683.72,-2.86
986076437730306688,2020-11,1481.66,2626.5,0,1463.33,-2608.17,-2611.03
986076437730306688,2020-12,2788.06,1101.79,2613.68,1876.22,2423.73,-187.3
988983548895386496,2020-01,590.16,0,0,0,590.16,590.16
988983548895386496,2020-02,1401.18,853.48,2665.61,0,3213.31,3803.47
988983548895386496,2020-03,2444.84,601.48,1870.48,2758.15,955.69,4759.16
988983548895386496,2020-04,1222.45,0,467.98,3014.67,-1324.24,3434.92
988983548895386496,2020-05,0,1930.34,2633.51,0,703.17,4138.09
988983548895386496,2020-06,0,29.55,0,1038.78,-1068.33,3069.76
988983548895386496,2020-08,1136.87,1496.54,1002.1,1648.84,-1006.41,2063.35
988983548895386496,2020-10,1813.7,0,0,1999.68,-185.98,1877.37
988983548895386496,2020-11,0,1031.27,3.22,0,-1028.05,849.32
988983548895386496,2020-12,3456.56,0,0,0,3456.56,4305.88
989993519124344192,2020-01,1339.69,2039.14,2281.33,2936.53,-1354.65,-1354.65
989993519124344192,2020-02,4470.46,771.91,3408.78,1483.9,5623.43,4268.78
989993519124344192,2020-03,2272.07,2104.42,1435.09,0,1602.74,5871.52
989993519124344192,2020-04,4380.43,0,1971.18,5606.91,744.7,6616.22
989993519124344192,2020-05,2756.02,2668.31,1328.76,912.25,504.22,7120.44
989993519124344192,2020-06,1972.51,2120.03,2293.13,879.31,1266.3,8386.74
989993519124344192,2020-07,1946.74,3842.88,104.01,2020.59,-3812.72,4574.02
989993519124344192,2020-08,1248.9,2995.44,3742.67,1763.24,232.89,4806.91
989993519124344192,2020-09,3731.29,907.94,3427.41,2251.98,3998.78,8805.69
989993519124344192,2020-10,3355.53,474.06,2417.25,2259.91,3038.81,11844.5
989993519124344192,2020-11,3624.83,0,3093.77,1165.12,5553.48,17397.98
989993519124344192,2020-12,2266.3,1704.07,7878.73,0,8440.96,25838.94
990001155510780416,2020-01,4766.04,4327.57,6858.73,5715.33,1581.87,1581.87
990001155510780416,2020-02,3212.26,5907.45,6700.95,2422.7,1583.06,3164.93
990001155510780416,2020-03,2834.55,7798.47,3114.28,4509.51,-6359.15,-3194.22
990001155510780416,2020-04,3265.68,2705.57,7077.87,4435.75,3202.23,8.01
990001155510780416,2020-05,3209.77,3271.61,3804.56,6282.32,-2539.6,-2531.59
990001155510780416,2020-06,1829.11,5633.01,5384.05,4128.42,-2548.27,-5079.86
990001155510780416,2020-07,2240.9,1032.85,2764.75,7139.65,-3166.85,-8246.71
990001155510780416,2020-08,6154.32,2387.86,4766.06,1694.69,6837.83,-1408.88
990001155510780416,2020-09,4407.43,4580.52,4749.77,5806.08,-1229.4,-2638.28
990001155510780416,2020-10,4339.08,8839.89,4134.62,3486.36,-3852.55,-6490.83
990001155510780416,2020-11,4438.04,4725.58,3327.16,8981.7,-5942.08,-12432.91
990001155510780416,2020-12,2040.82,5810.8,5156.86,8277.46,-6890.58,-19323.49
990180862833394816,2020-01,8283.5,8363.91,8913.63,962.07,7871.15,7871.15
990180862833394816,2020-02,2145.42,0,2714.72,4965.13,-104.99,7766.16
990180862833394816,2020-03,915.12,1202.31,9670.51,8046.29,1337.03,9103.19
990180862833394816,2020-04,9004.92,2534.53,5886.9,6807.73,5549.56,14652.75
990180862833394816,2020-05,6954.7,3214.7,5649.76,4584.55,4805.21,19457.96
990180862833394816,2020-06,6093.82,5427.63,2422.42,3941.81,-853.2,18604.76
990180862833394816,2020-07,1625.32,6619.95,3461.45,6694.2,-8227.38,10377.38
990180862833394816,2020-08,6613.19,9729.2,2623.04,4291.84,-4784.81,5592.57
990180862833394816,2020-09,4206.09,2813.51,8264.23,4535.51,5121.3,10713.87
990180862833394816,2020-10,7438.12,3917.62,3033.71,8868.99,-2314.78,8399.09
990180862833394816,2020-11,1712.14,8283.47,5849.78,5816.67,-6538.22,1860.87
990180862833394816,2020-12,6017.94,7067.54,2747.69,1837.24,-139.15,1721.72
990700466464835712,2020-01,1218.65,3333.22,3489.75,1802.83,-427.65,-427.65
990700466464835712,2020-02,0,602.82,731.86,3334.69,-3205.65,-3633.3
990700466464835712,2020-03,3898.68,3915.34,1580.33,842.95,720.72,-2912.58
990700466464835712,2020-04,3573.27,951.62,3127.92,4236.06,1513.51,-1399.07
990700466464835712,2020-05,3724.35,1937.98,2455.57,20.3,4221.64,2822.57
990700466464835712,2020-06,3498,3309.46,67.12,3531.02,-3275.36,-452.79
990700466464835712,2020-07,0,3074.43,0,673.67,-3748.1,-4200.89
990700466464835712,2020-08,4735.6,2373.78,1129.27,655.11,2835.98,-1364.91
990700466464835712,2020-09,931.79,2440.6,3470.36,3875.08,-1913.53,-3278.44
990700466464835712,2020-10,3822.74,1396.79,6932.79,0,9358.74,6080.3
990700466464835712,2020-11,2352.32,3413.98,4854.05,6035.07,-2242.68,3837.62
990700466464835712,2020-12,1194.81,374.39,6316.2,1967.72,5168.9,9006.52
991508173779115776,2020-01,1149.49,6005.12,1545.46,3818.8,-7128.97,-7128.97
991508173779115776,2020-02,1503.97,1290.2,1546.8,1295.37,465.2,-6663.77
991508173779115776,2020-03,1736.06,1816.55,329.28,2683.94,-2435.15,-9098.92
991508173779115776,2020-04,477.66,0,1541.85,2461.37,-441.86,-9540.78
991508173779115776,2020-05,502.17,6530.72,3966.5,2986.06,-5048.11,-14588.89
991508173779115776,2020-06,1407.94,73.76,4158.58,4406.24,1086.52,-13502.37
991508173779115776,2020-07,1473.86,3851.83,4736.05,1038.43,1319.65,-12182.72
991508173779115776,2020-08,2080.15,3121.29,1373.93,1830.76,-1497.97,-13680.69
991508173779115776,2020-09,1883.09,5746.78,2828.21,5255.73,-6291.21,-19971.9
991508173779115776,2020-11,0,3105.71,154.78,2428.15,-5379.08,-25350.98
991508173779115776,2020-12,1320.5,1731.16,2617.27,2135.51,71.1,-25279.88
992538106218163968,2020-01,0,648.74,4131.48,2325.64,1157.1,1157.1
992538106218163968,2020-02,1849.63,116.18,0,0,1733.45,2890.55
992538106218163968,2020-03,2865.7,7713.82,2697.46,1283.43,-3434.09,-543.54
992538106218163968,2020-04,4140.75,1582.85,5330.75,1034.1,6854.55,6311.01
992538106218163968,2020-05,3260.02,4742.34,0,2517.41,-3999.73,2311.28
992538106218163968,2020-06,4400.93,4597.77,5022.5,1193.83,3631.83,5943.11
992538106218163968,2020-07,2277.81,376.49,5410.67,5643.94,1668.05,7611.16
992538106218163968,2020-08,1998.9,0,2643.12,2775.49,1866.53,9477.69
992538106218163968,2020-09,2034.99,4111.37,2465.65,3076.52,-2687.25,6790.44
992538106218163968,2020-10,3073.67,2694.26,3660.85,901.95,3138.31,9928.75
992538106218163968,2020-11,273.95,3384.95,0,2298.62,-5409.62,4519.13
992538106218163968,2020-12,3100.97,1681.97,2249.76,2003.81,1664.95,6184.08
995139022629042688,2020-01,1021.36,316.1,685.71,828.76,562.21,562.21
995139022629042688,2020-02,350.4,0,1656.68,582.13,1424.95,1987.16
995139022629042688,2020-03,0,1381.3,294.73,0,-1086.57,900.59
995139022629042688,2020-04,367.38,1326.88,0,1566.3,-2525.8,-1625.21
995139022629042688,2020-05,1509.58,318.09,0,1157.25,34.24,-1590.97
995139022629042688,2020-06,1004.82,0,1509.17,0,2513.99,923.02
995139022629042688,2020-07,0,665.74,537.51,0,-128.23,794.79
995139022629042688,2020-08,183.52,0,0,1072.35,-888.83,-94.04
995139022629042688,2020-09,0,1421.52,1245.91,1568.52,-1744.13,-1838.17
995139022629042688,2020-10,1270.59,324.24,2309.75,0,3256.1,1417.93
995139022629042688,2020-11,1645.62,0,1470.68,0,3116.3,4534.23
995649284465218304,2020-03,0,1314.43,985.64,0,-328.79,-328.79
995649284465218304,2020-04,0,1177.96,853.38,0,-324.58,-653.37
995649284465218304,2020-10,958.62,1399.07,0,683.78,-1124.23,-1777.6
995819150724784384,2020-02,649.29,1553.74,1476.4,0,571.95,571.95
995819150724784384,2020-03,448.38,3108.96,0,394.42,-3055,-2483.05
995819150724784384,2020-04,1673.65,812.13,0,4507.54,-3646.02,-6129.07
995819150724784384,2020-05,136.13,351.28,151.44,0,-63.71,-6192.78
995819150724784384,2020-06,379.26,0,3239.23,1694.87,1923.62,-4269.16
995819150724784384,2020-07,4517.78,4368.7,2163.22,0,2312.3,-1956.86
995819150724784384,2020-08,885.35,513.1,1969.71,2497.98,-156.02,-2112.88
995819150724784384,2020-10,781.25,3158.36,2351.21,277.52,-303.42,-2416.3
995819150724784384,2020-11,1252.11,0,4266.97,549.95,4969.13,2552.83
995819150724784384,2020-12,1883.21,1851.78,420.29,938.99,-487.27,2065.56
995906565691736832,2020-01,35.9,1677.89,3115.49,0,1473.5,1473.5
995906565691736832,2020-02,349.37,128.9,1784.65,1665.92,339.2,1812.7
995906565691736832,2020-03,348.74,3677.74,1316.81,1594.95,-3607.14,-1794.44
995906565691736832,2020-04,0,2556.5,284.24,534.45,-2806.71,-4601.15
995906565691736832,2020-05,732.28,0,1191.3,1682.37,241.21,-4359.94
995906565691736832,2020-06,3467.39,0,2701.95,1969.73,4199.61,-160.33
995906565691736832,2020-07,1384.74,0,2102.03,847.15,2639.62,2479.29
995906565691736832,2020-08,1664.62,2372.89,178.44,0,-529.83,1949.46
995906565691736832,2020-09,0,1326.24,0,2833.76,-4160,-2210.54
995906565691736832,2020-11,933.14,23.6,1357.37,1510.35,756.56,-1453.98
995906565691736832,2020-12,200.76,0,1301.91,54,1448.67,-5.31
996267931213962112,2020-01,5574.04,6979.36,9540.34,6354.21,1780.81,1780.81
996267931213962112,2020-02,881.24,0,4115.86,7145.66,-2148.56,-367.75
996267931213962112,2020-03,5696.88,5809.13,3407.58,6744.51,-3449.18,-3816.93
996267931213962112,2020-04,7972.31,3679.02,5814.45,5248.4,4859.34,1042.41
996267931213962112,2020-05,2941.74,2122.91,1700.84,4045.47,-1525.8,-483.39
996267931213962112,2020-06,4772.15,3855.72,4331.05,3601.8,1645.68,1162.29
996267931213962112,2020-07,2244.73,3521.25,367.98,4112.92,-5021.46,-3859.17
996267931213962112,2020-08,4135.35,3102.37,2195.65,5074.9,-1846.27,-5705.44
996267931213962112,2020-09,2930.19,545.05,2008.32,2386.99,2006.47,-3698.97
996267931213962112,2020-10,1775.75,4920.52,1417.26,6812.16,-8539.67,-12238.64
996267931213962112,2020-11,8959.98,8211.87,1447.47,3699.96,-1504.38,-13743.02
996267931213962112,2020-12,3297.89,3493.72,6352.94,4149.99,2007.12,-11735.9
996929790368373760,2020-01,1494.3,4.18,3570.91,2643.74,2417.29,2417.29
996929790368373760,2020-02,4532.56,2253.94,4873.4,3440.56,3711.46,6128.75
996929790368373760,2020-03,3136.9,6444.51,3037.99,759.1,-1028.72,5100.03
996929790368373760,2020-04,1185.32,1688.91,1222.28,919.73,-201.04,4898.99
996929790368373760,2020-05,5000.71,2011.22,3640.73,2641.32,3988.9,8887.89
996929790368373760,2020-06,0,5870.31,6729.36,0,859.05,9746.94
996929790368373760,2020-07,1920.53,1109.36,2295.15,4143.71,-1037.39,8709.55
996929790368373760,2020-08,2349.04,3020.64,5490.22,1880.76,2937.86,11647.41
996929790368373760,2020-09,3227.95,3265.3,4583.06,0,4545.71,16193.12
996929790368373760,2020-10,1531.77,480.14,1414.4,656.12,1809.91,18003.03
996929790368373760,2020-11,4010.05,0,183.31,1082.64,3110.72,21113.75
996929790368373760,2020-12,3083.28,3956.28,4205.49,4144.63,-812.14,20301.61
997009855980774528,2020-01,824.08,0,0,0,824.08,824.08
997009855980774528,2020-03,2141.71,30.74,1455.32,0,3566.29,4390.37
997009855980774528,2020-04,0,829.75,141.78,1289.54,-1977.51,2412.86
997009855980774528,2020-06,0,506.16,1614.1,641.21,466.73,2879.59
997009855980774528,2020-08,0,158.61,0,0,-158.61,2720.98
997009855980774528,2020-09,0,311.42,0,1629.74,-1941.16,779.82
997009855980774528,2020-10,0,516.51,0,0,-516.51,263.31
997009855980774528,2020-12,1606.31,799.36,0,1886.86,-1079.91,-816.6
997463566344381312,2020-01,672.53,2930,3113.22,1232.61,-376.86,-376.86
997463566344381312,2020-02,1829.74,1227.81,2681.04,0,3282.97,2906.11
997463566344381312,2020-04,1837.39,0,1192.67,982.65,2047.41,4953.52
997463566344381312,2020-05,247.38,2374.35,742.16,1429.2,-2814.01,2139.51
997463566344381312,2020-06,967.86,1265.26,5208.89,2179.35,2732.14,4871.65
997463566344381312,2020-07,1716.95,29.57,4268.76,1000.69,4955.45,9827.1
997463566344381312,2020-08,1943.98,0,5073.41,1340.87,5676.52,15503.62
997463566344381312,2020-09,169.99,1170.2,676.65,425.5,-749.06,14754.56
997463566344381312,2020-10,1470.46,0,0,0,1470.46,16225.02
997463566344381312,2020-11,3447.49,1556.14,1775.97,2690.66,976.66,17201.68
997463566344381312,2020-12,1525.25,0,2051.85,529.25,3047.85,20249.53
997654233832081920,2020-01,869.5,1435.74,2952.13,3754.74,-1368.85,-1368.85
997654233832081920,2020-02,650.04,1089.78,1341.23,1663.52,-762.03,-2130.88
997654233832081920,2020-03,3703.78,2142.82,1478.2,2588.39,450.77,-1680.11
997654233832081920,2020-04,9462.07,580.33,3284.62,5092.03,7074.33,5394.22
997654233832081920,2020-05,5496.46,5187.78,4562.98,2064.98,2806.68,8200.9
997654233832081920,2020-06,2783.7,4828.37,65.07,928.61,-2908.21,5292.69
997654233832081920,2020-07,1268.16,746.03,4793.44,5685.46,-369.89,4922.8
997654233832081920,2020-08,1124.96,2555.39,670.68,2514.43,-3274.18,1648.62
997654233832081920,2020-09,3493.67,0,7130.83,3227.34,7397.16,9045.78
997654233832081920,2020-10,5201.45,1741.5,7281.51,217.44,10524.02,19569.8
997654233832081920,2020-11,2310.63,1815.31,2393.35,3004.15,-115.48,19454.32
997654233832081920,2020-12,346.69,4874.14,3862.3,2532.93,-3198.08,16256.24
997720059507809152,2020-01,2126.49,1336.9,1802.77,1870.33,722.03,722.03
997720059507809152,2020-02,456.33,3108.91,1692.4,2518.58,-3478.76,-2756.73
997720059507809152,2020-03,2381.12,1614.31,3463.7,0,4230.51,1473.78
997720059507809152,2020-04,2737.96,0,0,3037.01,-299.05,1174.73
997720059507809152,2020-05,1392.76,0,1756.84,2565.56,584.04,1758.77
997720059507809152,2020-06,2659.47,993.26,1417.24,341.32,2742.13,4500.9
997720059507809152,2020-07,1702.75,6594.45,362.47,0,-4529.23,-28.33
997720059507809152,2020-08,0,3062.92,5164.54,1997.42,104.2,75.87
997720059507809152,2020-09,0,157.48,2115.45,2479.53,-521.56,-445.69
997720059507809152,2020-10,0,8355.46,6217.07,1378.19,-3516.58,-3962.27
997720059507809152,2020-11,844.08,546.61,0,1589.8,-1292.33,-5254.6
997720059507809152,2020-12,1297.34,1279.73,0,1394.41,-1376.8,-6631.4
999895355615035648,2020-01,1534.59,1852.49,3730.49,2348.11,1064.48,1064.48
999895355615035648,2020-02,4957.01,0,2233.99,3095.12,4095.88,5160.36
999895355615035648,2020-03,2054.24,1731.65,272.11,823.02,-228.32,4932.04
999895355615035648,2020-04,263.86,1954.61,1028.19,845.37,-1507.93,3424.11
999895355615035648,2020-05,2136.67,4102.63,1920.33,5774.74,-5820.37,-2396.26
999895355615035648,2020-06,1120.93,3092.76,2870.51,4969.49,-4070.81,-6467.07
999895355615035648,2020-07,4671.54,3316.04,4829.92,5875.25,310.17,-6156.9
999895355615035648,2020-08,5772.03,3229.54,0,6753.1,-4210.61,-10367.51
999895355615035648,2020-09,1367.88,0,1455.74,2458.4,365.22,-10002.29
999895355615035648,2020-10,3813.4,2666.77,564.34,3299.75,-1588.78,-11591.07
999895355615035648,2020-11,3951.98,3999.75,1945.44,0,1897.67,-9693.4
999895355615035648,2020-12,2777.16,8243.7,2096.68,0,-3369.86,-13063.26
1000667155163612544,2020-01,8485.49,4935.66,4476.55,2867,5159.38,5159.38
1000667155163612544,2020-02,8497.93,6450.81,6468.61,2997.49,5518.24,10677.62
1000667155163612544,2020-03,5283.44,1163,1259.18,4394.98,984.64,11662.26
1000667155163612544,2020-04,3397.87,1968.09,2538.32,4044.39,-76.29,11585.97
1000667155163612544,2020-05,3878.35,2086.86,2592.16,3473.44,910.21,12496.18
1000667155163612544,2020-06,3879.75,6523.99,127.4,10529.3,-13046.14,-549.96
1000667155163612544,2020-07,5040.59,3120.57,3297.33,1705.92,3511.43,2961.47
1000667155163612544,2020-08,1751.33,7406.96,4114.81,7526.54,-9067.36,-6105.89
1000667155163612544,2020-09,1395.76,4041.05,1436.87,1842.5,-3050.92,-9156.81
1000667155163612544,2020-10,1535.95,3301.91,2386.69,4275.07,-3654.34,-12811.15
1000667155163612544,2020-11,4924.76,1451.7,3842.6,0,7315.66,-5495.49
1000667155163612544,2020-12,4882.83,3784.37,1811.95,3458.87,-548.46,-6043.95
1001241849719113600,2020-02,0,359.88,37.83,0,-322.05,-322.05
1001241849719113600,2020-05,497.63,0,880.37,577.33,800.67,478.62
1001241849719113600,2020-06,0,646.86,0,0,-646.86,-168.24
1001241849719113600,2020-08,0,3214.64,0,920.16,-4134.8,-4303.04
1001241849719113600,2020-09,0,1361.19,0,578.45,-1939.64,-6242.68
1001241849719113600,2020-11,0,2023.27,0,0,-2023.27,-8265.95
1001241849719113600,2020-12,0,172.68,1430.63,1265.11,-7.16,-8273.11
1002983021315960960,2020-01,18.28,1396.72,0,0,-1378.44,-1378.44
1002983021315960960,2020-02,1600.38,0,592.5,836.6,1356.28,-22.16
1002983021315960960,2020-03,1118.87,3350.44,58.91,0,-2172.66,-2194.82
1002983021315960960,2020-05,119.82,0,0,0,119.82,-2075
1002983021315960960,2020-06,0,576.76,3614.98,0,3038.22,963.22
1002983021315960960,2020-07,0,3410.37,84.4,149.98,-3475.95,-2512.73
1002983021315960960,2020-08,605.18,1160.37,2780.31,0,2225.12,-287.61
1002983021315960960,2020-09,4518.7,0,1577.27,0,6095.97,5808.36
1002983021315960960,2020-10,502.4,232.44,340.13,0,610.09,6418.45
1002983021315960960,2020-11,694.83,0,16.38,2828.36,-2117.15,4301.3
1002983021315960960,2020-12,1078,1891.01,0,0,-813.01,3488.29
1005361594962370688,2020-01,1430.51,0,0,0,1430.51,1430.51
1005361594962370688,2020-03,0,185.85,0,0,-185.85,1244.66
1005361594962370688,2020-05,0,872.59,0,0,-872.59,372.07
1005361594962370688,2020-07,0,1233.82,0,0,-1233.82,-861.75
1005708591458280064,2020-01,0,595.95,0,1044.94,-1640.89,-1640.89
1005708591458280064,2020-03,998.73,1461.95,1889.25,0,1426.03,-214.86
1005708591458280064,2020-04,0,1798.11,0,3427.92,-5226.03,-5440.89
1005708591458280064,2020-05,438.58,226.78,0,1276.59,-1064.79,-6505.68
1005708591458280064,2020-06,0,2076.44,1385.66,252.41,-943.19,-7448.87
1005708591458280064,2020-07,1407.42,0,105.88,0,1513.3,-5935.57
1005708591458280064,2020-08,3488.46,0,3756.56,0,7245.02,1309.45
1005708591458280064,2020-09,0,3352.8,1887.47,0,-1465.33,-155.88
1005708591458280064,2020-10,0,478.11,0,1556.69,-2034.8,-2190.68
1005708591458280064,2020-11,1523.78,1194.07,3487.96,0,3817.67,1626.99
1005708591458280064,2020-12,868.79,0,142.11,0,1010.9,2637.89
1006189969186550656,2020-01,0,5964.23,1555.8,4552.92,-8961.35,-8961.35
1006189969186550656,2020-02,7107.44,2762.85,5327.99,3238.58,6434,-2527.35
1006189969186550656,2020-03,6394.23,3873.42,2571.86,1223.39,3869.28,1341.93
1006189969186550656,2020-04,1859.45,2697.94,2886.27,7578.74,-5530.96,-4189.03
1006189969186550656,2020-05,9470.17,468.61,1349.56,2618.11,7733.01,3543.98
1006189969186550656,2020-06,1423.45,1090.99,0,1884.68,-1552.22,1991.76
1006189969186550656,2020-07,5153.05,5264.78,2238.58,4211.28,-2084.43,-92.67
1006189969186550656,2020-08,3003.45,2630.14,0,789.62,-416.31,-508.98
1006189969186550656,2020-09,4078.75,2511.05,2761.05,4182.96,145.79,-363.19
1006189969186550656,2020-10,3146.6,113.45,2514.51,4285.85,1261.81,898.62
1006189969186550656,2020-11,4255.24,7199.67,6631.92,3247.95,439.54,1338.16
1006189969186550656,2020-12,921.27,1632.73,1783.73,2557.64,-1485.37,-147.21
1006261837513863296,2020-01,2314.41,1401.91,6551.88,5671.6,1792.78,1792.78
1006261837513863296,2020-02,4678.44,4642.61,3137.72,4754.23,-1580.68,212.1
1006261837513863296,2020-03,4075.69,7190.4,5064.89,8003.52,-6053.34,-5841.24
1006261837513863296,2020-04,8872.28,7159.4,1278.32,3338.21,-347.01,-6188.25
1006261837513863296,2020-05,3321.44,2948.02,122.04,1829.48,-1334.02,-7522.27
1006261837513863296,2020-06,5388.31,6055.67,6897.97,3964.46,2266.15,-5256.12
1006261837513863296,2020-07,0,1673.11,0,3819.81,-5492.92,-10749.04
1006261837513863296,2020-08,5217.94,1375.09,4244.83,7111.91,975.77,-9773.27
1006261837513863296,2020-09,6494.2,5706.09,3432.15,3776.92,443.34,-9329.93
1006261837513863296,2020-10,4334.61,6211.5,39.55,3934.38,-5771.72,-15101.65
1006261837513863296,2020-11,3590.12,2741.67,3437.34,3281.29,1004.5,-14097.15
1006261837513863296,2020-12,3825.48,2019.34,5276.16,3560.2,3522.1,-10575.05
1007067550255743488,2020-01,3280.15,2633.05,3204.56,3091.74,759.92,759.92
1007067550255743488,2020-02,2029.92,2257.64,2637.79,6612.02,-4201.95,-3442.03
1007067550255743488,2020-03,160.15,3053.25,1096.87,2421.83,-4218.06,-7660.09
1007067550255743488,2020-04,4256.75,4059.34,4078.84,6787.08,-2510.83,-10170.92
1007067550255743488,2020-05,350.84,2964.91,4130.78,3986.29,-2469.58,-12640.5
1007067550255743488,2020-06,169.91,6700.99,4042.14,1224.84,-3713.78,-16354.28
1007067550255743488,2020-07,5301.73,243.02,8450.9,1868.82,11640.79,-4713.49
1007067550255743488,2020-08,804.1,8948.25,0,779.96,-8924.11,-13637.6
1007067550255743488,2020-09,7023.26,3412.26,5155.5,10867.45,-2100.95,-15738.55
1007067550255743488,2020-10,2837.17,5357.56,2129.57,1081.33,-1472.15,-17210.7
1007067550255743488,2020-11,4012.45,1739.91,9848.12,2440.75,9679.91,-7530.79
1007067550255743488,2020-12,2831.67,4236.29,3259.87,1115.88,739.37,-6791.42
1008595718578159360,2020-01,3714.21,5295.08,3085.95,1840.57,-335.49,-335.49
1008595718578159360,2020-02,5801.16,375.3,4704.88,2006.25,8124.49,7789
1008595718578159360,2020-03,7536.32,9777.04,3323.49,10000.16,-8917.39,-1128.39
1008595718578159360,2020-04,2760.92,8357.51,4991.12,3817.94,-4423.41,-5551.8
1008595718578159360,2020-05,5036.19,4778.59,2478.01,6346.42,-3610.81,-9162.61
1008595718578159360,2020-06,5782.34,2817.63,6414.53,5325.11,4054.13,-5108.48
1008595718578159360,2020-07,3109.8,3012.9,6303.86,2411.5,3989.26,-1119.22
1008595718578159360,2020-08,8216.27,6513.76,1570.83,2921.42,351.92,-767.3
1008595718578159360,2020-09,3345.23,4426.74,2455.15,7848.36,-6474.72,-7242.02
1008595718578159360,2020-10,6866.31,2636.44,4214.16,4729.43,3714.6,-3527.42
1008595718578159360,2020-11,3638.42,5536.84,4997.08,4127.57,-1028.91,-4556.33
1008595718578159360,2020-12,7273.99,5992.31,2829.86,4652.28,-540.74,-5097.07
1008613490135551616,2020-01,655.71,2997.66,167.88,836.8,-3010.87,-3010.87
1008613490135551616,2020-02,2911.29,1290.36,0,664.55,956.38,-2054.49
1008613490135551616,2020-03,0,1411.08,3176.96,2965.84,-1199.96,-3254.45
1008613490135551616,2020-04,547.07,1447.11,1525.44,1638.31,-1012.91,-4267.36
1008613490135551616,2020-05,2694.65,397.53,1174.37,369.58,3101.91,-1165.45
1008613490135551616,2020-06,0,1718.43,0,5891.65,-7610.08,-8775.53
1008613490135551616,2020-07,0,1796.6,3225.36,1466.21,-37.45,-8812.98
1008613490135551616,2020-08,1933.42,2671.14,1188.02,4698.19,-4247.89,-13060.87
1008613490135551616,2020-09,1571.16,0,1260.28,2489.18,342.26,-12718.61
1008613490135551616,2020-10,0,1129.02,2510.01,2801.39,-1420.4,-14139.01
1008613490135551616,2020-11,177.41,0,0,0,177.41,-13961.6
1008613490135551616,2020-12,1716.89,2092.54,2798.5,953.62,1469.23,-12492.37
1008807824201172480,2020-01,7645.97,1641.36,1644.25,2555.08,5093.78,5093.78
1008807824201172480,2020-02,8372.93,4469.59,3932.38,653.56,7182.16,12275.94
1008807824201172480,2020-03,8569.84,6944.27,2604.43,4435.85,-205.85,12070.09
1008807824201172480,2020-04,3812.96,5577.79,8069.23,5141.21,1163.19,13233.28
1008807824201172480,2020-05,2354.32,4310.29,3241.31,2750.44,-1465.1,11768.18
1008807824201172480,2020-06,5005.2,2182.63,1553.09,2941.65,1434.01,13202.19
1008807824201172480,2020-07,697.61,4746.59,702.8,5338.29,-8684.47,4517.72
1008807824201172480,2020-08,5953.68,4777.93,6441.42,1987.85,5629.32,10147.04
1008807824201172480,2020-09,7489.85,9679.64,2214.67,3975.06,-3950.18,6196.86
1008807824201172480,2020-10,6654.48,11067.65,2125.6,7265.34,-9552.91,-3356.05
1008807824201172480,2020-11,4902.92,6550.81,10264.52,1093.69,7522.94,4166.89
1008807824201172480,2020-12,682.24,4924.08,2376.96,5729.53,-7594.41,-3427.52
1008950534960985472,2020-01,0,2280.32,0,0,-2280.32,-2280.32
1008950534960985472,2020-02,0,1565.44,1358.6,52.77,-259.61,-2539.93
1008950534960985472,2020-03,170.76,28.55,1788.28,3449.29,-1518.8,-4058.73
1008950534960985472,2020-06,874.43,0,0,1788.86,-914.43,-4973.16
1008950534960985472,2020-07,0,1585.2,1922.88,3491.27,-3153.59,-8126.75
1008950534960985472,2020-08,825.69,1333.6,12.68,1873.07,-2368.3,-10495.05
1008950534960985472,2020-09,0,3610.45,0,0,-3610.45,-14105.5
1008950534960985472,2020-10,529.4,0,2725.81,0,3255.21,-10850.29
1008950534960985472,2020-12,0,1687.93,0,0,-1687.93,-12538.22
1009379001646726144,2020-01,228.76,0,0,0,228.76,228.76
1009379001646726144,2020-04,1384.26,0,0,0,1384.26,1613.02
1009379001646726144,2020-12,0,373.83,0,0,-373.83,1239.19
1009683356835193984,2020-03,1908.19,1698.38,1005.65,1790.49,-575.03,-575.03
1009683356835193984,2020-04,266.63,2565.93,971.67,0,-1327.63,-1902.66
1009683356835193984,2020-05,1197.99,0,1997.29,2166.57,1028.71,-873.95
1009683356835193984,2020-06,1663.16,2697.14,0,1059.59,-2093.57,-2967.52
1009683356835193984,2020-07,1635.24,1994.44,0,883.89,-1243.09,-4210.61
1009683356835193984,2020-08,0,3749.12,69.79,767.43,-4446.76,-8657.37
1009683356835193984,2020-09,1651.62,2451.39,2147.66,985.43,362.46,-8294.91
1009683356835193984,2020-10,1068.44,0,1737.46,0,2805.9,-5489.01
1009683356835193984,2020-11,712.44,3056.08,359.42,2198.87,-4183.09,-9672.1
1009683356835193984,2020-12,0,1987.46,962.8,900.76,-1925.42,-11597.52
1010442258264510976,2020-01,5221.64,1694.54,3102.21,1960.36,4668.95,4668.95
1010442258264510976,2020-02,284.92,3888.79,1208.8,5219.45,-7614.52,-2945.57
1010442258264510976,2020-03,1164.99,2425.23,3305.63,1752.92,292.47,-2653.1
1010442258264510976,2020-04,5310.96,1306.93,10.16,0,4014.19,1361.09
1010442258264510976,2020-05,3257.53,1109.84,0,5765.34,-3617.65,-2256.56
1010442258264510976,2020-06,6211.42,4021,2249.16,3648.37,791.21,-1465.35
1010442258264510976,2020-07,1653.77,1579.37,3106.84,4763.56,-1582.32,-3047.67
1010442258264510976,2020-08,2412.02,1830.41,965.86,1586.82,-39.35,-3087.02
1010442258264510976,2020-09,914.11,940.46,551.31,3512.03,-2987.07,-6074.09
1010442258264510976,2020-10,3392.64,1233.9,1144.92,2192.32,1111.34,-4962.75
1010442258264510976,2020-11,1937.16,86.01,1157.12,1868.88,1139.39,-3823.36
1010442258264510976,2020-12,929.05,3559.79,1083.47,6225.82,-7773.09,-11596.45
1010662633500431104,2020-01,1829.05,1370.29,2526.22,3537.79,-552.81,-552.81
1010662633500431104,2020-02,3759.62,2358.66,4754.41,1949.1,4206.27,3653.46
1010662633500431104,2020-03,5751.6,2804.48,5415.33,4663.72,3698.73,7352.19
1010662633500431104,2020-04,3416.88,3584.28,4422.07,3159.24,1095.43,8447.62
1010662633500431104,2020-05,1922.59,4897.19,2767.23,2603.51,-2810.88,5636.74
1010662633500431104,2020-06,2361.23,7880.49,6324.38,989.07,-183.95,5452.79
1010662633500431104,2020-07,5102.55,8694.01,3262.18,3748.89,-4078.17,1374.62
1010662633500431104,2020-08,6866.54,2022.66,5468.77,1001.15,9311.5,10686.12
1010662633500431104,2020-09,5406.22,2736.08,2318.58,5511.39,-522.67,10163.45
1010662633500431104,2020-10,1955.46,6160.49,5459.66,3531.1,-2276.47,7886.98
1010662633500431104,2020-11,6594.87,1631.09,5486.22,4395.32,6054.68,13941.66
1010662633500431104,2020-12,6007.84,2950.22,6041.66,5615.97,3483.31,17424.97
1011292738798005376,2020-01,2338.79,6485.88,8508.7,2837.98,1523.63,1523.63
1011292738798005376,2020-02,3321.97,5151.78,3352.31,7090.04,-5567.54,-4043.91
1011292738798005376,2020-03,4536.26,7871.67,7684.1,7749.22,-3400.53,-7444.44
1011292738798005376,2020-04,2623.85,3592.79,2066.69,5890.97,-4793.22,-12237.66
1011292738798005376,2020-05,4204.56,2864.79,7505.81,4371.23,4474.35,-7763.31
1011292738798005376,2020-06,3555.11,1324.22,9607.38,5210.06,6628.21,-1135.1
1011292738798005376,2020-07,8948.51,3780.75,4429.69,2347.13,7250.32,6115.22
1011292738798005376,2020-08,5182.86,2845.61,6105.44,2129.53,6313.16,12428.38
1011292738798005376,2020-09,6340.91,4609.43,3258.54,3448.16,1541.86,13970.24
1011292738798005376,2020-10,3401.61,4413.26,1692.28,6933.18,-6252.55,7717.69
1011292738798005376,2020-11,2874.34,2288.63,5710.08,2612.25,3683.54,11401.23
1011292738798005376,2020-12,3420.49,6540.13,5898.36,4964.86,-2186.14,9215.09
1011607384771822848,2020-01,3016.87,3289.73,4470.78,2289.34,1908.58,1908.58
1011607384771822848,2020-02,2598.43,0,2916.46,1244.01,4270.88,6179.46
1011607384771822848,2020-03,2433.08,4488.96,1043.5,0,-1012.38,5167.08
1011607384771822848,2020-04,4031.26,2017,1033.87,1360.97,1687.16,6854.24
1011607384771822848,2020-05,185.65,1775.31,2314.81,2786.65,-2061.5,4792.74
1011607384771822848,2020-06,1588.93,0,288.23,2138.66,-261.5,4531.24
1011607384771822848,2020-07,1234.37,2946.93,2324.83,2158.96,-1546.69,2984.55
1011607384771822848,2020-08,1929.46,1918.63,1521.82,3781.97,-2249.32,735.23
1011607384771822848,2020-09,2425.35,1629.75,496.11,1535.35,-243.64,491.59
1011607384771822848,2020-10,3094.89,2183.95,2111.59,0,3022.53,3514.12
1011607384771822848,2020-11,189.6,1887.2,1138.38,0,-559.22,2954.9
1011607384771822848,2020-12,3982.73,938.78,1400.99,3268.31,1176.63,4131.53
1012465450756202624,2020-01,2711.36,982.4,3922.74,3480.04,2171.66,2171.66
1012465450756202624,2020-02,2868.32,1603.11,2577.3,1329.34,2513.17,4684.83
1012465450756202624,2020-03,2363.79,1707.1,1653.17,2300.43,9.43,4694.26
1012465450756202624,2020-04,3750.96,3827.88,912.91,3253.35,-2417.36,2276.9
1012465450756202624,2020-05,6772.43,635.5,0,2427.87,3709.06,5985.96
1012465450756202624,2020-06,936.63,1890.14,1616.34,2585.34,-1922.51,4063.45
1012465450756202624,2020-08,1210.9,3424.87,3167.92,0,953.95,5017.4
1012465450756202624,2020-09,3638.15,74.47,765.23,2548.32,1780.59,6797.99
1012465450756202624,2020-10,3926.14,0,4973.7,2209.62,6690.22,13488.21
1012465450756202624,2020-11,366.33,1361.49,1768.89,0,773.73,14261.94
1012465450756202624,2020-12,1581.31,5622.76,0,0,-4041.45,10220.49
1013237813822084864,2020-01,0,608.27,1859.68,0,1251.41,1251.41
1013237813822084864,2020-02,55.08,0,1350.54,0,1405.62,2657.03
1013237813822084864,2020-03,0,290.03,2758.95,6158.55,-3689.63,-1032.6
1013237813822084864,2020-04,597.67,2036.26,0,5485.51,-6924.1,-7956.7
1013237813822084864,2020-05,2284.58,3096.26,342.99,1578.17,-2046.86,-10003.56
1013237813822084864,2020-06,0,1978.59,0,3140.25,-5118.84,-15122.4
1013237813822084864,2020-07,1514.05,1252.71,996.41,4193.89,-2936.14,-18058.54
1013237813822084864,2020-08,0,3660.19,1843.98,1648.05,-3464.26,-21522.8
1013237813822084864,2020-09,1203.34,1210.53,1846.79,4244.07,-2404.47,-23927.27
1013237813822084864,2020-10,2973.58,0,724.41,1563.38,2134.61,-21792.66
1013237813822084864,2020-11,445.85,4716.87,2974.88,1299.95,-2596.09,-24388.75
1013237813822084864,2020-12,6361.16,3455.6,1666.63,1865.94,2706.25,-21682.5
1013897981879463296,2020-01,5359.36,4206.61,3515.94,5817.98,-1149.29,-1149.29
1013897981879463296,2020-02,3039.17,3212.87,6171.78,2368.48,3629.6,2480.31
1013897981879463296,2020-03,9650.29,2716.18,6099.69,0,13033.8,15514.11
1013897981879463296,2020-04,3429.9,6349.26,7658.03,545,4193.67,19707.78
1013897981879463296,2020-05,5212.22,2404.17,3390.55,3398.21,2800.39,22508.17
1013897981879463296,2020-06,14135.02,2412.2,5135.94,7294.03,9564.73,32072.9
1013897981879463296,2020-07,6615.2,6031.6,5941.96,3203.58,3321.98,35394.88
1013897981879463296,2020-08,3182.03,8714.1,7783.66,8238.17,-5986.58,29408.3
1013897981879463296,2020-09,2384.8,8429.52,5423.51,7207.41,-7828.62,21579.68
1013897981879463296,2020-10,3180.89,5638.86,5015.35,6643.42,-4086.04,17493.64
1013897981879463296,2020-11,253.59,6094.31,3365.86,6694.4,-9169.26,8324.38
1013897981879463296,2020-12,2237.7,1385.07,1339.8,7862.03,-5669.6,2654.78
1014445052727900288,2020-01,214.33,2806.71,1703.83,3551.15,-4439.7,-4439.7
1014445052727900288,2020-02,0,1691.4,1889.57,2772.03,-2573.86,-7013.56
1014445052727900288,2020-03,5088.55,557.14,735.34,2027.85,3238.9,-3774.66
1014445052727900288,2020-04,6666.69,3066.81,4257.55,1570.43,6287,2512.34
1014445052727900288,2020-05,2422.74,1084.77,5747.95,3741.46,3344.46,5856.8
1014445052727900288,2020-06,3705.58,2418.72,2245.77,3504.42,28.21,5885.01
1014445052727900288,2020-07,3413.11,4130.38,1388.82,0,671.55,6556.56
1014445052727900288,2020-08,1624.97,2172.17,1182.12,7395.85,-6760.93,-204.37
1014445052727900288,2020-09,948.54,2779.26,3411.06,2191.12,-610.78,-815.15
1014445052727900288,2020-10,1432.45,4341.79,3386.38,2717.58,-2240.54,-3055.69
1014445052727900288,2020-11,2867.58,3881.49,3213.06,0,2199.15,-856.54
1014445052727900288,2020-12,2311.38,2306.7,160.26,8555.65,-8390.71,-9247.25
1014723260961153920,2020-01,3789.37,451.62,3176.74,4544.41,1970.08,1970.08
1014723260961153920,2020-02,2098.35,7202.26,0,0,-5103.91,-3133.83
1014723260961153920,2020-03,3200.28,4940.5,0,678.1,-2418.32,-5552.15
1014723260961153920,2020-04,7006.49,455.34,2731.68,412.98,8869.85,3317.7
1014723260961153920,2020-05,1236.32,3842.05,1190.36,1061.29,-2476.66,841.04
1014723260961153920,2020-06,3220.82,0,5616.83,0,8837.65,9678.69
1014723260961153920,2020-07,2954.4,5566.82,3835.04,2140.61,-917.99,8760.7
1014723260961153920,2020-08,340.81,3355.79,5487.97,7613.35,-5140.36,3620.34
1014723260961153920,2020-09,1879.44,1094.15,6555.71,5606.94,1734.06,5354.4
1014723260961153920,2020-10,840.82,0,2489.33,3986.97,-656.82,4697.58
1014723260961153920,2020-11,1233.5,4834.87,3000.55,6703.49,-7304.31,-2606.73
1014723260961153920,2020-12,1429.7,2937.75,1900.68,2006.87,-1614.24,-4220.97
1014867243359378176,2020-01,2822.93,0,4327.49,3149.58,4000.84,4000.84
1014867243359378176,2020-02,2906.5,493.55,1597.58,5305.95,-1295.42,2705.42
1014867243359378176,2020-03,2598.25,1936.36,782.53,946.33,498.09,3203.51
1014867243359378176,2020-04,0,1685.73,1150.59,3072.83,-3607.97,-404.46
1014867243359378176,2020-05,2586.07,2077.81,0,833.13,-324.87,-729.33
1014867243359378176,2020-06,0,2033.26,1409.96,2398.28,-3021.58,-3750.91
1014867243359378176,2020-07,3527.91,1700.22,0,2261.02,-433.33,-4184.24
1014867243359378176,2020-08,261.99,3467.46,0,0,-3205.47,-7389.71
1014867243359378176,2020-09,4494.88,2131.86,4677.61,1817.22,5223.41,-2166.3
1014867243359378176,2020-10,3225.22,1231.21,1653.89,0,3647.9,1481.6
1014867243359378176,2020-11,663.87,0,5698.96,1947.28,4415.55,5897.15
1014867243359378176,2020-12,3604.13,2932.96,4111.98,3565.01,1218.14,7115.29
1015074660403196288,2020-01,2618.76,1075,1650.7,2647.47,546.99,546.99
1015074660403196288,2020-02,4145.21,678.98,233.27,1275.49,2424.01,2971
1015074660403196288,2020-03,2093.15,0,300.82,1085.38,1308.59,4279.59
1015074660403196288,2020-04,0,3283.02,3316.47,0,33.45,4313.04
1015074660403196288,2020-05,6279.66,0,961.81,1923.07,5318.4,9631.44
1015074660403196288,2020-07,1608.59,1997.74,3396.49,0,3007.34,12638.78
1015074660403196288,2020-08,145.7,0,3139.89,0,3285.59,15924.37
1015074660403196288,2020-09,4853.13,0,32.93,1127.41,3758.65,19683.02
1015074660403196288,2020-10,0,2173.77,0,0,-2173.77,17509.25
1015074660403196288,2020-11,1550.44,0,0,2957.46,-1407.02,16102.23
1015074660403196288,2020-12,44.56,1970.29,0,1261.53,-3187.26,12914.97
1015335680114615936,2020-01,1727.32,3246.49,5485.04,5538.62,-1572.75,-1572.75
1015335680114615936,2020-02,5920.8,3784.22,2893.39,3554.65,1475.32,-97.43
1015335680114615936,2020-03,2632.35,12078.2,2606.08,5789.41,-12629.18,-12726.61
1015335680114615936,2020-04,3771.39,5491.42,7271.74,5905.96,-354.25,-13080.86
1015335680114615936,2020-05,1623.87,5268.28,5627.55,5976.01,-3992.87,-17073.73
1015335680114615936,2020-06,1812.71,2887.66,4562.49,5930.56,-2443.02,-19516.75
1015335680114615936,2020-07,5496.62,4244.51,3557.85,4616.89,193.07,-19323.68
1015335680114615936,2020-08,1526.54,2263.81,3107.26,3952.26,-1582.27,-20905.95
1015335680114615936,2020-09,6603.77,3050.76,2347.4,8834.16,-2933.75,-23839.7
1015335680114615936,2020-10,294.92,2837.35,6054.73,7235.17,-3722.87,-27562.57
1015335680114615936,2020-11,1751.41,3901.26,4429.47,8608.02,-6328.4,-33890.97
1015335680114615936,2020-12,1379.84,6733.68,7866.07,3892.71,-1380.48,-35271.45
1015854630981724800,2020-03,0,346.64,1194.43,0,847.79,847.79
1015854630981724800,2020-04,1813.78,513.32,0,1167.9,132.56,980.35
1015854630981724800,2020-05,1737.12,1692.77,1557.82,1395.73,206.44,1186.79
1015854630981724800,2020-06,0,3697.45,452.47,75.47,-3320.45,-2133.66
1015854630981724800,2020-07,611.73,1282.43,1977.91,1219.97,87.24,-2046.42
1015854630981724800,2020-08,1403.47,315.26,0,1506.56,-418.35,-2464.77
1015854630981724800,2020-09,229.39,1472.48,1974.7,150.58,581.03,-1883.74
1015854630981724800,2020-10,0,672.31,154.55,2110.73,-2628.49,-4512.23
1015854630981724800,2020-12,1901.59,235.18,0,0,1666.41,-2845.82
1015941350048107008,2020-01,3787.59,7151.56,3974.41,2905.94,-2295.5,-2295.5
1015941350048107008,2020-02,5534.11,4372.97,3661.26,5781.49,-959.09,-3254.59
1015941350048107008,2020-03,4276.12,7617.55,6984.12,3847.34,-204.65,-3459.24
1015941350048107008,2020-04,4667.28,4974.99,4542.31,6155.33,-1920.73,-5379.97
1015941350048107008,2020-05,5023.71,3802.96,2049.97,6632.66,-3361.94,-8741.91
1015941350048107008,2020-06,1950.69,2132.06,4269.06,3648.68,439.01,-8302.9
1015941350048107008,2020-07,1251.25,6843.81,4421.48,13772.57,-14943.65,-23246.55
1015941350048107008,2020-08,644.42,3773.55,3825.93,6630.78,-5933.98,-29180.53
1015941350048107008,2020-09,3175.55,5026.32,5192.79,3757.13,-415.11,-29595.64
1015941350048107008,2020-10,1184.3,4125.34,2433.75,4300.46,-4807.75,-34403.39
1015941350048107008,2020-11,5788.36,7211.33,8597.69,4752.3,2422.42,-31980.97
1015941350048107008,2020-12,8224.54,5619.02,2515.66,3352.02,1769.16,-30211.81
1017181895242115584,2020-01,1638.3,3944.3,2433.44,1231.04,-1103.6,-1103.6
1017181895242115584,2020-02,0,5944.72,2939.14,1220.22,-4225.8,-5329.4
1017181895242115584,2020-03,1314.78,1963.94,2631.13,2782.5,-800.53,-6129.93
1017181895242115584,2020-04,4604.23,4740.83,277.41,5460.06,-5319.25,-11449.18
1017181895242115584,2020-05,2291.35,2081.59,2607.39,1373.31,1443.84,-10005.34
1017181895242115584,2020-06,3678.74,1790.38,2134.26,4524.2,-501.58,-10506.92
1017181895242115584,2020-07,479.38,1621.83,1655.28,2732.05,-2219.22,-12726.14
1017181895242115584,2020-08,794.46,5447.56,616.6,3657.07,-7693.57,-20419.71
1017181895242115584,2020-09,2342.93,1192.48,2972.48,1461.3,2661.63,-17758.08
1017181895242115584,2020-10,2272.64,0,1792.11,7219.77,-3155.02,-20913.1
1017181895242115584,2020-11,2131.42,4545.98,5292.34,4948.83,-2071.05,-22984.15
1017181895242115584,2020-12,5500.52,1247.14,3254.57,1613.55,5894.4,-17089.75
1018092362245973120,2020-01,3711.12,1932.6,4373.27,4402.88,1748.91,1748.91
1018092362245973120,2020-02,6713.25,361.15,5579.34,68.85,11862.59,13611.5
1018092362245973120,2020-03,2793.1,4368.63,920.61,2957.7,-3612.62,9998.88
1018092362245973120,2020-04,7767.49,6242.22,2845.72,9871.27,-5500.28,4498.6
1018092362245973120,2020-05,1872.27,9933.33,4075.57,7566.93,-11552.42,-7053.82
1018092362245973120,2020-06,1490.55,1636.98,0,6546.97,-6693.4,-13747.22
1018092362245973120,2020-07,3335.63,3587.35,10743.61,2713.17,7778.72,-5968.5
1018092362245973120,2020-08,1727.94,2490.59,10427.73,4046.24,5618.84,-349.66
1018092362245973120,2020-09,2124.92,1829.12,7322.98,3322.46,4296.32,3946.66
1018092362245973120,2020-10,4132.18,3682.71,7420.78,3620.81,4249.44,8196.1
1018092362245973120,2020-11,4037.36,4077.73,1731.95,4403.13,-2711.55,5484.55
1018092362245973120,2020-12,1281.06,966.2,5580.6,5387.57,507.89,5992.44
1018644289557156992,2020-03,0,1531.93,0,0,-1531.93,-1531.93
1018644289557156992,2020-04,1731.1,1261.36,0,1731.82,-1262.08,-2794.01
1018644289557156992,2020-05,0,1798.72,0,0,-1798.72,-4592.73
1018644289557156992,2020-06,979.49,1241.55,213.91,0,-48.15,-4640.88
1018644289557156992,2020-07,99.49,1903.88,0,1008.58,-2812.97,-7453.85
1018644289557156992,2020-09,3443.68,0,0,0,3443.68,-4010.17
1018644289557156992,2020-10,2181.23,0,0,0,2181.23,-1828.94
1018644289557156992,2020-11,2746.68,1168.43,0,0,1578.25,-250.69
1019483664334047744,2020-01,1827.67,4009.19,991.89,3404.14,-4593.77,-4593.77
1019483664334047744,2020-02,2594.08,2431.65,2029.03,0,2191.46,-2402.31
1019483664334047744,2020-03,476.68,812.26,3067.26,1713.77,1017.91,-1384.4
1019483664334047744,2020-04,3312.95,4898.09,5718.09,4560.91,-427.96,-1812.36
1019483664334047744,2020-05,1437.37,7941.92,3357.1,6088.23,-9235.68,-11048.04
1019483664334047744,2020-06,1909.89,1795.46,5749.44,1549.46,4314.41,-6733.63
1019483664334047744,2020-07,8312.76,3103.73,1308.5,1846.58,4670.95,-2062.68
1019483664334047744,2020-08,4882.75,538.74,4043.51,2497.63,5889.89,3827.21
1019483664334047744,2020-09,8212.71,644.66,890.16,1776.75,6681.46,10508.67
1019483664334047744,2020-10,6882.57,3225.81,2613.73,4780.39,1490.1,11998.77
1019483664334047744,2020-11,1597.71,1266.78,5090.71,1818.05,3603.59,15602.36
1019483664334047744,2020-12,2195.45,1519.51,9876.58,0,10552.52,26154.88
1022099037173520768,2020-01,637.5,1051.95,1923.8,1467.3,42.05,42.05
1022099037173520768,2020-02,919.14,3976.51,1206.35,0,-1851.02,-1808.97
1022099037173520768,2020-03,5085.14,0,1762.06,0,6847.2,5038.23
1022099037173520768,2020-04,1844.01,696.98,0,4402.85,-3255.82,1782.41
1022099037173520768,2020-05,230.12,2557.08,220.45,532.34,-2638.85,-856.44
1022099037173520768,2020-06,1414.19,2484.2,11.15,252.39,-1311.25,-2167.69
1022099037173520768,2020-07,5151.83,161.43,0,11.4,4979,2811.31
1022099037173520768,2020-08,8.3,167.98,564.49,565.33,-160.52,2650.79
1022099037173520768,2020-09,349.82,675.08,1084.92,1116.5,-356.84,2293.95
1022099037173520768,2020-10,576.65,0,2885.45,2182.59,1279.51,3573.46
1022099037173520768,2020-11,1962.53,3520.1,0,566.68,-2124.25,1449.21
1022099037173520768,2020-12,0,2137.62,3205.7,0,1068.08,2517.29
1023094850297788288,2020-01,3012.44,181.49,3774.76,170.14,6435.57,6435.57
1023094850297788288,2020-02,0,2031.8,1731.44,1766.15,-2066.51,4369.06
1023094850297788288,2020-03,2627.48,1367.75,1282.48,4129.72,-1587.51,2781.55
1023094850297788288,2020-04,2394.69,1846.71,1996.5,0,2544.48,5326.03
1023094850297788288,2020-05,1815.86,2460.78,4617.39,450.6,3521.87,8847.9
1023094850297788288,2020-06,1134.32,1420.19,1250.63,1188.64,-223.88,8624.02
1023094850297788288,2020-07,4752.26,2158.68,3856.78,5024,1426.36,10050.38
1023094850297788288,2020-08,0,2849.14,1333.35,0,-1515.79,8534.59
1023094850297788288,2020-09,855.17,992.38,1275.77,2638.56,-1500,7034.59
1023094850297788288,2020-10,1183.34,2961.54,147.69,1423.66,-3054.17,3980.42
1023094850297788288,2020-11,1234.2,3012.47,1320.3,761.5,-1219.47,2760.95
1023094850297788288,2020-12,2979.9,752.98,1396.05,5615.31,-1992.34,768.61
1023585899504292736,2020-01,1482.04,126.24,1067.48,0,2423.28,2423.28
1023585899504292736,2020-02,1651.39,1667.34,272.2,0,256.25,2679.53
1023585899504292736,2020-03,0,746.13,809.59,0,63.46,2742.99
1023585899504292736,2020-04,0,1763.54,1598.75,338.54,-503.33,2239.66
1023585899504292736,2020-05,2348.4,0,0,0,2348.4,4588.06
1023585899504292736,2020-06,247.32,1795.55,1622.07,3831.81,-3757.97,830.09
1023585899504292736,2020-10,1764.95,841.84,3203.14,2953.17,1173.08,2003.17
1023585899504292736,2020-11,0,1398.82,0,1231.64,-2630.46,-627.29
1023670537458903424,2020-01,3248.19,420.13,2162.16,0,4990.22,4990.22
1023670537458903424,2020-02,2019.04,1348.77,801.36,0,1471.63,6461.85
1023670537458903424,2020-03,1982.22,1223.76,3105.26,136.15,3727.57,10189.42
1023670537458903424,2020-04,755.43,3587.74,5708.62,1657.74,1218.57,11407.99
1023670537458903424,2020-05,4431.66,2841.68,3822.57,3503.01,1909.54,13317.53
1023670537458903424,2020-06,1249.2,4051.97,1571.57,3701.04,-4932.24,8385.29
1023670537458903424,2020-07,1709.36,3719.93,1080.77,0,-929.8,7455.49
1023670537458903424,2020-08,1153.61,2565.49,1397.55,1392.77,-1407.1,6048.39
1023670537458903424,2020-09,8315.79,3233.1,2223.24,3934.71,3371.22,9419.61
1023670537458903424,2020-10,3994.85,2263.84,3783.59,3500.4,2014.2,11433.81
1023670537458903424,2020-11,4505.46,1190.87,122.05,2570.03,866.61,12300.42
1023670537458903424,2020-12,3598.4,1703.93,1723.85,2364.11,1254.21,13554.63
1023821064609238144,2020-01,1298.19,0,2715.15,388.64,3624.7,3624.7
1023821064609238144,2020-02,3592.02,1780.42,1122.58,1931.28,1002.9,4627.6
1023821064609238144,2020-03,1854.05,0,0,686.51,1167.54,5795.14
1023821064609238144,2020-04,3364.94,3067.6,2186.41,897.44,1586.31,7381.45
1023821064609238144,2020-05,2124.33,3645.16,3568.07,3596.98,-1549.74,5831.71
1023821064609238144,2020-06,0,887.94,0,2281.11,-3169.05,2662.66
1023821064609238144,2020-07,462.49,2569.75,2763.74,180.09,476.39,3139.05
1023821064609238144,2020-08,2916.06,0,464.72,1957.99,1422.79,4561.84
1023821064609238144,2020-09,2334.13,2173.64,2647.82,1209.49,1598.82,6160.66
1023821064609238144,2020-10,410.9,0,1076.89,1887.16,-399.37,5761.29
1023821064609238144,2020-11,1077.36,2319,1846.99,2558.11,-1952.76,3808.53
1023821064609238144,2020-12,882.49,0,1068.71,0,1951.2,5759.73
1025277930145388544,2020-01,2539.35,760.29,0,1568.14,210.92,210.92
1025277930145388544,2020-02,2896.57,1264.31,3751.69,8064.49,-2680.54,-2469.62
1025277930145388544,2020-03,1286.83,22.19,0,2904.51,-1639.87,-4109.49
1025277930145388544,2020-04,0,19.68,2019.72,0,2000.04,-2109.45
1025277930145388544,2020-05,908,4109.23,4964.38,789.35,973.8,-1135.65
1025277930145388544,2020-06,1971.44,3328.43,1036.91,0,-320.08,-1455.73
1025277930145388544,2020-07,192.16,1965.82,2789.56,1873.8,-857.9,-2313.63
1025277930145388544,2020-08,1853.66,873.26,592.3,1919.72,-347.02,-2660.65
1025277930145388544,2020-09,3683.79,840.89,67.41,2225.17,685.14,-1975.51
1025277930145388544,2020-10,2559.21,1600.59,579.4,2278.28,-740.26,-2715.77
1025277930145388544,2020-11,2169.44,3514.64,57.56,1612.92,-2900.56,-5616.33
1025277930145388544,2020-12,95.29,1591.6,1743.55,1949.44,-1702.2,-7318.53
1025614169333504512,2020-01,4965.12,9794.82,2024.01,5816.59,-8622.28,-8622.28
1025614169333504512,2020-02,2500.69,4515.44,4016.14,3586.62,-1585.23,-10207.51
1025614169333504512,2020-03,4103.78,8302.5,6271.52,1780.23,292.57,-9914.94
1025614169333504512,2020-04,2292.09,5674.39,4371.47,2247.04,-1257.87,-11172.81
1025614169333504512,2020-05,2566.23,9534.89,2996.15,6197.72,-10170.23,-21343.04
1025614169333504512,2020-06,3807.52,6389.16,2768.62,12445.42,-12258.44,-33601.48
1025614169333504512,2020-07,8460.74,3956.63,3607.42,8089.37,22.16,-33579.32
1025614169333504512,2020-08,1386.76,4583.08,4255.17,3693.37,-2634.52,-36213.84
1025614169333504512,2020-09,3446.25,0,1770.92,1869.28,3347.89,-32865.95
1025614169333504512,2020-10,4503.98,3907.88,4537.75,2136.42,2997.43,-29868.52
1025614169333504512,2020-11,6375.94,3709.41,2571,4072.98,1164.55,-28703.97
1025614169333504512,2020-12,3845.33,4595.17,2658.85,3832.4,-1923.39,-30627.36
1026510386897346688,2020-01,4307.3,7953.69,0,3412.65,-7059.04,-7059.04
1026510386897346688,2020-02,9.93,1695.44,1666.41,3030.48,-3049.58,-10108.62
1026510386897346688,2020-03,2956.39,1582.23,1881.91,3305.89,-49.82,-10158.44
1026510386897346688,2020-04,3487.56,2480.16,4689.72,3092.94,2604.18,-7554.26
1026510386897346688,2020-05,1258.69,2295.39,4058.29,5600.59,-2579,-10133.26
1026510386897346688,2020-06,5916.55,6022.39,0,5172.76,-5278.6,-15411.86
1026510386897346688,2020-07,4357.19,3637.93,3771.46,0,4490.72,-10921.14
1026510386897346688,2020-08,2572.6,1691.62,4244.03,1977.16,3147.85,-7773.29
1026510386897346688,2020-09,2160.69,1047.8,5850.49,3050.4,3912.98,-3860.31
1026510386897346688,2020-10,7493.86,1896.26,6344.48,734.97,11207.11,7346.8
1026510386897346688,2020-11,2746.7,7061.08,3006.52,2799.48,-4107.34,3239.46
1026510386897346688,2020-12,3921.21,3363.41,255.34,3117.5,-2304.36,935.1
1026526759813689984,2020-01,3887.88,2358.5,2448.45,2440.79,1537.04,1537.04
1026526759813689984,2020-02,5255.12,1449.26,4731.92,152.95,8384.83,9921.87
1026526759813689984,2020-03,7351.52,1088.06,2593.35,5158.28,3698.53,13620.4
1026526759813689984,2020-04,4332.02,1020.8,3673.67,4456.62,2528.27,16148.67
1026526759813689984,2020-05,177.41,2032.74,3981.17,2910.98,-785.14,15363.53
1026526759813689984,2020-06,2612.74,5204,1659.81,3999.25,-4930.7,10432.83
1026526759813689984,2020-07,2134.97,1424.24,1448.38,7985.59,-5826.48,4606.35
1026526759813689984,2020-08,4283.4,6851.07,2376.08,5818.43,-6010.02,-1403.67
1026526759813689984,2020-09,5216.01,2252.35,1427.78,6090.34,-1698.9,-3102.57
1026526759813689984,2020-10,5058.33,6295.19,8845.07,1558.4,6049.81,2947.24
1026526759813689984,2020-11,2111.98,1429.68,5904.38,4313.46,2273.22,5220.46
1026526759813689984,2020-12,4330.14,2619.59,1403.58,2847.83,266.3,5486.76
1027723092389070208,2020-01,7234.83,3260.81,205.41,794.61,3384.82,3384.82
1027723092389070208,2020-02,1172,2981.92,2261.91,2863.67,-2411.68,973.14
1027723092389070208,2020-03,4164.65,4653.54,1757.68,1570.3,-301.51,671.63
1027723092389070208,2020-04,1111.82,1020.57,2570.3,2265.97,395.58,1067.21
1027723092389070208,2020-05,1157.46,3458.11,4527.36,1827.8,398.91,1466.12
1027723092389070208,2020-06,0,1911.81,4688.64,334.72,2442.11,3908.23
1027723092389070208,2020-07,1134.99,2151.83,2433.87,1635.53,-218.5,3689.73
1027723092389070208,2020-08,0,4587.39,435.54,1752.56,-5904.41,-2214.68
1027723092389070208,2020-09,836.94,4679.67,1620.35,992.34,-3214.72,-5429.4
1027723092389070208,2020-10,3566.28,0,3674.24,1834.91,5405.61,-23.79
1027723092389070208,2020-11,4682.12,3290.27,3882.27,0,5274.12,5250.33
1027723092389070208,2020-12,3570.62,4341.61,1832.7,2694.06,-1632.35,3617.98
1028404737318295424,2020-02,1870.31,636.81,1904.55,2746.31,391.74,391.74
1028404737318295424,2020-03,541.62,980.43,1034.51,2316.92,-1721.22,-1329.48
1028404737318295424,2020-04,0,4702.7,1909.36,1796.51,-4589.85,-5919.33
1028404737318295424,2020-06,410.83,1142.37,1854.94,1342.54,-219.14,-6138.47
1028404737318295424,2020-07,3533.4,1526.14,1498.56,3568.88,-63.06,-6201.53
1028404737318295424,2020-08,666.45,2261.12,4109.14,2935.67,-421.2,-6622.73
1028404737318295424,2020-09,2977.55,1642.22,2508.5,4422.65,-578.82,-7201.55
1028404737318295424,2020-10,1950.17,1118.28,23.13,811.87,43.15,-7158.4
1028404737318295424,2020-11,3522.73,1701.81,591.94,0,2412.86,-4745.54
1028404737318295424,2020-12,833.52,0,2339.1,0,3172.62,-1572.92
1029397655713511168,2020-01,3402.19,3025.44,3439.23,0,3815.98,3815.98
1029397655713511168,2020-02,1413.22,1439.83,2464.04,1245.64,1191.79,5007.77
1029397655713511168,2020-03,467.21,575.58,6171.07,1636.24,4426.46,9434.23
1029397655713511168,2020-04,2035.95,5569.06,1516.32,6543.98,-8560.77,873.46
1029397655713511168,2020-05,1202.92,5799.53,3688.31,5518.41,-6426.71,-5553.25
1029397655713511168,2020-06,5053.72,1630.16,2678.66,2017.42,4084.8,-1468.45
1029397655713511168,2020-07,7189.52,3673.74,1298.59,8557.37,-3743,-5211.45
1029397655713511168,2020-08,4157.44,7767.67,1998.97,0,-1611.26,-6822.71
1029397655713511168,2020-09,3172.02,3082.49,2058.39,5167.46,-3019.54,-9842.25
1029397655713511168,2020-10,2444.77,4440.45,4927.91,5359.21,-2426.98,-12269.23
1029397655713511168,2020-11,1553.71,3112.66,3409.96,8861.94,-7010.93,-19280.16
1029397655713511168,2020-12,3261.63,3159.22,4857.79,1212.84,3747.36,-15532.8
1029774162761347456,2020-01,0,20.97,1905.88,0,1884.91,1884.91
1029774162761347456,2020-03,527.71,1711.26,0,0,-1183.55,701.36
1029774162761347456,2020-05,0,764.53,1747.36,0,982.83,1684.19
1029774162761347456,2020-08,0,1801.93,1304.84,0,-497.09,1187.1
1029774162761347456,2020-09,2190.5,226.09,0,0,1964.41,3151.51
1029774162761347456,2020-11,1098.54,0,1488.71,0,2587.25,5738.76
1029774162761347456,2020-12,0,1504.84,0,360.69,-1865.53,3873.23
1030382561412382848,2020-01,0,1874.25,132.97,1018.74,-2760.02,-2760.02
1030382561412382848,2020-02,0,117.89,4186.71,1413.83,2654.99,-105.03
1030382561412382848,2020-03,1341.61,166.34,1302.59,2026.17,451.69,346.66
1030382561412382848,2020-04,0,1130.43,0,0,-1130.43,-783.77
1030382561412382848,2020-05,0,2535.52,0,0,-2535.52,-3319.29
1030382561412382848,2020-07,0,1150.57,975.64,1652.97,-1827.9,-5147.19
1030382561412382848,2020-08,0,2477.72,0,0,-2477.72,-7624.91
1030382561412382848,2020-09,1460.18,0,631.09,0,2091.27,-5533.64
1030382561412382848,2020-11,0,1431.33,0,0,-1431.33,-6964.97
1030382561412382848,2020-12,0,1854.08,0,1966.33,-3820.41,-10785.38
1031537448385968640,2020-01,1328.46,0,3231.7,0,4560.16,4560.16
1031537448385968640,2020-03,1075.27,0,0,1774.89,-699.62,3860.54
1031537448385968640,2020-04,6503.04,0,1885.9,0,8388.94,12249.48
1031537448385968640,2020-05,1012.48,0,1633.73,0,2646.21,14895.69
1031537448385968640,2020-06,1532.28,2548.38,533.25,872.83,-1355.68,13540.01
1031537448385968640,2020-07,1901.31,0,0,1635.83,265.48,13805.49
1031537448385968640,2020-08,0,1436.08,0,1313.79,-2749.87,11055.62
1031537448385968640,2020-09,516.67,2809.3,0,1846.95,-4139.58,6916.04
1031537448385968640,2020-11,450.4,0,0,306.78,143.62,7059.66
1031537448385968640,2020-12,1945.85,537.99,30.46,2986.88,-1548.56,5511.1
1032736995475615232,2020-01,3112.33,4768.06,2903.6,2934.51,-1686.64,-1686.64
1032736995475615232,2020-02,4939.09,414.12,2057.92,1354.64,5228.25,3541.61
1032736995475615232,2020-03,6965.14,4508.08,5890.8,2140.26,6207.6,9749.21
1032736995475615232,2020-04,3488.67,3261.74,218.14,2983.69,-2538.62,7210.59
1032736995475615232,2020-05,2.95,4722.16,5596.74,2955.99,-2078.46,5132.13
1032736995475615232,2020-06,1112.5,368.07,0,6032.14,-5287.71,-155.58
1032736995475615232,2020-07,6221.22,1691.46,2547.62,5696.5,1380.88,1225.3
1032736995475615232,2020-08,2667.03,7614.06,4456.8,1374.11,-1864.34,-639.04
1032736995475615232,2020-09,1633.69,3387.85,4561.46,3627.22,-819.92,-1458.96
1032736995475615232,2020-10,5732.71,2268.42,2199.52,1534.51,4129.3,2670.34
1032736995475615232,2020-11,4269.67,3709.78,4103.81,6999.98,-2336.28,334.06
1032736995475615232,2020-12,4616.01,2833.39,6.4,1997.74,-208.72,125.34
1032810163652747776,2020-01,1692.77,7188.42,8024.66,4468.71,-1939.7,-1939.7
1032810163652747776,2020-02,6136.69,3906.14,3748.91,318.71,5660.75,3721.05
1032810163652747776,2020-03,4952.34,3404.18,3280.68,1971.91,2856.93,6577.98
1032810163652747776,2020-04,4378,1989.75,4892.72,3378.32,3902.65,10480.63
1032810163652747776,2020-05,7581.31,3995.39,2844.21,666.21,5763.92,16244.55
1032810163652747776,2020-06,741.35,537.7,6973.3,2399.13,4777.82,21022.37
1032810163652747776,2020-07,4014.15,4548.79,4151.48,5068.48,-1451.64,19570.73
1032810163652747776,2020-08,6418.07,344.98,413.89,1477.05,5009.93,24580.66
1032810163652747776,2020-09,6206.64,1577.46,2576.05,8472.24,-1267.01,23313.65
1032810163652747776,2020-10,2713.9,2694.2,1733.74,4707.14,-2953.7,20359.95
1032810163652747776,2020-11,3493.63,4477.72,4787.59,3185.15,618.35,20978.3
1032810163652747776,2020-12,0,3871.19,2941.83,0,-929.36,20048.94
1032965871338162048,2020-02,3134.99,1997.33,1728.25,0,2865.91,2865.91
1032965871338162048,2020-03,1961.77,2926.19,1724.54,2245.02,-1484.9,1381.01
1032965871338162048,2020-04,2860.45,754.6,841.48,0,2947.33,4328.34
1032965871338162048,2020-05,199.46,1628.1,1464.22,611.37,-575.79,3752.55
1032965871338162048,2020-06,1138.48,1696.8,3522.36,1230.71,1733.33,5485.88
1032965871338162048,2020-07,372.84,2437.19,3119.25,2661.67,-1606.77,3879.11
1032965871338162048,2020-08,4520.24,1225.06,855.02,1832.71,2317.49,6196.6
1032965871338162048,2020-09,4096,2485.77,1216.53,778.09,2048.67,8245.27
1032965871338162048,2020-10,666.81,4354.81,337.15,3000.09,-6350.94,1894.33
1032965871338162048,2020-11,581.27,2790.13,783.35,1844.86,-3270.37,-1376.04
1032965871338162048,2020-12,2018.64,0,391.72,1943.61,466.75,-909.29
1033695664202270464,2020-01,8139.69,6931.85,4256.4,7312.31,-1848.07,-1848.07
1033695664202270464,2020-02,9805.35,7394.41,4416.26,1124.67,5702.53,3854.46
1033695664202270464,2020-03,8133.65,3071.96,2453.48,4308.44,3206.73,7061.19
1033695664202270464,2020-04,2001.28,3801.92,2747.06,5614.7,-4668.28,2392.91
1033695664202270464,2020-05,3345.53,9562.33,0,7753.25,-13970.05,-11577.14
1033695664202270464,2020-06,3035.08,8548.59,7956.13,4304.99,-1862.37,-13439.51
1033695664202270464,2020-07,1741.53,5589.76,6746.46,6977.24,-4079.01,-17518.52
1033695664202270464,2020-08,4446.23,2155.43,4781.4,3380.93,3691.27,-13827.25
1033695664202270464,2020-09,7740.3,2281.47,8994.33,4484,9969.16,-3858.09
1033695664202270464,2020-10,1539.86,1269.01,4228.42,5355.35,-856.08,-4714.17
1033695664202270464,2020-11,7217.23,5872.59,4128.54,4866.84,606.34,-4107.83
1033695664202270464,2020-12,9809.72,2880.3,1395.85,1682.74,6642.53,2534.7
1035742001266391808,2020-01,1568.86,3623.01,4573.68,6220.31,-3700.78,-3700.78
1035742001266391808,2020-02,5977.82,3560.06,3597.24,2250.68,3764.32,63.54
1035742001266391808,2020-03,2293.98,2426.85,1154.6,3273.98,-2252.25,-2188.71
1035742001266391808,2020-04,2863.2,3018.72,4252.79,954.86,3142.41,953.7
1035742001266391808,2020-05,2322.22,5466.36,4997.51,4132.33,-2278.96,-1325.26
1035742001266391808,2020-06,4370.35,4590.02,521.67,6561.12,-6259.12,-7584.38
1035742001266391808,2020-07,2787.48,2988,6411.51,4226.35,1984.64,-5599.74
1035742001266391808,2020-08,555.96,1625.77,4092.06,3626.73,-604.48,-6204.22
1035742001266391808,2020-09,2748.68,4939.34,3649.4,632.41,826.33,-5377.89
1035742001266391808,2020-10,3847.19,8709.29,3808.9,1725.98,-2779.18,-8157.07
1035742001266391808,2020-11,1791.51,1460.23,4249.66,6321.76,-1740.82,-9897.89
1035742001266391808,2020-12,3118.54,0,1203.17,2690.17,1631.54,-8266.35
1036124430961792256,2020-01,3667,2384.69,2671.28,775.03,3178.56,3178.56
1036124430961792256,2020-02,1969.82,3320.26,2240.96,3037.85,-2147.33,1031.23
1036124430961792256,2020-03,879.51,4130.13,4134.18,2399.41,-1515.85,-484.62
1036124430961792256,2020-04,1237.27,4653.38,1492.66,1920.37,-3843.82,-4328.44
1036124430961792256,2020-05,3572.22,4163.72,2567.46,4875.48,-2899.52,-7227.96
1036124430961792256,2020-06,3430.01,2817.1,3141.49,4286.17,-531.77,-7759.73
1036124430961792256,2020-07,3486.43,3727.77,0,3886.15,-4127.49,-11887.22
1036124430961792256,2020-08,5139.21,0,279.74,1882.4,3536.55,-8350.67
1036124430961792256,2020-09,4925.3,0,3410.7,0,8336,-14.67
1036124430961792256,2020-10,1122.23,3178.85,2558.25,2734.54,-2232.91,-2247.58
1036124430961792256,2020-11,427.95,2645.05,2303.45,1551.85,-1465.5,-3713.08
1036124430961792256,2020-12,0,1949.27,4719.06,3435.46,-665.67,-4378.75
1036233948061982464,2020-01,1943.05,6725.66,4928.91,4780.27,-4633.97,-4633.97
1036233948061982464,2020-02,3385.39,4066.59,3903.53,4510.53,-1288.2,-5922.17
1036233948061982464,2020-03,1777.78,5170.14,6825,6630.02,-3197.38,-9119.55
1036233948061982464,2020-04,2044.73,1841.05,849.13,7168.99,-6116.18,-15235.73
1036233948061982464,2020-05,6992.43,6850.67,383.85,2306.86,-1781.25,-17016.98
1036233948061982464,2020-06,8243.42,7823.4,3619.87,9086.51,-5046.62,-22063.6
1036233948061982464,2020-07,2659.64,2943.31,7410.59,5556.49,1570.43,-20493.17
1036233948061982464,2020-08,5312.31,1898.44,4764.68,2718.72,5459.83,-15033.34
1036233948061982464,2020-09,7662.26,1660.11,4232.96,7490.71,2744.4,-12288.94
1036233948061982464,2020-10,2016.63,4066.16,11854.58,2596.71,7208.34,-5080.6
1036233948061982464,2020-11,217.85,528.2,6515.09,3970.94,2233.8,-2846.8
1036233948061982464,2020-12,5027.39,5568.6,5353.48,3562.51,1249.76,-1597.04
1036919345141805184,2020-01,3864.21,1944.37,5976.78,3595.51,4301.11,4301.11
1036919345141805184,2020-02,3616.93,3217.54,2514.62,4266.1,-1352.09,2949.02
1036919345141805184,2020-03,3449.64,3481.3,3836.05,8597.42,-4793.03,-1844.01
1036919345141805184,2020-04,127.58,2852.69,4136.76,9393.71,-7982.06,-9826.07
1036919345141805184,2020-05,2676.25,12447.24,3904.73,0,-5866.26,-15692.33
1036919345141805184,2020-06,6064.03,4919.05,6327.92,2315.98,5156.92,-10535.41
1036919345141805184,2020-07,5183.49,8489.69,1663.87,3281.24,-4923.57,-15458.98
1036919345141805184,2020-08,4099.62,3524.64,7576.7,4641.91,3509.77,-11949.21
1036919345141805184,2020-09,4199.83,4350.01,3235.31,12276.44,-9191.31,-21140.52
1036919345141805184,2020-10,2556.62,2292.45,4511.56,2161.19,2614.54,-18525.98
1036919345141805184,2020-11,3335.38,6131.39,763.44,4984.69,-7017.26,-25543.24
1036919345141805184,2020-12,6246,6042.15,1625.44,6578.93,-4749.64,-30292.88
1039531588608828288,2020-01,0,1606.87,4838.61,1575.46,1656.28,1656.28
1039531588608828288,2020-02,1695.61,3187.72,1204.33,0,-287.78,1368.5
1039531588608828288,2020-03,0,1654.46,1743.18,3363.07,-3274.35,-1905.85
1039531588608828288,2020-04,0,1280.12,594.71,0,-685.41,-2591.26
1039531588608828288,2020-05,1246.98,1834.21,4013.19,1999.63,1426.33,-1164.93
1039531588608828288,2020-06,2833.78,2867.35,3201.51,2388.96,778.98,-385.95
1039531588608828288,2020-07,0,1842.79,1794.69,1760.76,-1808.86,-2194.81
1039531588608828288,2020-09,729.6,2696.58,1183.98,2088.78,-2871.78,-5066.59
1039531588608828288,2020-10,3547.2,4150.07,1610.99,188.37,819.75,-4246.84
1039531588608828288,2020-11,1274.01,1147.32,2752.81,1900.47,979.03,-3267.81
1039531588608828288,2020-12,681.96,2976.79,2068.75,0,-226.08,-3493.89
1039742162882628864,2020-01,4138.43,2539.55,3369.3,1684.63,3283.55,3283.55
1039742162882628864,2020-02,301.58,2103.76,378.33,6483.26,-7907.11,-4623.56
1039742162882628864,2020-03,1219.96,1393.49,2595.55,7197.12,-4775.1,-9398.66
1039742162882628864,2020-04,3516.22,0,6264.71,4983.45,4797.48,-4601.18
1039742162882628864,2020-05,5627.06,9300.57,2571.3,6129.13,-7231.34,-11832.52
1039742162882628864,2020-06,4553.57,4897.32,5387.92,11590.24,-6546.07,-18378.59
1039742162882628864,2020-07,4624.03,4965.78,1610.18,3753.44,-2485.01,-20863.6
1039742162882628864,2020-08,5442.22,4595.29,2710.37,2439.32,1117.98,-19745.62
1039742162882628864,2020-09,11705.47,5227.37,1517.95,2424.44,5571.61,-14174.01
1039742162882628864,2020-10,4043.92,3096.57,2404.39,7052.45,-3700.71,-17874.72
1039742162882628864,2020-11,6175.48,5146.67,4323.06,2108.99,3242.88,-14631.84
1039742162882628864,2020-12,6292.18,6037.7,2210.97,4861.26,-2395.81,-17027.65
1040161888929300224,2020-01,629.8,4080.91,6448.05,1659.15,1337.79,1337.79
1040161888929300224,2020-02,0,4041.75,8191.1,6192.7,-2043.35,-705.56
1040161888929300224,2020-03,6265.63,4052.53,3625.15,7736.92,-1898.67,-2604.23
1040161888929300224,2020-04,3499.5,2700.75,7882.88,3290.64,5390.99,2786.76
1040161888929300224,2020-05,7901.36,11825.28,3935.98,10613.27,-10601.21,-7814.45
1040161888929300224,2020-06,3624.76,2738.96,2821.68,4102.62,-395.14,-8209.59
1040161888929300224,2020-07,2064.93,12418.92,8627.89,3690.85,-5416.95,-13626.54
1040161888929300224,2020-08,4443.42,1992.06,4852.62,5093.77,2210.21,-11416.33
1040161888929300224,2020-09,6670.7,4009.96,1038.31,4752.76,-1053.71,-12470.04
1040161888929300224,2020-10,4636.69,7471.36,2227.11,1351.94,-1959.5,-14429.54
1040161888929300224,2020-11,6659.64,3109.64,7254.09,1778.56,9025.53,-5404.01
1040161888929300224,2020-12,2380.14,6202.44,6205.87,4899.96,-2516.39,-7920.4
1040552679237262720,2020-01,536.78,0,2000.46,2507.52,29.72,29.72
1040552679237262720,2020-02,864.35,0,1701.56,0,2565.91,2595.63
1040552679237262720,2020-04,0,68.48,378.7,2258.12,-1947.9,647.73
1040552679237262720,2020-05,1722.3,999.78,1893.29,0,2615.81,3263.54
1040552679237262720,2020-06,0,1933.19,0,2837.18,-4770.37,-1506.83
1040552679237262720,2020-07,0,591.48,3067.72,0,2476.24,969.41
1040552679237262720,2020-08,0,365.66,1011.54,0,645.88,1615.29
1040552679237262720,2020-11,2715.83,1709.75,332.31,748.94,589.45,2204.74
1040552679237262720,2020-12,1066.89,1146.69,4245.07,0,4165.27,6370.01
1042427549897580928,2020-01,0,230.43,693.82,0,463.39,463.39
1042427549897580928,2020-03,293.16,0,0,1357.51,-1064.35,-600.96
1042427549897580928,2020-08,0,71.86,0,0,-71.86,-672.82
1042427549897580928,2020-10,0,3271.9,0,0,-3271.9,-3944.72
1042427549897580928,2020-11,4047.99,0,0,0,4047.99,103.27
1042427549897580928,2020-12,0,509.24,0,0,-509.24,-405.97
1043178872830515200,2020-01,649.17,3134.51,1905.32,4775.79,-5355.81,-5355.81
1043178872830515200,2020-02,1851.12,1755.66,2467.2,790.28,1772.38,-3583.43
1043178872830515200,2020-03,0,1192.65,0,1575.4,-2768.05,-6351.48
1043178872830515200,2020-04,3601.79,971.89,931.01,84.14,3476.77,-2874.71
1043178872830515200,2020-05,2104.16,1306.49,1343.04,372.2,1768.51,-1106.2
1043178872830515200,2020-06,272.07,2664.23,2928.31,16.22,519.93,-586.27
1043178872830515200,2020-07,1963,4928.69,1143.73,718.96,-2540.92,-3127.19
1043178872830515200,2020-08,1892.12,959.72,3118.58,0,4050.98,923.79
1043178872830515200,2020-09,3402.56,2911.87,4546.99,0,5037.68,5961.47
1043178872830515200,2020-10,1665.4,0,1782.56,2681.36,766.6,6728.07
1043178872830515200,2020-11,3383.77,690.05,655.53,0,3349.25,10077.32
1043178872830515200,2020-12,2679.41,837.96,1647.64,96.55,3392.54,13469.86
1043216364022172288,2020-02,0,3089,0,1085.7,-4174.7,-4174.7
1043216364022172288,2020-04,0,3162.41,2029.81,0,-1132.6,-5307.3
1043216364022172288,2020-05,64.94,0,0,0,64.94,-5242.36
1043216364022172288,2020-06,317.55,218.76,1079.6,0,1178.39,-4063.97
1043216364022172288,2020-07,0,1292.37,0,0,-1292.37,-5356.34
1043216364022172288,2020-08,305.05,0,0,1150.8,-845.75,-6202.09
1043216364022172288,2020-10,1138.22,0,0,2552.96,-1414.74,-7616.83
1043216364022172288,2020-11,836.75,330.48,0,305.22,201.05,-7415.78
1043216364022172288,2020-12,0,1882.93,0,1405.98,-3288.91,-10704.69
1043378570508378624,2020-01,9060.94,3818.94,1799.48,4092.79,2948.69,2948.69
1043378570508378624,2020-02,239.29,6504.14,5871.53,6119.94,-6513.26,-3564.57
1043378570508378624,2020-03,802.69,3127.75,4333.43,800.39,1207.98,-2356.59
1043378570508378624,2020-04,4096.57,3495.51,7873.18,1736.7,6737.54,4380.95
1043378570508378624,2020-05,4587.86,3395.49,5748.36,6747.16,193.57,4574.52
1043378570508378624,2020-06,8122.47,3804.62,0,5420.06,-1102.21,3472.31
1043378570508378624,2020-07,3435.03,6337.78,1870.81,5497.66,-6529.6,-3057.29
1043378570508378624,2020-08,4887.41,4376.55,5365.19,5192.09,683.96,-2373.33
1043378570508378624,2020-09,6250.24,2353.93,1422.75,5206.45,112.61,-2260.72
1043378570508378624,2020-10,2671.54,3321.05,6699.06,8554.19,-2504.64,-4765.36
1043378570508378624,2020-11,5338.4,7200.04,2859.62,5590.16,-4592.18,-9357.54
1043378570508378624,2020-12,5267.07,8139.96,2798.66,3535.77,-3610,-12967.54
1043989959424879872,2020-01,2913.74,3040.99,5167.68,4584.03,456.4,456.4
1043989959424879872,2020-02,4367.14,3543.65,7271.31,2239.61,5855.19,6311.59
1043989959424879872,2020-03,6676.78,6063.01,4048.46,1784.73,2877.5,9189.09
1043989959424879872,2020-04,11293.71,2909.97,4661.81,10290.79,2754.76,11943.85
1043989959424879872,2020-05,7850.73,2779.62,3782.17,7825.78,1027.5,12971.35
1043989959424879872,2020-06,1551.8,4338.4,3366.14,5563.62,-4984.08,7987.27
1043989959424879872,2020-07,1156.39,3334.11,7368.86,4930.65,260.49,8247.76
1043989959424879872,2020-08,5352.7,1250.31,535.27,3004.15,1633.51,9881.27
1043989959424879872,2020-09,3788.15,6100.36,5445.34,1483.22,1649.91,11531.18
1043989959424879872,2020-10,2220.89,3374.74,4965.88,7958.4,-4146.37,7384.81
1043989959424879872,2020-11,2669.69,1927.07,2593.5,2873.66,462.46,7847.27
1043989959424879872,2020-12,10294.09,4814.53,1920.2,3307.72,4092.04,11939.31
1044037801306785408,2020-01,811.59,0,1711.1,1906.76,615.93,615.93
1044037801306785408,2020-02,1767.32,3133.71,1426.84,1242.5,-1182.05,-566.12
1044037801306785408,2020-03,1753.1,1823.24,2220.37,0,2150.23,1584.11
1044037801306785408,2020-04,1092.44,1639.38,0,0,-546.94,1037.17
1044037801306785408,2020-05,5340.39,2537.82,2643.89,615.99,4830.47,5867.64
1044037801306785408,2020-06,655.35,0,0,3417.37,-2762.02,3105.62
1044037801306785408,2020-07,1957.56,0,0,1853.62,103.94,3209.56
1044037801306785408,2020-08,1002.45,57.37,103.56,2306.68,-1258.04,1951.52
1044037801306785408,2020-09,508.33,2100.9,1365.36,1746.91,-1974.12,-22.6
1044037801306785408,2020-10,0,1072.15,1673.46,0,601.31,578.71
1044037801306785408,2020-11,1116.89,1803.21,0,0,-686.32,-107.61
1044037801306785408,2020-12,2322.24,4086.07,2342.41,0,578.58,470.97
1045090498074148224,2020-01,2711.89,2198.08,1689.46,3271.34,-1068.07,-1068.07
1045090498074148224,2020-02,745.86,5622.64,0,1156.98,-6033.76,-7101.83
1045090498074148224,2020-03,3342.2,2726.23,1009.16,4846.33,-3221.2,-10323.03
1045090498074148224,2020-04,5218.57,2047.59,4002.34,3554.34,3618.98,-6704.05
1045090498074148224,2020-05,0,10280.8,1011.77,1753.67,-11022.7,-17726.75
1045090498074148224,2020-06,971.48,1967.09,2814.75,7115.36,-5296.22,-23022.97
1045090498074148224,2020-07,4112.75,3540.11,1976.34,3662.01,-1113.03,-24136
1045090498074148224,2020-08,5103.27,2779.73,2988.76,3928.18,1384.12,-22751.88
1045090498074148224,2020-09,2847.67,7211.55,5991.65,2428.95,-801.18,-23553.06
1045090498074148224,2020-10,2008.82,1688.91,4810.58,2817.68,2312.81,-21240.25
1045090498074148224,2020-11,4567.76,4824.94,6136.5,3943.82,1935.5,-19304.75
1045090498074148224,2020-12,937.33,3463.75,4635.49,3983.53,-1874.46,-21179.21
1045706753715146240,2020-01,2003.22,307.47,1192.8,39.86,2848.69,2848.69
1045706753715146240,2020-02,1636.84,1905.43,0,853.91,-1122.5,1726.19
1045706753715146240,2020-04,813.18,1222.01,3882.88,3753.54,-279.49,1446.7
1045706753715146240,2020-05,1754.4,1535,1897.87,0,2117.27,3563.97
1045706753715146240,2020-06,1716.38,2029.03,1256.2,1820.45,-876.9,2687.07
1045706753715146240,2020-08,1170.61,0,1963.02,1973.48,1160.15,3847.22
1045706753715146240,2020-09,1667.46,2302.7,1120.54,0,485.3,4332.52
1045706753715146240,2020-10,0,1329.39,1734.78,1004.45,-599.06,3733.46
1045706753715146240,2020-11,1925.59,2169.48,0,1447.91,-1691.8,2041.66
1045706753715146240,2020-12,1880.21,4336.64,307,0,-2149.43,-107.77
1046811094570634240,2020-01,1861.72,2685.94,5837.96,2669.25,2344.49,2344.49
1046811094570634240,2020-02,7597.87,4231.41,757.94,4670.47,-546.07,1798.42
1046811094570634240,2020-03,6542.49,6736.82,3655.05,7309.52,-3848.8,-2050.38
1046811094570634240,2020-04,4369.05,1512,1245.21,590.17,3512.09,1461.71
1046811094570634240,2020-05,1538.16,2515.22,2716.97,5230.94,-3491.03,-2029.32
1046811094570634240,2020-06,5093.9,885.59,4899.22,1575.53,7532,5502.68
1046811094570634240,2020-07,0,5426.25,1278.14,5301.79,-9449.9,-3947.22
1046811094570634240,2020-08,6422.19,3441.77,3248.56,6975.44,-746.46,-4693.68
1046811094570634240,2020-09,3319.6,4947.65,1141.96,6085.35,-6571.44,-11265.12
1046811094570634240,2020-10,3980.61,4754.4,5153.57,0,4379.78,-6885.34
1046811094570634240,2020-11,0,6493.08,4398.16,2980.23,-5075.15,-11960.49
1046811094570634240,2020-12,6443.52,9015.51,6908.1,1304.65,3031.46,-8929.03
1048481110073363328,2020-01,2865.19,357.14,1502.2,2980.59,1029.66,1029.66
1048481110073363328,2020-02,0,3477.31,1688.31,2774.97,-4563.97,-3534.31
1048481110073363328,2020-03,2805.04,0,0,218.59,2586.45,-947.86
1048481110073363328,2020-04,4256.34,1645.19,3173.58,2596.67,3188.06,2240.2
1048481110073363328,2020-05,1330.26,502.18,1658.67,1612.1,874.65,3114.85
1048481110073363328,2020-06,2617.55,3471.62,0,3540.46,-4394.53,-1279.68
1048481110073363328,2020-07,3521.79,1347.91,2521.55,2719.12,1976.31,696.63
1048481110073363328,2020-08,985.48,2584.36,3305.58,586.8,1119.9,1816.53
1048481110073363328,2020-09,5562.36,0,3418.78,0,8981.14,10797.67
1048481110073363328,2020-10,0,924.68,1734.81,2252.92,-1442.79,9354.88
1048481110073363328,2020-11,4251.52,0,0,1548.79,2702.73,12057.61
1048481110073363328,2020-12,1815.47,5960.48,2008.77,2756.65,-4892.89,7164.72
1049180010134687872,2020-02,134.04,0,0,0,134.04,134.04
1049180010134687872,2020-03,0,1524.62,566.06,0,-958.56,-824.52
1049180010134687872,2020-05,680.3,2243.92,0,0,-1563.62,-2388.14
1049180010134687872,2020-06,1567.72,0,544.07,0,2111.79,-276.35
1049180010134687872,2020-07,777.21,182.25,0,3282.24,-2687.28,-2963.63
1049180010134687872,2020-09,317.49,2387.02,685.15,1886.82,-3271.2,-6234.83
1049180010134687872,2020-10,30.87,4573.8,0,1682.82,-6225.75,-12460.58
1049180010134687872,2020-11,0,1874.77,64.86,0,-1809.91,-14270.49
1049180010134687872,2020-12,2086.58,0,0,172,1914.58,-12355.91
1053592324742491648,2020-01,964.96,5291.23,603.5,5211.91,-8934.68,-8934.68
1053592324742491648,2020-02,3365.63,470.9,1679.06,4481.79,92,-8842.68
1053592324742491648,2020-03,3465.27,2212.89,1426.42,2280.46,398.34,-8444.34
1053592324742491648,2020-04,611.77,7184.26,2951.39,3490.58,-7111.68,-15556.02
1053592324742491648,2020-05,5367.02,1467.03,0,2753.88,1146.11,-14409.91
1053592324742491648,2020-06,378.74,491.83,6961.06,0,6847.97,-7561.94
1053592324742491648,2020-07,2141,3061.31,1102.13,0,181.82,-7380.12
1053592324742491648,2020-08,2472.33,3216.64,431.19,2225.39,-2538.51,-9918.63
1053592324742491648,2020-09,3406.68,6811.6,1973.74,0,-1431.18,-11349.81
1053592324742491648,2020-10,5828.62,230.02,0,1355.35,4243.25,-7106.56
1053592324742491648,2020-11,854.72,5386.65,2426.11,611.07,-2716.89,-9823.45
1053592324742491648,2020-12,6494.74,2862.89,3185.77,1378.08,5439.54,-4383.91
1055810355806961920,2020-01,0,4178.18,533.52,5919.21,-9563.87,-9563.87
1055810355806961920,2020-02,2912.72,4987.41,1425.16,3031.67,-3681.2,-13245.07
1055810355806961920,2020-03,1737.42,5278.74,5463.15,1901,20.83,-13224.24
1055810355806961920,2020-04,1746.57,3366.15,179.06,4176.85,-5617.37,-18841.61
1055810355806961920,2020-05,4311.75,3031.22,2755.91,0,4036.44,-14805.17
1055810355806961920,2020-06,2724.5,163.53,0,1584.61,976.36,-13828.81
1055810355806961920,2020-07,1641.2,8047,3089.07,5338.44,-8655.17,-22483.98
1055810355806961920,2020-08,5425.55,4700.17,6855.07,3595.94,3984.51,-18499.47
1055810355806961920,2020-09,3145.56,3238.92,860.38,3073.41,-2306.39,-20805.86
1055810355806961920,2020-10,1579.96,6676.23,2842.82,3435.82,-5689.27,-26495.13
1055810355806961920,2020-11,1307.01,645.67,2750.97,2305.59,1106.72,-25388.41
1055810355806961920,2020-12,2108.75,530.16,3475.15,4823.7,230.04,-25158.37
1056689333861846656,2020-01,2201.91,3856.71,845.71,4394.51,-5203.6,-5203.6
1056689333861846656,2020-02,0,2885.41,4715.89,4291.41,-2460.93,-7664.53
1056689333861846656,2020-03,4823.37,9218.43,3435.21,5889.19,-6849.04,-14513.57
1056689333861846656,2020-04,5089.78,1408.5,5714.91,4440.77,4955.42,-9558.15
1056689333861846656,2020-05,8227.19,2807.9,5822.94,3380.76,7861.47,-1696.68
1056689333861846656,2020-06,6529.27,2063.9,1489.36,8.95,5945.78,4249.1
1056689333861846656,2020-07,728.88,5272.97,3842.4,5644.74,-6346.43,-2097.33
1056689333861846656,2020-08,6388.45,2087.75,3057.26,3233.14,4124.82,2027.49
1056689333861846656,2020-09,5965.62,6690.53,7066.9,2202.27,4139.72,6167.21
1056689333861846656,2020-10,4659.86,3569.79,2151.16,2061.45,1179.78,7346.99
1056689333861846656,2020-11,5110.64,6601.52,1289.25,0,-201.63,7145.36
1056689333861846656,2020-12,8770.32,1434.96,3781.24,3178.06,7938.54,15083.9
1058768528638427904,2020-01,5850.62,4520.6,3483.39,1816.61,2996.8,2996.8
1058768528638427904,2020-02,1754.03,1734.01,6223.02,3465.65,2777.39,5774.19
1058768528638427904,2020-03,6103.7,682.98,8272.41,2736.04,10957.09,16731.28
1058768528638427904,2020-04,1665.67,2312.3,1687.45,848.85,191.97,16923.25
1058768528638427904,2020-05,3069.08,10608.66,1801.37,2114.75,-7852.96,9070.29
1058768528638427904,2020-06,2935.4,7537.84,3516.85,497,-1582.59,7487.7
1058768528638427904,2020-07,2131.4,4425.33,1267.23,956.61,-1983.31,5504.39
1058768528638427904,2020-08,7041.73,2673.59,3207.93,0,7576.07,13080.46
1058768528638427904,2020-09,4061.79,4441.44,6974.65,4138.64,2456.36,15536.82
1058768528638427904,2020-10,6301.15,5601.35,2008.82,2401.02,307.6,15844.42
1058768528638427904,2020-11,1036.88,4171.66,5557.81,3420.78,-997.75,14846.67
1058768528638427904,2020-12,6100.7,4503.31,0,4147.88,-2550.49,12296.18
1058841458592980352,2020-01,3362.81,0,0,548.85,2813.96,2813.96
1058841458592980352,2020-02,785.1,1786.42,0,1295.28,-2296.6,517.36
1058841458592980352,2020-03,2492.4,1882.62,768.97,1718.81,-340.06,177.3
1058841458592980352,2020-05,0,3318.95,54.85,0,-3264.1,-3086.8
1058841458592980352,2020-06,0,1197.76,0,120.9,-1318.66,-4405.46
1058841458592980352,2020-07,1759.11,1122.8,2012.37,752.6,1896.08,-2509.38
1058841458592980352,2020-08,449.85,1277.56,0,18.09,-845.8,-3355.18
1058841458592980352,2020-09,0,1734.39,383.22,3174.81,-4525.98,-7881.16
1058841458592980352,2020-10,97.95,0,1561.43,3969.66,-2310.28,-10191.44
1058841458592980352,2020-11,684.71,1343.29,1645.46,0,986.88,-9204.56
1059751551406962560,2020-01,4585.16,1295.83,942.42,3638.1,593.65,593.65
1059751551406962560,2020-02,2250.89,1774.87,7977.06,286.09,8166.99,8760.64
1059751551406962560,2020-03,1222.13,0,0,2946.49,-1724.36,7036.28
1059751551406962560,2020-04,1733.85,3500.41,5192.11,0,3425.55,10461.83
1059751551406962560,2020-05,0,5864.68,3182.79,1148.56,-3830.45,6631.38
1059751551406962560,2020-06,3591.05,1155.17,209.24,1715.21,929.91,7561.29
1059751551406962560,2020-07,2747.34,1317.61,2439.79,3401.69,467.83,8029.12
1059751551406962560,2020-08,1550.79,2653.99,972.58,5263.9,-5394.52,2634.6
1059751551406962560,2020-09,1705.68,0,5387.83,236.8,6856.71,9491.31
1059751551406962560,2020-10,2802.45,2869.03,880.66,1229.11,-415.03,9076.28
1059751551406962560,2020-11,5352.35,5393.9,0,4227.03,-4268.58,4807.7
1059751551406962560,2020-12,3171.32,1607.7,2774.36,830.37,3507.61,8315.31
1061424623487906048,2020-01,0,1154.92,142.19,1344.01,-2356.74,-2356.74
1061424623487906048,2020-02,742.14,1167.81,3069.64,3300.46,-656.49,-3013.23
1061424623487906048,2020-03,1584.19,96.86,964.46,0,2451.79,-561.44
1061424623487906048,2020-04,301.4,1301.26,1050.75,0,50.89,-510.55
1061424623487906048,2020-06,0,2119.98,803.83,1946.2,-3262.35,-3772.9
1061424623487906048,2020-07,244.83,0,0,1350.25,-1105.42,-4878.32
1061424623487906048,2020-08,1751.78,0,327.61,277.9,1801.49,-3076.83
1061424623487906048,2020-09,0,3877.98,1697.94,1490.7,-3670.74,-6747.57
1061424623487906048,2020-10,1733.81,1651.42,0,0,82.39,-6665.18
1061424623487906048,2020-11,1165.34,0,1640.66,383.61,2422.39,-4242.79
1061424623487906048,2020-12,1710.27,1862.83,0,0,-152.56,-4395.35
1061616519000785792,2020-01,1081.54,6726.72,27.24,3179.89,-8797.83,-8797.83
1061616519000785792,2020-02,4066.07,1255.36,2570.28,6438.66,-1057.67,-9855.5
1061616519000785792,2020-03,0,4618.71,0,426.48,-5045.19,-14900.69
1061616519000785792,2020-04,0,2104.15,2714.07,5050.97,-4441.05,-19341.74
1061616519000785792,2020-05,1700.65,710.54,0,3716.29,-2726.18,-22067.92
1061616519000785792,2020-06,0,716.38,616.82,1330.34,-1429.9,-23497.82
1061616519000785792,2020-07,1404.11,0,0,1826.72,-422.61,-23920.43
1061616519000785792,2020-08,1949.29,0,1988.71,0,3938,-19982.43
1061616519000785792,2020-09,3099.38,5065.2,550.72,3115.49,-4530.59,-24513.02
1061616519000785792,2020-10,4953.52,4471.03,5273.46,498.21,5257.74,-19255.28
1061616519000785792,2020-11,3013.8,4045.89,2009.89,1686.75,-708.95,-19964.23
1061616519000785792,2020-12,238.86,866.9,3424.76,4683.76,-1887.04,-21851.27
1061715139067239936,2020-01,2607.66,3497.37,1222.91,2642.62,-2309.42,-2309.42
1061715139067239936,2020-02,3095.51,699.95,1523.92,3950.22,-30.74,-2340.16
1061715139067239936,2020-03,2794.64,4793.72,1340.53,1510.33,-2168.88,-4509.04
1061715139067239936,2020-04,3828.04,5705.6,448.35,2557.63,-3986.84,-8495.88
1061715139067239936,2020-05,803.97,3600,925.91,3563.97,-5434.09,-13929.97
1061715139067239936,2020-06,3590.19,2959.81,0,2972.09,-2341.71,-16271.68
1061715139067239936,2020-07,2549.48,859.68,2482.49,2757.4,1414.89,-14856.79
1061715139067239936,2020-08,2273.23,2005.94,969.64,4201.1,-2964.17,-17820.96
1061715139067239936,2020-09,4846.14,3314.62,4290.04,1116.1,4705.46,-13115.5
1061715139067239936,2020-10,2965.89,2642.39,1519.32,4859.11,-3016.29,-16131.79
1061715139067239936,2020-11,860.9,522.61,6133.6,5753.99,717.9,-15413.89
1061715139067239936,2020-12,3501.9,2884.12,1936.29,878.68,1675.39,-13738.5
1062775455097222144,2020-01,3521.29,5629.99,1057.8,7399.22,-8450.12,-8450.12
1062775455097222144,2020-02,8350.01,3959.51,4847.14,6937.02,2300.62,-6149.5
1062775455097222144,2020-03,1031.44,2067.72,4999.25,1155.13,2807.84,-3341.66
1062775455097222144,2020-04,1252.25,5435.19,7793.71,1854.01,1756.76,-1584.9
1062775455097222144,2020-05,2828.68,8512.82,4197.19,8254.04,-9740.99,-11325.89
1062775455097222144,2020-06,1739.64,4643.59,2896.48,5062.71,-5070.18,-16396.07
1062775455097222144,2020-07,3590.59,813.88,1014.07,2545.37,1245.41,-15150.66
1062775455097222144,2020-08,6877,434.38,5406.31,3182.88,8666.05,-6484.61
1062775455097222144,2020-09,1662.92,8457.59,2667.47,3935.02,-8062.22,-14546.83
1062775455097222144,2020-10,4105.09,8093.82,5010.91,6927.62,-5905.44,-20452.27
1062775455097222144,2020-11,8042.6,2563.57,4513.28,5447.18,4545.13,-15907.14
1062775455097222144,2020-12,1969.97,4367.25,0,3275.36,-5672.64,-21579.78
1062923926654286976,2020-01,4216.69,3291.58,157.57,1838.62,-755.94,-755.94
1062923926654286976,2020-02,3613.18,0,0,2012.6,1600.58,844.64
1062923926654286976,2020-03,0,1943.94,6077.91,5134.71,-1000.74,-156.1
1062923926654286976,2020-04,5711.99,5134.03,293.72,1317.42,-445.74,-601.84
1062923926654286976,2020-05,0,1680.42,1480.72,4860.2,-5059.9,-5661.74
1062923926654286976,2020-06,7016.02,821.33,2992.01,2577.76,6608.94,947.2
1062923926654286976,2020-07,3368.06,3620.4,1738.95,1683.35,-196.74,750.46
1062923926654286976,2020-08,884.97,1068.12,533.73,2025.97,-1675.39,-924.93
1062923926654286976,2020-09,615.19,2299.25,641.42,3398.34,-4440.98,-5365.91
1062923926654286976,2020-10,1919.17,801.83,1012.71,987.34,1142.71,-4223.2
1062923926654286976,2020-11,4292.75,1160.83,3998.54,3102.36,4028.1,-195.1
1062923926654286976,2020-12,4325.48,1587.27,0,918.65,1819.56,1624.46
1063879325979690624,2020-02,1612.19,0,0,0,1612.19,1612.19
1063879325979690624,2020-07,311.55,378.13,0,0,-66.58,1545.61
1063879325979690624,2020-08,1022.61,0,0,0,1022.61,2568.22
1065081690375671936,2020-01,4674.04,8990.61,5090.52,10739.33,-9965.38,-9965.38
1065081690375671936,2020-02,4156.46,2249.16,3870.57,2897.94,2879.93,-7085.45
1065081690375671936,2020-03,3450.42,5361.57,2078.05,8355.75,-8188.85,-15274.3
1065081690375671936,2020-04,3114.33,2617.26,2837.68,9131.79,-5797.04,-21071.34
1065081690375671936,2020-05,7943.09,6721.65,10673.54,1671.37,10223.61,-10847.73
1065081690375671936,2020-06,2989.86,5424,778.85,4118.41,-5773.7,-16621.43
1065081690375671936,2020-07,2579.89,5348.52,2367.59,10389.85,-10790.89,-27412.32
1065081690375671936,2020-08,7690.23,3365.37,2392.4,4824.06,1893.2,-25519.12
1065081690375671936,2020-09,2724.45,286.6,5176.26,1004.83,6609.28,-18909.84
1065081690375671936,2020-10,2765.22,3882.89,6745.14,3199.7,2427.77,-16482.07
1065081690375671936,2020-11,2009.93,10187.13,4344.97,4149.71,-7981.94,-24464.01
1065081690375671936,2020-12,1689.35,8824.71,4515.51,2165.81,-4785.66,-29249.67
1065646671525179136,2020-01,0,1675.1,1695.5,1303.18,-1282.78,-1282.78
1065646671525179136,2020-02,1141.28,2433.87,0,1387,-2679.59,-3962.37
1065646671525179136,2020-03,2347.45,1243.67,1339.02,2626.96,-184.16,-4146.53
1065646671525179136,2020-04,2350.71,1875.88,1037.54,135.33,1377.04,-2769.49
1065646671525179136,2020-05,1863.19,0,0,1382.31,480.88,-2288.61
1065646671525179136,2020-06,831.65,2074.85,971.88,3042.51,-3313.83,-5602.44
1065646671525179136,2020-07,0,1519.37,2296.88,801.79,-24.28,-5626.72
1065646671525179136,2020-08,6096.13,1972.21,0,2630.02,1493.9,-4132.82
1065646671525179136,2020-09,5194.84,1061.69,7518.21,1697.58,9953.78,5820.96
1065646671525179136,2020-10,2183.5,1014.18,974.82,2304.69,-160.55,5660.41
1065646671525179136,2020-11,0,3415.51,2558.8,2548.73,-3405.44,2254.97
1065646671525179136,2020-12,1546.81,0,3669.92,1348.27,3868.46,6123.43
1065732023454816512,2020-01,1182.76,1530.92,1706.48,799.72,558.6,558.6
1065732023454816512,2020-02,5987.66,734.67,3378.29,4245.92,4385.36,4943.96
1065732023454816512,2020-03,3058.37,1663.8,1375.21,722.58,2047.2,6991.16
1065732023454816512,2020-04,3568.66,1554.68,0,70.33,1943.65,8934.81
1065732023454816512,2020-05,2576.22,5349.7,1885.44,233.42,-1121.46,7813.35
1065732023454816512,2020-06,3910.12,5031.21,1516.99,2613.78,-2217.88,5595.47
1065732023454816512,2020-07,3020.98,0,0,3762.48,-741.5,4853.97
1065732023454816512,2020-08,0,658.93,0,0,-658.93,4195.04
1065732023454816512,2020-09,3515.95,3935.11,2889.95,1057.5,1413.29,5608.33
1065732023454816512,2020-10,4521.2,0,3221.76,3055.69,4687.27,10295.6
1065732023454816512,2020-11,3658.1,4289.13,2389.71,0,1758.68,12054.28
1065732023454816512,2020-12,2870.02,5552.57,2048.37,3378.47,-4012.65,8041.63
1066510723390785536,2020-01,0,33.91,0,0,-33.91,-33.91
1066510723390785536,2020-02,2210.12,0,0,0,2210.12,2176.21
1066510723390785536,2020-06,0,1999.69,0,0,-1999.69,176.52
1066510723390785536,2020-08,1354.36,435.22,0,0,919.14,1095.66
1066510723390785536,2020-11,1731.85,0,0,0,1731.85,2827.51
1066510723390785536,2020-12,0,1686.17,1145.03,0,-541.14,2286.37
1067346043103692544,2020-01,1806.3,5568.31,3405.5,5689.22,-6045.73,-6045.73
1067346043103692544,2020-02,3857.39,7907.32,3365,5950.4,-6635.33,-12681.06
1067346043103692544,2020-03,1863.26,5185.91,92.3,5016.2,-8246.55,-20927.61
1067346043103692544,2020-04,2029.66,5739.03,4450.07,14617.17,-13876.47,-34804.08
1067346043103692544,2020-05,8447.54,3466.9,7198.75,2336.15,9843.24,-24960.84
1067346043103692544,2020-06,6322.47,2195.97,5505,4906.65,4724.85,-20235.99
1067346043103692544,2020-07,9110.73,5073.84,3727.28,4470.66,3293.51,-16942.48
1067346043103692544,2020-08,4519.78,1083.67,4299.29,5912.3,1823.1,-15119.38
1067346043103692544,2020-09,989.13,9546.87,2904.14,3303.72,-8957.32,-24076.7
1067346043103692544,2020-10,2114.22,2000.26,4461.64,3264.16,1311.44,-22765.26
1067346043103692544,2020-11,2386.61,10111.88,3370.54,6775.45,-11130.18,-33895.44
1067346043103692544,2020-12,8027.53,3484.67,462.42,5621.12,-615.84,-34511.28
1067525834984586752,2020-01,1393.28,2713.76,68.82,1115.59,-2367.25,-2367.25
1067525834984586752,2020-02,1685.34,1002.49,2326.98,0,3009.83,642.58
1067525834984586752,2020-03,2328.51,3293.91,1146.2,1771.26,-1590.46,-947.88
1067525834984586752,2020-04,1616.49,0,0,4856.93,-3240.44,-4188.32
1067525834984586752,2020-05,2196.58,2171.96,2575.56,3062.74,-462.56,-4650.88
1067525834984586752,2020-06,575.04,4897.3,18.82,561.23,-4864.67,-9515.55
1067525834984586752,2020-07,0,2100.06,0,883.25,-2983.31,-12498.86
1067525834984586752,2020-08,899.4,0,970.15,932.15,937.4,-11561.46
1067525834984586752,2020-09,0,3202.94,1583.7,1586.05,-3205.29,-14766.75
1067525834984586752,2020-10,4831.36,0,7243.6,738.11,11336.85,-3429.9
1067525834984586752,2020-12,1576.1,2040.7,3085.85,1388.65,1232.6,-2197.3
1067792234832692224,2020-01,7822.1,4785.29,2049.56,2048.65,3037.72,3037.72
1067792234832692224,2020-02,3297.3,2645.98,1659.27,423.58,1887.01,4924.73
1067792234832692224,2020-03,5959.19,0,5240.92,3942.74,7257.37,12182.1
1067792234832692224,2020-04,2318.17,1038.02,2440.26,4406.04,-685.63,11496.47
1067792234832692224,2020-05,3655.75,1366.1,3660.51,3360.55,2589.61,14086.08
1067792234832692224,2020-06,740.55,3216.03,1899.17,3693.24,-4269.55,9816.53
1067792234832692224,2020-07,0,2946.36,1449.53,4894.05,-6390.88,3425.65
1067792234832692224,2020-08,2898.52,3990.63,4791.22,3298.82,400.29,3825.94
1067792234832692224,2020-09,2538.15,5133.13,3406.14,1682.89,-871.73,2954.21
1067792234832692224,2020-10,2147.15,2138.07,4790.71,4474.39,325.4,3279.61
1067792234832692224,2020-11,3073.04,414.07,2266.07,3259.01,1666.03,4945.64
1067792234832692224,2020-12,4843.17,2765.13,3091.71,7694.23,-2524.48,2421.16
1070040381294951168,2020-01,314.83,5135.67,1021.06,4753.69,-8553.47,-8553.47
1070040381294951168,2020-02,5546.8,6722.84,79.66,3208.73,-4305.11,-12858.58
1070040381294951168,2020-03,4179.16,2833.49,4676.02,224.54,5797.15,-7061.43
1070040381294951168,2020-04,4732.88,3764.54,3546.72,2295.49,2219.57,-4841.86
1070040381294951168,2020-05,2310.89,2331.81,5194.3,3733.17,1440.21,-3401.65
1070040381294951168,2020-06,1489.34,1581.12,5403.8,2562.95,2749.07,-652.58
1070040381294951168,2020-07,3928.77,1920.34,0,2858.92,-850.49,-1503.07
1070040381294951168,2020-08,2859.96,7171.23,7444.69,5633.55,-2500.13,-4003.2
1070040381294951168,2020-09,3224.58,831.47,3016.82,1467.45,3942.48,-60.72
1070040381294951168,2020-10,232.4,5558.09,3600.25,3519.6,-5245.04,-5305.76
1070040381294951168,2020-11,4424.47,4845.91,4944.56,560.34,3962.78,-1342.98
1070040381294951168,2020-12,1858.77,2820.09,6220.03,894.75,4363.96,3020.98
1070618232719895296,2020-01,5125.69,3780.96,5645.31,2895.89,4094.15,4094.15
1070618232719895296,2020-02,4546.31,4728.58,1825.81,4631.4,-2987.86,1106.29
1070618232719895296,2020-03,2499.67,4739.85,5566.44,4479.02,-1152.76,-46.47
1070618232719895296,2020-04,1954.44,1200.36,5393.99,1399.86,4748.21,4701.74
1070618232719895296,2020-05,4213.67,7584.54,7520.03,5867.78,-1718.62,2983.12
1070618232719895296,2020-06,5920.39,2797.27,4062.41,2597.22,4588.31,7571.43
1070618232719895296,2020-07,6577.64,8200.71,4201.68,2391.94,186.67,7758.1
1070618232719895296,2020-08,543.17,2974.09,1805.43,4609.78,-5235.27,2522.83
1070618232719895296,2020-09,9747.35,4191.86,6417.45,7662.17,4310.77,6833.6
1070618232719895296,2020-10,3781.58,4139.5,1773.27,4705.54,-3290.19,3543.41
1070618232719895296,2020-11,7932.37,6456.09,8899.69,3916.81,6459.16,10002.57
1070618232719895296,2020-12,4093.44,3464.18,8071.48,2304.91,6395.83,16398.4
1071190047814581888,2020-01,1037.95,5340.15,8609.57,3791.44,515.93,515.93
1071190047814581888,2020-02,3764.31,3149.22,2364.56,2701.09,278.56,794.49
1071190047814581888,2020-03,6278.97,4879.57,4067.72,4156.27,1310.85,2105.34
1071190047814581888,2020-04,2830.05,5131.97,4107.38,649.61,1155.85,3261.19
1071190047814581888,2020-05,5875.82,7337.35,4021.73,3305.68,-745.48,2515.71
1071190047814581888,2020-06,4983.37,2991.48,2773.69,6278.8,-1513.22,1002.49
1071190047814581888,2020-07,1647.52,5908.65,5310.8,3887.72,-2838.05,-1835.56
1071190047814581888,2020-08,4567.99,2146.94,3050.81,9320.11,-3848.25,-5683.81
1071190047814581888,2020-09,4072.57,894.93,4259.05,7182.75,253.94,-5429.87
1071190047814581888,2020-10,1494.96,5853.32,4757.02,3279.09,-2880.43,-8310.3
1071190047814581888,2020-11,4916.1,3042.91,4754.52,1896.85,4730.86,-3579.44
1071190047814581888,2020-12,6442.45,2938.26,2907.74,6782.12,-370.19,-3949.63
1072844687916210176,2020-01,1515.21,8191.96,4383.66,1452.04,-3745.13,-3745.13
1072844687916210176,2020-02,5627.24,10501.27,6483.82,7333.12,-5723.33,-9468.46
1072844687916210176,2020-03,3828.09,5302.75,1742.06,2902.31,-2634.91,-12103.37
1072844687916210176,2020-04,1850.73,6045.02,9500.43,4107.82,1198.32,-10905.05
1072844687916210176,2020-05,3710.1,1229.51,6775.97,7881.83,1374.73,-9530.32
1072844687916210176,2020-06,4716.76,2717.12,8550.37,1075.32,9474.69,-55.63
1072844687916210176,2020-07,3554.96,4971.22,0,2945.76,-4362.02,-4417.65
1072844687916210176,2020-08,3892.5,5599.78,3541.4,7791.57,-5957.45,-10375.1
1072844687916210176,2020-09,9851.39,1552.2,8178.28,1395.47,15082,4706.9
1072844687916210176,2020-10,6837,3823.4,1877.88,2971.83,1919.65,6626.55
1072844687916210176,2020-11,5811.13,862.39,3643.17,5008.85,3583.06,10209.61
1072844687916210176,2020-12,1199.82,5738.35,1853.22,3432.76,-6118.07,4091.54
1073632179797759360,2020-01,1134.19,1094.3,1750.39,1093.11,697.17,697.17
1073632179797759360,2020-02,2514.52,1956.92,0,2737.36,-2179.76,-1482.59
1073632179797759360,2020-03,1270.97,0,4675.12,988.56,4957.53,3474.94
1073632179797759360,2020-04,0,1821.33,3282.29,2543.51,-1082.55,2392.39
1073632179797759360,2020-05,5620.65,1378.78,2341.92,1738.59,4845.2,7237.59
1073632179797759360,2020-06,2577.85,1898.56,0,3385.7,-2706.41,4531.18
1073632179797759360,2020-07,2246.33,0,1509.3,0,3755.63,8286.81
1073632179797759360,2020-08,839.78,0,0,1804.57,-964.79,7322.02
1073632179797759360,2020-09,2498.77,0,188.78,0,2687.55,10009.57
1073632179797759360,2020-10,1128.77,792.45,1994.36,1024.53,1306.15,11315.72
1073632179797759360,2020-11,237.69,390.61,4366.65,3387.31,826.42,12142.14
1073632179797759360,2020-12,654.22,3096.67,0,181.14,-2623.59,9518.55
1073777425524927488,2020-02,2877.92,239.92,861.52,1979.45,1520.07,1520.07
1073777425524927488,2020-05,3513.3,3701.85,3450.06,1986.78,1274.73,2794.8
1073777425524927488,2020-06,1677.48,1328.05,0,921.72,-572.29,2222.51
1073777425524927488,2020-07,1413.42,1723.7,5027.19,4912.15,-195.24,2027.27
1073777425524927488,2020-08,935.24,3117.44,5479.05,1501.5,1795.35,3822.62
1073777425524927488,2020-09,2779.67,394.84,0,3479.86,-1095.03,2727.59
1073777425524927488,2020-10,1078.07,892.83,0,880.12,-694.88,2032.71
1073777425524927488,2020-11,627.4,2664.55,2729.86,3974.63,-3281.92,-1249.21
1073777425524927488,2020-12,990.03,3703.36,0,3279.56,-5992.89,-7242.1
1073825546651203712,2020-01,10210.12,4866.6,3646.27,3587.09,5402.7,5402.7
1073825546651203712,2020-02,8976.01,3216.47,1243.42,3241.89,3761.07,9163.77
1073825546651203712,2020-03,6759.96,5371.48,2844.88,2246.68,1986.68,11150.45
1073825546651203712,2020-04,2998.76,5339.06,5776.9,5292.68,-1856.08,9294.37
1073825546651203712,2020-05,9081.11,12.66,4995.86,6117.89,7946.42,17240.79
1073825546651203712,2020-06,7457.35,1805.42,3942.89,7501.37,2093.45,19334.24
1073825546651203712,2020-07,1428.42,6229.1,5505.71,3344.38,-2639.35,16694.89
1073825546651203712,2020-08,3621.85,3569.49,2806.87,3650.46,-791.23,15903.66
1073825546651203712,2020-09,1540.49,9129.19,10894.1,19.98,3285.42,19189.08
1073825546651203712,2020-10,3441.31,2934.87,251.9,3719.11,-2960.77,16228.31
1073825546651203712,2020-11,3119.3,4952.15,2693,649.98,210.17,16438.48
1073825546651203712,2020-12,164.76,4146.41,4935.18,6480.79,-5527.26,10911.22
1074192462556587008,2020-01,2080.63,2851.57,2256.38,320.69,1164.75,1164.75
1074192462556587008,2020-02,1811.86,2538.56,5115.53,1767.95,2620.88,3785.63
1074192462556587008,2020-03,2527.85,1479.44,1688.88,1473.32,1263.97,5049.6
1074192462556587008,2020-04,806.06,1865.74,1554.91,274.19,221.04,5270.64
1074192462556587008,2020-05,2944.92,0,1428.12,1476.75,2896.29,8166.93
1074192462556587008,2020-06,3868.45,990.54,654.61,3963.08,-430.56,7736.37
1074192462556587008,2020-07,2459.27,0,0,2860.57,-401.3,7335.07
1074192462556587008,2020-08,0,1568.03,2393.71,1958.54,-1132.86,6202.21
1074192462556587008,2020-09,254.39,1236.47,0,3555.85,-4537.93,1664.28
1074192462556587008,2020-10,1722.78,2063.04,24.54,0,-315.72,1348.56
1074192462556587008,2020-11,1417.73,1235.21,0,1508.82,-1326.3,22.26
1074192462556587008,2020-12,613.75,0,1161.38,5220.61,-3445.48,-3423.22
1075251755458321920,2020-01,2016.31,4663,7775.38,631.36,4497.33,4497.33
1075251755458321920,2020-02,4213.18,2680.93,6661.64,2044.82,6149.07,10646.4
1075251755458321920,2020-03,4986.65,3684.17,5422.76,3370.69,3354.55,14000.95
1075251755458321920,2020-04,5516.89,3542.75,4611.71,5764.98,820.87,14821.82
1075251755458321920,2020-05,4435.46,4323.85,2658.87,2462.11,308.37,15130.19
1075251755458321920,2020-06,2014.76,0,5935.13,5704.52,2245.37,17375.56
1075251755458321920,2020-07,876.19,6746.09,5537.48,4686.79,-5019.21,12356.35
1075251755458321920,2020-08,5881.1,4949.3,2981.47,3582.28,330.99,12687.34
1075251755458321920,2020-09,3127.69,9898.68,5091.03,1568.05,-3248.01,9439.33
1075251755458321920,2020-10,6217.09,2038.26,4587.18,5480.01,3286,12725.33
1075251755458321920,2020-11,4600.04,6872.94,1636.55,8943.89,-9580.24,3145.09
1075251755458321920,2020-12,2149.3,3465.76,4340.07,7851.53,-4827.92,-1682.83
1076802903462334720,2020-01,1678.03,0,2886.12,1168.93,3395.22,3395.22
1076802903462334720,2020-03,1341.63,0,1392.05,1985.48,748.2,4143.42
1076802903462334720,2020-04,537.44,1130.86,0,2093.43,-2686.85,1456.57
1076802903462334720,2020-05,297.05,2307.31,3159.74,0,1149.48,2606.05
1076802903462334720,2020-06,735.28,506.48,682.13,800.36,110.57,2716.62
1076802903462334720,2020-07,2500.08,1704.44,169.08,0,964.72,3681.34
1076802903462334720,2020-08,2608,367.57,134.6,2795.22,-420.19,3261.15
1076802903462334720,2020-09,1117.82,1469.75,2130.49,921,857.56,4118.71
1076802903462334720,2020-10,2042.83,2345.56,681.17,1716.24,-1337.8,2780.91
1076802903462334720,2020-11,0,1657.03,913.16,1348.94,-2092.81,688.1
1076802903462334720,2020-12,794.04,0,1504.44,1454.67,843.81,1531.91
1077451774007418368,2020-01,2131.22,4924.35,1780.33,6451.09,-7463.89,-7463.89
1077451774007418368,2020-02,6224.38,7012.6,5739.59,130.31,4821.06,-2642.83
1077451774007418368,2020-03,7397.19,5645.77,4396.9,2966.82,3181.5,538.67
1077451774007418368,2020-04,10200.06,1834.44,4315.26,797.62,11883.26,12421.93
1077451774007418368,2020-05,4172.25,4455.47,4006.68,2209.92,1513.54,13935.47
1077451774007418368,2020-06,1338.26,4154.57,3508.67,2163.4,-1471.04,12464.43
1077451774007418368,2020-07,3534.84,2342.61,2222.39,3437.53,-22.91,12441.52
1077451774007418368,2020-08,6397.63,1629.83,5433.09,6029.27,4171.62,16613.14
1077451774007418368,2020-09,6284.59,985.96,413.28,5178.06,533.85,17146.99
1077451774007418368,2020-10,3936.2,7238.96,2672.58,0,-630.18,16516.81
1077451774007418368,2020-11,5625.08,1858.31,0,2299.94,1466.83,17983.64
1077451774007418368,2020-12,1325.86,3994.76,1994.69,1401.05,-2075.26,15908.38
1079364718870289664,2020-01,2910.63,1705.68,5670.34,9294.8,-2419.51,-2419.51
1079364718870289664,2020-02,3366.45,2737.99,6702.37,1191.81,6139.02,3719.51
1079364718870289664,2020-03,4279.33,2799.79,5810.75,791.58,6498.71,10218.22
1079364718870289664,2020-04,1102.56,3629.03,3440.04,4949.54,-4035.97,6182.25
1079364718870289664,2020-05,3999.64,5246.04,2857.8,3326.8,-1715.4,4466.85
1079364718870289664,2020-06,1843.19,825.14,6319.23,3610.83,3726.45,8193.3
1079364718870289664,2020-07,2942.72,4376.59,2851.09,3756.26,-2339.04,5854.26
1079364718870289664,2020-08,3153.03,3070.15,4515.31,3078.48,1519.71,7373.97
1079364718870289664,2020-09,4112.72,6731.63,7439.95,0,4821.04,12195.01
1079364718870289664,2020-10,4428.5,3825.81,1437.81,3927.23,-1886.73,10308.28
1079364718870289664,2020-11,5707.48,2583.03,3339.77,3143.59,3320.63,13628.91
1079364718870289664,2020-12,1497.86,3291.8,2900.33,1115.34,-8.95,13619.96
1081086886796655232,2020-01,4504.74,0,2929.69,3692.73,3741.7,3741.7
1081086886796655232,2020-02,4788.09,8275.91,3326.04,1892.15,-2053.93,1687.77
1081086886796655232,2020-03,4039.75,5067.85,5334.73,7694.15,-3387.52,-1699.75
1081086886796655232,2020-04,6267.73,1654.35,1896.37,2714.49,3795.26,2095.51
1081086886796655232,2020-05,8248.56,7567.16,3895.25,0,4576.65,6672.16
1081086886796655232,2020-06,2983.1,3278.41,3569.33,0,3274.02,9946.18
1081086886796655232,2020-07,3779.58,4554.07,3615.73,6797.03,-3955.79,5990.39
1081086886796655232,2020-08,3219.51,8515.01,4714.86,4220.94,-4801.58,1188.81
1081086886796655232,2020-09,7346.43,6869.61,822.62,4878.99,-3579.55,-2390.74
1081086886796655232,2020-10,1689.54,2884.4,4083.52,6740.52,-3851.86,-6242.6
1081086886796655232,2020-11,2050.49,6223.6,4156.66,2848.06,-2864.51,-9107.11
1081086886796655232,2020-12,10083.96,7155.15,3711.56,444.87,6195.5,-2911.61
1081574418266566528,2020-01,3488.2,2476.62,1479.73,210.44,2280.87,2280.87
1081574418266566528,2020-03,2550.19,0,916.28,895.3,2571.17,4852.04
1081574418266566528,2020-04,0,675.92,3944.97,770.66,2498.39,7350.43
1081574418266566528,2020-05,2816.18,496.89,2054.61,0,4373.9,11724.33
1081574418266566528,2020-06,776.09,0,0,547.32,228.77,11953.1
1081574418266566528,2020-07,1299.85,2021.5,0,2782.4,-3504.05,8449.05
1081574418266566528,2020-08,2601.11,0,0,1886.73,714.38,9163.43
1081574418266566528,2020-09,1790.52,0,554.01,1330.65,1013.88,10177.31
1081574418266566528,2020-10,2705.49,0,0,453.83,2251.66,12428.97
1081574418266566528,2020-11,0,3156.52,0,2223.96,-5380.48,7048.49
1081574418266566528,2020-12,418.23,1297.97,0,0,-879.74,6168.75
1081724331020562432,2020-01,2453.82,5539.66,4166.35,752.31,328.2,328.2
1081724331020562432,2020-02,4754.65,6071.27,3155.52,4031.36,-2192.46,-1864.26
1081724331020562432,2020-03,8563.33,7057.03,13067.1,1739.7,12833.7,10969.44
1081724331020562432,2020-04,1846.05,6497.96,3624.7,3481.53,-4508.74,6460.7
1081724331020562432,2020-05,2634.4,650.98,6083.73,5753.54,2313.61,8774.31
1081724331020562432,2020-06,5984.82,0,5399.36,2456.28,8927.9,17702.21
1081724331020562432,2020-07,3549.76,7596.62,1550.74,8423.9,-10920.02,6782.19
1081724331020562432,2020-08,4769.78,6575.2,6823.08,7863.72,-2846.06,3936.13
1081724331020562432,2020-09,4451.23,3634.38,6378.74,4432.67,2762.92,6699.05
1081724331020562432,2020-10,5909.92,2161.37,5867.27,2688.35,6927.47,13626.52
1081724331020562432,2020-11,3580.69,3856.06,7405.17,1649.97,5479.83,19106.35
1081724331020562432,2020-12,5249.47,9611.57,3283.58,2355.93,-3434.45,15671.9
1082987544894355456,2020-01,3905.27,4440.56,4050.95,855.67,2659.99,2659.99
1082987544894355456,2020-02,5436.15,6197.1,279.54,3197.77,-3679.18,-1019.19
1082987544894355456,2020-03,0,1238.09,2006.55,667.55,100.91,-918.28
1082987544894355456,2020-04,5770.71,3157.1,1270.2,3319.75,564.06,-354.22
1082987544894355456,2020-05,1221.79,872.36,4453.39,1053.66,3749.16,3394.94
1082987544894355456,2020-06,5775.12,0,4182.94,8755.62,1202.44,4597.38
1082987544894355456,2020-07,1502.14,3901.18,0,919.14,-3318.18,1279.2
1082987544894355456,2020-08,2052.43,0,3282.75,3138.48,2196.7,3475.9
1082987544894355456,2020-09,5716.33,1351.51,238.59,3273.41,1330,4805.9
1082987544894355456,2020-10,611.7,5574.49,4974.11,10842.39,-10831.07,-6025.17
1082987544894355456,2020-11,318.04,5634.07,3440.82,3506.09,-5381.3,-11406.47
1082987544894355456,2020-12,5239.1,1991.8,2556.19,4833.27,970.22,-10436.25
1083483631653526272,2020-01,8642.18,2774.26,951.31,3146.82,3672.41,3672.41
1083483631653526272,2020-02,2458.06,3742.21,3987.64,2980.65,-277.16,3395.25
1083483631653526272,2020-03,4789.56,3926.8,1962.58,1993.33,832.01,4227.26
1083483631653526272,2020-04,1278.06,2032.57,1275.36,709.27,-188.42,4038.84
1083483631653526272,2020-05,3209.26,5578.77,4874.34,1641.64,863.19,4902.03
1083483631653526272,2020-06,2227.88,1831.62,3029.7,7614.55,-4188.59,713.44
1083483631653526272,2020-07,4142.62,1638.85,5019.15,1541.63,5981.29,6694.73
1083483631653526272,2020-08,7341.1,7891.89,1423.08,5610.01,-4737.72,1957.01
1083483631653526272,2020-09,3454.95,5757.09,3818.92,3166.76,-1649.98,307.03
1083483631653526272,2020-10,7372.39,2409.37,4524,3784.45,5702.57,6009.6
1083483631653526272,2020-11,4823.81,1800.39,4188.89,3199.87,4012.44,10022.04
1083483631653526272,2020-12,1966.05,5107.62,2460.89,5632.52,-6313.2,3708.84
1084434076536674304,2020-01,2538.2,2817.11,2208.35,3193.87,-1264.43,-1264.43
1084434076536674304,2020-02,1410.46,2344.84,3569.85,5545.5,-2910.03,-4174.46
1084434076536674304,2020-03,4209.42,7731.41,4086.91,3016.98,-2452.06,-6626.52
1084434076536674304,2020-04,0,1919.26,1857.06,771.94,-834.14,-7460.66
1084434076536674304,2020-05,3844.42,4251.43,5677.46,3682.29,1588.16,-5872.5
1084434076536674304,2020-06,3076.99,1842.02,1101.31,3280.41,-944.13,-6816.63
1084434076536674304,2020-07,5281.15,2121.85,2478.8,1255.79,4382.31,-2434.32
1084434076536674304,2020-08,5080.89,0,1697.83,628.85,6149.87,3715.55
1084434076536674304,2020-09,326.83,1433.52,3441.74,3530.89,-1195.84,2519.71
1084434076536674304,2020-10,1714.32,4939.24,2128.68,5500.07,-6596.31,-4076.6
1084434076536674304,2020-11,4996.45,1572.55,923.89,1693.25,2654.54,-1422.06
1084434076536674304,2020-12,5683.22,3367.49,1948.29,5230.36,-966.34,-2388.4
1085802228732814976,2020-02,1619.57,0,0,0,1619.57,1619.57
1085802228732814976,2020-04,0,1671.07,0,48.31,-1719.38,-99.81
1086174688068351872,2020-01,2918.51,10328.54,4006.06,7584.38,-10988.35,-10988.35
1086174688068351872,2020-02,1495.8,7258.99,3298.58,7955.1,-10419.71,-21408.06
1086174688068351872,2020-03,8935.31,2757.18,7769.75,3917.11,10030.77,-11377.29
1086174688068351872,2020-04,3660.29,2799.11,4677.62,5295.01,243.79,-11133.5
1086174688068351872,2020-05,7220.38,5384.16,11415.41,4814.09,8437.54,-2695.96
1086174688068351872,2020-06,3699.72,3220.77,11323.61,4539.52,7263.04,4567.08
1086174688068351872,2020-07,2726.52,6981.03,5078.48,5238.04,-4414.07,153.01
1086174688068351872,2020-08,4390.13,2917.26,6839.06,1003.97,7307.96,7460.97
1086174688068351872,2020-09,2424.16,12273.33,1204.83,5976.51,-14620.85,-7159.88
1086174688068351872,2020-10,2611.86,3709.57,3659.91,6934.22,-4372.02,-11531.9
1086174688068351872,2020-11,2181.49,3494.07,2072.78,1083.51,-323.31,-11855.21
1086174688068351872,2020-12,4452.23,3296.2,3977.02,2154,2979.05,-8876.16
1087482730351705344,2020-01,845.87,0,371.63,0,1217.5,1217.5
1087482730351705344,2020-02,0,441.25,942.93,0,501.68,1719.18
1087482730351705344,2020-03,0,1630.55,0,0,-1630.55,88.63
1087482730351705344,2020-08,1942.8,0,0,1559.89,382.91,471.54
1087482730351705344,2020-09,1626.42,0,0,0,1626.42,2097.96
1087482730351705344,2020-10,1466.7,0,0,0,1466.7,3564.66
1087482730351705344,2020-12,0,1368.09,0,1563.92,-2932.01,632.65
1088631586376917248,2020-01,1596.82,0,1840.94,130.49,3307.27,3307.27
1088631586376917248,2020-02,1223.45,506.73,0,1789.26,-1072.54,2234.73
1088631586376917248,2020-03,0,3937.23,0,1611.93,-5549.16,-3314.43
1088631586376917248,2020-04,1047.23,0,0,0,1047.23,-2267.2
1088631586376917248,2020-05,2521.65,826.39,1902.42,2935.69,661.99,-1605.21
1088631586376917248,2020-06,614.99,1060.59,1793.4,1919.24,-571.44,-2176.65
1088631586376917248,2020-07,0,634.24,0,502.65,-1136.89,-3313.54
1088631586376917248,2020-08,2373,1491.17,2616.26,0,3498.09,184.55
1088631586376917248,2020-09,757.03,1224.21,0,1239.46,-1706.64,-1522.09
1088631586376917248,2020-10,0,1665.31,0,139.07,-1804.38,-3326.47
1088631586376917248,2020-11,1531.78,0,1539.62,0,3071.4,-255.07
1088631586376917248,2020-12,604.13,0,0,218.65,385.48,130.41
1088714251385577600,2020-01,3173.38,6970.18,9116.17,11805.99,-6486.62,-6486.62
1088714251385577600,2020-02,5392.87,3482.99,3502.53,4682.6,729.81,-5756.81
1088714251385577600,2020-03,5735.01,9082.85,8831.74,4850.44,633.46,-5123.35
1088714251385577600,2020-04,2474.28,3676.87,7027.04,2870.33,2954.12,-2169.23
1088714251385577600,2020-05,5554.87,2861.28,7773.71,6399.04,4068.26,1899.03
1088714251385577600,2020-06,2131.36,1276.28,10645.75,1581.98,9918.85,11817.88
1088714251385577600,2020-07,364.44,2306.07,4854.83,3295.26,-382.06,11435.82
1088714251385577600,2020-08,1045.82,890.16,6907.44,7460.5,-397.4,11038.42
1088714251385577600,2020-09,6186.14,2887.53,4085.34,5175.56,2208.39,13246.81
1088714251385577600,2020-10,5622.16,4855.44,6007.37,6050.94,723.15,13969.96
1088714251385577600,2020-11,4822.01,10011.31,4575.55,1406.91,-2020.66,11949.3
1088714251385577600,2020-12,6664.73,3988.46,5013.94,8041.32,-351.11,11598.19
1089530782386473600,2020-01,3132.37,4720.57,6345.64,1347.14,3410.3,3410.3
1089530782386473600,2020-02,5614.45,6679.17,2705.74,4352.78,-2711.76,698.54
1089530782386473600,2020-03,2814.47,7478.23,6563.75,1747.06,152.93,851.47
1089530782386473600,2020-04,9295.61,1472.32,2163.1,3279.13,6707.26,7558.73
1089530782386473600,2020-05,3993.22,6343.41,2318.27,3984.43,-4016.35,3542.38
1089530782386473600,2020-06,3201.14,6022.37,3656.34,4384.06,-3548.95,-6.57
1089530782386473600,2020-07,3482.89,10112.62,2467.58,3102.11,-7264.26,-7270.83
1089530782386473600,2020-08,5157.63,3517.22,6791.55,7646.81,785.15,-6485.68
1089530782386473600,2020-09,2069.09,12204.91,9978.51,9041.41,-9198.72,-15684.4
1089530782386473600,2020-10,2323.88,1666.22,3734.75,3309.99,1082.42,-14601.98
1089530782386473600,2020-11,6525.81,3698.07,7028.09,4157.66,5698.17,-8903.81
1089530782386473600,2020-12,2316.8,5533.66,4625.57,2535.21,-1126.5,-10030.31
1089802245487569920,2020-01,2860.21,2334.96,5293.86,5780.56,38.55,38.55
1089802245487569920,2020-02,2216.89,233.23,955.57,1686.55,1252.68,1291.23
1089802245487569920,2020-03,2616.14,0,1495.99,962.28,3149.85,4441.08
1089802245487569920,2020-04,1752.48,0,2594.01,1307.84,3038.65,7479.73
1089802245487569920,2020-05,3693.03,4176.35,1414,2731.87,-1801.19,5678.54
1089802245487569920,2020-06,1135.37,817.24,1603.16,498.32,1422.97,7101.51
1089802245487569920,2020-07,2312.88,818.35,608.4,2815.7,-712.77,6388.74
1089802245487569920,2020-08,1205.59,2473.79,2432.86,810.1,354.56,6743.3
1089802245487569920,2020-10,667.61,3099.96,1615.18,3401.49,-4218.66,2524.64
1089802245487569920,2020-11,745.64,1719.07,0,0,-973.43,1551.21
1089802245487569920,2020-12,754.65,6718.28,1551.1,1483.87,-5896.4,-4345.19
1090208725349014272,2020-01,2303.02,0,1462.74,0,3765.76,3765.76
1090208725349014272,2020-02,1811.39,807.74,0,4240.4,-3236.75,529.01
1090208725349014272,2020-03,3702.59,1871.29,1062.95,1618.29,1275.96,1804.97
1090208725349014272,2020-04,0,2237.69,0,1605.12,-3842.81,-2037.84
1090208725349014272,2020-06,960.46,0,0,2726.67,-1766.21,-3804.05
1090208725349014272,2020-07,3335.11,1325.39,0,1479.15,530.57,-3273.48
1090208725349014272,2020-09,1582.51,2062.72,0,3688.83,-4169.04,-7442.52
1090208725349014272,2020-11,1082.09,867.25,0,0,214.84,-7227.68
1090208725349014272,2020-12,0,2404.98,0,751.15,-3156.13,-10383.81
1090522474792643840,2020-01,3197.26,3656.5,0,0,-459.24,-459.24
1090522474792643840,2020-03,1471.67,0,5050.26,1230.63,5291.3,4832.06
1090522474792643840,2020-04,0,877.16,2007.55,2723.57,-1593.18,3238.88
1090522474792643840,2020-05,3676.06,2228.68,3323.31,279.8,4490.89,7729.77
1090522474792643840,2020-06,1597.83,871.54,0,0,726.29,8456.06
1090522474792643840,2020-07,673.34,1248.35,638.09,1011.17,-948.09,7507.97
1090522474792643840,2020-08,1411.75,0,2244.97,0,3656.72,11164.69
1090522474792643840,2020-09,3978.29,0,2259.54,0,6237.83,17402.52
1090522474792643840,2020-10,3226.22,0,495.37,3274.91,446.68,17849.2
1090522474792643840,2020-11,1094.31,1853.77,206.28,1921.7,-2474.88,15374.32
1090522474792643840,2020-12,152.29,3039.07,1513.65,0,-1373.13,14001.19
1091687752728927616,2020-01,1506.12,0,1376.03,2718.06,164.09,164.09
1091687752728927616,2020-02,262.51,1148.51,1838.3,0,952.3,1116.39
1091687752728927616,2020-03,5691.98,110.53,0,1697.47,3883.98,5000.37
1091687752728927616,2020-05,0,2045.6,0,4024.59,-6070.19,-1069.82
1091687752728927616,2020-06,1099.86,0,128.46,93.63,1134.69,64.87
1091687752728927616,2020-07,0,3284.57,1434.4,376.78,-2226.95,-2162.08
1091687752728927616,2020-08,1155.29,978.74,0,0,176.55,-1985.53
1091687752728927616,2020-09,1365.62,0,0,0,1365.62,-619.91
1091687752728927616,2020-11,0,2782.33,0,643.17,-3425.5,-4045.41
1091687752728927616,2020-12,0,1920.12,891.26,2450.91,-3479.77,-7525.18
1091789009656047360,2020-01,2116.38,3064.01,6110.93,642.17,4521.13,4521.13
1091789009656047360,2020-02,1352.96,2604.89,8350.79,1117.57,5981.29,10502.42
1091789009656047360,2020-03,0,5259.36,5813.86,6578.93,-6024.43,4477.99
1091789009656047360,2020-04,5456.49,1139.59,6218.67,5613.17,4922.4,9400.39
1091789009656047360,2020-05,8747.17,4352.32,3008.11,652.05,6750.91,16151.3
1091789009656047360,2020-06,0,2152.49,3421.28,4153.7,-2884.91,13266.39
1091789009656047360,2020-07,4820.77,3402.96,3814.31,2631,2601.12,15867.51
1091789009656047360,2020-08,0,4909.99,7957.54,1481.52,1566.03,17433.54
1091789009656047360,2020-09,5264.3,6965.44,1711.18,4110.92,-4100.88,13332.66
1091789009656047360,2020-10,3245.21,3625.87,5151.96,4286.8,484.5,13817.16
1091789009656047360,2020-11,3150.16,1023.19,2578.2,3218.78,1486.39,15303.55
1091789009656047360,2020-12,4732.13,1010.01,2991.54,3882.81,2830.85,18134.4
1092243256488380800,2020-01,2780.38,0,992.94,0,3773.32,3773.32
1092243256488380800,2020-02,2542.45,0,726.84,557.99,2711.3,6484.62
1092243256488380800,2020-03,0,3748.43,0,0,-3748.43,2736.19
1092243256488380800,2020-05,5666.65,77.94,213.41,144.8,5657.32,8393.51
1092243256488380800,2020-06,3250.59,0,3015.12,1342.83,4922.88,13316.39
1092243256488380800,2020-07,3194.9,0,1840.45,696.96,4338.39,17654.78
1092243256488380800,2020-08,2011.64,2743.88,0,2816.47,-3548.71,14106.07
1092243256488380800,2020-09,1700.98,0,1994.42,3610.45,84.95,14191.02
1092243256488380800,2020-10,934.22,1614.84,0,0,-680.62,13510.4
1092243256488380800,2020-11,1831.41,1958.51,0,0,-127.1,13383.3
1092243256488380800,2020-12,1646.93,1996.43,3278.15,965.98,1962.67,15345.97
1092591810760307072,2020-01,1308.39,0,0,0,1308.39,1308.39
1092591810760307072,2020-03,3544.44,81.67,0,575.52,2887.25,4195.64
1092591810760307072,2020-04,0,240.65,1286.83,170.28,875.9,5071.54
1092591810760307072,2020-05,958.79,308.71,1745.62,0,2395.7,7467.24
1092591810760307072,2020-07,328.53,0,1380.29,0,1708.82,9176.06
1092591810760307072,2020-08,1477.07,146.48,0,0,1330.59,10506.65
1092591810760307072,2020-09,0,2054.02,0,262.43,-2316.45,8190.2
1092591810760307072,2020-10,0,1291.03,0,0,-1291.03,6899.17
1092591810760307072,2020-11,2043.85,0,0,946.69,1097.16,7996.33
1092591810760307072,2020-12,0,1933.02,1054.09,0,-878.93,7117.4
1093107054789836544,2020-01,3162.22,6939.42,2913.31,5140.94,-6004.83,-6004.83
1093107054789836544,2020-02,3237.9,6105.72,4285.69,2512.6,-1094.73,-7099.56
1093107054789836544,2020-03,3355.04,3601.28,1515.83,2533.49,-1263.9,-8363.46
1093107054789836544,2020-04,2518.98,4596.4,6797.63,0,4720.21,-3643.25
1093107054789836544,2020-05,6772.83,3081.25,2649.81,4280.65,2060.74,-1582.51
1093107054789836544,2020-06,4543.87,1377.27,3246.47,3049.62,3363.45,1780.94
1093107054789836544,2020-07,1414.67,935.09,176.09,1296.94,-641.27,1139.67
1093107054789836544,2020-08,2690.73,4258.28,1575.98,1848.88,-1840.45,-700.78
1093107054789836544,2020-09,5678.42,4710.98,6037.43,1202.85,5802.02,5101.24
1093107054789836544,2020-10,4671.55,1285.47,5350.96,1008.76,7728.28,12829.52
1093107054789836544,2020-11,4948.42,0,5451.68,5708.48,4691.62,17521.14
1093107054789836544,2020-12,1437.47,770.7,4496.9,490.58,4673.09,22194.23
1094109863722785024,2020-01,3100.25,1599.14,5582.59,2707.36,4376.34,4376.34
1094109863722785024,2020-02,2462.01,5002.23,1165.39,1938.37,-3313.2,1063.14
1094109863722785024,2020-03,7057.14,6273.02,9.98,4988.22,-4194.12,-3130.98
1094109863722785024,2020-04,6050.94,1798.48,3.67,3017.86,1238.27,-1892.71
1094109863722785024,2020-05,1033.11,4064.17,4013.97,2648.51,-1665.6,-3558.31
1094109863722785024,2020-06,1300.86,2370.45,3295.33,4033.82,-1808.08,-5366.39
1094109863722785024,2020-07,2602.22,3741.83,3622.98,2027.51,455.86,-4910.53
1094109863722785024,2020-08,2095.36,5887.78,4502.49,2646.8,-1936.73,-6847.26
1094109863722785024,2020-09,2391.04,1385.93,2737.96,2892.94,850.13,-5997.13
1094109863722785024,2020-10,0,2553.87,985.46,4726.15,-6294.56,-12291.69
1094109863722785024,2020-11,1413.47,4845.03,2291.76,2734.51,-3874.31,-16166
1094109863722785024,2020-12,1583.93,3110.76,0,5670.13,-7196.96,-23362.96
1094240641346387840,2020-01,1711.94,4069.01,2775.01,921.57,-503.63,-503.63
1094240641346387840,2020-02,6420.02,1543.14,5062.98,0,9939.86,9436.23
1094240641346387840,2020-03,1588.74,1679.44,2000.6,8618.16,-6708.26,2727.97
1094240641346387840,2020-04,1386.31,3157.96,672.06,3115.75,-4215.34,-1487.37
1094240641346387840,2020-05,3213.69,73.06,5969.56,1179.17,7931.02,6443.65
1094240641346387840,2020-06,1798.25,4998.8,2671.88,422.67,-951.34,5492.31
1094240641346387840,2020-07,674.56,400.65,6923.6,2441.46,4756.05,10248.36
1094240641346387840,2020-08,4261.96,2020.32,3168.92,5539.08,-128.52,10119.84
1094240641346387840,2020-09,3837.08,1229.11,4063.48,2605.77,4065.68,14185.52
1094240641346387840,2020-10,3157.43,3567.77,4519.31,2228.77,1880.2,16065.72
1094240641346387840,2020-11,1487.1,6273.03,4757.58,3710.87,-3739.22,12326.5
1094240641346387840,2020-12,5578.58,3768.74,3568.94,3366.93,2011.85,14338.35
1096912279655546368,2020-01,0,731.75,0,1649.26,-2381.01,-2381.01
1096912279655546368,2020-02,671.87,1761.2,0,732.8,-1822.13,-4203.14
1096912279655546368,2020-03,267.08,0,596.75,1560.47,-696.64,-4899.78
1096912279655546368,2020-04,1501.3,1076.84,0,94.21,330.25,-4569.53
1096912279655546368,2020-05,1875.05,1198.29,3072.01,1957.57,1791.2,-2778.33
1096912279655546368,2020-06,1344.28,2980.34,1374.17,0,-261.89,-3040.22
1096912279655546368,2020-07,3536.9,0,1966.65,0,5503.55,2463.33
1096912279655546368,2020-08,1617.31,2302.66,2255.74,651.62,918.77,3382.1
1096912279655546368,2020-09,2330.85,0,407.88,522.06,2216.67,5598.77
1096912279655546368,2020-10,1982.62,0,0,0,1982.62,7581.39
1096912279655546368,2020-11,2583.86,1485.14,0,1135.58,-36.86,7544.53
1096912279655546368,2020-12,0,1637.91,4342.59,1079.55,1625.13,9169.66
1098414831690795520,2020-01,3925.03,7203.77,7767.34,3494.42,994.18,994.18
1098414831690795520,2020-02,4407.22,2216.56,6315.51,616.1,7890.07,8884.25
1098414831690795520,2020-03,3047.78,2468.92,5845.67,5929.52,495.01,9379.26
1098414831690795520,2020-04,2291.3,5298.7,4624.93,4838.35,-3220.82,6158.44
1098414831690795520,2020-05,980.74,8847.56,5754.11,5030.57,-7143.28,-984.84
1098414831690795520,2020-06,1123.23,4537.61,8984.17,7539.74,-1969.95,-2954.79
1098414831690795520,2020-07,1791.98,6986.79,2734.05,1804,-4264.76,-7219.55
1098414831690795520,2020-08,3351.54,3733.4,4592.7,4246.16,-35.32,-7254.87
1098414831690795520,2020-09,8822.51,6407.53,6272.98,6886.76,1801.2,-5453.67
1098414831690795520,2020-10,3637.91,150.43,12252.9,5039.58,10700.8,5247.13
1098414831690795520,2020-11,986.14,6643.72,3716.49,4525.58,-6466.67,-1219.54
1098414831690795520,2020-12,3700.14,1687.57,4849.94,2211.68,4650.83,3431.29
1100752009668955776,2020-01,6060.79,2050.96,1673.83,2275.2,3408.46,3408.46
1100752009668955776,2020-02,2686.36,2543.73,798.48,1041.74,-100.63,3307.83
1100752009668955776,2020-03,4011.11,1050.12,4935.91,5343.59,2553.31,5861.14
1100752009668955776,2020-04,3092.48,2801.7,3789.78,0,4080.56,9941.7
1100752009668955776,2020-05,1364.99,6953.3,1875.69,6325.82,-10038.44,-96.74
1100752009668955776,2020-06,0,1915.5,0,2222.54,-4138.04,-4234.78
1100752009668955776,2020-07,5038.34,1375.25,3834.44,1676.22,5821.31,1586.53
1100752009668955776,2020-08,2087.18,1605.35,4305.1,297.07,4489.86,6076.39
1100752009668955776,2020-09,1804.44,2654.94,0,1374.51,-2225.01,3851.38
1100752009668955776,2020-10,4485.28,0,3531.97,3071.04,4946.21,8797.59
1100752009668955776,2020-11,2099.18,1957.38,1902.29,1642.84,401.25,9198.84
1100752009668955776,2020-12,1199.12,4578.4,0,1568.54,-4947.82,4251.02
1101868804944365568,2020-04,0,1205.6,0,0,-1205.6,-1205.6
1101868804944365568,2020-05,1426.16,0,0,0,1426.16,220.56
1101868804944365568,2020-08,826.78,0,2895.22,0,3722,3942.56
1101868804944365568,2020-09,0,1452.04,0,801.82,-2253.86,1688.7
1104663173579246848,2020-01,939.86,472.04,4368.25,4434.3,401.77,401.77
1104663173579246848,2020-02,560.9,3505.9,3970.98,2597.86,-1571.88,-1170.11
1104663173579246848,2020-03,2342.62,3042.98,5426.76,5823.13,-1096.73,-2266.84
1104663173579246848,2020-04,3893.5,7790.59,5338.07,4332.37,-2891.39,-5158.23
1104663173579246848,2020-05,1141.14,2328.19,7796.66,3827.51,2782.1,-2376.13
1104663173579246848,2020-06,8518.81,740.74,2905.56,6000.08,4683.55,2307.42
1104663173579246848,2020-07,3756.89,3233.15,7905.08,5248.45,3180.37,5487.79
1104663173579246848,2020-08,5565.38,7643.48,6243.12,7559.82,-3394.8,2092.99
1104663173579246848,2020-09,2139.43,2376.18,5320.54,7462.14,-2378.35,-285.36
1104663173579246848,2020-10,1276.33,7806.97,7615.39,3185.22,-2100.47,-2385.83
1104663173579246848,2020-11,6487.68,3949.54,2691.15,5051.18,178.11,-2207.72
1104663173579246848,2020-12,4145.97,10871.89,3811.59,2190.25,-5104.58,-7312.3
1105392957885611008,2020-01,3369.06,1640.33,0,7723.76,-5995.03,-5995.03
1105392957885611008,2020-02,4071.18,1838.76,3640.09,904.12,4968.39,-1026.64
1105392957885611008,2020-03,2574.56,1056.62,0,3124.14,-1606.2,-2632.84
1105392957885611008,2020-04,2512.62,3137.33,3745.12,2744.71,375.7,-2257.14
1105392957885611008,2020-05,2893.04,6664.47,2823.36,1587.67,-2535.74,-4792.88
1105392957885611008,2020-06,8146.81,4081.86,6033.01,3448.56,6649.4,1856.52
1105392957885611008,2020-07,662.1,4467.22,6392.61,3760.79,-1173.3,683.22
1105392957885611008,2020-08,403.04,2034.19,38.69,1103.42,-2695.88,-2012.66
1105392957885611008,2020-09,3043.04,4425.94,2971.04,0,1588.14,-424.52
1105392957885611008,2020-10,2351.21,2590.08,1943.92,5083.07,-3378.02,-3802.54
1105392957885611008,2020-11,142.23,1290.7,4750.67,4696.36,-1094.16,-4896.7
1105392957885611008,2020-12,1829.71,8699.49,2537.42,3597.92,-7930.28,-12826.98
1106301898283088768,2020-01,1154.37,3412.3,0,0,-2257.93,-2257.93
1106301898283088768,2020-02,2009.53,0,820.51,0,2830.04,572.11
1106301898283088768,2020-03,883.42,4422.66,6141.52,3824.38,-1222.1,-649.99
1106301898283088768,2020-04,0,1985.99,4425.77,1391.3,1048.48,398.49
1106301898283088768,2020-05,2191.1,3691.56,1345.16,937.15,-1092.45,-693.96
1106301898283088768,2020-06,981.27,471.57,4479.63,3120.18,1869.15,1175.19
1106301898283088768,2020-07,3502.46,5439.79,2215.52,1101.97,-823.78,351.41
1106301898283088768,2020-08,3367.16,3669.45,1923.61,0,1621.32,1972.73
1106301898283088768,2020-09,264.91,2225.38,4506.19,1916.56,629.16,2601.89
1106301898283088768,2020-10,4280.39,1720.37,0,0,2560.02,5161.91
1106301898283088768,2020-11,2601.56,1305.78,4565.95,2597.37,3264.36,8426.27
1106301898283088768,2020-12,4240.68,0,5131.14,486.96,8884.86,17311.13
1106923490654134528,2020-02,0,1996.14,3402.42,0,1406.28,1406.28
1106923490654134528,2020-03,0,1161.99,2962.12,0,1800.13,3206.41
1106923490654134528,2020-05,407.84,442.06,97.01,1180.65,-1117.86,2088.55
1106923490654134528,2020-06,804.65,966.55,7.91,3922.21,-4076.2,-1987.65
1106923490654134528,2020-07,0,655.3,0,248.16,-903.46,-2891.11
1106923490654134528,2020-09,870.11,0,0,1254.83,-384.72,-3275.83
1106923490654134528,2020-10,0,848.9,0,1164.1,-2013,-5288.83
1106923490654134528,2020-11,1056.04,1447.03,1940.91,1280.42,269.5,-5019.33
1106923490654134528,2020-12,1048.29,1698.63,1653.4,1683.58,-680.52,-5699.85
1107243470007172608,2020-01,4022.71,2238.53,2888.62,3825.48,847.32,847.32
1107243470007172608,2020-02,3685,7070.85,1412.21,1135.56,-3109.2,-2261.88
1107243470007172608,2020-03,2985.39,2038.81,2973.16,2995.24,924.5,-1337.38
1107243470007172608,2020-04,5012.47,6436.58,4435.67,7670.04,-4658.48,-5995.86
1107243470007172608,2020-05,4234.59,4386.92,3567.57,0,3415.24,-2580.62
1107243470007172608,2020-06,6322.3,2042.07,2317.42,6758.25,-160.6,-2741.22
1107243470007172608,2020-07,7685.82,3599.46,6938.37,5064.17,5960.56,3219.34
1107243470007172608,2020-08,1438.44,1399.96,7136.43,3585.52,3589.39,6808.73
1107243470007172608,2020-09,5680.74,2419.25,5382.52,3904.29,4739.72,11548.45
1107243470007172608,2020-10,3294.36,3760.9,5899.81,3774.52,1658.75,13207.2
1107243470007172608,2020-11,7907.6,6696.65,2175.7,3546.04,-159.39,13047.81
1107243470007172608,2020-12,1544.78,3096.59,2636.04,1951.16,-866.93,12180.88
1107816695278406400,2020-02,1622.21,0,0,0,1622.21,1622.21
1108879539719279360,2020-01,3396.59,1962.3,3296.85,2279.39,2451.75,2451.75
1108879539719279360,2020-02,2199.08,3677.05,6066.1,1285.56,3302.57,5754.32
1108879539719279360,2020-03,799.77,1497.74,8232.21,3128.7,4405.54,10159.86
1108879539719279360,2020-04,1279.78,1892.47,5112.43,6886.44,-2386.7,7773.16
1108879539719279360,2020-05,8267.3,2320.49,2116.96,4140.12,3923.65,11696.81
1108879539719279360,2020-06,3660.72,1988.64,5128.66,1989.45,4811.29,16508.1
1108879539719279360,2020-07,50.24,4571.96,3326.22,5388.74,-6584.24,9923.86
1108879539719279360,2020-08,1406.79,2207.83,4811,4149.07,-139.11,9784.75
1108879539719279360,2020-09,3080.93,893.86,0,1766.33,420.74,10205.49
1108879539719279360,2020-10,3015.36,0,2881.33,1415.62,4481.07,14686.56
1108879539719279360,2020-11,1119.82,1300.71,752.77,776.37,-204.49,14482.07
1108879539719279360,2020-12,3448.4,267.32,0,5072.14,-1891.06,12591.01
1111170018453085952,2020-02,1587.61,736.29,0,0,851.32,851.32
1111170018453085952,2020-04,1364.38,1604.25,1404.68,840.79,324.02,1175.34
1111170018453085952,2020-05,0,3534.71,0,0,-3534.71,-2359.37
1111170018453085952,2020-06,0,704.08,315.88,0,-388.2,-2747.57
1111170018453085952,2020-09,1464.38,0,0,0,1464.38,-1283.19
1111170018453085952,2020-11,1955,0,783.94,2712.11,26.83,-1256.36
1111170018453085952,2020-12,0,1803.37,0,0,-1803.37,-3059.73
1112219938301351424,2020-01,1759.07,2412.9,1814.63,6813.86,-5653.06,-5653.06
1112219938301351424,2020-02,6164.43,4952.86,2368.66,3930.57,-350.34,-6003.4
1112219938301351424,2020-03,1989.69,7277.15,5346.87,709.09,-649.68,-6653.08
1112219938301351424,2020-04,3177.97,5688.89,1692.82,8291.48,-9109.58,-15762.66
1112219938301351424,2020-05,4840.12,4440.69,27.53,1274.2,-847.24,-16609.9
1112219938301351424,2020-06,6346.48,8819.5,4191.7,2710.36,-991.68,-17601.58
1112219938301351424,2020-07,2286.02,379.26,7973.2,9037.73,842.23,-16759.35
1112219938301351424,2020-08,6528.34,3705.47,1302.27,8635.77,-4510.63,-21269.98
1112219938301351424,2020-09,1891.62,2811.09,12024.58,2778.59,8326.52,-12943.46
1112219938301351424,2020-10,1742.71,3535.93,4644.97,8707.8,-5856.05,-18799.51
1112219938301351424,2020-11,2376.81,1457.92,5419.97,6549.46,-210.6,-19010.11
1112219938301351424,2020-12,4851.03,2680.47,569.54,4236.22,-1496.12,-20506.23
1113070175220745984,2020-01,5023.97,6215.58,5048.54,1941.95,1914.98,1914.98
1113070175220745984,2020-02,2027.99,2978.41,3143.54,3267.62,-1074.5,840.48
1113070175220745984,2020-03,1973.73,818.95,1655.99,1588.86,1221.91,2062.39
1113070175220745984,2020-04,2738.41,207.84,3607.57,0,6138.14,8200.53
1113070175220745984,2020-05,1005.35,3151.21,3603.89,1315.43,142.6,8343.13
1113070175220745984,2020-06,3304.16,2511.3,5037.4,1530.18,4300.08,12643.21
1113070175220745984,2020-07,1622.5,0,3820.76,1959.3,3483.96,16127.17
1113070175220745984,2020-08,1628.11,1068.84,823.69,2674.56,-1291.6,14835.57
1113070175220745984,2020-09,746.52,6918.27,0,5178.81,-11350.56,3485.01
1113070175220745984,2020-10,2414.72,411,3519.39,6631.19,-1108.08,2376.93
1113070175220745984,2020-11,0,1156.72,2521.6,2778.31,-1413.43,963.5
1113070175220745984,2020-12,6198.21,2536.49,1705.51,286.42,5080.81,6044.31
1115214586714816000,2020-01,4935.41,4183.66,1154.94,2926.42,-1019.73,-1019.73
1115214586714816000,2020-02,1852.55,3045.2,5664.78,6185.64,-1713.51,-2733.24
1115214586714816000,2020-03,3972.36,1193.53,595.4,3307.33,66.9,-2666.34
1115214586714816000,2020-04,4852.01,1620.55,5882.95,1893.56,7220.85,4554.51
1115214586714816000,2020-05,1003.62,4210.07,2080.09,2730.36,-3856.72,697.79
1115214586714816000,2020-06,3244.24,1052.19,1415.19,3393.43,213.81,911.6
1115214586714816000,2020-07,2207.16,4959.88,4248.76,1510.25,-14.21,897.39
1115214586714816000,2020-08,4622.1,2911.8,5287.84,2404.58,4593.56,5490.95
1115214586714816000,2020-09,3947.57,1625.39,4743.34,1161.23,5904.29,11395.24
1115214586714816000,2020-10,4113.72,2840.56,6135.13,6387.87,1020.42,12415.66
1115214586714816000,2020-11,3396.5,3600.66,4995.69,4510.54,280.99,12696.65
1115214586714816000,2020-12,3203.57,4386.03,4804.64,3038.56,583.62,13280.27
1118860027953849728,2020-01,195.78,4429.08,1580.65,1847.01,-4499.66,-4499.66
1118860027953849728,2020-02,1352.96,1262.85,1965.92,2097.37,-41.34,-4541
1118860027953849728,2020-03,0,3414.25,1951.14,0,-1463.11,-6004.11
1118860027953849728,2020-04,0,690.72,1430.09,0,739.37,-5264.74
1118860027953849728,2020-05,2836.5,172.8,2295.24,769.97,4188.97,-1075.77
1118860027953849728,2020-06,0,4688.87,1246.42,1867.54,-5309.99,-6385.76
1118860027953849728,2020-07,263.56,1890.02,0,0,-1626.46,-8012.22
1118860027953849728,2020-08,1367.81,0,1570.86,864.41,2074.26,-5937.96
1118860027953849728,2020-09,1224.81,5743.34,259.05,2982.23,-7241.71,-13179.67
1118860027953849728,2020-10,1142.54,0,2648.4,0,3790.94,-9388.73
1118860027953849728,2020-11,0,4776.15,0,0,-4776.15,-14164.88
1118860027953849728,2020-12,1709.68,0,0,0,1709.68,-12455.2
1119030742660839936,2020-04,102.05,0,0,0,102.05,102.05
1119030742660839936,2020-07,1254.94,0,0,0,1254.94,1356.99
1119894604203271424,2020-01,0,296.26,0,0,-296.26,-296.26
1119894604203271424,2020-02,380.73,0,0,0,380.73,84.47
1119894604203271424,2020-08,0,1907.48,0,0,-1907.48,-1823.01
1119894604203271424,2020-11,758.33,0,0,0,758.33,-1064.68
1120376209735889920,2020-02,0,3706.54,659.24,480.1,-3527.4,-3527.4
1120376209735889920,2020-06,0,189.38,0,0,-189.38,-3716.78
1120376209735889920,2020-10,2398.7,0,0,0,2398.7,-1318.08
1120376209735889920,2020-11,208.29,0,1060.86,0,1269.15,-48.93
1120376209735889920,2020-12,2574.3,571.14,1900.83,0,3903.99,3855.06
1120392891982935936,2020-01,2656.96,0,1192.95,0,3849.91,3849.91
1120392891982935936,2020-05,1331.78,0,0,1308.71,23.07,3872.98
1120392891982935936,2020-07,0,1181.56,527.63,0,-653.93,3219.05
1120392891982935936,2020-09,0,1567.76,0,0,-1567.76,1651.29
1120392891982935936,2020-10,0,2893.84,1548.89,0,-1344.95,306.34
1120528120312688768,2020-01,5436.97,6157.38,3151.05,1891.64,539,539
1120528120312688768,2020-02,2345.56,1526.62,4375.09,6332.82,-1138.79,-599.79
1120528120312688768,2020-03,4533.34,884.68,6971.93,3309.15,7311.44,6711.65
1120528120312688768,2020-04,1783.93,4583.67,2440.79,3060,-3418.95,3292.7
1120528120312688768,2020-05,4436.16,3311.73,604.22,6476.51,-4747.86,-1455.16
1120528120312688768,2020-06,2135.63,3234.9,3564.43,3120.95,-655.79,-2110.95
1120528120312688768,2020-07,2235.47,5838.9,3483.73,5448.13,-5567.83,-7678.78
1120528120312688768,2020-08,4277.71,2633.96,1634.9,83.34,3195.31,-4483.47
1120528120312688768,2020-09,4136.09,4742.63,3459.67,3983.62,-1130.49,-5613.96
1120528120312688768,2020-10,21.15,0,5273.37,5583.08,-288.56,-5902.52
1120528120312688768,2020-11,1790.71,4079.1,6886.54,4478.66,119.49,-5783.03
1120528120312688768,2020-12,3082.23,4127.68,2251.51,2245.87,-1039.81,-6822.84
1121044267411074560,2020-03,0,203.12,1825.39,0,1622.27,1622.27
1121044267411074560,2020-04,627.41,0,0,1087.61,-460.2,1162.07
1121044267411074560,2020-09,1837.77,0,0,0,1837.77,2999.84
1121476272623451520,2020-01,376.28,0,2964.35,0,3340.63,3340.63
1121476272623451520,2020-02,0,1749.94,0,0,-1749.94,1590.69
1121476272623451520,2020-03,0,1768.63,715.76,0,-1052.87,537.82
1121476272623451520,2020-04,1967.28,3262.05,1576.91,0,282.14,819.96
1121476272623451520,2020-05,2989.99,442.94,825.84,0,3372.89,4192.85
1121476272623451520,2020-08,0,204.89,3935.8,0,3730.91,7923.76
1121476272623451520,2020-09,688.39,0,0,144.69,543.7,8467.46
1121476272623451520,2020-10,133.04,2069.38,0,0,-1936.34,6531.12
1121476272623451520,2020-12,0,658.23,668.59,653.1,-642.74,5888.38
1121557992960804480,2020-01,4278.43,2468.33,7317.17,1808.64,7318.63,7318.63
1121557992960804480,2020-02,5799.87,1601.2,4011.18,4153.04,4056.81,11375.44
1121557992960804480,2020-03,4388.45,2639.9,6657.83,6390.23,2016.15,13391.59
1121557992960804480,2020-04,3232.94,3562.93,3835.16,3247.87,257.3,13648.89
1121557992960804480,2020-05,6073.99,4222.82,3394.44,5891.2,-645.59,13003.3
1121557992960804480,2020-06,9267.04,2597.9,5621.1,3230.5,9059.74,22063.04
1121557992960804480,2020-07,1329.3,4617.47,2655.73,2221.26,-2853.7,19209.34
1121557992960804480,2020-08,1918.32,6843.28,6163.89,4691.2,-3452.27,15757.07
1121557992960804480,2020-09,6099.72,2744.9,2565.91,4863.93,1056.8,16813.87
1121557992960804480,2020-10,4593.41,7964.07,1667.93,4109.63,-5812.36,11001.51
1121557992960804480,2020-11,4870.36,2596.1,7277.54,1829.36,7722.44,18723.95
1121557992960804480,2020-12,5472.39,11400.91,72.36,5951.98,-11808.14,6915.81
1121750009062982912,2020-01,1664.38,3966.09,3862.79,4097.46,-2536.38,-2536.38
1121750009062982912,2020-02,7228.63,3386.82,2205.04,3920.44,2126.41,-409.97
1121750009062982912,2020-03,701.74,3135.13,3111.25,3615.79,-2937.93,-3347.9
1121750009062982912,2020-04,3234.12,1423.04,6890.29,4277.97,4423.4,1075.5
1121750009062982912,2020-05,3994.63,2581.88,4505.85,3174.26,2744.34,3819.84
1121750009062982912,2020-06,2016.69,3243.88,4326.54,10437.63,-7338.28,-3518.44
1121750009062982912,2020-07,4159,4180.1,3999.78,4403.33,-424.65,-3943.09
1121750009062982912,2020-08,6569.63,3462.16,637.31,7295.84,-3551.06,-7494.15
1121750009062982912,2020-09,4187.12,7092.95,2637.23,3002.18,-3270.78,-10764.93
1121750009062982912,2020-10,7989.72,3162.49,2832.92,6557.64,1102.51,-9662.42
1121750009062982912,2020-11,3363.29,6781.44,2106.68,5020.39,-6331.86,-15994.28
1121750009062982912,2020-12,4041.14,2515.82,6898.21,3675.08,4748.45,-11245.83
1122198613345153920,2020-02,1983.87,937.96,1641.83,0,2687.74,2687.74
1122198613345153920,2020-03,0,701.19,0,2239.47,-2940.66,-252.92
1122198613345153920,2020-04,0,1582.8,571.83,432,-1442.97,-1695.89
1122198613345153920,2020-05,1515.78,0,1442.95,0,2958.73,1262.84
1122198613345153920,2020-06,0,1123.33,2739.62,0,1616.29,2879.13
1122198613345153920,2020-07,1629.39,0,0,0,1629.39,4508.52
1122198613345153920,2020-08,252.79,0,0,0,252.79,4761.31
1122198613345153920,2020-10,0,1835.61,2587.17,0,751.56,5512.87
1122198613345153920,2020-11,0,1000.7,0,0,-1000.7,4512.17
1122198613345153920,2020-12,1878.3,0,0,0,1878.3,6390.47
1123751729148116352,2020-03,2078.45,240.77,0,0,1837.68,1837.68
1123751729148116352,2020-05,1813.54,83.56,200.05,0,1930.03,3767.71
1123751729148116352,2020-06,1459.34,0,0,0,1459.34,5227.05
1123751729148116352,2020-07,726.87,113.27,0,0,613.6,5840.65
1123751729148116352,2020-08,0,234.1,0,0,-234.1,5606.55
1123751729148116352,2020-09,0,1697.45,0,1206.11,-2903.56,2702.99
1123751729148116352,2020-10,2564.89,0,0,505.53,2059.36,4762.35
1123751729148116352,2020-11,944.86,0,0,0,944.86,5707.21
1123751729148116352,2020-12,940.37,1258.49,0,0,-318.12,5389.09
1124337722170793344,2020-01,2911.11,4686.08,1801.4,2973.27,-2946.84,-2946.84
1124337722170793344,2020-02,1852.33,1549.23,4507.93,4086.75,724.28,-2222.56
1124337722170793344,2020-03,2741.66,744.45,2626.88,6495.35,-1871.26,-4093.82
1124337722170793344,2020-04,107.69,3867.8,5142.18,2836.05,-1453.98,-5547.8
1124337722170793344,2020-05,1590.58,970.12,4716.77,2029.6,3307.63,-2240.17
1124337722170793344,2020-06,1818.1,6554.22,1228.25,1857.9,-5365.77,-7605.94
1124337722170793344,2020-07,2258.57,2569.43,7801.95,1560.4,5930.69,-1675.25
1124337722170793344,2020-08,2018.38,8470.84,5698.43,4449.47,-5203.5,-6878.75
1124337722170793344,2020-09,979.03,2202.08,2554.6,1671.98,-340.43,-7219.18
1124337722170793344,2020-10,5892.95,1499.92,3495.47,5897.76,1990.74,-5228.44
1124337722170793344,2020-11,1962.45,2098.1,351.5,4105.14,-3889.29,-9117.73
1124337722170793344,2020-12,4759.38,3281.84,3061.7,5017.95,-478.71,-9596.44
1125986684503965824,2020-01,4927.84,5658.59,7153.02,916.99,5505.28,5505.28
1125986684503965824,2020-02,4498.27,1249.65,1456.88,1452.26,3253.24,8758.52
1125986684503965824,2020-03,10387.55,2653.25,5160.79,1106.95,11788.14,20546.66
1125986684503965824,2020-04,2886,2189.64,3165.45,3319.89,541.92,21088.58
1125986684503965824,2020-05,5398.99,2441.07,2082.69,3367.13,1673.48,22762.06
1125986684503965824,2020-06,4425.07,6019.18,2828.04,2118.45,-884.52,21877.54
1125986684503965824,2020-07,5414.4,6093.49,9339.08,4254.26,4405.73,26283.27
1125986684503965824,2020-08,4550.52,489.49,3584.57,4358.2,3287.4,29570.67
1125986684503965824,2020-09,7022.08,6275.52,580.12,5036.97,-3710.29,25860.38
1125986684503965824,2020-10,956.41,2021.28,1504.62,7315.91,-6876.16,18984.22
1125986684503965824,2020-11,4879.6,1676.24,3646,5557.51,1291.85,20276.07
1125986684503965824,2020-12,2831.95,3611.3,3350.3,1274.16,1296.79,21572.86
1127857824048717440,2020-01,1438.32,1526.77,4215.56,8961.5,-4834.39,-4834.39
1127857824048717440,2020-02,67.59,0,6416.35,2121.73,4362.21,-472.18
1127857824048717440,2020-03,158.11,1062.54,3621.02,1971.92,744.67,272.49
1127857824048717440,2020-04,1509.49,3542.99,3395.7,1582.06,-219.86,52.63
1127857824048717440,2020-05,2068.55,2221.61,5972.16,6706.98,-887.88,-835.25
1127857824048717440,2020-06,418.07,6079.85,3061.44,2473.43,-5073.77,-5909.02
1127857824048717440,2020-07,935.8,6070.99,6336.16,0,1200.97,-4708.05
1127857824048717440,2020-08,7030.91,853.22,8259.69,423.69,14013.69,9305.64
1127857824048717440,2020-09,4693.49,2415,411.42,1856.03,833.88,10139.52
1127857824048717440,2020-10,857.14,3516.92,1660.65,6950.89,-7950.02,2189.5
1127857824048717440,2020-11,2343.98,831.86,966.06,0,2478.18,4667.68
1127857824048717440,2020-12,1794.76,1973.53,4754.63,1577.94,2997.92,7665.6
1127934797913957632,2020-01,2060.09,2661.63,623.84,1772.75,-1750.45,-1750.45
1127934797913957632,2020-02,4100.99,1624.35,1476.01,3491.8,460.85,-1289.6
1127934797913957632,2020-03,1166.04,3874.67,831.03,5277.08,-7154.68,-8444.28
1127934797913957632,2020-04,1506.48,234.83,4225.84,2132.02,3365.47,-5078.81
1127934797913957632,2020-05,1545.32,3261.16,1467.3,1795.96,-2044.5,-7123.31
1127934797913957632,2020-06,2368.88,0,1367.94,1675.52,2061.3,-5062.01
1127934797913957632,2020-07,1433.95,0,2989.81,1876.77,2546.99,-2515.02
1127934797913957632,2020-08,2406.49,0,5867.31,3295.59,4978.21,2463.19
1127934797913957632,2020-09,1912.9,4177.73,1973.16,665.8,-957.47,1505.72
1127934797913957632,2020-10,1634.97,873.71,608.93,0,1370.19,2875.91
1127934797913957632,2020-11,0,2304.59,2287.94,2460.47,-2477.12,398.79
1127934797913957632,2020-12,271.68,2711.41,1911.32,0,-528.41,-129.62
1131782977201411584,2020-01,3206.57,0,2785.47,2539.46,3452.58,3452.58
1131782977201411584,2020-02,0,2746.73,815.46,670.97,-2602.24,850.34
1131782977201411584,2020-03,1141.86,3025.08,3975.77,317.78,1774.77,2625.11
1131782977201411584,2020-04,4777.08,1741.68,1581.38,124.2,4492.58,7117.69
1131782977201411584,2020-05,2446.93,2722.62,2092.5,3092.96,-1276.15,5841.54
1131782977201411584,2020-06,3427.43,6779.93,1005.95,0,-2346.55,3494.99
1131782977201411584,2020-07,1631.54,0,2565.31,661.81,3535.04,7030.03
1131782977201411584,2020-08,3739.31,2912.7,1391.17,89.98,2127.8,9157.83
1131782977201411584,2020-09,1626.76,1782.92,893.78,1987.44,-1249.82,7908.01
1131782977201411584,2020-10,1174.16,3827.95,0,0,-2653.79,5254.22
1131782977201411584,2020-11,0,1738.91,1617.41,1227.77,-1349.27,3904.95
1131782977201411584,2020-12,2694.39,3720.87,0,3884.62,-4911.1,-1006.15
1131994813904811648,2020-09,0,95.8,0,0,-95.8,-95.8
1132420705450011776,2020-01,7420.39,4634.13,3985.08,1158.72,5612.62,5612.62
1132420705450011776,2020-02,5485.29,533.87,1046.61,4727.36,1270.67,6883.29
1132420705450011776,2020-03,3507.57,4565.29,3874.74,2696.71,120.31,7003.6
1132420705450011776,2020-04,2198.65,3570.17,3018.82,2691.78,-1044.48,5959.12
1132420705450011776,2020-05,2271.73,2556.19,5095.09,6919.84,-2109.21,3849.91
1132420705450011776,2020-06,2042.8,4394.55,6202.17,8737.87,-4887.45,-1037.54
1132420705450011776,2020-07,2881.83,4230.18,4500.6,1632.56,1519.69,482.15
1132420705450011776,2020-08,3314.62,742.82,5927.48,3700.74,4798.54,5280.69
1132420705450011776,2020-09,5870.28,9642,1125.14,3637.51,-6284.09,-1003.4
1132420705450011776,2020-10,1136.66,4361.31,5931.19,3264.19,-557.65,-1561.05
1132420705450011776,2020-11,4050.66,5391.49,6567.76,2703.27,2523.66,962.61
1132420705450011776,2020-12,3754.1,7524.44,7803.33,6420.95,-2387.96,-1425.35
1132674631571553664,2020-01,4796.61,1220.06,6113.93,4111.62,5578.86,5578.86
1132674631571553664,2020-02,4879.49,3559.43,575.44,3659.21,-1763.71,3815.15
1132674631571553664,2020-03,3148.13,6625.4,883.63,2427.75,-5021.39,-1206.24
1132674631571553664,2020-04,6541.28,3229.91,2110.07,2188.7,3232.74,2026.5
1132674631571553664,2020-05,815.3,3529.86,2461.26,4604.37,-4857.67,-2831.17
1132674631571553664,2020-06,3016.43,0,2352.46,2922.82,2446.07,-385.1
1132674631571553664,2020-07,1992.87,4351.29,2988.99,2981.48,-2350.91,-2736.01
1132674631571553664,2020-08,2441.12,5559.3,1753.34,2401.49,-3766.33,-6502.34
1132674631571553664,2020-09,2197.97,5944.8,1891.36,1213.65,-3069.12,-9571.46
1132674631571553664,2020-10,1227.09,5960.71,1305.58,3026.66,-6454.7,-16026.16
1132674631571553664,2020-11,987.97,2735.26,7792.52,2411.85,3633.38,-12392.78
1132674631571553664,2020-12,1972.35,0,6792.96,4163.09,4602.22,-7790.56
1132841251705764352,2020-01,0,2246.65,1943.44,0,-303.21,-303.21
1132841251705764352,2020-02,649.19,1014.76,4863.2,1038.74,3458.89,3155.68
1132841251705764352,2020-03,0,1391.43,0,0,-1391.43,1764.25
1132841251705764352,2020-06,1421.78,0,2561.5,0,3983.28,5747.53
1132841251705764352,2020-07,864.56,0,0,3384.24,-2519.68,3227.85
1132841251705764352,2020-08,4453.94,0,5216.09,0,9670.03,12897.88
1132841251705764352,2020-10,1506.49,3151.23,0,2007.63,-3652.37,9245.51
1132841251705764352,2020-11,3995.65,2788.68,0,0,1206.97,10452.48
1132841251705764352,2020-12,0,6401.13,47.97,0,-6353.16,4099.32
1134440169400677504,2020-01,6382.98,3856.8,2015.58,7303.68,-2761.92,-2761.92
1134440169400677504,2020-02,3852.57,3022.94,3676.18,2301.47,2204.34,-557.58
1134440169400677504,2020-03,4609.21,3173.76,676.98,0,2112.43,1554.85
1134440169400677504,2020-04,4931.63,3902.55,877.66,6475.26,-4568.52,-3013.67
1134440169400677504,2020-05,3135.98,4121.43,3447.61,2706.33,-244.17,-3257.84
1134440169400677504,2020-06,894.31,2986.15,5800.64,6170.75,-2461.95,-5719.79
1134440169400677504,2020-07,2714.24,3777.06,5822.66,2817.82,1942.02,-3777.77
1134440169400677504,2020-08,6817.4,6435.2,7346.18,4470.29,3258.09,-519.68
1134440169400677504,2020-09,988.14,5135.34,800.82,2260.54,-5606.92,-6126.6
1134440169400677504,2020-10,2243.06,6968,3349.9,2180.8,-3555.84,-9682.44
1134440169400677504,2020-11,1834.99,4232.91,1571.49,2738.55,-3564.98,-13247.42
1134440169400677504,2020-12,2354.3,426.7,2107.8,1234.54,2800.86,-10446.56
1134738212702573568,2020-01,2078.61,1523.46,0,3798.47,-3243.32,-3243.32
1134738212702573568,2020-02,2734.66,2327.08,567.05,1967.46,-992.83,-4236.15
1134738212702573568,2020-03,2282.36,349.85,7182.12,2146.13,6968.5,2732.35
1134738212702573568,2020-04,0,6168.31,3168.84,2174.61,-5174.08,-2441.73
1134738212702573568,2020-05,0,1186.34,1609.79,0,423.45,-2018.28
1134738212702573568,2020-06,858.02,2186.02,0,4125.05,-5453.05,-7471.33
1134738212702573568,2020-07,2836.12,3302.44,2468.9,768.47,1234.11,-6237.22
1134738212702573568,2020-08,1300.31,2162.99,3128.67,4580.32,-2314.33,-8551.55
1134738212702573568,2020-09,2237.06,3697.52,513.39,1555.58,-2502.65,-11054.2
1134738212702573568,2020-10,1947.53,1580.36,4257.06,1249.97,3374.26,-7679.94
1134738212702573568,2020-11,2742.69,1537.47,3879.98,1975.87,3109.33,-4570.61
1134738212702573568,2020-12,2651.13,2588.48,3749.71,3160.41,651.95,-3918.66
1134913398395832192,2020-01,814.92,0,1317.26,0,2132.18,2132.18
1134913398395832192,2020-02,882.08,0,1626.86,0,2508.94,4641.12
1134913398395832192,2020-03,768.44,109.69,0,774.26,-115.51,4525.61
1134913398395832192,2020-04,280.11,2140.69,1194.62,0,-665.96,3859.65
1134913398395832192,2020-05,1769.8,812.46,3939.6,2307.49,2589.45,6449.1
1134913398395832192,2020-06,870.28,2545.02,1409.3,2503.76,-2769.2,3679.9
1134913398395832192,2020-08,0,1052.85,3123.62,843.96,1226.81,4906.71
1134913398395832192,2020-09,388.42,3434.76,53.32,0,-2993.02,1913.69
1134913398395832192,2020-10,143.37,1313.22,206.78,126.95,-1090.02,823.67
1134913398395832192,2020-11,0,2081.08,0,4.73,-2085.81,-1262.14
1134913398395832192,2020-12,860.63,0,341.49,0,1202.12,-60.02
1135172054250470400,2020-01,635.57,2671.52,2535.07,1786.58,-1287.46,-1287.46
1135172054250470400,2020-02,438.53,2053.95,3572.22,890.18,1066.62,-220.84
1135172054250470400,2020-03,2900.35,3515.85,1796.89,4543.25,-3361.86,-3582.7
1135172054250470400,2020-04,4921.29,2967.94,2366.4,1591.49,2728.26,-854.44
1135172054250470400,2020-05,7185.44,2111.59,2831.31,1440.74,6464.42,5609.98
1135172054250470400,2020-06,3382.97,2825.1,4540.18,6801.93,-1703.88,3906.1
1135172054250470400,2020-07,1492.95,1689.05,1170.34,3398.2,-2423.96,1482.14
1135172054250470400,2020-08,1658.21,587.95,4490.74,5195.32,365.68,1847.82
1135172054250470400,2020-09,3728.72,2843.14,2699.11,0,3584.69,5432.51
1135172054250470400,2020-10,3323.54,1214.75,1613.68,853.89,2868.58,8301.09
1135172054250470400,2020-11,4535.26,1553.45,0,4626.06,-1644.25,6656.84
1135172054250470400,2020-12,0,2288.91,118.53,0,-2170.38,4486.46
1135230866268876032,2020-01,3892.99,3309.6,1535.57,8490.2,-6371.24,-6371.24
1135230866268876032,2020-02,4662.3,1422.96,3836.61,4774.24,2301.71,-4069.53
1135230866268876032,2020-03,4060.99,4827.82,2875.8,7303.55,-5194.58,-9264.11
1135230866268876032,2020-04,324.87,0,1556.87,3588.73,-1706.99,-10971.1
1135230866268876032,2020-05,2113.54,5361.97,5341.66,1566.24,526.99,-10444.11
1135230866268876032,2020-06,6828.43,8878.56,2950.1,3217.59,-2317.62,-12761.73
1135230866268876032,2020-07,1775.61,8733.66,5457.68,1441.31,-2941.68,-15703.41
1135230866268876032,2020-08,905.96,451.84,1443.99,5588.96,-3690.85,-19394.26
1135230866268876032,2020-09,4423.68,6725.4,5479.06,2736.09,441.25,-18953.01
1135230866268876032,2020-10,9276.67,968.07,6092.07,6817.33,7583.34,-11369.67
1135230866268876032,2020-11,1933.04,5660.79,5614.46,4593.88,-2707.17,-14076.84
1135230866268876032,2020-12,3811.62,5059.76,2731.41,2505.46,-1022.19,-15099.03
1138091313280378368,2020-01,0,2203.99,3267.05,0,1063.06,1063.06
1138091313280378368,2020-03,0,1545.67,1608.03,0,62.36,1125.42
1138091313280378368,2020-05,651.73,716.82,0,74.84,-139.93,985.49
1138091313280378368,2020-07,1532.72,0,0,0,1532.72,2518.21
1138091313280378368,2020-08,3069.77,7.74,0,0,3062.03,5580.24
1138091313280378368,2020-09,2008.44,0,0,1997.25,11.19,5591.43
1138091313280378368,2020-10,111.48,0,1968.92,0,2080.4,7671.83
1138091313280378368,2020-11,1885.25,0,1893.82,0,3779.07,11450.9
1138091313280378368,2020-12,0,1535.43,62.01,0,-1473.42,9977.48
1138343552593731712,2020-01,3365.84,2234.26,2285.26,1030.84,2386,2386
1138343552593731712,2020-02,1834.39,52.77,0,1558.42,223.2,2609.2
1138343552593731712,2020-03,1820.75,1259.75,3546.16,1473.07,2634.09,5243.29
1138343552593731712,2020-04,0,2681.56,1266.28,1636.12,-3051.4,2191.89
1138343552593731712,2020-05,1491.96,5559.37,2645.81,612.9,-2034.5,157.39
1138343552593731712,2020-06,1629.21,1060,1423.59,2005.03,-12.23,145.16
1138343552593731712,2020-07,3538.44,0,132.87,3632.64,38.67,183.83
1138343552593731712,2020-08,818.15,1719.33,3937.6,2991.28,45.14,228.97
1138343552593731712,2020-09,0,3163.79,0,1736.47,-4900.26,-4671.29
1138343552593731712,2020-10,3241.59,0,347.94,0,3589.53,-1081.76
1138343552593731712,2020-11,894.59,0,0,2257.82,-1363.23,-2444.99
1138343552593731712,2020-12,595.07,0,2184.43,1980.54,798.96,-1646.03
1138693967118421504,2020-01,5918.62,3240.06,3634.02,133.22,6179.36,6179.36
1138693967118421504,2020-02,2797.96,1156.24,5953.25,5225.16,2369.81,8549.17
1138693967118421504,2020-03,4157.91,0,4382.86,2007.58,6533.19,15082.36
1138693967118421504,2020-04,3909.5,3612.76,6840.73,468.35,6669.12,21751.48
1138693967118421504,2020-05,1671.15,1664.49,1502.4,3428.55,-1919.49,19831.99
1138693967118421504,2020-06,0,1796.05,1423.67,0,-372.38,19459.61
1138693967118421504,2020-07,1420.36,2799.36,1628.16,4195.88,-3946.72,15512.89
1138693967118421504,2020-08,2664.03,2084.43,3958.39,1923.1,2614.89,18127.78
1138693967118421504,2020-09,0,7662.27,3504.14,3448.04,-7606.17,10521.61
1138693967118421504,2020-10,7662,3210.56,1667.62,0,6119.06,16640.67
1138693967118421504,2020-11,1753.4,7959.82,3271.3,2272.35,-5207.47,11433.2
1138693967118421504,2020-12,2874.34,0,638.62,2741.05,771.91,12205.11
1139113871709509248,2020-02,11.69,169.54,339.47,0,181.62,181.62
1139113871709509248,2020-03,0,1312.84,0,0,-1312.84,-1131.22
1139113871709509248,2020-04,1236.81,0,48.9,0,1285.71,154.49
1139113871709509248,2020-05,70.23,0,0,0,70.23,224.72
1139113871709509248,2020-07,1786.72,0,0,0,1786.72,2011.44
1139113871709509248,2020-08,968.52,0,0,0,968.52,2979.96
1139113871709509248,2020-10,0,1117.25,0,0,-1117.25,1862.71
1139113871709509248,2020-11,465.41,0,0,0,465.41,2328.12
1139113871709509248,2020-12,0,478.97,0,0,-478.97,1849.15
1139744594836191104,2020-01,6885.39,2662.19,5327.83,3350.73,6200.3,6200.3
1139744594836191104,2020-02,0,4903.8,3179.19,7478.39,-9203,-3002.7
1139744594836191104,2020-03,5391.59,4684.8,65.06,3597.11,-2825.26,-5827.96
1139744594836191104,2020-04,3886.04,7826.59,1209.15,1304.55,-4035.95,-9863.91
1139744594836191104,2020-05,5379.94,5726.22,3385.14,2225.77,813.09,-9050.82
1139744594836191104,2020-06,6416.16,6495.81,2072.22,8385.73,-6393.16,-15443.98
1139744594836191104,2020-07,6150.47,5129.64,1945.8,4829.22,-1862.59,-17306.57
1139744594836191104,2020-08,3648.18,480.48,3221.92,3754.23,2635.39,-14671.18
1139744594836191104,2020-09,3526.9,2806.97,3193.22,3762.83,150.32,-14520.86
1139744594836191104,2020-10,6457.02,597.11,6127.96,4717.11,7270.76,-7250.1
1139744594836191104,2020-11,2200.42,903.25,5041.75,3117.34,3221.58,-4028.52
1139744594836191104,2020-12,4497.91,5067.56,4047.22,4692.82,-1215.25,-5243.77
1140859530758375680,2020-01,2715.18,5187.69,3357.42,2462.24,-1577.33,-1577.33
1140859530758375680,2020-02,1642.63,993.43,4446.66,6470.99,-1375.13,-2952.46
1140859530758375680,2020-03,2246.54,3565.46,369.27,4583.51,-5533.16,-8485.62
1140859530758375680,2020-04,4907.93,3241.04,6494.75,4135.84,4025.8,-4459.82
1140859530758375680,2020-05,3628.09,3140.96,2376.9,3220.82,-356.79,-4816.61
1140859530758375680,2020-06,3617.78,3121.55,1280.12,1386.71,389.64,-4426.97
1140859530758375680,2020-07,2735.83,2115.22,1449.06,1117.44,952.23,-3474.74
1140859530758375680,2020-08,3970.11,4436.4,1601.46,5995.11,-4859.94,-8334.68
1140859530758375680,2020-09,4658.25,4034.51,2906.97,1450.91,2079.8,-6254.88
1140859530758375680,2020-10,1364.85,5750.58,902.3,6971.38,-10454.81,-16709.69
1140859530758375680,2020-11,4642.96,5470.79,4456.96,2129.87,1499.26,-15210.43
1140859530758375680,2020-12,197.52,3613.56,0,1059.21,-4475.25,-19685.68
1143512545711333632,2020-01,1993.35,1855.65,5711.07,3667.44,2181.33,2181.33
1143512545711333632,2020-02,1664.74,4754.36,3400.71,3159.98,-2848.89,-667.56
1143512545711333632,2020-03,6070.31,2473.45,3197.04,5960.77,833.13,165.57
1143512545711333632,2020-04,2139.85,2299.88,1630.8,5098.41,-3627.64,-3462.07
1143512545711333632,2020-05,5189.55,6851.13,6378.98,439.67,4277.73,815.66
1143512545711333632,2020-06,0,232.67,5493.07,2074.67,3185.73,4001.39
1143512545711333632,2020-07,7425.62,2882.96,4856.22,3057.01,6341.87,10343.26
1143512545711333632,2020-08,5508.67,4727.24,3338.59,4244.41,-124.39,10218.87
1143512545711333632,2020-09,3283.23,0,548.83,7240.2,-3408.14,6810.73
1143512545711333632,2020-10,2834.68,3873.49,2521.2,3201.77,-1719.38,5091.35
1143512545711333632,2020-11,793.91,3652.87,8912.98,6483.78,-429.76,4661.59
1143512545711333632,2020-12,3612.77,7690.07,1967.49,5372.75,-7482.56,-2820.97
1143714650292597376,2020-01,1366.92,5338.77,4792.69,4592.02,-3771.18,-3771.18
1143714650292597376,2020-02,1796.69,1771.39,0,1635.01,-1609.71,-5380.89
1143714650292597376,2020-03,1202.52,3076.03,3083.08,1134.44,75.13,-5305.76
1143714650292597376,2020-04,1470.02,3000.69,2050.05,4223.74,-3704.36,-9010.12
1143714650292597376,2020-05,2983.33,1337.67,430.29,4274.31,-2198.36,-11208.48
1143714650292597376,2020-06,2546.33,8290.57,4185.94,0,-1558.3,-12766.78
1143714650292597376,2020-07,4644.46,3256.57,2024.02,3022.98,388.93,-12377.85
1143714650292597376,2020-08,4685.43,610.56,3966.22,2928.88,5112.21,-7265.64
1143714650292597376,2020-09,1745.35,4950,4636,2866.12,-1434.77,-8700.41
1143714650292597376,2020-10,3858.62,860.45,7766.81,7592.78,3172.2,-5528.21
1143714650292597376,2020-11,725.29,5305.48,3957,3270.91,-3894.1,-9422.31
1143714650292597376,2020-12,3116.69,0,2657.67,2784.3,2990.06,-6432.25
1144098078315905408,2020-01,8218.42,6773.27,3079.25,3094.14,1430.26,1430.26
1144098078315905408,2020-02,4968.69,1083.83,6105.36,4962.84,5027.38,6457.64
1144098078315905408,2020-03,3157.3,6320.92,7811.42,2281.54,2366.26,8823.9
1144098078315905408,2020-04,6977.67,1377.85,4832.65,1438.11,8994.36,17818.26
1144098078315905408,2020-05,2993.06,3878,745.53,6881.61,-7021.02,10797.24
1144098078315905408,2020-06,4250.41,4636.69,4827.74,1240.01,3201.45,13998.69
1144098078315905408,2020-07,3788.89,0,8294,4193.73,7889.16,21887.85
1144098078315905408,2020-08,2018.63,4881.77,6875.1,3914.55,97.41,21985.26
1144098078315905408,2020-09,2012.77,4685.87,7665.86,6612.09,-1619.33,20365.93
1144098078315905408,2020-10,7992.92,1217.78,897.93,535.72,7137.35,27503.28
1144098078315905408,2020-11,5834.77,4162.68,5682.46,2560.43,4794.12,32297.4
1144098078315905408,2020-12,3973.62,10404.47,1417.56,2626.74,-7640.03,24657.37
1144933435822976896,2020-01,5109.75,3270.49,0,694.63,1144.63,1144.63
1144933435822976896,2020-02,2793.38,0,1072.15,1588.45,2277.08,3421.71
1144933435822976896,2020-03,1859.93,1303.31,0,1470.45,-913.83,2507.88
1144933435822976896,2020-04,726.01,1952.84,4033.39,3188.04,-381.48,2126.4
1144933435822976896,2020-05,580.24,3153,569.76,0,-2003,123.4
1144933435822976896,2020-06,2742.49,208.6,742.77,1869.94,1406.72,1530.12
1144933435822976896,2020-07,1246.9,1560.12,2777.95,0,2464.73,3994.85
1144933435822976896,2020-08,5047.14,2357.81,967.81,3451.64,205.5,4200.35
1144933435822976896,2020-09,0,1804.34,0,139.41,-1943.75,2256.6
1144933435822976896,2020-10,4192.26,3165.15,0,0,1027.11,3283.71
1144933435822976896,2020-11,290.53,0,1783.9,1597.68,476.75,3760.46
1144933435822976896,2020-12,2322.44,1507.02,0,845.89,-30.47,3729.99
1145247285991924736,2020-01,4885.23,923.99,3897.58,619.95,7238.87,7238.87
1145247285991924736,2020-02,569.52,2685.65,4609.86,6145.64,-3651.91,3586.96
1145247285991924736,2020-03,3238.89,6640.93,4717.39,3054.31,-1738.96,1848
1145247285991924736,2020-04,6640.76,1523.46,3008.21,1926.1,6199.41,8047.41
1145247285991924736,2020-05,5930.54,2577.17,8036.12,5328.05,6061.44,14108.85
1145247285991924736,2020-06,1991.02,1190.9,5472.44,4092.44,2180.12,16288.97
1145247285991924736,2020-07,6442.5,6996.54,2221.99,2220.52,-552.57,15736.4
1145247285991924736,2020-08,5300.02,1981.94,853.03,5336.86,-1165.75,14570.65
1145247285991924736,2020-09,378.93,2221.84,4589.43,2831.77,-85.25,14485.4
1145247285991924736,2020-10,3097.44,3865.23,419.44,3689.55,-4037.9,10447.5
1145247285991924736,2020-11,2950.44,1908.56,9203.31,1315.24,8929.95,19377.45
1145247285991924736,2020-12,3276.59,3220.08,1672.45,1628.35,100.61,19478.06
1146143234072335744,2020-01,1748.39,1368.74,2449.25,0,2828.9,2828.9
1146143234072335744,2020-02,1455.27,1754.08,2549.94,183.37,2067.76,4896.66
1146143234072335744,2020-03,1589.57,2306.73,1541.39,1608.18,-783.95,4112.71
1146143234072335744,2020-04,3530.51,4672.48,1035.92,2097.19,-2203.24,1909.47
1146143234072335744,2020-05,0,5733.9,1478.28,605.15,-4860.77,-2951.3
1146143234072335744,2020-06,2628,6559.99,2642.57,0,-1289.42,-4240.72
1146143234072335744,2020-07,5194.72,4179.13,1304.81,0,2320.4,-1920.32
1146143234072335744,2020-08,1924.29,1362.55,2119.76,2142.36,539.14,-1381.18
1146143234072335744,2020-09,5819.85,0,3609.19,2800.55,6628.49,5247.31
1146143234072335744,2020-10,1992.13,3042.59,3602.94,0,2552.48,7799.79
1146143234072335744,2020-11,1509.31,2781.97,4655.59,0,3382.93,11182.72
1146143234072335744,2020-12,222.2,3275.28,511.21,1851.28,-4393.15,6789.57
1146467993990053248,2020-01,2761.55,286.16,3458.84,745.44,5188.79,5188.79
1146467993990053248,2020-02,3278.5,2068.17,1858.64,3452.97,-384,4804.79
1146467993990053248,2020-03,2314.68,3310.19,3175.8,3012.18,-831.89,3972.9
1146467993990053248,2020-04,2658.51,2942.92,567.21,4637.76,-4354.96,-382.06
1146467993990053248,2020-05,3281.44,3145.78,3868.11,1223.15,2780.62,2398.56
1146467993990053248,2020-06,7672.65,6910.04,5812.74,3919.45,2655.9,5054.46
1146467993990053248,2020-07,8157.09,3591.11,434.57,2262.62,2737.93,7792.39
1146467993990053248,2020-08,1504.76,3446.82,3083.61,1812.36,-670.81,7121.58
1146467993990053248,2020-09,3794.62,2918.78,4182.08,821.98,4235.94,11357.52
1146467993990053248,2020-10,7756.67,3241.1,1547.79,1983.24,4080.12,15437.64
1146467993990053248,2020-11,2008.95,8678.22,1042.16,4737.63,-10364.74,5072.9
1146467993990053248,2020-12,3016.44,1403.88,3886.61,3576.17,1923,6995.9
1146876278023388032,2020-01,4915.82,3385.21,9395.58,2834.57,8091.62,8091.62
1146876278023388032,2020-02,4560.98,5895.91,1975.59,4943.93,-4303.27,3788.35
1146876278023388032,2020-03,2667.44,64.56,2386.36,5611.5,-622.26,3166.09
1146876278023388032,2020-04,8298.79,1827.45,6482.67,4773.58,8180.43,11346.52
1146876278023388032,2020-05,7940.73,7437.5,9047.1,5745.39,3804.94,15151.46
1146876278023388032,2020-06,0,3365.74,754.75,1942.41,-4553.4,10598.06
1146876278023388032,2020-07,5160.46,681.66,618.94,3216.07,1881.67,12479.73
1146876278023388032,2020-08,3613.11,6254.96,2769.13,916.49,-789.21,11690.52
1146876278023388032,2020-09,954.32,288.66,5720.14,8705.49,-2319.69,9370.83
1146876278023388032,2020-10,2378.56,10606.9,7517.5,3126.5,-3837.34,5533.49
1146876278023388032,2020-11,2775.19,6403.22,3514.45,2943.31,-3056.89,2476.6
1146876278023388032,2020-12,8291.89,6410.96,9860.61,9774.78,1966.76,4443.36
1147115922620192896,2020-01,1845.79,953.26,711.13,0,1603.66,1603.66
1147115922620192896,2020-02,2157.96,0,0,1296.17,861.79,2465.45
1147115922620192896,2020-03,2701.17,0,1224.44,2435.54,1490.07,3955.52
1147115922620192896,2020-04,973.85,1075.27,0,2931.67,-3033.09,922.43
1147115922620192896,2020-05,373.29,0,1654.86,0,2028.15,2950.58
1147115922620192896,2020-06,0,241.29,923.93,0,682.64,3633.22
1147115922620192896,2020-07,128.33,2123.92,0,0,-1995.59,1637.63
1147115922620192896,2020-08,1895.34,0,0,0,1895.34,3532.97
1147115922620192896,2020-09,2870.51,0,784.03,2245.1,1409.44,4942.41
1147115922620192896,2020-10,1902.39,0,1692.12,0,3594.51,8536.92
1147115922620192896,2020-11,2150.52,1563.31,61.88,1993.44,-1344.35,7192.57
1147115922620192896,2020-12,0,693.97,1825.54,698.23,433.34,7625.91
1147289058654037120,2020-01,3967.26,6642.45,6284.26,3068.96,540.11,540.11
1147289058654037120,2020-02,2253.32,6259.28,2588.55,10632.69,-12050.1,-11509.99
1147289058654037120,2020-03,3337.17,3609.72,6595.66,1507.28,4815.83,-6694.16
1147289058654037120,2020-04,5569.13,2665.59,2516.22,2058.87,3360.89,-3333.27
1147289058654037120,2020-05,7558.76,6877.99,6470.91,3486.48,3665.2,331.93
1147289058654037120,2020-06,4049.37,5280.11,1856.38,750.69,-125.05,206.88
1147289058654037120,2020-07,5181.83,5256.33,2837.77,5701.1,-2937.83,-2730.95
1147289058654037120,2020-08,6913.28,5615.16,756.51,4449.84,-2395.21,-5126.16
1147289058654037120,2020-09,5806.46,7698.36,8833.92,726.44,6215.58,1089.42
1147289058654037120,2020-10,813.33,3349.62,7089.64,3676.43,876.92,1966.34
1147289058654037120,2020-11,3220.78,7083.95,523.85,3372.75,-6712.07,-4745.73
1147289058654037120,2020-12,3965.83,5362.1,6459.68,9037.78,-3974.37,-8720.1
1148250066685507072,2020-01,3464.14,485.72,4433.67,3748.22,3663.87,3663.87
1148250066685507072,2020-02,2751.2,921.9,6494.16,4109.88,4213.58,7877.45
1148250066685507072,2020-03,9150.04,7965.27,3397.03,5032.68,-450.88,7426.57
1148250066685507072,2020-04,2548.19,4157.06,6607.29,5133.01,-134.59,7291.98
1148250066685507072,2020-05,4084.68,5500.33,2597.76,4069.68,-2887.57,4404.41
1148250066685507072,2020-06,2026.87,5791.52,2898.41,7588.9,-8455.14,-4050.73
1148250066685507072,2020-07,2296.31,3648,10618.21,5149.01,4117.51,66.78
1148250066685507072,2020-08,3790.39,10239.92,2330.8,2986.06,-7104.79,-7038.01
1148250066685507072,2020-09,3558.27,4674.21,1960.12,2389.43,-1545.25,-8583.26
1148250066685507072,2020-10,2976.83,3625.04,4257.64,1709.12,1900.31,-6682.95
1148250066685507072,2020-11,8752.82,2251.71,969.79,6055.42,1415.48,-5267.47
1148250066685507072,2020-12,4468.85,2348.52,3717.93,6138.14,-299.88,-5567.35
1150634540290954368,2020-01,2929.58,8008.52,5428.32,2502.75,-2153.37,-2153.37
1150634540290954368,2020-02,2258.2,3318.5,2390.65,1350.57,-20.22,-2173.59
1150634540290954368,2020-03,4160.58,6394.35,6790.99,7874.62,-3317.4,-5490.99
1150634540290954368,2020-04,4286.48,3370.32,4783.64,10186.84,-4487.04,-9978.03
1150634540290954368,2020-05,6098.02,892.86,430.72,4608.4,1027.48,-8950.55
1150634540290954368,2020-06,6718.55,5212.42,4081.81,2342.38,3245.56,-5704.99
1150634540290954368,2020-07,7518.94,8537.57,2613.35,7013.58,-5418.86,-11123.85
1150634540290954368,2020-08,9684.15,6590.03,5727.27,3442.07,5379.32,-5744.53
1150634540290954368,2020-09,6595.34,2627.82,5777.64,5557.55,4187.61,-1556.92
1150634540290954368,2020-10,5855.82,6956.2,1222.85,987.41,-864.94,-2421.86
1150634540290954368,2020-11,3415.62,5843.18,6859.15,4682.5,-250.91,-2672.77
1150634540290954368,2020-12,4617.62,1758.91,2925.47,6713.3,-929.12,-3601.89
1151142393992098688,2020-01,1312.7,0,0,0,1312.7,1312.7
1151142393992098688,2020-11,887.71,0,0,0,887.71,2200.41
1152320668580052992,2020-01,1933.26,1257.4,0,0,675.86,675.86
1152320668580052992,2020-02,1956.2,0,0,0,1956.2,2632.06
1152320668580052992,2020-03,0,1641.7,0,2077.43,-3719.13,-1087.07
1152320668580052992,2020-04,549.19,817.48,1667.53,0,1399.24,312.17
1152320668580052992,2020-09,814.63,0,0,0,814.63,1126.8
1152320668580052992,2020-11,3071.18,1679.58,1815.33,3397.45,-190.52,936.28
1153446787509044224,2020-01,4298.1,2370.58,4659.98,968.13,5619.37,5619.37
1153446787509044224,2020-02,3948.69,4382.18,2056.61,2563.22,-940.1,4679.27
1153446787509044224,2020-03,0,5570.49,3724.43,3542.68,-5388.74,-709.47
1153446787509044224,2020-04,5950.82,1775.72,3144.29,2603.37,4716.02,4006.55
1153446787509044224,2020-05,4049.59,4347.63,4683.93,3724.97,660.92,4667.47
1153446787509044224,2020-06,1474.46,2141.69,3106.56,6384.71,-3945.38,722.09
1153446787509044224,2020-07,7305.33,2433.11,6313.28,0,11185.5,11907.59
1153446787509044224,2020-08,1372.64,1812.19,2506.83,3432.52,-1365.24,10542.35
1153446787509044224,2020-09,7632.8,4265.92,2842.45,5700.7,508.63,11050.98
1153446787509044224,2020-10,390.87,522.62,758.93,4602.85,-3975.67,7075.31
1153446787509044224,2020-11,2706.07,8797.4,2120.06,2113.25,-6084.52,990.79
1153446787509044224,2020-12,3265.9,9413.22,1782.71,1121.03,-5485.64,-4494.85
1153480115862950912,2020-01,3449.63,7985,3253.26,2105.92,-3388.03,-3388.03
1153480115862950912,2020-02,3164.45,5216.17,4447.23,6214.48,-3818.97,-7207
1153480115862950912,2020-03,7439.63,7951.56,4702.06,1005.86,3184.27,-4022.73
1153480115862950912,2020-04,7805.26,2783.99,6969.96,3887.42,8103.81,4081.08
1153480115862950912,2020-05,3915.36,2673.62,6840.96,1613.89,6468.81,10549.89
1153480115862950912,2020-06,3355.26,1942.85,3833.14,8442.39,-3196.84,7353.05
1153480115862950912,2020-07,7584.57,4026.73,5415.84,2953.93,6019.75,13372.8
1153480115862950912,2020-08,9306.99,8649.31,5628.4,4982.86,1303.22,14676.02
1153480115862950912,2020-09,4626.34,5301.21,5479.25,1389.72,3414.66,18090.68
1153480115862950912,2020-10,7442.27,2584.35,3224.3,2308.99,5773.23,23863.91
1153480115862950912,2020-11,6437.39,3345.82,8782.73,6062.08,5812.22,29676.13
1153480115862950912,2020-12,5598.66,9207.27,5590.95,3490.64,-1508.3,28167.83
1154336720147996672,2020-01,1397.05,85.7,0,1377.77,-66.42,-66.42
1154336720147996672,2020-03,1981.78,0,0,789.24,1192.54,1126.12
1154336720147996672,2020-04,1471.25,0,202.95,0,1674.2,2800.32
1154336720147996672,2020-06,1638.04,0,1727.89,0,3365.93,6166.25
1154336720147996672,2020-07,0,3771.05,0,0,-3771.05,2395.2
1154336720147996672,2020-08,0,861.06,1872.01,4051.3,-3040.35,-645.15
1154336720147996672,2020-09,552.35,1346.12,0,0,-793.77,-1438.92
1154336720147996672,2020-10,2963.24,2304.7,0,0,658.54,-780.38
1154336720147996672,2020-11,930.28,0,0,0,930.28,149.9
1154336720147996672,2020-12,1248.14,0,1141.59,1652.25,737.48,887.38
1154541498566905088,2020-04,0,1081.88,0,0,-1081.88,-1081.88
1154541498566905088,2020-05,0,1339.04,0,0,-1339.04,-2420.92
1156076761998805504,2020-02,0,395.57,514.57,2684.43,-2565.43,-2565.43
1156076761998805504,2020-03,2128.1,0,1360.37,0,3488.47,923.04
1156076761998805504,2020-04,0,1477.31,1521.93,1347.11,-1302.49,-379.45
1156076761998805504,2020-05,0,2627.59,2935.64,4686.51,-4378.46,-4757.91
1156076761998805504,2020-06,1043.89,0,2963.53,1134.27,2873.15,-1884.76
1156076761998805504,2020-07,15.58,1182.2,1109.71,197,-253.91,-2138.67
1156076761998805504,2020-08,421.45,4349.4,0,1010.67,-4938.62,-7077.29
1156076761998805504,2020-09,101.39,0,0,1761.12,-1659.73,-8737.02
1156076761998805504,2020-10,1534.09,0,1304.57,0,2838.66,-5898.36
1156076761998805504,2020-11,191.73,1477.8,1963.14,0,677.07,-5221.29
1156076761998805504,2020-12,0,612.35,511.95,2735.6,-2836,-8057.29
1156772845794232832,2020-01,1561.52,0,1559.01,1990.43,1130.1,1130.1
1156772845794232832,2020-02,3705.54,0,425.03,710.52,3420.05,4550.15
1156772845794232832,2020-03,832.29,4332.29,4562.71,1505.33,-442.62,4107.53
1156772845794232832,2020-04,2841.8,1866.71,2070.78,619.4,2426.47,6534
1156772845794232832,2020-05,4824.49,3368.26,0,0,1456.23,7990.23
1156772845794232832,2020-06,1956.99,2173.78,2863.71,432.87,2214.05,10204.28
1156772845794232832,2020-07,1352.93,3374.18,2794.38,8146.88,-7373.75,2830.53
1156772845794232832,2020-08,3273.94,1288.28,806.71,1710.07,1082.3,3912.83
1156772845794232832,2020-09,4471.93,2980.89,424.75,2743.08,-827.29,3085.54
1156772845794232832,2020-10,1833.79,3405.47,516.11,552.81,-1608.38,1477.16
1156772845794232832,2020-11,1425.23,3676.81,5473.95,1147.08,2075.29,3552.45
1156772845794232832,2020-12,1279.79,2880.26,3221.4,743.68,877.25,4429.7
1157119775477140224,2020-01,1826.6,973.86,3395.86,3363.94,884.66,884.66
1157119775477140224,2020-02,5471.08,1309.75,4064.31,1414,6811.64,7696.3
1157119775477140224,2020-03,3154.9,4060.16,2967.13,5031.83,-2969.96,4726.34
1157119775477140224,2020-04,2978.4,5159.35,1152.03,0,-1028.92,3697.42
1157119775477140224,2020-05,969.62,3627.94,4065.73,1022.65,384.76,4082.18
1157119775477140224,2020-06,1087.64,4931.43,4745.39,0,901.6,4983.78
1157119775477140224,2020-07,4816.79,2461.63,708.22,6540.47,-3477.09,1506.69
1157119775477140224,2020-08,3155.37,5244.02,4520.32,3690.61,-1258.94,247.75
1157119775477140224,2020-09,3263.9,1318.57,886.65,4996.09,-2164.11,-1916.36
1157119775477140224,2020-10,0,2207.01,2653.45,3243.59,-2797.15,-4713.51
1157119775477140224,2020-11,1215.03,2722.7,0,1956.16,-3463.83,-8177.34
1157119775477140224,2020-12,1185.79,1618.97,1155.21,4146.3,-3424.27,-11601.61
1158006953795349504,2020-01,0,2040.25,0,98.63,-2138.88,-2138.88
1158006953795349504,2020-02,0,6.93,0,181.3,-188.23,-2327.11
1158006953795349504,2020-03,1187.6,0,0,1353.97,-166.37,-2493.48
1158006953795349504,2020-05,864.84,0,0,1875.86,-1011.02,-3504.5
1158006953795349504,2020-07,0,1519.04,281.17,740.16,-1978.03,-5482.53
1158006953795349504,2020-08,0,622.13,1734.16,657.62,454.41,-5028.12
1158006953795349504,2020-09,200.62,0,1621.32,1019.81,802.13,-4225.99
1158006953795349504,2020-10,707.64,0,1942.2,0,2649.84,-1576.15
1158006953795349504,2020-12,0,459.56,1471.91,1052.25,-39.9,-1616.05
1158262855792564480,2020-01,2854.22,7624.21,10364.64,5912.37,-317.72,-317.72
1158262855792564480,2020-02,4439.74,2310.1,3823.92,1409.14,4544.42,4226.7
1158262855792564480,2020-03,3862.56,6283.14,347.26,2243.95,-4317.27,-90.57
1158262855792564480,2020-04,1722.44,6497.12,5714.98,6576.02,-5635.72,-5726.29
1158262855792564480,2020-05,4959.95,3023.35,4895.35,7189.85,-357.9,-6084.19
1158262855792564480,2020-06,2191.65,3188.06,5965.47,5174.28,-205.22,-6289.41
1158262855792564480,2020-07,3704.4,2932.04,2680.59,2166.14,1286.81,-5002.6
1158262855792564480,2020-08,390.04,3403.08,6658.69,6884.58,-3238.93,-8241.53
1158262855792564480,2020-09,641.99,4810.72,4713.81,799.75,-254.67,-8496.2
1158262855792564480,2020-10,7969.15,6083.31,2627.92,6705.29,-2191.53,-10687.73
1158262855792564480,2020-11,4799.48,5626.3,4215.14,2140.18,1248.14,-9439.59
1158262855792564480,2020-12,4740.01,2444.25,1582.63,428.5,3449.89,-5989.7
1158945660897203968,2020-01,4180.87,1766.98,6981.73,1753.25,7642.37,7642.37
1158945660897203968,2020-02,6863.57,7163.1,2842.06,5759.8,-3217.27,4425.1
1158945660897203968,2020-03,11688.05,748.38,5425.1,5009.59,11355.18,15780.28
1158945660897203968,2020-04,4660.01,2663.16,4580.55,3047.8,3529.6,19309.88
1158945660897203968,2020-05,6253.34,0,7903.19,4912.88,9243.65,28553.53
1158945660897203968,2020-06,5840.86,3937.11,4485.5,5230.31,1158.94,29712.47
1158945660897203968,2020-07,1094.58,2934.53,6380.02,5787.8,-1247.73,28464.74
1158945660897203968,2020-08,3271.33,5299.02,4207.87,5049.96,-2869.78,25594.96
1158945660897203968,2020-09,0,1912.21,6323.33,2723.46,1687.66,27282.62
1158945660897203968,2020-10,3929.57,4769.52,9003,3392.8,4770.25,32052.87
1158945660897203968,2020-11,7951.11,8932.07,2595.22,5008.04,-3393.78,28659.09
1158945660897203968,2020-12,5511.52,8943.71,3277.97,3522.47,-3676.69,24982.4
1159330086767907840,2020-04,0,1548.59,0,0,-1548.59,-1548.59
1159330086767907840,2020-07,0,233.23,712.88,0,479.65,-1068.94
1159330086767907840,2020-08,3956.51,0,236.65,0,4193.16,3124.22
1159330086767907840,2020-10,0,1971.47,0,0,-1971.47,1152.75
1159330086767907840,2020-11,577.38,0,0,0,577.38,1730.13
1159366850877460736,2020-01,0,1515.32,5680.36,5674.49,-1509.45,-1509.45
1159366850877460736,2020-02,9088.61,3785.25,5802.83,456.12,10650.07,9140.62
1159366850877460736,2020-03,5211.6,5308.92,3955.29,10060.31,-6202.34,2938.28
1159366850877460736,2020-04,2266.52,569.54,10418.76,5738.33,6377.41,9315.69
1159366850877460736,2020-05,5127.1,1529.97,14814.38,6401.38,12010.13,21325.82
1159366850877460736,2020-06,4485.59,8703.62,6363.5,3094.33,-948.86,20376.96
1159366850877460736,2020-07,5701.94,2095.37,4909.62,2630.77,5885.42,26262.38
1159366850877460736,2020-08,512.79,3318.48,8950.24,1900.15,4244.4,30506.78
1159366850877460736,2020-09,4061.73,2240.24,8654.67,3146.82,7329.34,37836.12
1159366850877460736,2020-10,4829.95,2462.06,7489.26,7646.78,2210.37,40046.49
1159366850877460736,2020-11,4563.49,2713.71,756.49,3660.06,-1053.79,38992.7
1159366850877460736,2020-12,4088.95,3324.68,3275.99,3829.52,210.74,39203.44
1159551567029026304,2020-01,1890.62,1459.36,3950.41,3096.83,1284.84,1284.84
1159551567029026304,2020-02,2256.61,5496.39,5212.45,6525.24,-4552.57,-3267.73
1159551567029026304,2020-03,6112.25,1720.15,11254.05,5831.59,9814.56,6546.83
1159551567029026304,2020-04,4304.18,9695.32,6295.6,685.64,218.82,6765.65
1159551567029026304,2020-05,2643.85,4304.92,843.36,4622.55,-5440.26,1325.39
1159551567029026304,2020-06,293.38,1652.58,5697.78,1972.45,2366.13,3691.52
1159551567029026304,2020-07,890.04,2567.52,8175.64,660.27,5837.89,9529.41
1159551567029026304,2020-08,1484.34,10134.97,6682.63,3320.46,-5288.46,4240.95
1159551567029026304,2020-09,5626.5,2696.71,1457.5,3662.95,724.34,4965.29
1159551567029026304,2020-10,5974.28,2568.73,5090.06,5232.81,3262.8,8228.09
1159551567029026304,2020-11,3848.24,5117.02,1697.88,7868.51,-7439.41,788.68
1159551567029026304,2020-12,2612.85,2027.9,3665.37,1947.67,2302.65,3091.33
1161219940642378240,2020-01,5490.82,4888.67,5195.96,1017.13,4780.98,4780.98
1161219940642378240,2020-02,12091.11,3566.02,1804.57,3259.69,7069.97,11850.95
1161219940642378240,2020-03,2609.3,5005.01,1378.63,4898.05,-5915.13,5935.82
1161219940642378240,2020-04,2229.45,1432.35,1720.64,2957.26,-439.52,5496.3
1161219940642378240,2020-05,2861.81,265.88,2750.67,7175.38,-1828.78,3667.52
1161219940642378240,2020-06,3023.9,3893.66,5056.41,4690.04,-503.39,3164.13
1161219940642378240,2020-07,5612.67,0,1843.89,5161.99,2294.57,5458.7
1161219940642378240,2020-08,3069.62,1686.01,3430.31,6647.81,-1833.89,3624.81
1161219940642378240,2020-09,6617.7,4530.02,5519.24,5365.39,2241.53,5866.34
1161219940642378240,2020-10,3921.51,1721.76,1517.61,3813.78,-96.42,5769.92
1161219940642378240,2020-11,4101.71,2719.56,2061.63,1577.03,1866.75,7636.67
1161219940642378240,2020-12,3503.92,3556.07,983.81,4488.17,-3556.51,4080.16
1162245146144792576,2020-06,559.45,0,0,0,559.45,559.45
1162245146144792576,2020-12,1715.91,0,0,0,1715.91,2275.36
1165422013542530048,2020-01,5423.14,3280.99,5531.2,2116.31,5557.04,5557.04
1165422013542530048,2020-02,5696.23,5163.73,5724.27,1314.53,4942.24,10499.28
1165422013542530048,2020-03,7935.53,3467.06,3721.45,6306.74,1883.18,12382.46
1165422013542530048,2020-04,3014.93,5728.51,2881.51,8632.83,-8464.9,3917.56
1165422013542530048,2020-05,827.91,4193.78,4228.44,3482.43,-2619.86,1297.7
1165422013542530048,2020-06,568.09,2968.98,1477.46,4161.61,-5085.04,-3787.34
1165422013542530048,2020-07,2657.45,1850.5,6019.81,4164.78,2661.98,-1125.36
1165422013542530048,2020-08,2810.41,3735.29,4565.09,3501.24,138.97,-986.39
1165422013542530048,2020-09,2007.47,3605.32,7017.81,3359.09,2060.87,1074.48
1165422013542530048,2020-10,5855.22,832.44,1879.8,2270.81,4631.77,5706.25
1165422013542530048,2020-11,1381.26,0,3214.24,2907.35,1688.15,7394.4
1165422013542530048,2020-12,983.54,2720.72,2507.29,755.68,14.43,7408.83
1166892296450124288,2020-01,3050.96,10412.22,2970.55,4304.09,-8694.8,-8694.8
1166892296450124288,2020-02,4046.42,5537.5,0,2796.59,-4287.67,-12982.47
1166892296450124288,2020-03,1281.53,4775.18,4628.02,4005.23,-2870.86,-15853.33
1166892296450124288,2020-04,3057.57,5119.25,1870.22,4179.45,-4370.91,-20224.24
1166892296450124288,2020-05,2364.42,5136.36,1035.66,3516.27,-5252.55,-25476.79
1166892296450124288,2020-06,5345.8,4563.21,3392.68,8007.13,-3831.86,-29308.65
1166892296450124288,2020-07,0,3241.51,3556.01,2516.99,-2202.49,-31511.14
1166892296450124288,2020-08,3047.78,8742.1,6963.6,1487.45,-218.17,-31729.31
1166892296450124288,2020-09,893.42,5960.77,6878.62,3814.2,-2002.93,-33732.24
1166892296450124288,2020-10,4485.67,3011.57,2401.71,3244.17,631.64,-33100.6
1166892296450124288,2020-11,1037.39,1746.89,3018.32,786.43,1522.39,-31578.21
1166892296450124288,2020-12,3133.93,2593.09,3059.81,1711.63,1889.02,-29689.19
1167203371979416064,2020-01,173.77,2052.66,0,2078.78,-3957.67,-3957.67
1167203371979416064,2020-02,0,1285.1,595.1,0,-690,-4647.67
1167203371979416064,2020-03,2774.28,1962.63,1795.96,137.35,2470.26,-2177.41
1167203371979416064,2020-04,1823.38,1432.67,0,3587.38,-3196.67,-5374.08
1167203371979416064,2020-05,5263.43,550.45,769.83,0,5482.81,108.73
1167203371979416064,2020-06,2298.44,2581.23,1930.48,1866.12,-218.43,-109.7
1167203371979416064,2020-07,334.99,1336.38,0,2281.04,-3282.43,-3392.13
1167203371979416064,2020-08,2276.31,2719.01,2540.33,0,2097.63,-1294.5
1167203371979416064,2020-09,290.18,500.49,0,0,-210.31,-1504.81
1167203371979416064,2020-10,1434.7,0,654.77,1545.37,544.1,-960.71
1167203371979416064,2020-11,2017.42,1944.22,5496.61,735.07,4834.74,3874.03
1167203371979416064,2020-12,0,1859.75,1322.27,0,-537.48,3336.55
1171203017793766656,2020-01,0,2199.77,4704.07,1675.82,828.48,828.48
1171203017793766656,2020-02,2002.92,3687.1,1439.78,2192.66,-2437.06,-1608.58
1171203017793766656,2020-03,2132.4,3974.38,3594.4,2279.66,-527.24,-2135.82
1171203017793766656,2020-04,0,3395.05,1533.52,3596.12,-5457.65,-7593.47
1171203017793766656,2020-05,0,2687.84,1041.5,2756.39,-4402.73,-11996.2
1171203017793766656,2020-06,159.99,919.69,3868.56,443.38,2665.48,-9330.72
1171203017793766656,2020-07,1833.66,3371.02,3234.47,1883.66,-186.55,-9517.27
1171203017793766656,2020-08,1101.22,2296.05,1990.62,659.64,136.15,-9381.12
1171203017793766656,2020-09,1284.55,2694.52,1082.87,3651.49,-3978.59,-13359.71
1171203017793766656,2020-10,1819.79,0,169.71,1249.92,739.58,-12620.13
1171203017793766656,2020-11,5903.02,3114.26,0,110.28,2678.48,-9941.65
1171203017793766656,2020-12,2635.12,654.5,1689.94,0,3670.56,-6271.09
1172031951509287680,2020-01,1172.18,3116.73,1532.55,344.52,-756.52,-756.52
1172031951509287680,2020-02,0,506.28,1404.3,2830.67,-1932.65,-2689.17
1172031951509287680,2020-03,1564.08,0,2505.57,0,4069.65,1380.48
1172031951509287680,2020-04,933.64,660.25,3901.3,131.75,4042.94,5423.42
1172031951509287680,2020-05,0,1800.07,1790.97,0,-9.1,5414.32
1172031951509287680,2020-06,1858.73,0,1830.27,0,3689,9103.32
1172031951509287680,2020-07,0,2297.47,0,1945.39,-4242.86,4860.46
1172031951509287680,2020-08,0,3611,4403.69,3655.42,-2862.73,1997.73
1172031951509287680,2020-09,1015.49,1679.79,0,64.75,-729.05,1268.68
1172031951509287680,2020-10,0,274.4,939.89,78.93,586.56,1855.24
1172031951509287680,2020-11,1294.83,0,0,0,1294.83,3150.07
1172031951509287680,2020-12,3237.87,1786.41,754.92,1408.49,797.89,3947.96
1173097305793426432,2020-01,2314.46,2451.22,2128.44,5877.63,-3885.95,-3885.95
1173097305793426432,2020-02,6929.55,2940.9,3977.25,7627.26,338.64,-3547.31
1173097305793426432,2020-03,1141.69,5737.22,2242.12,2897.41,-5250.82,-8798.13
1173097305793426432,2020-04,2802.22,5235.76,6625.05,3697.19,494.32,-8303.81
1173097305793426432,2020-05,0,5600.38,2869.98,2105.79,-4836.19,-13140
1173097305793426432,2020-06,879.06,1689.21,6169.73,3757.11,1602.47,-11537.53
1173097305793426432,2020-07,3668.05,3838.07,2669.4,5449.77,-2950.39,-14487.92
1173097305793426432,2020-08,6398.36,8304.19,6841.41,3900.95,1034.63,-13453.29
1173097305793426432,2020-09,3078.23,3457.43,5221.55,965.64,3876.71,-9576.58
1173097305793426432,2020-10,4641.1,2597.97,1368.72,4496.67,-1084.82,-10661.4
1173097305793426432,2020-11,1818.11,4296.97,3654.11,2665.86,-1490.61,-12152.01
1173097305793426432,2020-12,7095.18,2291.72,3707.73,7222.61,1288.58,-10863.43
1173306636433992960,2020-01,1460.16,0,0,4687.12,-3226.96,-3226.96
1173306636433992960,2020-02,2698.65,2532.85,2565.64,725.14,2006.3,-1220.66
1173306636433992960,2020-03,1722.37,997.54,2077.62,4558.31,-1755.86,-2976.52
1173306636433992960,2020-04,1820.95,4497.41,2590.25,1248.25,-1334.46,-4310.98
1173306636433992960,2020-05,0,1776.04,922.8,909.06,-1762.3,-6073.28
1173306636433992960,2020-06,1050.55,0,717.82,414.18,1354.19,-4719.09
1173306636433992960,2020-07,0,1327.27,3646.67,4034.47,-1715.07,-6434.16
1173306636433992960,2020-08,1471.19,1358.74,2808.16,1468.01,1452.6,-4981.56
1173306636433992960,2020-09,1806.12,4089.14,3462.77,1360.2,-180.45,-5162.01
1173306636433992960,2020-10,310.43,4015.47,752.82,490.26,-3442.48,-8604.49
1173306636433992960,2020-11,0,3643.47,2706.93,827.31,-1763.85,-10368.34
1173306636433992960,2020-12,143.27,2151.49,2025.73,335.35,-317.84,-10686.18
1173810188156396288,2020-01,1814.43,5437.94,2031.31,1782.37,-3374.57,-3374.57
1173810188156396288,2020-02,6459.19,3459.47,3132.76,4049.91,2082.57,-1292
1173810188156396288,2020-03,5460.55,1321.73,4937,2361.66,6714.16,5422.16
1173810188156396288,2020-04,3521.07,1053.2,3737.69,5828.18,377.38,5799.54
1173810188156396288,2020-05,1126.43,7371.13,6324.25,4842.18,-4762.63,1036.91
1173810188156396288,2020-06,1490.31,1261.4,6470.54,4211.62,2487.83,3524.74
1173810188156396288,2020-07,583.99,1247.46,8144.18,2869.74,4610.97,8135.71
1173810188156396288,2020-08,559.17,3848.09,6439.87,1350.98,1799.97,9935.68
1173810188156396288,2020-09,206.9,5206.2,1283.07,2499.85,-6216.08,3719.6
1173810188156396288,2020-10,5406.49,4034.2,5207.84,4390.95,2189.18,5908.78
1173810188156396288,2020-11,5275.57,4416.67,5082.71,7470.14,-1528.53,4380.25
1173810188156396288,2020-12,8411.4,5317.52,1771.85,1643.92,3221.81,7602.06
1174669385787789824,2020-01,0,4242.13,3805.95,2462.2,-2898.38,-2898.38
1174669385787789824,2020-02,8022.6,1391.81,0,2431.46,4199.33,1300.95
1174669385787789824,2020-03,1163.03,3892.53,0,1162.85,-3892.35,-2591.4
1174669385787789824,2020-04,4331.16,3158.65,3675.74,2329.26,2518.99,-72.41
1174669385787789824,2020-05,3801.38,0,3343.41,107.98,7036.81,6964.4
1174669385787789824,2020-06,1258.27,972.55,949.86,3508.03,-2272.45,4691.95
1174669385787789824,2020-07,1994.16,472.99,2433.44,2367.9,1586.71,6278.66
1174669385787789824,2020-08,1697.8,1641.83,620.57,4196.21,-3519.67,2758.99
1174669385787789824,2020-09,5198.42,1259.04,2584.38,1867.94,4655.82,7414.81
1174669385787789824,2020-10,1250.72,1917.07,1845.87,976.75,202.77,7617.58
1174669385787789824,2020-11,1594.37,1201.16,1221.9,1826.33,-211.22,7406.36
1174669385787789824,2020-12,1007.81,4360.8,3830.39,1557.51,-1080.11,6326.25
1174828881303312896,2020-01,6240.86,2443.68,7944.86,10207.14,1534.9,1534.9
1174828881303312896,2020-02,3400.96,1975.63,1859,8580.29,-5295.96,-3761.06
1174828881303312896,2020-03,3376.41,9476.72,5220.61,2747.56,-3627.26,-7388.32
1174828881303312896,2020-04,6724.94,6174.3,10665.46,5087.87,6128.23,-1260.09
1174828881303312896,2020-05,1194.29,8842.58,1068.26,3621.55,-10201.58,-11461.67
1174828881303312896,2020-06,4211.54,748.26,6014.08,3833.16,5644.2,-5817.47
1174828881303312896,2020-07,9783.6,3443.04,8361.83,1897.21,12805.18,6987.71
1174828881303312896,2020-08,7499.56,905.83,5037.47,8245.92,3385.28,10372.99
1174828881303312896,2020-09,3545.02,3839.01,3198.44,7229.99,-4325.54,6047.45
1174828881303312896,2020-10,4680.12,0,1736.59,2094.43,4322.28,10369.73
1174828881303312896,2020-11,2654.02,3052.22,1172.82,2524.66,-1750.04,8619.69
1174828881303312896,2020-12,4266.22,7524.37,4248.3,4843.34,-3853.19,4766.5
1174831556553695744,2020-01,410.07,992.66,3727.37,4243.72,-1098.94,-1098.94
1174831556553695744,2020-02,2930.02,5928.42,1682.15,1781.54,-3097.79,-4196.73
1174831556553695744,2020-03,5054.84,3422.77,1532.4,688.43,2476.04,-1720.69
1174831556553695744,2020-04,3777.2,3289.19,1971.17,4373.6,-1914.42,-3635.11
1174831556553695744,2020-05,2374.68,10089.56,1509.35,1103.81,-7309.34,-10944.45
1174831556553695744,2020-06,2489.1,3442.57,4791.63,4607.07,-768.91,-11713.36
1174831556553695744,2020-07,1452.92,2732.45,795.49,0,-484.04,-12197.4
1174831556553695744,2020-08,6286.86,8632.5,3087.95,700.69,41.62,-12155.78
1174831556553695744,2020-09,1175.96,3910.59,2297.25,2761.4,-3198.78,-15354.56
1174831556553695744,2020-10,1566.53,3683.58,3294.39,3256.86,-2079.52,-17434.08
1174831556553695744,2020-11,2971.84,2411.01,2678.66,3493.94,-254.45,-17688.53
1174831556553695744,2020-12,3263.68,1988.49,2230.51,0,3505.7,-14182.83
1174942604784923392,2020-01,687.59,0,1547.32,2303.63,-68.72,-68.72
1174942604784923392,2020-02,1578.7,1234.1,3192.94,1987.17,1550.37,1481.65
1174942604784923392,2020-03,4265.81,3055.61,317.08,2428.74,-901.46,580.19
1174942604784923392,2020-04,2174.21,1998.04,3680.93,648.82,3208.28,3788.47
1174942604784923392,2020-05,0,1813.05,4039.88,75.23,2151.6,5940.07
1174942604784923392,2020-06,3452.9,2774.97,2826.69,1435.98,2068.64,8008.71
1174942604784923392,2020-07,1650.19,850.22,2564.83,1978.53,1386.27,9394.98
1174942604784923392,2020-08,2654.01,1651.65,0,2553.45,-1551.09,7843.89
1174942604784923392,2020-09,2288.48,2062.08,2805.06,2325.44,706.02,8549.91
1174942604784923392,2020-10,2208.49,967.1,0,2469.26,-1227.87,7322.04
1174942604784923392,2020-11,3257.19,2933.23,664.46,1334.27,-345.85,6976.19
1174942604784923392,2020-12,290.53,1178.12,0,2276.47,-3164.06,3812.13
1175310501503876864,2020-01,4687.89,577.28,0,3644.44,466.17,466.17
1175310501503876864,2020-02,312.94,639.41,0,1494.9,-1821.37,-1355.2
1175310501503876864,2020-03,625.31,4119.24,1835.63,278.09,-1936.39,-3291.59
1175310501503876864,2020-04,654.37,3729.1,0,14.65,-3089.38,-6380.97
1175310501503876864,2020-05,4315.52,4343.14,4650.03,1496.81,3125.6,-3255.37
1175310501503876864,2020-07,1833.84,613.39,2323.12,2221.27,1322.3,-1933.07
1175310501503876864,2020-08,2671.84,1681.94,3642.67,803.96,3828.61,1895.54
1175310501503876864,2020-09,0,1661.22,1396.01,2969.03,-3234.24,-1338.7
1175310501503876864,2020-10,0,1429.21,831.46,0,-597.75,-1936.45
1175310501503876864,2020-11,1657.93,873.76,1182.29,1605.08,361.38,-1575.07
1175660105173463808,2020-03,1110.42,0,0,0,1110.42,1110.42
1175660105173463808,2020-04,602.41,0,0,0,602.41,1712.83
1175660105173463808,2020-05,0,1234.61,1559.84,0,325.23,2038.06
1175660105173463808,2020-08,0,1489.07,0,0,-1489.07,548.99
1175660105173463808,2020-11,1774.2,0,0,0,1774.2,2323.19
1176498583799249408,2020-01,4972.79,7450.48,4015.84,7498.35,-5960.2,-5960.2
1176498583799249408,2020-02,5605.34,5309.22,1881.81,3748.43,-1570.5,-7530.7
1176498583799249408,2020-03,5177.27,288.06,1512.53,6490.04,-88.3,-7619
1176498583799249408,2020-04,3189.93,4516.38,1561.81,802.28,-566.92,-8185.92
1176498583799249408,2020-05,7987.96,4128.71,6439.06,2574.23,7724.08,-461.84
1176498583799249408,2020-06,2993.25,2807.39,5841.7,4929.4,1098.16,636.32
1176498583799249408,2020-07,5248.43,3927.17,4335.57,5443.34,213.49,849.81
1176498583799249408,2020-08,2541.9,2742.74,4819.62,8184.38,-3565.6,-2715.79
1176498583799249408,2020-09,3343.95,4906.85,3635.33,905.35,1167.08,-1548.71
1176498583799249408,2020-10,8609.88,1616.21,383.63,3081.19,4296.11,2747.4
1176498583799249408,2020-11,3143.73,2870.5,7111.19,5744.54,1639.88,4387.28
1176498583799249408,2020-12,5503.51,1718.29,7621.17,4648.79,6757.6,11144.88
1177173019302456576,2020-03,51.6,0,0,0,51.6,51.6
1177173019302456576,2020-05,0,1506.33,0,0,-1506.33,-1454.73
1177173019302456576,2020-11,1034.12,1393.67,681.82,0,322.27,-1132.46
1177544157731127040,2020-01,4233.51,746.2,0,0,3487.31,3487.31
1177544157731127040,2020-02,2402.26,2017.02,1144.69,2514.5,-984.57,2502.74
1177544157731127040,2020-03,3243.96,1172.15,3160.54,6803.64,-1571.29,931.45
1177544157731127040,2020-04,1599.47,1905.63,8969.15,858.51,7804.48,8735.93
1177544157731127040,2020-05,1761.29,247.3,3194.88,0,4708.87,13444.8
1177544157731127040,2020-06,1489.2,689.08,423.24,0,1223.36,14668.16
1177544157731127040,2020-07,3201.54,1750.02,5603.99,64.95,6990.56,21658.72
1177544157731127040,2020-08,2121.49,2080.58,1632.85,0,1673.76,23332.48
1177544157731127040,2020-09,1852.59,0,5165.67,3026.18,3992.08,27324.56
1177544157731127040,2020-10,0,2075.98,2898.52,1112.46,-289.92,27034.64
1177544157731127040,2020-11,6727.34,1486.97,0,2176.94,3063.43,30098.07
1177544157731127040,2020-12,997,2727.27,3910.96,1007.63,1173.06,31271.13
1179226274501617408,2020-01,7807.86,2309.51,5530.54,5828.17,5200.72,5200.72
1179226274501617408,2020-02,3977.24,6538.39,1640.91,4433.78,-5354.02,-153.3
1179226274501617408,2020-03,4289.94,6953.36,1199.17,3577.56,-5041.81,-5195.11
1179226274501617408,2020-04,3232.38,4147.23,4542.66,8043.34,-4415.53,-9610.64
1179226274501617408,2020-05,3294.61,5191.06,3567.98,4254.7,-2583.17,-12193.81
1179226274501617408,2020-06,4080.38,3691.75,1183.05,4913.49,-3341.81,-15535.62
1179226274501617408,2020-07,13438.75,3777.2,6383.65,5693.17,10352.03,-5183.59
1179226274501617408,2020-08,4710.35,3946.8,4639.06,8533.34,-3130.73,-8314.32
1179226274501617408,2020-09,2785.03,1897.52,1191.41,5314.99,-3236.07,-11550.39
1179226274501617408,2020-10,3413.06,3540.34,5069.4,6225.39,-1283.27,-12833.66
1179226274501617408,2020-11,5101.94,4814.28,8829.15,3947.08,5169.73,-7663.93
1179226274501617408,2020-12,4299.61,3401.82,5028.13,2300.79,3625.13,-4038.8
1179637238688351744,2020-01,0,5099.97,3059.3,2379.11,-4419.78,-4419.78
1179637238688351744,2020-02,0,2574.44,0,3698.38,-6272.82,-10692.6
1179637238688351744,2020-03,4501.28,5079.17,4599.84,2057.28,1964.67,-8727.93
1179637238688351744,2020-04,109.59,1769.71,3299.21,3264.77,-1625.68,-10353.61
1179637238688351744,2020-05,1390.53,678.88,3021.79,3786.22,-52.78,-10406.39
1179637238688351744,2020-06,0,4881.74,6375.24,2613.78,-1120.28,-11526.67
1179637238688351744,2020-07,602.64,3599.73,4923.28,2831.03,-904.84,-12431.51
1179637238688351744,2020-08,871.56,1224.85,446.83,5691.4,-5597.86,-18029.37
1179637238688351744,2020-09,3604.04,2185.2,4501.36,828.76,5091.44,-12937.93
1179637238688351744,2020-10,1737.58,3037.59,4719.84,1839.61,1580.22,-11357.71
1179637238688351744,2020-11,2053.46,3996.9,0,3818.13,-5761.57,-17119.28
1179637238688351744,2020-12,3668.01,1886.63,3101.16,896.33,3986.21,-13133.07
1179832357173819648,2020-01,0,764.54,0,0,-764.54,-764.54
1179832357173819648,2020-11,1442.77,0,0,1609.1,-166.33,-930.87
1179846146234826496,2020-01,12241.96,2032.83,7247.94,4900.11,12556.96,12556.96
1179846146234826496,2020-02,5847.5,2999.05,6184.03,3110.07,5922.41,18479.37
1179846146234826496,2020-03,2696.1,8954.21,4034.45,6356.82,-8580.48,9898.89
1179846146234826496,2020-04,3249.03,2615.24,8591.91,3031.69,6194.01,16092.9
1179846146234826496,2020-05,3237.11,3493.04,1220.69,6281.22,-5316.46,10776.44
1179846146234826496,2020-06,6563.98,6674.5,2250.23,6060.85,-3921.14,6855.3
1179846146234826496,2020-07,2351.98,3762.64,2499.02,4375.6,-3287.24,3568.06
1179846146234826496,2020-08,2206.47,3059.35,3994.14,0,3141.26,6709.32
1179846146234826496,2020-09,1121.79,1382.02,4356.55,3066.92,1029.4,7738.72
1179846146234826496,2020-10,4772.1,4599.41,7386.08,3741.07,3817.7,11556.42
1179846146234826496,2020-11,3577.13,2202.62,8176.58,3347.97,6203.12,17759.54
1179846146234826496,2020-12,3731.1,1784.84,2496.3,3147.65,1294.91,19054.45
1181475318149096192,2020-02,0,1832.13,0,718.73,-2550.86,-2550.86
1181475318149096192,2020-04,484.5,1932.76,0,2596.6,-4044.86,-6595.72
1181475318149096192,2020-05,863.63,231.43,1849.22,0,2481.42,-4114.3
1181475318149096192,2020-07,0,840.44,732.1,2686.34,-2794.68,-6908.98
1181475318149096192,2020-08,0,1285.94,1654.58,0,368.64,-6540.34
1181475318149096192,2020-11,0,984.68,1862.91,0,878.23,-5662.11
1181475318149096192,2020-12,0,559.42,0,0,-559.42,-6221.53
1181737240240139264,2020-01,4394.94,11209.2,5969.91,1189.86,-2034.21,-2034.21
1181737240240139264,2020-02,5653.25,7884.64,1469.52,6968.98,-7730.85,-9765.06
1181737240240139264,2020-03,955.92,2645.57,4368.78,4699.24,-2020.11,-11785.17
1181737240240139264,2020-04,1174.9,7287.98,3923.01,2155.36,-4345.43,-16130.6
1181737240240139264,2020-05,1980.19,6891.44,4889.19,6586.65,-6608.71,-22739.31
1181737240240139264,2020-06,2271.86,6164.52,3528.49,3739.85,-4104.02,-26843.33
1181737240240139264,2020-07,7444.65,5727.85,3572.85,7146.11,-1856.46,-28699.79
1181737240240139264,2020-08,9247.87,7374.17,8815.65,5880.9,4808.45,-23891.34
1181737240240139264,2020-09,4190.85,4472.09,1697,2010.88,-595.12,-24486.46
1181737240240139264,2020-10,3389.93,1723.18,1579.78,4300.76,-1054.23,-25540.69
1181737240240139264,2020-11,5566.93,4538.74,4063.27,4426.98,664.48,-24876.21
1181737240240139264,2020-12,7860.25,9161.2,4727.76,8075.6,-4648.79,-29525
1181922904690271744,2020-01,1965.7,1400.38,8675.81,2962.72,6278.41,6278.41
1181922904690271744,2020-02,0,4647.41,4888.29,3813.87,-3572.99,2705.42
1181922904690271744,2020-03,1400.58,5494.84,3001.51,3861.1,-4953.85,-2248.43
1181922904690271744,2020-04,0,3850.19,4804.47,3686.91,-2732.63,-4981.06
1181922904690271744,2020-05,0,2792.75,1777.07,2280.64,-3296.32,-8277.38
1181922904690271744,2020-06,1046.8,4155.41,2336.91,2440.47,-3212.17,-11489.55
1181922904690271744,2020-07,2398.7,1307.26,3493.99,4741.94,-156.51,-11646.06
1181922904690271744,2020-08,2818.23,1720.4,2513.87,2821.18,790.52,-10855.54
1181922904690271744,2020-09,5986.6,1548.67,1126.23,7106.73,-1542.57,-12398.11
1181922904690271744,2020-10,4548.01,3944.72,2761.22,2848.74,515.77,-11882.34
1181922904690271744,2020-11,5187.33,6358.99,3067.47,3043.83,-1148.02,-13030.36
1181922904690271744,2020-12,3427.67,5547.2,5880.69,3439.4,321.76,-12708.6
1183192964232210944,2020-01,5190.55,3650.36,3970.17,5883.34,-372.98,-372.98
1183192964232210944,2020-02,3200.34,4459.13,5561.15,4411.66,-109.3,-482.28
1183192964232210944,2020-03,5914.43,238.6,4719.71,1864.01,8531.53,8049.25
1183192964232210944,2020-04,10687.23,4972.52,5822.44,9206.02,2331.13,10380.38
1183192964232210944,2020-05,3001.82,11263.77,3962.42,6789.54,-11089.07,-708.69
1183192964232210944,2020-06,5330.34,4463.88,2541.45,1601.44,1806.47,1097.78
1183192964232210944,2020-07,5054.89,9900.2,4809.37,6748.86,-6784.8,-5687.02
1183192964232210944,2020-08,5410.07,6736.15,3541.38,3830.09,-1614.79,-7301.81
1183192964232210944,2020-09,2166.32,6805.59,5897.71,6770.43,-5511.99,-12813.8
1183192964232210944,2020-10,2722.57,4419.65,7301.13,2927.07,2676.98,-10136.82
1183192964232210944,2020-11,4668.95,954.96,4028.38,1956.6,5785.77,-4351.05
1183192964232210944,2020-12,4519.15,3130.83,3375.58,2415.74,2348.16,-2002.89
1183821455117358080,2020-01,4227.61,4248.98,6403.03,3799.23,2582.43,2582.43
1183821455117358080,2020-02,1661.9,2146.7,3360.84,3245.4,-369.36,2213.07
1183821455117358080,2020-03,1023.55,2983.24,8743.71,6856.19,-72.17,2140.9
1183821455117358080,2020-04,7130.11,3205.52,4934.31,4882.81,3976.09,6116.99
1183821455117358080,2020-05,4659.66,890.33,0,4375.16,-605.83,5511.16
1183821455117358080,2020-06,5328.39,4986.6,3401.32,6081.02,-2337.91,3173.25
1183821455117358080,2020-07,2765.16,6471.46,5458.28,3551.39,-1799.41,1373.84
1183821455117358080,2020-08,4280.79,4395.46,3442.02,4019.48,-692.13,681.71
1183821455117358080,2020-09,5093.84,3867.65,6722.39,2604.03,5344.55,6026.26
1183821455117358080,2020-10,2393.97,3760.63,4652.73,1966.79,1319.28,7345.54
1183821455117358080,2020-11,206.87,3185.8,4329.99,350.05,1001.01,8346.55
1183821455117358080,2020-12,2412.36,2642.01,7487.25,2025.65,5231.95,13578.5
1183986025740465408,2020-03,853.17,0,1108.61,0,1961.78,1961.78
1183986025740465408,2020-05,0,944.07,0,0,-944.07,1017.71
1183986025740465408,2020-06,439.44,0,0,0,439.44,1457.15
1183986025740465408,2020-09,1465.58,0,458.89,0,1924.47,3381.62
1184201848651400192,2020-01,5050.2,5483.46,3858.42,2603.77,821.39,821.39
1184201848651400192,2020-02,2357.47,2841.41,6123.08,5373.06,266.08,1087.47
1184201848651400192,2020-03,1315.17,2507.66,3759.27,3694.5,-1127.72,-40.25
1184201848651400192,2020-04,604.53,4437.32,3107.17,287.96,-1013.58,-1053.83
1184201848651400192,2020-05,1075.28,2668.49,6285.39,415.24,4276.94,3223.11
1184201848651400192,2020-06,1784.9,515.3,2705.13,4890.91,-916.18,2306.93
1184201848651400192,2020-07,4846.92,1945.27,5946.41,0,8848.06,11154.99
1184201848651400192,2020-08,4252.4,3421.68,11973.56,3040.17,9764.11,20919.1
1184201848651400192,2020-09,2489.34,3559.08,4013.17,4035.58,-1092.15,19826.95
1184201848651400192,2020-10,3865.67,120.24,2153.27,0,5898.7,25725.65
1184201848651400192,2020-11,6064.33,5439.26,3704.77,2834.83,1495.01,27220.66
1184201848651400192,2020-12,1490,3998.09,1214.15,3034.87,-4328.81,22891.85
1184997338439076352,2020-01,3195.83,2157.59,0,0,1038.24,1038.24
1184997338439076352,2020-03,2473.23,3935.69,1636.01,43.8,129.75,1167.99
1184997338439076352,2020-04,1445.03,3255.5,5361.17,267.56,3283.14,4451.13
1184997338439076352,2020-05,1449.06,1580.04,2073.67,1257.42,685.27,5136.4
1184997338439076352,2020-06,1215.89,1156.45,153.93,6516.53,-6303.16,-1166.76
1184997338439076352,2020-07,482.43,3037.55,1248.79,1440.49,-2746.82,-3913.58
1184997338439076352,2020-08,399.01,1029.81,0,2497.63,-3128.43,-7042.01
1184997338439076352,2020-09,0,1928.14,0,1539.89,-3468.03,-10510.04
1184997338439076352,2020-10,5293.08,1730.95,1725.4,942.26,4345.27,-6164.77
1184997338439076352,2020-11,2455.6,0,392.27,1880.02,967.85,-5196.92
1184997338439076352,2020-12,0,4890.58,4318.02,194.31,-766.87,-5963.79
1185001353883719936,2020-01,6447.16,1924.15,3722.79,4965.29,3280.51,3280.51
1185001353883719936,2020-02,6174.63,646.32,2698.29,3286.96,4939.64,8220.15
1185001353883719936,2020-03,5985.26,5351.85,0,3380.69,-2747.28,5472.87
1185001353883719936,2020-04,2491.17,962.63,6103.56,1913.14,5718.96,11191.83
1185001353883719936,2020-05,5032.14,1883.87,7625.28,2817.29,7956.26,19148.09
1185001353883719936,2020-06,3708.51,483.5,133.97,5335.46,-1976.48,17171.61
1185001353883719936,2020-07,5334.46,5067.41,2301.46,2363.39,205.12,17376.73
1185001353883719936,2020-08,5881.2,2123.56,2403.78,4319.71,1841.71,19218.44
1185001353883719936,2020-09,2592.34,2404.09,3340.57,723.35,2805.47,22023.91
1185001353883719936,2020-10,7181.19,4550.93,5510.1,1935.13,6205.23,28229.14
1185001353883719936,2020-11,2465.01,2751.58,2478.96,2652.52,-460.13,27769.01
1185001353883719936,2020-12,6975.93,919.67,6731.87,2138.48,10649.65,38418.66
1185864894030962688,2020-01,2100.87,1896.54,2620.4,2792.13,32.6,32.6
1185864894030962688,2020-02,5515.02,5058.84,3584.34,4256.3,-215.78,-183.18
1185864894030962688,2020-03,3907.54,3753.56,4686.19,212.8,4627.37,4444.19
1185864894030962688,2020-04,4163.27,446.55,1081.41,0,4798.13,9242.32
1185864894030962688,2020-05,5814.58,5027.97,702.83,4350.35,-2860.91,6381.41
1185864894030962688,2020-06,2507,1126.3,655.63,3167.94,-1131.61,5249.8
1185864894030962688,2020-07,3618.68,3810.67,643.07,3697.75,-3246.67,2003.13
1185864894030962688,2020-08,769.11,1029.29,3371.78,2288.5,823.1,2826.23
1185864894030962688,2020-09,5343.52,5775.9,2416,1655.76,327.86,3154.09
1185864894030962688,2020-10,854.92,2480.65,6956.11,3793.57,1536.81,4690.9
1185864894030962688,2020-11,989.6,3188.78,2505.03,0,305.85,4996.75
1185864894030962688,2020-12,1281.01,4394.74,2623.22,1079.52,-1570.03,3426.72
1185875650104176384,2020-01,7216.78,7330.74,5971.18,3422.43,2434.79,2434.79
1185875650104176384,2020-02,4539.89,3251.56,7400.71,3865.69,4823.35,7258.14
1185875650104176384,2020-03,4635.89,2529.43,3324.41,1965.64,3465.23,10723.37
1185875650104176384,2020-04,1089.73,7504.76,2875.09,285.64,-3825.58,6897.79
1185875650104176384,2020-05,6849.83,5641.18,259.95,3599.78,-2131.18,4766.61
1185875650104176384,2020-06,6900.77,5045.19,5045.76,3821.34,3080,7846.61
1185875650104176384,2020-07,4731.27,5405.99,5513.19,4575.02,263.45,8110.06
1185875650104176384,2020-08,5701.4,568.71,5684.51,10117.04,700.16,8810.22
1185875650104176384,2020-09,5367.22,2501.04,3906.69,3388.06,3384.81,12195.03
1185875650104176384,2020-10,2518.75,7930.37,2019.64,5488.49,-8880.47,3314.56
1185875650104176384,2020-11,5912.19,1536.22,5624.47,401.91,9598.53,12913.09
1185875650104176384,2020-12,3255.71,10707.73,5228.41,2701.02,-4924.63,7988.46
1186135383698762240,2020-01,1786.31,1686.96,0,5879.11,-5779.76,-5779.76
1186135383698762240,2020-02,1720.65,26.6,2901.31,2740.44,1854.92,-3924.84
1186135383698762240,2020-03,72.31,1715.47,0,188.94,-1832.1,-5756.94
1186135383698762240,2020-05,2588.28,238.78,4086.11,1114.76,5320.85,-436.09
1186135383698762240,2020-06,3402.55,601.33,0,524.09,2277.13,1841.04
1186135383698762240,2020-07,0,4471.72,0,2881.29,-7353.01,-5511.97
1186135383698762240,2020-08,2222.28,2071.37,6047.38,0,6198.29,686.32
1186135383698762240,2020-09,208.62,1845.24,0,0,-1636.62,-950.3
1186135383698762240,2020-10,3434.63,0,2538.53,1821.68,4151.48,3201.18
1186135383698762240,2020-11,4550.56,3526.5,2854.69,0,3878.75,7079.93
1186135383698762240,2020-12,0,1452.34,1694.26,2951.11,-2709.19,4370.74
1186589352919246080,2020-01,4613.34,2453.77,1554.98,3028.32,686.23,686.23
1186589352919246080,2020-02,2771.69,1582.61,3284.97,5156.54,-682.49,3.74
1186589352919246080,2020-03,7612.14,0,2957.36,3780.8,6788.7,6792.44
1186589352919246080,2020-04,6417.13,2367.88,1518.39,4544.8,1022.84,7815.28
1186589352919246080,2020-05,3579.31,967.47,7028.49,2738.66,6901.67,14716.95
1186589352919246080,2020-06,4414.86,5807.58,3866.35,3169.87,-696.24,14020.71
1186589352919246080,2020-07,5587.45,4474.69,4693.56,5239.34,566.98,14587.69
1186589352919246080,2020-08,1542.83,5266.76,5820.92,5761.47,-3664.48,10923.21
1186589352919246080,2020-09,1829.7,4956.06,2240.18,3978.6,-4864.78,6058.43
1186589352919246080,2020-10,990.06,3932.85,6893.26,3645.17,305.3,6363.73
1186589352919246080,2020-11,2587.78,3765.08,2860.43,3365.9,-1682.77,4680.96
1186589352919246080,2020-12,1916.75,10295.41,4311.69,2510.5,-6577.47,-1896.51
1187383254238527488,2020-01,1931.28,448.19,0,1210.02,273.07,273.07
1187383254238527488,2020-02,2044.96,0,0,4685.05,-2640.09,-2367.02
1187383254238527488,2020-03,1964.88,2749.75,2952.17,3130.03,-962.73,-3329.75
1187383254238527488,2020-04,0,855.27,0,1727.79,-2583.06,-5912.81
1187383254238527488,2020-05,2268.49,0,0,3207.07,-938.58,-6851.39
1187383254238527488,2020-06,2536.93,1617.71,531.22,1341.37,109.07,-6742.32
1187383254238527488,2020-08,4118.86,5359.33,592.13,1326.86,-1975.2,-8717.52
1187383254238527488,2020-10,1728.75,0,1789.55,728.39,2789.91,-5927.61
1187383254238527488,2020-11,2490.82,114.13,3230.42,2119.78,3487.33,-2440.28
1187383254238527488,2020-12,131.59,2764.66,1503.74,0,-1129.33,-3569.61
1188119922556041984,2020-03,917.64,363.73,1978.59,5302.59,-2770.09,-2770.09
1188119922556041984,2020-04,522.9,1910.61,0,0,-1387.71,-4157.8
1188119922556041984,2020-05,2753.21,2188.56,628.56,2088.22,-895.01,-5052.81
1188119922556041984,2020-06,1915.09,164.26,0,0,1750.83,-3301.98
1188119922556041984,2020-07,0,438.3,460.47,1646.41,-1624.24,-4926.22
1188119922556041984,2020-08,1077.94,1494.68,1615.66,1012.28,186.64,-4739.58
1188119922556041984,2020-09,1207.6,683.94,1859.57,940.15,1443.08,-3296.5
1188119922556041984,2020-10,1980.23,3444.86,1587.62,0,122.99,-3173.51
1188119922556041984,2020-11,2181.63,1293.39,0,0,888.24,-2285.27
1188119922556041984,2020-12,2111.46,1211.24,2746.66,3032.68,614.2,-1671.07
1189313400071555072,2020-01,5188.41,3239.93,1981.42,3744.01,185.89,185.89
1189313400071555072,2020-02,2973.82,1164,1731.78,1964.74,1576.86,1762.75
1189313400071555072,2020-03,3072.4,1277.73,256.7,934.94,1116.43,2879.18
1189313400071555072,2020-04,0,4569.6,3618.13,3691.52,-4642.99,-1763.81
1189313400071555072,2020-05,0,1557.03,2860.92,4282.65,-2978.76,-4742.57
1189313400071555072,2020-06,3764.5,1948.66,1279.71,1084.37,2011.18,-2731.39
1189313400071555072,2020-07,1399.5,3310.86,1912.36,2222.26,-2221.26,-4952.65
1189313400071555072,2020-08,1326.82,3341.88,744.91,1647.09,-2917.24,-7869.89
1189313400071555072,2020-09,3477.7,781.49,674.82,173.03,3198,-4671.89
1189313400071555072,2020-10,1422.7,1941.3,2454.6,0,1936,-2735.89
1189313400071555072,2020-11,8463.52,1011.02,4.37,3195.65,4261.22,1525.33
1189313400071555072,2020-12,2274.94,3161.55,0,0,-886.61,638.72
1189637438703870976,2020-01,1838.8,4573.22,786,4781.15,-6729.57,-6729.57
1189637438703870976,2020-02,2704.21,4063.16,6095.19,9478.08,-4741.84,-11471.41
1189637438703870976,2020-03,3760.23,7205.23,10226.09,6464.1,316.99,-11154.42
1189637438703870976,2020-04,1582.86,3744.82,10196.22,4069.2,3965.06,-7189.36
1189637438703870976,2020-05,6221.83,632.43,4569.31,2180,7978.71,789.35
1189637438703870976,2020-06,9351.18,6372.93,3305.82,3022.27,3261.8,4051.15
1189637438703870976,2020-07,3285.4,11223.02,3077.01,3894.08,-8754.69,-4703.54
1189637438703870976,2020-08,1681.42,4137.28,5289.23,5490.9,-2657.53,-7361.07
1189637438703870976,2020-09,4574.4,625.54,6398.87,5424.38,4923.35,-2437.72
1189637438703870976,2020-10,2990.65,4374.13,5281.46,5906.9,-2008.92,-4446.64
1189637438703870976,2020-11,3333.53,2042.88,462.44,3747.03,-1993.94,-6440.58
1189637438703870976,2020-12,9141.08,4273.25,5114.25,691.13,9290.95,2850.37
1190914348107151104,2020-01,7067.49,2017.67,5776.32,5898.03,4928.11,4928.11
1190914348107151104,2020-02,377.63,3644.5,3052.74,3414.86,-3628.99,1299.12
1190914348107151104,2020-03,6360.97,2103.95,3109.71,3887.9,3478.83,4777.95
1190914348107151104,2020-04,2883.13,762.87,5411.73,3953.22,3578.77,8356.72
1190914348107151104,2020-05,8455.78,5806.5,4028.76,6130.38,547.66,8904.38
1190914348107151104,2020-06,2238.79,4828.6,2308.9,6331.99,-6612.9,2291.48
1190914348107151104,2020-07,1141.31,7176.64,8213.63,225.64,1952.66,4244.14
1190914348107151104,2020-08,1697.01,7808,3308.36,3767.02,-6569.65,-2325.51
1190914348107151104,2020-09,3811.96,3881.82,4643.4,4416.48,157.06,-2168.45
1190914348107151104,2020-10,3299.3,2553.69,5128.27,1996.09,3877.79,1709.34
1190914348107151104,2020-11,6059.54,4180,4681.05,244.47,6316.12,8025.46
1190914348107151104,2020-12,6457.8,3156.6,2839.86,2159.01,3982.05,12007.51
1192952158768389376,2020-02,0,1854.26,0,1958.35,-3812.61,-3812.61
1192952158768389376,2020-03,0,652.44,0,3272.79,-3925.23,-7737.84
1192952158768389376,2020-05,1664.41,0,2691.65,0,4356.06,-3381.78
1192952158768389376,2020-06,1921.34,3063.93,4301.84,578.01,2581.24,-800.54
1192952158768389376,2020-07,927.71,0,0,0,927.71,127.17
1192952158768389376,2020-08,0,232.32,972.36,2961.06,-2221.02,-2093.85
1192952158768389376,2020-09,0,1610.42,1082.27,1285.51,-1813.66,-3907.51
1192952158768389376,2020-10,1236.98,4953.94,0,4370.43,-8087.39,-11994.9
1192952158768389376,2020-11,1547.77,754.46,1407.75,2254.02,-52.96,-12047.86
1192952158768389376,2020-12,1352.45,1375.92,5804.54,0,5781.07,-6266.79
1192962979515616512,2020-01,0,802.79,440.94,985.51,-1347.36,-1347.36
1192962979515616512,2020-03,0,866.32,0,0,-866.32,-2213.68
1192962979515616512,2020-04,0,1964.14,545.46,1420.1,-2838.78,-5052.46
1192962979515616512,2020-05,0,749.81,0,1898.47,-2648.28,-7700.74
1192962979515616512,2020-06,0,1821.64,0,0,-1821.64,-9522.38
1192962979515616512,2020-08,0,669.42,0,3868.02,-4537.44,-14059.82
1192962979515616512,2020-09,0,1771.13,174.12,1759.94,-3356.95,-17416.77
1193234806014966272,2020-01,1955.54,4822.12,5691.82,2542.67,282.57,282.57
1193234806014966272,2020-02,2365.85,4844.8,5791.42,3591.44,-278.97,3.6
1193234806014966272,2020-03,7029,1775.77,1707.77,4985.76,1975.24,1978.84
1193234806014966272,2020-04,228.58,1712.88,3587.65,3331.55,-1228.2,750.64
1193234806014966272,2020-05,4197.1,1548.14,934.66,2114.09,1469.53,2220.17
1193234806014966272,2020-06,3588.18,607.93,1415.48,3833.55,562.18,2782.35
1193234806014966272,2020-07,2865.32,2958.15,1085.26,4083.43,-3091,-308.65
1193234806014966272,2020-08,2520.62,4193.52,5410.64,79.14,3658.6,3349.95
1193234806014966272,2020-09,2922.23,1378.39,2232.59,3008.54,767.89,4117.84
1193234806014966272,2020-10,2964.66,3795.54,6326.49,7296.12,-1800.51,2317.33
1193234806014966272,2020-11,0,6799.31,4978.21,844.63,-2665.73,-348.4
1193234806014966272,2020-12,1752.26,2685.76,2974.03,1987.81,52.72,-295.68
1194200142771996160,2020-01,520.5,4235.09,3953.78,2145.02,-1905.83,-1905.83
1194200142771996160,2020-02,4469.63,41.49,5383.3,3793.88,6017.56,4111.73
1194200142771996160,2020-03,2723.72,1340.29,6518.39,8517.46,-615.64,3496.09
1194200142771996160,2020-04,4440.7,0,4779.48,4780.74,4439.44,7935.53
1194200142771996160,2020-05,6995.58,7083.69,4016.9,2620.54,1308.25,9243.78
1194200142771996160,2020-06,2410.42,1631.97,4935.17,5049.71,663.91,9907.69
1194200142771996160,2020-07,1155.01,6664.78,2012.73,174.98,-3672.02,6235.67
1194200142771996160,2020-08,4778.15,3635.81,4123.84,2815.31,2450.87,8686.54
1194200142771996160,2020-09,6716.28,1050.11,0,5521.71,144.46,8831
1194200142771996160,2020-10,1773.6,1523.09,1488.42,3894.74,-2155.81,6675.19
1194200142771996160,2020-11,3242.59,1510.93,3918.78,3255.51,2394.93,9070.12
1194200142771996160,2020-12,6608.66,54.01,3269.9,0,9824.55,18894.67
1194250273909380864,2020-01,0,6682.35,2447.5,5200.01,-9434.86,-9434.86
1194250273909380864,2020-02,6404.02,2480.05,7753.46,3901.47,7775.96,-1658.9
1194250273909380864,2020-03,7333.06,2902.09,5110.93,700.26,8841.64,7182.74
1194250273909380864,2020-04,6694.6,175.15,0,1925.72,4593.73,11776.47
1194250273909380864,2020-05,1905.92,7550.97,1822.11,118.2,-3941.14,7835.33
1194250273909380864,2020-06,4781.09,1447.53,4573.26,2160.57,5746.25,13581.58
1194250273909380864,2020-07,1973.95,2738.32,7158.71,1235.36,5158.98,18740.56
1194250273909380864,2020-08,3220,4729.22,2236.97,3664.1,-2936.35,15804.21
1194250273909380864,2020-09,842.1,4202.61,2886.45,6855.13,-7329.19,8475.02
1194250273909380864,2020-10,2436.11,435.18,0,2060.25,-59.32,8415.7
1194250273909380864,2020-11,2473.48,6369.23,2912.71,4090.35,-5073.39,3342.31
1194250273909380864,2020-12,2011.82,2045.56,1350.2,7203.61,-5887.15,-2544.84
1195954516810286080,2020-01,0,1688.67,1348.17,2546.31,-2886.81,-2886.81
1195954516810286080,2020-03,0,850.31,4816.89,0,3966.58,1079.77
1195954516810286080,2020-04,564.41,1353.21,1989.37,3216.03,-2015.46,-935.69
1195954516810286080,2020-05,1374.19,3407.28,1769.54,0,-263.55,-1199.24
1195954516810286080,2020-07,2512.53,5137.12,1806.92,0,-817.67,-2016.91
1195954516810286080,2020-08,1468.51,1150.36,2349.32,1755.31,912.16,-1104.75
1195954516810286080,2020-09,1970.03,1787.71,3058.3,1620.17,1620.45,515.7
1195954516810286080,2020-10,0,4198.57,0,325.74,-4524.31,-4008.61
1195954516810286080,2020-11,2759.47,2330.54,4412.86,3913.77,928.02,-3080.59
1195954516810286080,2020-12,3289.29,39,1681.75,4231.83,700.21,-2380.38
1196421469614266624,2020-01,888.25,0,0,580.54,307.71,307.71
1196421469614266624,2020-02,0,556.67,789.18,0,232.51,540.22
1196421469614266624,2020-03,546.4,0,0,0,546.4,1086.62
1196421469614266624,2020-04,343.08,20.76,2981.81,1109.88,2194.25,3280.87
1196421469614266624,2020-06,1862.83,0,1580.5,0,3443.33,6724.2
1196421469614266624,2020-07,563.84,0,639.14,0,1202.98,7927.18
1196421469614266624,2020-09,1760.61,1651.24,0,0,109.37,8036.55
1196421469614266624,2020-10,3005.18,1990.13,1947.4,1682.16,1280.29,9316.84
1197032890448005632,2020-07,1032.94,0,0,1920.33,-887.39,-887.39
1197032890448005632,2020-10,0,1263.43,0,0,-1263.43,-2150.82
1198182172844090880,2020-01,2696.86,1716.18,2206.72,0,3187.4,3187.4
1198182172844090880,2020-02,0,280.15,0,0,-280.15,2907.25
1198182172844090880,2020-03,0,804.84,0,1093.93,-1898.77,1008.48
1198182172844090880,2020-04,1361.95,0,891.95,0,2253.9,3262.38
1198182172844090880,2020-05,0,3100.18,3197.42,1500.55,-1403.31,1859.07
1198182172844090880,2020-07,1115.74,0,2880.55,641.07,3355.22,5214.29
1198182172844090880,2020-08,0,2506.68,0,0,-2506.68,2707.61
1198182172844090880,2020-09,1598.01,1345.23,0,0,252.78,2960.39
1198182172844090880,2020-11,1837.19,1077.5,1711.82,3810.16,-1338.65,1621.74
1198182172844090880,2020-12,226.15,1686.49,0,0,-1460.34,161.4
1198512802618083840,2020-01,3227.53,0,2083.74,3347.79,1963.48,1963.48
1198512802618083840,2020-02,1988.42,0.26,0,0,1988.16,3951.64
1198512802618083840,2020-03,4634.79,2545.1,1998.92,1022.38,3066.23,7017.87
1198512802618083840,2020-04,5432.98,2361.4,4691.6,3683.15,4080.03,11097.9
1198512802618083840,2020-05,5562.74,2218.22,1005.29,5004.58,-654.77,10443.13
1198512802618083840,2020-06,1660.98,239.87,0,839.61,581.5,11024.63
1198512802618083840,2020-07,1983.57,2329.51,570.51,1916.09,-1691.52,9333.11
1198512802618083840,2020-08,1937.02,5401.61,4143.18,1727.77,-1049.18,8283.93
1198512802618083840,2020-09,1383.64,3652.03,2288.93,3504.21,-3483.67,4800.26
1198512802618083840,2020-10,2510.08,4861.11,448.21,1911.05,-3813.87,986.39
1198512802618083840,2020-11,1678.37,1252.81,1972.02,2152.91,244.67,1231.06
1198512802618083840,2020-12,957.97,0,1094.97,0,2052.94,3284
1199482819504654592,2020-01,4060.27,7413.08,3687.88,8248.26,-7913.19,-7913.19
1199482819504654592,2020-02,5750.97,4189.47,2015.87,2663,914.37,-6998.82
1199482819504654592,2020-03,2826.41,2280.51,8092.35,6703.26,1934.99,-5063.83
1199482819504654592,2020-04,5627.38,3387.01,3451.25,3431.02,2260.6,-2803.23
1199482819504654592,2020-05,10054.99,5257.98,2600.84,589.86,6807.99,4004.76
1199482819504654592,2020-06,5028.93,3729.69,8608.85,2364.7,7543.39,11548.15
1199482819504654592,2020-07,7198.46,1575.39,6354.17,2998.42,8978.82,20526.97
1199482819504654592,2020-08,1104.36,4844.14,9133.65,4317.96,1075.91,21602.88
1199482819504654592,2020-09,4076.17,5513,4387.93,1849.25,1101.85,22704.73
1199482819504654592,2020-10,6708.81,7756.31,3311.73,417.32,1846.91,24551.64
1199482819504654592,2020-11,5709.89,6209.85,6325.87,4757.85,1068.06,25619.7
1199482819504654592,2020-12,1492.47,5108.87,4736.93,4870.78,-3750.25,21869.45
1200164976378336768,2020-01,0,2668.1,1930.07,5055.73,-5793.76,-5793.76
1200164976378336768,2020-02,2116.38,2071.16,4653.07,2031.38,2666.91,-3126.85
1200164976378336768,2020-03,267.51,5221.96,1819.84,1173.83,-4308.44,-7435.29
1200164976378336768,2020-04,7170.88,3627.28,739.56,4229.7,53.46,-7381.83
1200164976378336768,2020-05,3991.75,91.88,0,1216.19,2683.68,-4698.15
1200164976378336768,2020-06,2114.76,3409.6,1796.55,7098.91,-6597.2,-11295.35
1200164976378336768,2020-07,1283.44,164.59,1729.01,2754.45,93.41,-11201.94
1200164976378336768,2020-08,1820.42,2256.79,0,3999.76,-4436.13,-15638.07
1200164976378336768,2020-09,4482.06,3263.43,2775.6,1203.88,2790.35,-12847.72
1200164976378336768,2020-10,1835.06,1921.95,0,5017.77,-5104.66,-17952.38
1200164976378336768,2020-11,559.93,5075.34,2190.26,4225.16,-6550.31,-24502.69
1200164976378336768,2020-12,2973.5,5138.09,2008.49,4887.33,-5043.43,-29546.12
1200313281852182016,2020-01,3615.23,3244.76,2198.61,8300.48,-5731.4,-5731.4
1200313281852182016,2020-02,7838.78,1719.25,10492.19,4519.96,12091.76,6360.36
1200313281852182016,2020-03,2407.23,8854.7,2178.49,4319.93,-8588.91,-2228.55
1200313281852182016,2020-04,4622.28,1857.46,3556.59,6474.4,-152.99,-2381.54
1200313281852182016,2020-05,3982.13,3714.9,7836.6,6789.27,1314.56,-1066.98
1200313281852182016,2020-06,2943.25,9574.24,5547.7,3321.93,-4405.22,-5472.2
1200313281852182016,2020-07,4856.36,7299.32,2752.6,2688.84,-2379.2,-7851.4
1200313281852182016,2020-08,4857.38,3683.12,3920.86,8017.97,-2922.85,-10774.25
1200313281852182016,2020-09,2182.45,3343.97,4085.06,3865.48,-941.94,-11716.19
1200313281852182016,2020-10,4659.04,7818.18,5569.17,4012.51,-1602.48,-13318.67
1200313281852182016,2020-11,4973.98,6906.43,5885.56,5053.78,-1100.67,-14419.34
1200313281852182016,2020-12,3627.25,0,7224.81,5367.07,5484.99,-8934.35
1201114577047030016,2020-01,5458.1,3504.99,1235.68,4901.01,-1712.22,-1712.22
1201114577047030016,2020-02,1519.59,897.2,1899.73,3496.56,-974.44,-2686.66
1201114577047030016,2020-03,293.05,5566.97,4720.08,3747.05,-4300.89,-6987.55
1201114577047030016,2020-04,2061.53,1996.59,1302.11,0,1367.05,-5620.5
1201114577047030016,2020-05,3150.67,2827.66,2156.2,1281.73,1197.48,-4423.02
1201114577047030016,2020-06,2484.33,3155,2226.35,0,1555.68,-2867.34
1201114577047030016,2020-07,666.81,5429.71,7838.66,3055.64,20.12,-2847.22
1201114577047030016,2020-08,2508.82,3603.89,3427.03,2050.27,281.69,-2565.53
1201114577047030016,2020-09,1098.02,4776.86,2922.41,2684.99,-3441.42,-6006.95
1201114577047030016,2020-10,1445.68,109.9,5188.81,1888.37,4636.22,-1370.73
1201114577047030016,2020-11,1908.95,1218.84,561.01,1751.31,-500.19,-1870.92
1201114577047030016,2020-12,5689.36,6176.07,3450.39,2867.95,95.73,-1775.19
1201884970732422144,2020-02,1862.16,0,0,0,1862.16,1862.16
1201884970732422144,2020-03,1191.48,0,0,0,1191.48,3053.64
1201884970732422144,2020-04,0,1960.49,0,316.71,-2277.2,776.44
1203118863883411456,2020-01,4947.05,1647.91,1543.79,3525.05,1317.88,1317.88
1203118863883411456,2020-02,3125.74,2128.55,2865.22,2993.68,868.73,2186.61
1203118863883411456,2020-03,3484.46,1987.53,5048.69,7302.33,-756.71,1429.9
1203118863883411456,2020-04,4258.39,2497.94,0,246.34,1514.11,2944.01
1203118863883411456,2020-05,6297.53,4355.94,0,7323.27,-5381.68,-2437.67
1203118863883411456,2020-06,3561.05,4862.15,1817.89,4190.1,-3673.31,-6110.98
1203118863883411456,2020-07,2466.6,1677.44,1627.99,1132.64,1284.51,-4826.47
1203118863883411456,2020-08,6077.84,5554.64,3338.63,1418.93,2442.9,-2383.57
1203118863883411456,2020-09,2657.56,4495.03,3443.11,440.15,1165.49,-1218.08
1203118863883411456,2020-10,3405.96,3088.01,5108.57,1655,3771.52,2553.44
1203118863883411456,2020-11,0,308.94,1380.38,3085.73,-2014.29,539.15
1203118863883411456,2020-12,0,2605.26,1892.94,4579.89,-5292.21,-4753.06
1203718471916291840,2020-01,675.17,0,2062.17,0,2737.34,2737.34
1203718471916291840,2020-05,0,48.81,0,0,-48.81,2688.53
1203718471916291840,2020-07,0,1772.55,0,309.53,-2082.08,606.45
1203718471916291840,2020-10,855.86,0,0,0,855.86,1462.31
1203718471916291840,2020-11,223.91,0,963.94,1468.88,-281.03,1181.28
1203718471916291840,2020-12,0,1223.65,524.18,0,-699.47,481.81
1203919281535061248,2020-01,2246.98,1195.41,3513.91,870.26,3695.22,3695.22
1203919281535061248,2020-02,2784.94,2438.9,5694.02,4601.32,1438.74,5133.96
1203919281535061248,2020-03,1753.27,2986.77,690.16,3093.65,-3636.99,1496.97
1203919281535061248,2020-04,2822.11,5573.03,2766.34,2029.39,-2013.97,-517
1203919281535061248,2020-05,2412.21,7381.42,2151.51,5086.6,-7904.3,-8421.3
1203919281535061248,2020-06,0,4565.81,1925.89,1018.49,-3658.41,-12079.71
1203919281535061248,2020-07,4004.96,4337.97,2510.51,6965.88,-4788.38,-16868.09
1203919281535061248,2020-08,5314.68,2778.58,2040.85,3836.68,740.27,-16127.82
1203919281535061248,2020-09,1898.32,1744.11,816.48,3087.39,-2116.7,-18244.52
1203919281535061248,2020-10,5146.48,2418.95,7960.81,4055.51,6632.83,-11611.69
1203919281535061248,2020-11,401.68,5346.07,428.76,0,-4515.63,-16127.32
1203919281535061248,2020-12,5140.41,2761.33,1816.79,7120.87,-2925,-19052.32
1204867597188626432,2020-01,4208.98,6334.27,6875.63,3804.23,946.11,946.11
1204867597188626432,2020-02,5600.89,5637.39,994.08,3856.83,-2899.25,-1953.14
1204867597188626432,2020-03,1383.13,6120.21,4113.33,680.23,-1303.98,-3257.12
1204867597188626432,2020-04,1089.4,1506.49,3612.6,3596.84,-401.33,-3658.45
1204867597188626432,2020-05,930.03,6374.3,3558.6,2509.87,-4395.54,-8053.99
1204867597188626432,2020-06,681.21,1991.5,2673.06,5395.53,-4032.76,-12086.75
1204867597188626432,2020-07,4137.3,739.1,3075.84,5162.69,1311.35,-10775.4
1204867597188626432,2020-08,4137.42,513.8,4238.81,3717.13,4145.3,-6630.1
1204867597188626432,2020-09,7273.78,6774.94,3973.91,283.51,4189.24,-2440.86
1204867597188626432,2020-10,2140.94,1618.23,1366.08,3512.28,-1623.49,-4064.35
1204867597188626432,2020-11,3166.14,3463.03,4114.87,4293.83,-475.85,-4540.2
1204867597188626432,2020-12,3360.74,279.36,728.73,5935.22,-2125.11,-6665.31
1204971991386701056,2020-01,11011.23,6703.46,3893.63,6060.46,2140.94,2140.94
1204971991386701056,2020-02,5758.32,1894.21,9809.05,2529.18,11143.98,13284.92
1204971991386701056,2020-03,5270.4,2185.63,4222.36,2918.93,4388.2,17673.12
1204971991386701056,2020-04,4957.52,4153.13,6623.44,6789.25,638.58,18311.7
1204971991386701056,2020-05,4108.12,7255.45,1128.58,3800.27,-5819.02,12492.68
1204971991386701056,2020-06,5519.34,7932.32,2929.37,3791.1,-3274.71,9217.97
1204971991386701056,2020-07,4345.83,5297.04,530.21,5042.43,-5463.43,3754.54
1204971991386701056,2020-08,3175.29,8756.35,5817.58,5706.91,-5470.39,-1715.85
1204971991386701056,2020-09,2827.61,4553.67,5421.91,5804.95,-2109.1,-3824.95
1204971991386701056,2020-10,5535.07,835.85,5869.73,7779.79,2789.16,-1035.79
1204971991386701056,2020-11,4645.52,2257.36,5225.93,3077.8,4536.29,3500.5
1204971991386701056,2020-12,3817.44,4944.55,5701.63,12587.18,-8012.66,-4512.16
1206279794188776704,2020-01,1485.71,0,589.83,543.27,1532.27,1532.27
1206279794188776704,2020-02,740.95,0,231.61,3980.81,-3008.25,-1475.98
1206279794188776704,2020-03,0,3572.61,914.91,0,-2657.7,-4133.68
1206279794188776704,2020-04,1750.79,910.19,0,0,840.6,-3293.08
1206279794188776704,2020-06,0,904.92,0,0,-904.92,-4198
1206279794188776704,2020-07,1543.02,374.6,469.13,454.94,1182.61,-3015.39
1206279794188776704,2020-08,169.78,1146.36,0,0,-976.58,-3991.97
1206279794188776704,2020-09,3358.49,0,2378.51,823.06,4913.94,921.97
1206279794188776704,2020-10,44.74,779.57,868.1,0,133.27,1055.24
1206279794188776704,2020-12,1641.64,2704.12,0,764.33,-1826.81,-771.57
1206307829493205248,2020-01,831.24,0,0,0,831.24,831.24
1206307829493205248,2020-03,2726.57,3449.68,3819.71,203.43,2893.17,3724.41
1206307829493205248,2020-04,0,529.73,156.96,0,-372.77,3351.64
1206307829493205248,2020-06,0,687.48,2914.38,0,2226.9,5578.54
1206307829493205248,2020-07,598.09,0,950.75,5169.56,-3620.72,1957.82
1206307829493205248,2020-11,13.61,868.04,0,322,-1176.43,781.39
1207763412567092992,2020-01,930.98,199.63,1180.19,3645.37,-1733.83,-1733.83
1207763412567092992,2020-02,1557.76,1548.97,0,5784.8,-5776.01,-7509.84
1207763412567092992,2020-03,1082.11,163.31,108.69,0,1027.49,-6482.35
1207763412567092992,2020-04,1825.87,0,663.99,2379.65,110.21,-6372.14
1207763412567092992,2020-05,2487.67,2271.11,1023.26,3944.39,-2704.57,-9076.71
1207763412567092992,2020-06,1050.18,3099.61,5662.86,0,3613.43,-5463.28
1207763412567092992,2020-07,0,755.3,4354.69,2173.57,1425.82,-4037.46
1207763412567092992,2020-08,1392.88,1528.21,2152.67,1818.96,198.38,-3839.08
1207763412567092992,2020-09,3321.04,0,2304.77,3675.34,1950.47,-1888.61
1207763412567092992,2020-10,690.78,310.26,7325.5,93.38,7612.64,5724.03
1207763412567092992,2020-11,1043.78,0,4298.69,1008.02,4334.45,10058.48
1207763412567092992,2020-12,1967.14,2582.53,2866.8,5600.17,-3348.76,6709.72
1207932280820772608,2020-01,1518.52,1336.16,1133.25,2445.3,-1129.69,-1129.69
1207932280820772608,2020-02,882.51,1332.09,3308.05,1673.14,1185.33,55.64
1207932280820772608,2020-03,4615.39,0,1432.67,1140.8,4907.26,4962.9
1207932280820772608,2020-04,2504.75,1319.74,992.65,2496.08,-318.42,4644.48
1207932280820772608,2020-05,2640.37,6030.66,2394.84,2363.52,-3358.97,1285.51
1207932280820772608,2020-06,577.44,0,3061.51,2782.89,856.06,2141.57
1207932280820772608,2020-07,0,3280.63,887.67,1974.72,-4367.68,-2226.11
1207932280820772608,2020-08,1242.99,378.23,945.62,3243.38,-1433,-3659.11
1207932280820772608,2020-09,3002.91,0,1760.88,2546.31,2217.48,-1441.63
1207932280820772608,2020-10,1291.87,1760.55,1883.04,3576.01,-2161.65,-3603.28
1207932280820772608,2020-11,616.3,688.08,5095.8,1742.69,3281.33,-321.95
1207932280820772608,2020-12,2580.97,3698.25,2830.66,2441.35,-727.97,-1049.92
1209084463018404864,2020-01,0,3168.75,0,1070.2,-4238.95,-4238.95
1209084463018404864,2020-02,1897.8,432.87,1559.37,684.3,2340,-1898.95
1209084463018404864,2020-03,426.03,1625.09,1027.43,0,-171.63,-2070.58
1209084463018404864,2020-04,3097.4,2423.48,956.22,2907.58,-1277.44,-3348.02
1209084463018404864,2020-05,743.73,2660.21,2632.81,831.49,-115.16,-3463.18
1209084463018404864,2020-06,1025.7,3231.57,1237.79,4123.67,-5091.75,-8554.93
1209084463018404864,2020-07,1927.92,1509.33,1433.55,5978.52,-4126.38,-12681.31
1209084463018404864,2020-08,0,4551.69,0,3244.2,-7795.89,-20477.2
1209084463018404864,2020-09,4142.17,4256.91,4077.61,0,3962.87,-16514.33
1209084463018404864,2020-11,1233.02,723.41,754.17,3066.44,-1802.66,-18316.99
1209084463018404864,2020-12,895.78,1421.48,0,0,-525.7,-18842.69
1210062777718373632,2020-01,2058.85,807.92,4508.03,3463.32,2295.64,2295.64
1210062777718373632,2020-02,4686.93,3941.39,547.53,1161.66,131.41,2427.05
1210062777718373632,2020-03,5189.02,4336.78,4969.38,2202.06,3619.56,6046.61
1210062777718373632,2020-04,1770.56,1654.71,1835.66,523.06,1428.45,7475.06
1210062777718373632,2020-05,2804.39,8598.22,3540.95,970.68,-3223.56,4251.5
1210062777718373632,2020-06,2469.62,2256.2,2024.22,3184.06,-946.42,3305.08
1210062777718373632,2020-07,3113.63,2401.01,3013.88,508.92,3217.58,6522.66
1210062777718373632,2020-08,2938.08,2427.41,4246.74,2182.8,2574.61,9097.27
1210062777718373632,2020-09,2502.05,4661.67,6752.88,2327.05,2266.21,11363.48
1210062777718373632,2020-10,3926.04,1341.49,3322.89,3105.85,2801.59,14165.07
1210062777718373632,2020-11,4499.83,1519.98,1884.11,6289.46,-1425.5,12739.57
1210062777718373632,2020-12,1612.84,3251.47,3276.09,6948.86,-5311.4,7428.17
1210403934699555072,2020-01,1797.72,0,0,0,1797.72,1797.72
1210403934699555072,2020-02,2641.78,791.67,4114.67,2860.21,3104.57,4902.29
1210403934699555072,2020-03,93.18,270.79,409.35,1858.25,-1626.51,3275.78
1210403934699555072,2020-04,3332.82,2987.9,1297.93,0,1642.85,4918.63
1210403934699555072,2020-05,1291.61,1195.94,3346.32,560.66,2881.33,7799.96
1210403934699555072,2020-06,157.8,1355.28,3040.36,123.78,1719.1,9519.06
1210403934699555072,2020-07,0,4917.66,2984.68,338.55,-2271.53,7247.53
1210403934699555072,2020-08,972.51,0,1814.25,142.95,2643.81,9891.34
1210403934699555072,2020-09,0,769.5,2915.98,2466.5,-320.02,9571.32
1210403934699555072,2020-10,581.85,82.51,1728.29,3850.11,-1622.48,7948.84
1210403934699555072,2020-11,5352.11,3037.01,201.8,3330.33,-813.43,7135.41
1210403934699555072,2020-12,1223.81,1339.37,0,1533.57,-1649.13,5486.28
1211369762537074688,2020-01,0,407.68,1250.86,0,843.18,843.18
1211369762537074688,2020-02,1760.51,0,0,0,1760.51,2603.69
1211369762537074688,2020-03,38.41,0,0,0,38.41,2642.1
1213413498701202176,2020-01,2043.89,2986.45,0,3939.15,-4881.71,-4881.71
1213413498701202176,2020-02,1374.32,2122.38,957.36,0,209.3,-4672.41
1213413498701202176,2020-03,3495.66,374.1,1899.02,4274.71,745.87,-3926.54
1213413498701202176,2020-04,897.91,3792.55,3147.12,1386.72,-1134.24,-5060.78
1213413498701202176,2020-06,1924.63,5.3,239.33,1863.79,294.87,-4765.91
1213413498701202176,2020-07,0,1976.28,0,1157.84,-3134.12,-7900.03
1213413498701202176,2020-08,1867.11,3286.61,0,3611.02,-5030.52,-12930.55
1213413498701202176,2020-11,1654.12,1168.71,0,2499.63,-2014.22,-14944.77
1213413498701202176,2020-12,667.73,688.3,503.24,1374.66,-891.99,-15836.76
1213466897199329024,2020-01,1374.99,6019.84,17.57,5674.9,-10302.18,-10302.18
1213466897199329024,2020-02,4284.21,3317.49,338.11,1168.36,136.47,-10165.71
1213466897199329024,2020-03,4336.99,3366.8,2310.36,3989.47,-708.92,-10874.63
1213466897199329024,2020-04,6699.34,3876.59,3784.13,5945.44,661.44,-10213.19
1213466897199329024,2020-05,1463.39,7182.97,3050.87,2823.84,-5492.55,-15705.74
1213466897199329024,2020-06,7215.17,3576.59,2594.11,5356.61,876.08,-14829.66
1213466897199329024,2020-07,3356.68,3583.36,1638.86,2102.5,-690.32,-15519.98
1213466897199329024,2020-08,4674.31,1383.56,5866.13,2328.84,6828.04,-8691.94
1213466897199329024,2020-09,2417.04,2976.26,4421.54,1822.97,2039.35,-6652.59
1213466897199329024,2020-10,7786.88,2018.25,3082.06,1756.25,7094.44,441.85
1213466897199329024,2020-11,1636.41,5621.59,6417.17,1162.05,1269.94,1711.79
1213466897199329024,2020-12,3645.22,3632.33,0,0,12.89,1724.68
1213479065462362624,2020-01,1311.43,6730.03,9522.93,10875.76,-6771.43,-6771.43
1213479065462362624,2020-02,6080.44,2654.43,2112.66,1874.47,3664.2,-3107.23
1213479065462362624,2020-03,8143.1,1637.76,7639.48,4223.43,9921.39,6814.16
1213479065462362624,2020-04,2077.37,3919.71,4926.3,5548.56,-2464.6,4349.56
1213479065462362624,2020-05,7262.62,10895.89,1173.78,2677.46,-5136.95,-787.39
1213479065462362624,2020-06,8526.7,7263.42,3635.47,4776.53,122.22,-665.17
1213479065462362624,2020-07,8720.75,2604.42,7030.79,7496.24,5650.88,4985.71
1213479065462362624,2020-08,3481.76,7385.47,8313.25,4443.06,-33.52,4952.19
1213479065462362624,2020-09,2157.46,3934.18,4891.4,11672.32,-8557.64,-3605.45
1213479065462362624,2020-10,7473.73,2001.17,1418.05,7027.77,-137.16,-3742.61
1213479065462362624,2020-11,4385.86,4539.75,3027.01,4516.92,-1643.8,-5386.41
1213479065462362624,2020-12,1845.91,5133.81,3903.46,3988.38,-3372.82,-8759.23
1214458214571806208,2020-01,2055.65,1820.57,0,157.18,77.9,77.9
1214458214571806208,2020-02,0,2523.45,3225.76,3286.33,-2584.02,-2506.12
1214458214571806208,2020-03,5363.84,3310.47,3501.47,1950.41,3604.43,1098.31
1214458214571806208,2020-04,2562.9,536.6,3090.6,1591.57,3525.33,4623.64
1214458214571806208,2020-05,1761.73,1284.41,913.71,1185.79,205.24,4828.88
1214458214571806208,2020-06,1069.61,6172.77,1591.24,2632.79,-6144.71,-1315.83
1214458214571806208,2020-08,6757.86,0,2805.59,1620.75,7942.7,6626.87
1214458214571806208,2020-09,575.24,1797.64,2072.75,1372.28,-521.93,6104.94
1214458214571806208,2020-10,1919.08,5022.7,0,1798.1,-4901.72,1203.22
1214458214571806208,2020-11,1652.77,2438.49,4506.55,8501.66,-4780.83,-3577.61
1214458214571806208,2020-12,3912.25,799.77,393.9,6152.02,-2645.64,-6223.25
1214651247203805440,2020-01,3037.28,0,1694.15,1350.19,3381.24,3381.24
1214651247203805440,2020-02,685.14,622.29,2200.24,4303.34,-2040.25,1340.99
1214651247203805440,2020-03,0,1798.68,614.08,0,-1184.6,156.39
1214651247203805440,2020-04,445.97,3108.3,635.91,2183.58,-4210,-4053.61
1214651247203805440,2020-05,54.33,837.08,353.76,1649,-2077.99,-6131.6
1214651247203805440,2020-06,1131.64,2727.99,0,1579.19,-3175.54,-9307.14
1214651247203805440,2020-07,1359.45,1382.69,590.05,786.88,-220.07,-9527.21
1214651247203805440,2020-08,0,106.84,531.66,0,424.82,-9102.39
1214651247203805440,2020-09,2383.98,2968.59,2021.9,1696.81,-259.52,-9361.91
1214651247203805440,2020-11,1955.34,1805.83,0,464.76,-315.25,-9677.16
1214651247203805440,2020-12,2861,0,978.46,1299.45,2540.01,-7137.15
1214741863808634112,2020-01,3180.33,917.72,4487.93,2587.85,4162.69,4162.69
1214741863808634112,2020-02,5527.68,3163.93,68.22,2733.39,-301.42,3861.27
1214741863808634112,2020-03,3443.57,2944.98,1361.27,570.37,1289.49,5150.76
1214741863808634112,2020-04,4343.98,4630.44,2875.73,1679.52,909.75,6060.51
1214741863808634112,2020-05,7068.82,1199.85,720.88,4645.59,1944.26,8004.77
1214741863808634112,2020-06,4038.61,6723.08,227.31,1785.66,-4242.82,3761.95
1214741863808634112,2020-07,3239.45,1274.53,1609.02,4442.05,-868.11,2893.84
1214741863808634112,2020-08,4489.58,2853.97,3838.35,1064.98,4408.98,7302.82
1214741863808634112,2020-09,2353.4,3984.18,1848.64,5630.89,-5413.03,1889.79
1214741863808634112,2020-10,5053.29,5559.78,6030.41,1762.7,3761.22,5651.01
1214741863808634112,2020-11,3548.39,3137.65,4623.55,1506.83,3527.46,9178.47
1214741863808634112,2020-12,504.91,6284,5687.91,1940.88,-2032.06,7146.41
1214810379084089600,2020-01,5027.49,7062.45,2609.93,8250.55,-7675.58,-7675.58
1214810379084089600,2020-02,5485.03,3726.07,4199.53,1130.3,4828.19,-2847.39
1214810379084089600,2020-03,4843.02,6048,2380.48,5690.74,-4515.24,-7362.63
1214810379084089600,2020-04,1410.25,1060.02,3413.83,5794.84,-2030.78,-9393.41
1214810379084089600,2020-05,3490.28,1920.69,2536.53,5011.87,-905.75,-10299.16
1214810379084089600,2020-06,1866.36,1796.67,2130.94,5254.62,-3053.99,-13353.15
1214810379084089600,2020-07,5706.2,995.99,2591.37,3648.88,3652.7,-9700.45
1214810379084089600,2020-08,5513.19,4307.89,1776.69,3262.77,-280.78,-9981.23
1214810379084089600,2020-09,4532.23,2781.63,10868.39,4676.16,7942.83,-2038.4
1214810379084089600,2020-10,552.98,3182.16,110.87,4632.13,-7150.44,-9188.84
1214810379084089600,2020-11,3529.53,5081.84,3657.27,2585.09,-480.13,-9668.97
1214810379084089600,2020-12,0,1840.55,0,2092.82,-3933.37,-13602.34
1214862092215853568,2020-01,0,1573.23,0,0,-1573.23,-1573.23
1214862092215853568,2020-02,0,1119.63,0,804.76,-1924.39,-3497.62
1214862092215853568,2020-03,1915.49,1512.84,1438.22,1738.76,102.11,-3395.51
1214862092215853568,2020-04,2117.79,980.27,1736.48,2119.27,754.73,-2640.78
1214862092215853568,2020-05,0,2101.78,1130.9,898.54,-1869.42,-4510.2
1214862092215853568,2020-06,2323.77,274.1,2411.75,430.33,4031.09,-479.11
1214862092215853568,2020-07,0,958.74,1972.06,0,1013.32,534.21
1214862092215853568,2020-08,1684.22,0,0,1782.09,-97.87,436.34
1214862092215853568,2020-10,778.43,1602.92,2198.62,961.98,412.15,848.49
1214862092215853568,2020-11,0,440.53,1811.4,1255.66,115.21,963.7
1214862092215853568,2020-12,1406.68,0,0,0,1406.68,2370.38
1215207833608556032,2020-01,2449.95,1707.6,0,1638.47,-896.12,-896.12
1215207833608556032,2020-02,2460.9,1368.62,1187.69,267.38,2012.59,1116.47
1215207833608556032,2020-03,2238.68,4281.21,3777.01,1831.05,-96.57,1019.9
1215207833608556032,2020-04,5066.19,886.76,2650.6,2782.11,4047.92,5067.82
1215207833608556032,2020-05,1161.66,917.13,581.02,1620.99,-795.44,4272.38
1215207833608556032,2020-06,4474.07,1026,4027.08,2189.34,5285.81,9558.19
1215207833608556032,2020-07,1731.49,1518.63,1815.28,0,2028.14,11586.33
1215207833608556032,2020-08,1410.56,2836.33,0,1266.88,-2692.65,8893.68
1215207833608556032,2020-09,0,2757.59,3270.16,1822.44,-1309.87,7583.81
1215207833608556032,2020-10,1671.97,1993.34,1337.05,2363.82,-1348.14,6235.67
1215207833608556032,2020-11,154.16,3278.1,5011.16,4439.16,-2551.94,3683.73
1215207833608556032,2020-12,2843.62,3852.78,1962.68,2041.64,-1088.12,2595.61
1215675894791390720,2020-01,608.03,587.55,0,1564.99,-1544.51,-1544.51
1215675894791390720,2020-02,320.23,0,2199.58,3432.93,-913.12,-2457.63
1215675894791390720,2020-03,3519.14,1218.49,293.76,0,2594.41,136.78
1215675894791390720,2020-04,1676.3,3496.93,983.91,2499.38,-3336.1,-3199.32
1215675894791390720,2020-05,1315.92,408.48,1946.09,4309.6,-1456.07,-4655.39
1215675894791390720,2020-06,778.96,0,0,0,778.96,-3876.43
1215675894791390720,2020-07,1413.69,998.1,933.48,2231.5,-882.43,-4758.86
1215675894791390720,2020-08,1547.96,900.65,4256.41,2456.75,2446.97,-2311.89
1215675894791390720,2020-09,1779.33,2248.35,0,1725.21,-2194.23,-4506.12
1215675894791390720,2020-10,607.17,0,1552.35,2089.09,70.43,-4435.69
1215675894791390720,2020-12,5015.09,5989.97,2820.33,3596.34,-1750.89,-6186.58
1215976372578996480,2020-01,7792.09,6522.9,7524.67,6443.55,2350.31,2350.31
1215976372578996480,2020-02,2791.97,1527.34,3704.8,9766.79,-4797.36,-2447.05
1215976372578996480,2020-03,3881.18,3725.71,5737.45,4628.84,1264.08,-1182.97
1215976372578996480,2020-04,3145.06,13346.96,8407.22,5540.04,-7334.72,-8517.69
1215976372578996480,2020-05,8773.79,5064.56,3347.62,389.88,6666.97,-1850.72
1215976372578996480,2020-06,3888.62,5876.79,8601.68,6516.84,96.67,-1754.05
1215976372578996480,2020-07,4228.7,10026.4,4140.76,4041.1,-5698.04,-7452.09
1215976372578996480,2020-08,1984.03,11035.51,2838.62,3262.31,-9475.17,-16927.26
1215976372578996480,2020-09,1922.19,3665.6,2804.08,3961.38,-2900.71,-19827.97
1215976372578996480,2020-10,2340.06,2002.43,7121.63,4051.64,3407.62,-16420.35
1215976372578996480,2020-11,3007.42,884.71,6000.96,3476.5,4647.17,-11773.18
1215976372578996480,2020-12,5062.86,1725.32,7401.13,2579.11,8159.56,-3613.62
1216685994079986688,2020-01,1473.65,1892.04,1108.87,4281.73,-3591.25,-3591.25
1216685994079986688,2020-02,3033.8,0,1210.13,0,4243.93,652.68
1216685994079986688,2020-03,0,3187.05,207.34,388.53,-3368.24,-2715.56
1216685994079986688,2020-04,1543.59,6438.23,4414.78,4070.04,-4549.9,-7265.46
1216685994079986688,2020-05,1447.86,792.41,1163.9,128.88,1690.47,-5574.99
1216685994079986688,2020-06,194.75,1929.25,4944.98,785.48,2425,-3149.99
1216685994079986688,2020-07,2447.02,2762.38,2987.1,1770.06,901.68,-2248.31
1216685994079986688,2020-08,4172.61,1990.45,1169.13,6660.73,-3309.44,-5557.75
1216685994079986688,2020-09,1775.57,0,164.59,683.48,1256.68,-4301.07
1216685994079986688,2020-11,392.02,5606.19,1337.74,398.32,-4274.75,-8575.82
1216685994079986688,2020-12,943.72,2386.6,589.64,2501.8,-3355.04,-11930.86
1216711767252007680,2020-01,1129.09,2298.17,5961.29,3189.54,1602.67,1602.67
1216711767252007680,2020-02,675.21,1354.15,2992.27,6800.38,-4487.05,-2884.38
1216711767252007680,2020-03,13037.87,0,5136.04,1212.73,16961.18,14076.8
1216711767252007680,2020-04,2534.85,7321.35,2325.63,4493.78,-6954.65,7122.15
1216711767252007680,2020-05,3743.23,3193.25,5476.81,1420.99,4605.8,11727.95
1216711767252007680,2020-06,4713.11,1499.69,957.07,1160.35,3010.14,14738.09
1216711767252007680,2020-07,4852.47,2908.82,1190.73,6180.43,-3046.05,11692.04
1216711767252007680,2020-08,0,5781.86,3316.85,1896.56,-4361.57,7330.47
1216711767252007680,2020-09,4033.15,2502.44,2843.69,2889.53,1484.87,8815.34
1216711767252007680,2020-10,1812.77,3258.23,5175.33,1882.69,1847.18,10662.52
1216711767252007680,2020-11,4277.61,2931.19,1552.76,1755.27,1143.91,11806.43
1216711767252007680,2020-12,168.74,1895.72,3558.09,2127.53,-296.42,11510.01
1217607696117498112,2020-01,7571.06,6994.36,5576.43,2697.67,3455.46,3455.46
1217607696117498112,2020-02,3787.03,4665.24,6733.85,2592.36,3263.28,6718.74
1217607696117498112,2020-03,2595.28,4511.3,898.3,6605.94,-7623.66,-904.92
1217607696117498112,2020-04,6859.39,2572.42,6733.22,937.72,10082.47,9177.55
1217607696117498112,2020-05,2222.39,1967.4,2315.63,4037.02,-1466.4,7711.15
1217607696117498112,2020-06,5584.31,10344.18,3403.84,4252.86,-5608.89,2102.26
1217607696117498112,2020-07,8740.1,9447.84,3235.07,774.85,1752.48,3854.74
1217607696117498112,2020-08,870.78,8618.2,3707.44,9986.4,-14026.38,-10171.64
1217607696117498112,2020-09,6298.14,5227.27,6011.42,4541.76,2540.53,-7631.11
1217607696117498112,2020-10,1693,5361.12,4294.93,2853.78,-2226.97,-9858.08
1217607696117498112,2020-11,5277.69,9722.3,1161.5,9027.31,-12310.42,-22168.5
1217607696117498112,2020-12,1342.19,5064.66,3392.96,1958.09,-2287.6,-24456.1
1219930422929869056,2020-01,1562.4,0,1174.46,2469.24,267.62,267.62
1219930422929869056,2020-02,1575.28,2389.62,0,2337.69,-3152.03,-2884.41
1219930422929869056,2020-03,1108.46,1557.48,173.08,3783.57,-4059.51,-6943.92
1219930422929869056,2020-04,0,2035.11,1034.93,2549.84,-3550.02,-10493.94
1219930422929869056,2020-05,1942.2,818.01,1974.66,986.45,2112.4,-8381.54
1219930422929869056,2020-06,0,330.63,5162.95,0,4832.32,-3549.22
1219930422929869056,2020-07,713.2,1727.3,1994.01,3270.85,-2290.94,-5840.16
1219930422929869056,2020-08,2517.6,4365.02,2170.41,3312.9,-2989.91,-8830.07
1219930422929869056,2020-09,1571.88,1654.42,0,5560.35,-5642.89,-14472.96
1219930422929869056,2020-10,0,836.72,1376.23,2743.77,-2204.26,-16677.22
1219930422929869056,2020-11,0,3284.34,0,3459.39,-6743.73,-23420.95
1219930422929869056,2020-12,0,1218.9,3022.33,2323.74,-520.31,-23941.26
1220409979528778240,2020-01,2826.9,862.92,0,763,1200.98,1200.98
1220409979528778240,2020-02,2103.9,114.25,258.62,2982.85,-734.58,466.4
1220409979528778240,2020-03,1081.63,5032.36,2301.69,0,-1649.04,-1182.64
1220409979528778240,2020-04,1874.68,2137.1,267.07,1467.67,-1463.02,-2645.66
1220409979528778240,2020-05,1766.86,3358.87,2685.33,3004.56,-1911.24,-4556.9
1220409979528778240,2020-06,104.62,0,243.5,3863.36,-3515.24,-8072.14
1220409979528778240,2020-07,1180.67,1771.99,1653.04,7504.4,-6442.68,-14514.82
1220409979528778240,2020-08,1276.72,3569.03,831.64,3975.37,-5436.04,-19950.86
1220409979528778240,2020-09,2041.87,5992.13,3294.4,708.9,-1364.76,-21315.62
1220409979528778240,2020-10,0,1830.98,962.25,1614.66,-2483.39,-23799.01
1220409979528778240,2020-11,2024.41,6039.79,1439.32,0,-2576.06,-26375.07
1220409979528778240,2020-12,839.67,2293.32,315.14,6517.8,-7656.31,-34031.38
1221420954018507520,2020-01,7845.8,2488.2,2693.24,2869.31,5181.53,5181.53
1221420954018507520,2020-02,5380.84,3690.03,4588,2366.89,3911.92,9093.45
1221420954018507520,2020-03,5017.53,5130.7,3615.75,10413.49,-6910.91,2182.54
1221420954018507520,2020-04,4839.06,164.29,7464.95,5472.18,6667.54,8850.08
1221420954018507520,2020-05,2253.21,6389.77,4247.79,6033.95,-5922.72,2927.36
1221420954018507520,2020-06,4755.66,4930.1,2547.75,6179.7,-3806.39,-879.03
1221420954018507520,2020-07,7355.05,3446.85,3733.35,3257.1,4384.45,3505.42
1221420954018507520,2020-08,4355.07,2722.58,3678.81,8040.34,-2729.04,776.38
1221420954018507520,2020-09,4445.52,7907.46,1799.56,1430.58,-3092.96,-2316.58
1221420954018507520,2020-10,483.65,3040.19,3784.61,10155.15,-8927.08,-11243.66
1221420954018507520,2020-11,6469.31,2992.75,6871.32,4883.23,5464.65,-5779.01
1221420954018507520,2020-12,1123.77,2617.75,6835.57,859.25,4482.34,-1296.67
1221849189622660608,2020-01,1932.21,1863.89,0,0,68.32,68.32
1221849189622660608,2020-02,3082.08,4127.39,0,2321.92,-3367.23,-3298.91
1221849189622660608,2020-03,4667.16,0,1717.24,1693.51,4690.89,1391.98
1221849189622660608,2020-04,793.56,1628.82,0,432.97,-1268.23,123.75
1221849189622660608,2020-05,1671.99,5700.31,2007.17,1500.85,-3522,-3398.25
1221849189622660608,2020-06,681.23,517.92,526.48,1032.04,-342.25,-3740.5
1221849189622660608,2020-07,1639.91,936.59,908.89,5401.19,-3788.98,-7529.48
1221849189622660608,2020-08,4704.19,1267.95,495.89,3722.88,209.25,-7320.23
1221849189622660608,2020-09,6068.97,3400.19,3572.86,778.29,5463.35,-1856.88
1221849189622660608,2020-10,1800.11,851.32,3340.22,1953.15,2335.86,478.98
1221849189622660608,2020-11,5198.58,5141.26,1224.23,4348.26,-3066.71,-2587.73
1221849189622660608,2020-12,2573.68,2526.99,2310.35,4804.25,-2447.21,-5034.94
1221964421343960064,2020-01,1258.7,0,2922.86,0,4181.56,4181.56
1221964421343960064,2020-02,2622.71,0,1922.62,2071.32,2474.01,6655.57
1221964421343960064,2020-03,3103.74,0,1011.58,1092.73,3022.59,9678.16
1221964421343960064,2020-04,4748.24,2776.97,102.32,0,2073.59,11751.75
1221964421343960064,2020-05,1826.97,1577.64,286.82,532.67,3.48,11755.23
1221964421343960064,2020-06,570.84,3055.64,0,1070.9,-3555.7,8199.53
1221964421343960064,2020-07,3811.59,0,2307.3,2247.01,3871.88,12071.41
1221964421343960064,2020-08,1583.7,1446,0,3439.41,-3301.71,8769.7
1221964421343960064,2020-09,3811.95,3530.88,0,5618.99,-5337.92,3431.78
1221964421343960064,2020-10,0,370,199.11,1559.12,-1730.01,1701.77
1221964421343960064,2020-11,0,714.19,0,575.48,-1289.67,412.1
1221964421343960064,2020-12,1231.48,1754.83,1769.45,339.22,906.88,1318.98
1222340324697352192,2020-01,2938.8,1705.8,3248.58,2883.46,1598.12,1598.12
1222340324697352192,2020-02,2002.68,2219.3,877.05,1663.48,-1003.05,595.07
1222340324697352192,2020-03,6630.72,3718.86,586.11,1914.72,1583.25,2178.32
1222340324697352192,2020-04,929.83,0,2198.15,581.79,2546.19,4724.51
1222340324697352192,2020-05,1147.89,1055.06,1417.38,3087.43,-1577.22,3147.29
1222340324697352192,2020-06,1637,1465.32,8614.14,1365.7,7420.12,10567.41
1222340324697352192,2020-07,4382.02,4201.89,4899.39,1975.31,3104.21,13671.62
1222340324697352192,2020-08,356.49,1567.86,3691.71,0,2480.34,16151.96
1222340324697352192,2020-09,2185.12,644.25,4589.01,4429.15,1700.73,17852.69
1222340324697352192,2020-10,1295.39,0,2263.99,3666.61,-107.23,17745.46
1222340324697352192,2020-11,2795,0,0,2852.98,-57.98,17687.48
1222340324697352192,2020-12,4282.77,0,421.35,1364.51,3339.61,21027.09
1223337586947810816,2020-01,4068.82,2948.46,833.82,2254.16,-299.98,-299.98
1223337586947810816,2020-02,3241.38,2682.95,3743.28,3587.56,714.15,414.17
1223337586947810816,2020-03,6926.57,3335.23,3577.73,4012,3157.07,3571.24
1223337586947810816,2020-04,6962.14,9256.78,4259.33,7744.31,-5779.62,-2208.38
1223337586947810816,2020-05,2472.12,2545.67,8350.48,2895.94,5380.99,3172.61
1223337586947810816,2020-06,3116.04,9081.36,1811.29,5268.03,-9422.06,-6249.45
1223337586947810816,2020-07,4508.82,2074.29,10416.98,8260.66,4590.85,-1658.6
1223337586947810816,2020-08,1942.77,5182.47,1049.37,6915.48,-9105.81,-10764.41
1223337586947810816,2020-09,3581.49,1898.32,3050.67,4436.26,297.58,-10466.83
1223337586947810816,2020-10,7091.64,5511.72,1853.09,3208.98,224.03,-10242.8
1223337586947810816,2020-11,6150.15,4378.36,3124.67,2368.24,2528.22,-7714.58
1223337586947810816,2020-12,3910.48,2144.83,5110.82,4516.16,2360.31,-5354.27
1223595936017635328,2020-01,4928.54,1198.42,0,2520.63,1209.49,1209.49
1223595936017635328,2020-02,2345.12,0,2012.61,1842.07,2515.66,3725.15
1223595936017635328,2020-03,2075.51,1712.52,2733.24,1970.82,1125.41,4850.56
1223595936017635328,2020-04,2736.13,249.66,2276.33,2777.97,1984.83,6835.39
1223595936017635328,2020-05,3761.89,4309.21,0,152.78,-700.1,6135.29
1223595936017635328,2020-06,4958.38,1781.16,2238.35,2961.43,2454.14,8589.43
1223595936017635328,2020-07,4904.02,1761.61,4086.53,737.1,6491.84,15081.27
1223595936017635328,2020-08,1821.59,383.61,2783.69,1026.09,3195.58,18276.85
1223595936017635328,2020-09,1332.2,1961.9,3556.19,1175.05,1751.44,20028.29
1223595936017635328,2020-10,1883.18,2842.22,874.22,2837.13,-2921.95,17106.34
1223595936017635328,2020-11,844.11,2739.97,4026.52,457.72,1672.94,18779.28
1223595936017635328,2020-12,174.18,2709.23,4284.84,8.47,1741.32,20520.6
1224808397470321152,2020-01,3722.54,5621.55,607.75,947.55,-2238.81,-2238.81
1224808397470321152,2020-02,3101.54,3951.33,3012.91,4619.79,-2456.67,-4695.48
1224808397470321152,2020-03,3816.9,1400.35,3657.39,2144.79,3929.15,-766.33
1224808397470321152,2020-04,5182.1,2679.61,5139.82,3634.71,4007.6,3241.27
1224808397470321152,2020-05,2164.07,4334.28,5948.35,2670.52,1107.62,4348.89
1224808397470321152,2020-06,7268.98,5521.74,3897.13,5372.18,272.19,4621.08
1224808397470321152,2020-07,1466.05,4146.69,1227.25,1036.89,-2490.28,2130.8
1224808397470321152,2020-08,6766.36,6289.79,3223.91,1601.59,2098.89,4229.69
1224808397470321152,2020-09,4362.56,3426.28,3186.88,0,4123.16,8352.85
1224808397470321152,2020-10,763.03,4623.06,3930.86,2431.52,-2360.69,5992.16
1224808397470321152,2020-11,3294,1290.42,1746.63,2670.26,1079.95,7072.11
1224808397470321152,2020-12,5432.81,2264.71,601.71,3784.62,-14.81,7057.3
1224879407422209792,2020-01,4833.29,7261.61,0,6185.96,-8614.28,-8614.28
1224879407422209792,2020-02,5138.62,1808.3,2679.58,2723.63,3286.27,-5328.01
1224879407422209792,2020-03,3235.49,9599.77,1805.4,2318.56,-6877.44,-12205.45
1224879407422209792,2020-04,4163.23,51.59,2400.93,8117.26,-1604.69,-13810.14
1224879407422209792,2020-05,1539.76,1765.7,1997.73,2278.91,-507.12,-14317.26
1224879407422209792,2020-06,2676.28,524.84,827.8,7657.8,-4678.56,-18995.82
1224879407422209792,2020-07,3321.43,2325.88,4346.77,4321.97,1020.35,-17975.47
1224879407422209792,2020-08,6364.46,6207.57,671.39,3726.98,-2898.7,-20874.17
1224879407422209792,2020-09,5090.3,3522.11,782.49,4594.47,-2243.79,-23117.96
1224879407422209792,2020-10,2241.68,1183.87,4213.76,1434.99,3836.58,-19281.38
1224879407422209792,2020-11,934.45,6076.88,3005.39,5508.26,-7645.3,-26926.68
1224879407422209792,2020-12,1764.64,2748.35,3741.41,5046.44,-2288.74,-29215.42
1225036967592360960,2020-01,914.56,5943.55,4396.53,2698.06,-3330.52,-3330.52
1225036967592360960,2020-02,687.72,5268.83,3489.93,3720.58,-4811.76,-8142.28
1225036967592360960,2020-03,2350.1,1617.02,2612.21,968.16,2377.13,-5765.15
1225036967592360960,2020-04,3874.31,953.57,4162.63,2292.55,4790.82,-974.33
1225036967592360960,2020-05,3293.39,3609.42,1349.24,1579.3,-546.09,-1520.42
1225036967592360960,2020-06,2089.59,4177.19,1927.92,3730.5,-3890.18,-5410.6
1225036967592360960,2020-07,2677.16,327.4,3915.82,0,6265.58,854.98
1225036967592360960,2020-08,1585.79,2737.49,1836.67,733.57,-48.6,806.38
1225036967592360960,2020-09,385.87,2828.02,1159.66,2486.8,-3769.29,-2962.91
1225036967592360960,2020-10,3583.83,2543.86,1495.26,4735.84,-2200.61,-5163.52
1225036967592360960,2020-11,3575.59,6076.24,277.34,1180.18,-3403.49,-8567.01
1225036967592360960,2020-12,7586.55,7365.32,3786.39,1605.81,2401.81,-6165.2
1226746536347503360,2020-01,4856.06,2688.77,5449.02,4400.31,3216,3216
1226746536347503360,2020-02,1876.59,0,1512.15,4277.97,-889.23,2326.77
1226746536347503360,2020-03,1814.65,1129.73,4890.84,1125.6,4450.16,6776.93
1226746536347503360,2020-04,3027.98,1166.36,4008.44,1444.19,4425.87,11202.8
1226746536347503360,2020-05,1902.03,0,5976.8,3496.05,4382.78,15585.58
1226746536347503360,2020-06,862.8,5010.89,4340.58,1986.05,-1793.56,13792.02
1226746536347503360,2020-07,1064.04,1649.2,503.78,2061.22,-2142.6,11649.42
1226746536347503360,2020-08,865.9,3978.99,1957.68,424.45,-1579.86,10069.56
1226746536347503360,2020-09,3929.56,4426.64,2594.93,734.73,1363.12,11432.68
1226746536347503360,2020-10,3260.01,4251.39,3417.24,3570.38,-1144.52,10288.16
1226746536347503360,2020-11,477.51,2782.96,3110.6,6130.21,-5325.06,4963.1
1226746536347503360,2020-12,2369.92,2256.29,0,2525.5,-2411.87,2551.23
1228820912926270208,2020-01,3944.37,2598.98,4752.07,2875.47,3221.99,3221.99
1228820912926270208,2020-02,2715.01,3525.14,4422.06,6047.72,-2435.79,786.2
1228820912926270208,2020-03,4916.78,7320.34,2498.64,2693.08,-2598,-1811.8
1228820912926270208,2020-04,1507.81,5104.82,8552.23,4662.26,292.96,-1518.84
1228820912926270208,2020-05,3204.22,8243.42,1616.74,1547.73,-4970.19,-6489.03
1228820912926270208,2020-06,6069.09,4295.07,2335.09,3863.04,246.07,-6242.96
1228820912926270208,2020-07,5048.94,3267.61,5762.94,6553.31,990.96,-5252
1228820912926270208,2020-08,6599.79,1509.51,3760.04,4603.76,4246.56,-1005.44
1228820912926270208,2020-09,6077.15,1577.79,1276.99,4253.3,1523.05,517.61
1228820912926270208,2020-10,3338.66,0,5130.69,4543.22,3926.13,4443.74
1228820912926270208,2020-11,6164.36,1540.58,3966.19,7339.79,1250.18,5693.92
1228820912926270208,2020-12,1042.68,5417.11,4453.85,596.7,-517.28,5176.64
1229262637001381632,2020-01,1199.4,0,1574.41,1718.01,1055.8,1055.8
1229262637001381632,2020-02,0,2404.28,2111.01,5207.69,-5500.96,-4445.16
1229262637001381632,2020-03,1866.03,0,3010.63,1772.8,3103.86,-1341.3
1229262637001381632,2020-05,2121.51,1330.13,352.86,552.86,591.38,-749.92
1229262637001381632,2020-06,930.74,0,0,1963.23,-1032.49,-1782.41
1229262637001381632,2020-07,1222.05,1737.95,1421.94,2144.57,-1238.53,-3020.94
1229262637001381632,2020-08,0,428.19,0,817.8,-1245.99,-4266.93
1229262637001381632,2020-09,0,1421.08,1301.94,0,-119.14,-4386.07
1229262637001381632,2020-10,891.15,1942.08,0,2295.09,-3346.02,-7732.09
1229262637001381632,2020-11,1506.14,562.77,2006.45,1415.64,1534.18,-6197.91
1229262637001381632,2020-12,0,4431.08,1571.57,2521.93,-5381.44,-11579.35
1229505160495398656,2020-01,4167.04,1436.68,2329.89,0,5060.25,5060.25
1229505160495398656,2020-02,4063.44,2276.28,24.07,849.18,962.05,6022.3
1229505160495398656,2020-03,3189.28,1699.83,0,0,1489.45,7511.75
1229505160495398656,2020-04,1452.07,2452.66,4104.07,26.16,3077.32,10589.07
1229505160495398656,2020-05,3107.41,3056.52,0,3067.92,-3017.03,7572.04
1229505160495398656,2020-06,1400.62,866.14,76.68,1323.82,-712.66,6859.38
1229505160495398656,2020-08,1415.76,0,1537.43,0,2953.19,9812.57
1229505160495398656,2020-09,0,2062.39,0,1442.12,-3504.51,6308.06
1229505160495398656,2020-10,2458.98,3779.7,241.31,0,-1079.41,5228.65
1229505160495398656,2020-11,3658.66,2006.49,2400.41,646.37,3406.21,8634.86
1229505160495398656,2020-12,1173.72,225.35,3963.4,474.18,4437.59,13072.45
1230483860979808512,2020-01,3295.16,4626.15,729.41,3147.93,-3749.51,-3749.51
1230483860979808512,2020-02,4643.18,3671.48,1995.41,541.48,2425.63,-1323.88
1230483860979808512,2020-03,1255.62,753.57,0,0,502.05,-821.83
1230483860979808512,2020-04,1500.13,636.99,1789.9,0,2653.04,1831.21
1230483860979808512,2020-05,0,2563.55,1396.27,1508.25,-2675.53,-844.32
1230483860979808512,2020-06,3978.8,0,1937.03,1052.62,4863.21,4018.89
1230483860979808512,2020-07,683.24,403.63,0,1764.54,-1484.93,2533.96
1230483860979808512,2020-08,717.07,1180.96,0,865.13,-1329.02,1204.94
1230483860979808512,2020-09,3599.9,912.83,2418.09,3339.56,1765.6,2970.54
1230483860979808512,2020-10,2293.78,1738.14,2231.24,1546.15,1240.73,4211.27
1230483860979808512,2020-11,0,744.68,27.58,1738.5,-2455.6,1755.67
1230483860979808512,2020-12,1854.73,1837.85,1210.82,2260.85,-1033.15,722.52
1234700450164998912,2020-01,1109.85,1633.35,5254.45,2119.83,2611.12,2611.12
1234700450164998912,2020-02,4255.15,0,5028.42,4186.44,5097.13,7708.25
1234700450164998912,2020-03,3492.09,628.15,0,3978.96,-1115.02,6593.23
1234700450164998912,2020-04,2078.21,747.43,4372.49,1805.44,3897.83,10491.06
1234700450164998912,2020-05,1620.42,7541.29,1120.1,3690.43,-8491.2,1999.86
1234700450164998912,2020-06,2059.77,858.23,1243.75,2960.49,-515.2,1484.66
1234700450164998912,2020-07,1917.13,2348.84,5269.48,4215.21,622.56,2107.22
1234700450164998912,2020-08,8444.19,4447.57,1447.05,2265.6,3178.07,5285.29
1234700450164998912,2020-09,7559.6,4040.12,3660.31,6909.41,270.38,5555.67
1234700450164998912,2020-10,4720.97,7534.16,2409.4,4443.67,-4847.46,708.21
1234700450164998912,2020-11,7768.26,5886.85,7691.67,2039.96,7533.12,8241.33
1234700450164998912,2020-12,7247.87,3423.62,2652.62,2882.9,3593.97,11835.3
1235094068106811392,2020-02,1477.38,0,942.53,0,2419.91,2419.91
1235094068106811392,2020-03,3533,0,0,1581.16,1951.84,4371.75
1235094068106811392,2020-04,0,1644.54,0,0,-1644.54,2727.21
1235094068106811392,2020-05,1125.59,467.36,18.01,859.02,-182.78,2544.43
1235094068106811392,2020-06,776.54,0,1393.74,1996.51,173.77,2718.2
1235094068106811392,2020-07,333,2173.45,1685.43,0,-155.02,2563.18
1235094068106811392,2020-08,0,81.63,577.98,0,496.35,3059.53
1235094068106811392,2020-10,0,269.92,0,0,-269.92,2789.61
1235094068106811392,2020-11,508.9,0,0,0,508.9,3298.51
1235677095579724544,2020-01,0,384,1510.44,1884.75,-758.31,-758.31
1235677095579724544,2020-02,1197.82,2966.41,1505.59,0,-263,-1021.31
1235677095579724544,2020-03,3339.76,0,375.04,2278.92,1435.88,414.57
1235677095579724544,2020-04,3954.51,89.9,0,874.89,2989.72,3404.29
1235677095579724544,2020-05,3386.32,1820.46,0,3878.11,-2312.25,1092.04
1235677095579724544,2020-07,6.7,819.64,1895.35,0,1082.41,2174.45
1235677095579724544,2020-08,2968.18,0,2525.75,0,5493.93,7668.38
1235677095579724544,2020-09,0,1387.97,751.92,0,-636.05,7032.33
1235677095579724544,2020-10,4382.2,1966.51,2643.26,670.92,4388.03,11420.36
1235677095579724544,2020-11,4927.74,2894.35,1105.27,0,3138.66,14559.02
1235677095579724544,2020-12,0,1384.5,0,1745.54,-3130.04,11428.98
1236279531996738816,2020-01,4708.03,1542.06,7911.46,4739.13,6338.3,6338.3
1236279531996738816,2020-02,3722.76,2764.76,1698.17,3675.15,-1018.98,5319.32
1236279531996738816,2020-03,2514.37,569.84,3050.4,0,4994.93,10314.25
1236279531996738816,2020-04,1965.7,1540.84,2871.36,5274.8,-1978.58,8335.67
1236279531996738816,2020-05,1979.39,2670.85,4090.93,3266.49,132.98,8468.65
1236279531996738816,2020-06,2644.95,3353.11,0,3483.11,-4191.27,4277.38
1236279531996738816,2020-07,8509.11,3563.23,4345.77,1790.93,7500.72,11778.1
1236279531996738816,2020-08,4356.37,2710.69,6576.14,0,8221.82,19999.92
1236279531996738816,2020-09,1387.15,3982.38,2829.19,1884.44,-1650.48,18349.44
1236279531996738816,2020-10,8678.21,5117.66,2027.47,198.55,5389.47,23738.91
1236279531996738816,2020-11,1590.28,7909.71,1729.46,3261.27,-7851.24,15887.67
1236279531996738816,2020-12,1973.15,4755.85,2032.1,1087.52,-1838.12,14049.55
1236436702601087232,2020-01,1648.16,1822.49,4218.61,2877.29,1166.99,1166.99
1236436702601087232,2020-02,1517.39,762.21,3012.11,1192.61,2574.68,3741.67
1236436702601087232,2020-03,3537.88,2132.88,3757.92,6400.87,-1237.95,2503.72
1236436702601087232,2020-04,5503.79,2230.5,9001.04,819.82,11454.51,13958.23
1236436702601087232,2020-05,930.74,4780.67,1058.89,4006.15,-6797.19,7161.04
1236436702601087232,2020-06,607.52,1267.55,505.15,4306.93,-4461.81,2699.23
1236436702601087232,2020-07,2819.73,0,3186.34,0,6006.07,8705.3
1236436702601087232,2020-08,1600.9,2392.08,3199.8,0,2408.62,11113.92
1236436702601087232,2020-09,2232.14,2722.65,7017.88,5214.59,1312.78,12426.7
1236436702601087232,2020-10,3719.75,1526.54,2909.92,1244.07,3859.06,16285.76
1236436702601087232,2020-11,2647.19,3196.95,3743.2,1131.32,2062.12,18347.88
1236436702601087232,2020-12,624.74,2566.71,3253.25,0,1311.28,19659.16
1237786860293169152,2020-03,0,1079.67,0,0,-1079.67,-1079.67
1237786860293169152,2020-04,1793.56,0,0,1260.19,533.37,-546.3
1237786860293169152,2020-05,2606.11,0,2198.02,0,4804.13,4257.83
1237786860293169152,2020-06,0,2367.55,0,544.76,-2912.31,1345.52
1237786860293169152,2020-07,0,474.48,0,0,-474.48,871.04
1237786860293169152,2020-10,1154,1315.97,0,0,-161.97,709.07
1237786860293169152,2020-11,1478.8,0,0,0,1478.8,2187.87
1237786860293169152,2020-12,1318.35,0,11.34,0,1329.69,3517.56
1238518501701956608,2020-01,0,2871.49,0,0,-2871.49,-2871.49
1238518501701956608,2020-03,3438.67,1088.27,0,1378.73,971.67,-1899.82
1238518501701956608,2020-04,714.51,0,0,1509.87,-795.36,-2695.18
1238518501701956608,2020-07,1639.24,449.3,135.51,0,1325.45,-1369.73
1238518501701956608,2020-09,0,1963.38,1648.32,1497.82,-1812.88,-3182.61
1238518501701956608,2020-10,0,231.3,1805.28,0,1573.98,-1608.63
1238518501701956608,2020-11,773.73,1126.29,0,2812.36,-3164.92,-4773.55
1238585744270950912,2020-01,1272.53,3465.64,1836.78,5492.73,-5849.06,-5849.06
1238585744270950912,2020-02,2258.8,3361.86,1970.79,3460.1,-2592.37,-8441.43
1238585744270950912,2020-03,4922.04,3949.84,1590.52,5679.79,-3117.07,-11558.5
1238585744270950912,2020-04,2339.7,1938.98,6788.17,3003.84,4185.05,-7373.45
1238585744270950912,2020-05,1579.04,5459.99,5619.48,2440.09,-701.56,-8075.01
1238585744270950912,2020-06,511.91,4341.2,3227.02,5149.33,-5751.6,-13826.61
1238585744270950912,2020-07,0,307.41,1224.94,3969.94,-3052.41,-16879.02
1238585744270950912,2020-08,3218.49,1876.63,1194.84,2282.61,254.09,-16624.93
1238585744270950912,2020-09,3284.48,4303.81,3305.96,6634.42,-4347.79,-20972.72
1238585744270950912,2020-10,2556.92,3528.05,6029.24,2022.92,3035.19,-17937.53
1238585744270950912,2020-11,85.67,3332.56,4926.6,6355.35,-4675.64,-22613.17
1238585744270950912,2020-12,1795.71,4017.18,5833.6,4243.47,-631.34,-23244.51
1238828952091041536,2020-02,0,1863.47,0,0,-1863.47,-1863.47
1238828952091041536,2020-03,1178.55,0,0,0,1178.55,-684.92
1238828952091041536,2020-04,0,374.3,0,0,-374.3,-1059.22
1238828952091041536,2020-05,0,1800.07,0,0,-1800.07,-2859.29
1238828952091041536,2020-06,0,1304.11,0,0,-1304.11,-4163.4
1239664369125196800,2020-01,2427.86,1771,1323.39,3762.48,-1782.23,-1782.23
1239664369125196800,2020-02,5847.34,4013.66,3006.78,927.44,3913.02,2130.79
1239664369125196800,2020-03,3111.34,1328.18,0,2508.54,-725.38,1405.41
1239664369125196800,2020-04,1748.58,3338.17,2764.95,869.61,305.75,1711.16
1239664369125196800,2020-05,1577.95,0,0,6361.5,-4783.55,-3072.39
1239664369125196800,2020-06,5063.46,66.87,935.2,254.77,5677.02,2604.63
1239664369125196800,2020-07,797.61,4795.94,2303.34,5319.08,-7014.07,-4409.44
1239664369125196800,2020-08,4136.03,3580.96,460.26,5015.99,-4000.66,-8410.1
1239664369125196800,2020-09,3041.59,0,2.98,243.19,2801.38,-5608.72
1239664369125196800,2020-10,3691.04,5820.8,3735.49,2401.56,-795.83,-6404.55
1239664369125196800,2020-11,249.98,3600,5382.29,0,2032.27,-4372.28
1239664369125196800,2020-12,2227.44,0,3840.3,1862.47,4205.27,-167.01
1240030629641028608,2020-01,1179.65,2444.73,7661.53,4337.07,2059.38,2059.38
1240030629641028608,2020-02,1418.29,3659.69,678.79,4241.88,-5804.49,-3745.11
1240030629641028608,2020-03,661.24,2101.82,1057.83,3642.89,-4025.64,-7770.75
1240030629641028608,2020-04,2210.35,5840.69,3686.93,912.56,-855.97,-8626.72
1240030629641028608,2020-05,2635.92,4476.14,3182.59,2053.76,-711.39,-9338.11
1240030629641028608,2020-06,1724.77,7493.21,620.5,818.44,-5966.38,-15304.49
1240030629641028608,2020-07,3399.66,5107.22,3016.89,1908.04,-598.71,-15903.2
1240030629641028608,2020-08,660.02,6968.73,2797.34,3257.6,-6768.97,-22672.17
1240030629641028608,2020-09,3306.99,1065.09,5020.16,4917.8,2344.26,-20327.91
1240030629641028608,2020-10,299.88,4216.75,2825.33,2746.7,-3838.24,-24166.15
1240030629641028608,2020-11,2950.59,4905.2,1109.26,0,-845.35,-25011.5
1240030629641028608,2020-12,2432.49,599.12,3956.93,558.9,5231.4,-19780.1
1240226229327547648,2020-01,5068.64,1227.26,1897.36,1559.66,4179.08,4179.08
1240226229327547648,2020-02,4211.5,514,1355.84,4501.27,552.07,4731.15
1240226229327547648,2020-03,5241.21,493.07,533.89,2664.91,2617.12,7348.27
1240226229327547648,2020-04,3530.83,6071.37,1729.22,3539.31,-4350.63,2997.64
1240226229327547648,2020-05,544.26,1197.92,0,2550.69,-3204.35,-206.71
1240226229327547648,2020-06,1194.51,2974.57,3116.09,3915.49,-2579.46,-2786.17
1240226229327547648,2020-07,1077.69,6949.12,0,8412.92,-14284.35,-17070.52
1240226229327547648,2020-08,4837.41,2748.19,1813.41,2686.32,1216.31,-15854.21
1240226229327547648,2020-09,1495.13,2316.58,271.87,2642.92,-3192.5,-19046.71
1240226229327547648,2020-10,3278.81,2049.4,1438.89,2977.6,-309.3,-19356.01
1240226229327547648,2020-11,0,836.33,380.89,0,-455.44,-19811.45
1240226229327547648,2020-12,1897.15,2823.66,1007.31,4524.76,-4443.96,-24255.41
1241503024913157632,2020-01,4340.16,0,3632.32,4235.67,3736.81,3736.81
1241503024913157632,2020-02,0,822.08,230.47,165.66,-757.27,2979.54
1241503024913157632,2020-03,3802.08,3295.95,1651.75,3347.6,-1189.72,1789.82
1241503024913157632,2020-04,2933.88,0,1707.08,1650.82,2990.14,4779.96
1241503024913157632,2020-05,4281.92,1570.16,1606.56,1092.37,3225.95,8005.91
1241503024913157632,2020-06,4704.54,0,4409.51,3771.65,5342.4,13348.31
1241503024913157632,2020-07,2042.57,1943.96,0,2442.82,-2344.21,11004.1
1241503024913157632,2020-08,900.91,0,2136.37,0,3037.28,14041.38
1241503024913157632,2020-09,0,2691.41,0,2056,-4747.41,9293.97
1241503024913157632,2020-10,1381.76,2191.42,879.16,0,69.5,9363.47
1241503024913157632,2020-11,6739.31,1715.1,4521.2,0,9545.41,18908.88
1241503024913157632,2020-12,5004.64,0,2164.27,1729.29,5439.62,24348.5
1242027027765681920,2020-01,2639.02,4870.02,1869.2,1586.95,-1948.75,-1948.75
1242027027765681920,2020-02,6044,2154.57,1128.11,4960.54,57,-1891.75
1242027027765681920,2020-03,3430.68,1901.12,798.37,817.37,1510.56,-381.19
1242027027765681920,2020-04,4746.61,0,5224.6,2746.93,7224.28,6843.09
1242027027765681920,2020-05,2130.45,2721.48,1278.54,1317.97,-630.46,6212.63
1242027027765681920,2020-06,4287.29,1326.71,1644.2,4957.72,-352.94,5859.69
1242027027765681920,2020-07,1536.24,0,2070.6,2520.7,1086.14,6945.83
1242027027765681920,2020-08,862.6,0,0,2691.23,-1828.63,5117.2
1242027027765681920,2020-09,154.08,440.41,1195.59,4825.99,-3916.73,1200.47
1242027027765681920,2020-10,2567.73,1496.18,483.67,0,1555.22,2755.69
1242027027765681920,2020-11,4209.18,2041.82,1162.69,3398.38,-68.33,2687.36
1242027027765681920,2020-12,1514.59,50.88,797.24,3100.41,-839.46,1847.9
1243074338859417344,2020-01,3018.86,1472.45,11002.99,723.72,11825.68,11825.68
1243074338859417344,2020-02,5117.91,3435.03,3178.56,2916.75,1944.69,13770.37
1243074338859417344,2020-03,6803.57,3503.22,2500.6,1523.5,4277.45,18047.82
1243074338859417344,2020-04,1749.67,1956.29,6772.66,1958.98,4607.06,22654.88
1243074338859417344,2020-05,3003.58,3458.39,6380.8,2346.19,3579.8,26234.68
1243074338859417344,2020-06,5819.87,0,2638.62,3087.92,5370.57,31605.25
1243074338859417344,2020-07,0,2931.89,2979.22,2188.21,-2140.88,29464.37
1243074338859417344,2020-08,6508.42,1810.43,5177.11,2831.98,7043.12,36507.49
1243074338859417344,2020-09,2144.21,1712.8,2099.02,0,2530.43,39037.92
1243074338859417344,2020-10,1706.42,3163.32,3085.99,4137.93,-2508.84,36529.08
1243074338859417344,2020-11,3645.79,2382.99,3891.86,3495.15,1659.51,38188.59
1243074338859417344,2020-12,2592.6,1631.22,2938.1,0,3899.48,42088.07
1245095747848101888,2020-01,4174.88,480.87,240.15,0,3934.16,3934.16
1245095747848101888,2020-02,1118.64,0,1769.99,0,2888.63,6822.79
1245095747848101888,2020-03,0,3792.15,0,1291.02,-5083.17,1739.62
1245095747848101888,2020-04,3895.51,0,0,0,3895.51,5635.13
1245095747848101888,2020-05,721.63,1384.3,2709.07,0,2046.4,7681.53
1245095747848101888,2020-06,2992.47,804.17,1677.23,505.35,3360.18,11041.71
1245095747848101888,2020-08,1113.57,1106.04,1301.08,1774.47,-465.86,10575.85
1245095747848101888,2020-09,1744.86,0,257.92,0,2002.78,12578.63
1245095747848101888,2020-10,0,2534.45,1208.75,1160.4,-2486.1,10092.53
1245095747848101888,2020-11,57.13,1797.16,1726.71,1570.8,-1584.12,8508.41
1245095747848101888,2020-12,1804.36,0,1861.75,0,3666.11,12174.52
1246265473809078272,2020-01,3481.41,4325.08,9913.28,5940.24,3129.37,3129.37
1246265473809078272,2020-02,1897.55,2055.28,0,1856.73,-2014.46,1114.91
1246265473809078272,2020-03,3665.14,3502.89,5269.2,5489.31,-57.86,1057.05
1246265473809078272,2020-04,8580.16,3903.82,858.97,6116.48,-581.17,475.88
1246265473809078272,2020-05,5797.77,2474.24,6625.29,5192.59,4756.23,5232.11
1246265473809078272,2020-06,5298.19,3370.3,7001.05,6173.39,2755.55,7987.66
1246265473809078272,2020-07,2023.66,8889.7,9621.02,6117.41,-3362.43,4625.23
1246265473809078272,2020-08,4377.83,2624.62,2350.84,4669.89,-565.84,4059.39
1246265473809078272,2020-09,7285.12,1795.68,4931.11,1596.63,8823.92,12883.31
1246265473809078272,2020-10,5903.06,2463.73,6801.51,992.63,9248.21,22131.52
1246265473809078272,2020-11,4861.49,2400.2,4990.34,7072.02,379.61,22511.13
1246265473809078272,2020-12,3083.57,4020.43,4073.32,57.01,3079.45,25590.58
1246284985691882752,2020-01,5153.9,2011.92,992.17,1469.15,2665,2665
1246284985691882752,2020-02,1157.93,851.78,4659.28,1162.16,3803.27,6468.27
1246284985691882752,2020-03,4122.32,3874.02,1959.48,426.78,1781,8249.27
1246284985691882752,2020-04,6482.17,3755.36,3803.63,0,6530.44,14779.71
1246284985691882752,2020-05,2019.7,5861.95,4335.84,3349.38,-2855.79,11923.92
1246284985691882752,2020-06,1742.35,0,2188.97,620.69,3310.63,15234.55
1246284985691882752,2020-07,4322.6,2764.06,7795.03,0,9353.57,24588.12
1246284985691882752,2020-08,5617.88,3147.22,232.37,1195.23,1507.8,26095.92
1246284985691882752,2020-09,3422.81,2000.43,4914.11,1694.85,4641.64,30737.56
1246284985691882752,2020-10,1836.06,5173.12,1836.04,2700.2,-4201.22,26536.34
1246284985691882752,2020-11,4339.75,5010.17,552.98,6071.52,-6188.96,20347.38
1246284985691882752,2020-12,1833.84,747.16,3955.84,0,5042.52,25389.9
1247141582204829440,2020-01,2893.82,1342.29,1612.05,0,3163.58,3163.58
1247141582204829440,2020-03,958.6,0,1914.91,0,2873.51,6037.09
1247141582204829440,2020-05,3157.23,0,0,0,3157.23,9194.32
1247141582204829440,2020-06,1975.85,0,0,0,1975.85,11170.17
1247141582204829440,2020-08,1568.14,1182.27,0,559.71,-173.84,10996.33
1247141582204829440,2020-09,1590.04,0,1062.31,1587.8,1064.55,12060.88
1247141582204829440,2020-11,0,1367.19,1932.73,0,565.54,12626.42
1247141582204829440,2020-12,2646.07,0,2579.33,0,5225.4,17851.82
1247269808266586880,2020-01,5016.12,4081.48,0,3711.21,-2776.57,-2776.57
1247269808266586880,2020-02,0,1375.84,4931.77,1963.2,1592.73,-1183.84
1247269808266586880,2020-03,0,5309.22,4503.35,1704.56,-2510.43,-3694.27
1247269808266586880,2020-04,2930.16,1210.72,1673.81,207.35,3185.9,-508.37
1247269808266586880,2020-05,3639.89,1455.5,1892.05,4049.88,26.56,-481.81
1247269808266586880,2020-06,430.52,4739.7,1726.84,713.23,-3295.57,-3777.38
1247269808266586880,2020-07,3534.67,4920.89,2268.71,3126.81,-2244.32,-6021.7
1247269808266586880,2020-08,1136.15,0,0,3233.09,-2096.94,-8118.64
1247269808266586880,2020-09,0,3812.05,0,4123.44,-7935.49,-16054.13
1247269808266586880,2020-10,3406.14,1787.42,3981.11,0,5599.83,-10454.3
1247269808266586880,2020-11,1914.52,1966.6,2874.41,1312.7,1509.63,-8944.67
1247269808266586880,2020-12,3678.56,1607.43,149.3,729.19,1491.24,-7453.43
1247577745142046208,2020-02,1919.73,0,722.08,0,2641.81,2641.81
1247577745142046208,2020-03,389.73,1529.33,0,0,-1139.6,1502.21
1247577745142046208,2020-04,537.64,1758.06,1607.07,0,386.65,1888.86
1247577745142046208,2020-06,1722.75,0,0,0,1722.75,3611.61
1247577745142046208,2020-07,916.68,0,0,0,916.68,4528.29
1247577745142046208,2020-10,0,1623.31,0,427.38,-2050.69,2477.6
1247577745142046208,2020-11,0,1433.49,4229.45,0,2795.96,5273.56
1248911604588442880,2020-01,3336.4,1622.76,5786.51,2837.99,4662.16,4662.16
1248911604588442880,2020-02,0,502.34,4797.51,0,4295.17,8957.33
1248911604588442880,2020-03,455.53,2421.13,3745.32,1857.23,-77.51,8879.82
1248911604588442880,2020-04,3059.95,668.77,3678.73,1557.03,4512.88,13392.7
1248911604588442880,2020-05,2857.3,0,1063.19,0,3920.49,17313.19
1248911604588442880,2020-06,4065.38,3506.83,3720.64,8989.54,-4710.35,12602.84
1248911604588442880,2020-07,2080.38,3381.31,3834.54,1434.61,1099,13701.84
1248911604588442880,2020-08,1891.39,2905.62,4304.82,3752.01,-461.42,13240.42
1248911604588442880,2020-09,1606.44,6701.08,1069.76,666.07,-4690.95,8549.47
1248911604588442880,2020-10,1533.58,2051.27,0,2201.03,-2718.72,5830.75
1248911604588442880,2020-11,5610.13,3204.88,2568.35,3271.17,1702.43,7533.18
1248911604588442880,2020-12,2712.21,3893.32,2132.69,4872.76,-3921.18,3612
1249309424932532224,2020-03,0,1061.67,1326.37,0,264.7,264.7
1249309424932532224,2020-08,0,1983.28,0,0,-1983.28,-1718.58
1249309424932532224,2020-09,1765.47,0,412.3,0,2177.77,459.19
1251231251708952064,2020-01,2612.27,843.9,1448.99,2783.21,434.15,434.15
1251231251708952064,2020-02,1656.63,2976.68,423.57,2675.65,-3572.13,-3137.98
1251231251708952064,2020-03,697.09,3160.88,616.16,2403.49,-4251.12,-7389.1
1251231251708952064,2020-04,1985,533.73,301.98,3353.01,-1599.76,-8988.86
1251231251708952064,2020-05,2241.6,1163.42,0,213.48,864.7,-8124.16
1251231251708952064,2020-06,1969.59,672.29,2065.52,0,3362.82,-4761.34
1251231251708952064,2020-07,4142.47,1677.36,968.95,2768.95,665.11,-4096.23
1251231251708952064,2020-08,0,2798.79,1861.19,2737.48,-3675.08,-7771.31
1251231251708952064,2020-09,6192.4,1942.64,938.13,2757.73,2430.16,-5341.15
1251231251708952064,2020-10,3381.77,1205.25,2055.14,2439.81,1791.85,-3549.3
1251231251708952064,2020-11,3448.78,2797.54,1159.1,0,1810.34,-1738.96
1251231251708952064,2020-12,0,3944.27,2099.78,0,-1844.49,-3583.45
1251928870186504960,2020-01,1191.42,1238.59,1122.97,1150.04,-74.24,-74.24
1251928870186504960,2020-02,678.45,3062.38,2593.49,1611.76,-1402.2,-1476.44
1251928870186504960,2020-03,1931.3,2643.68,3816.3,4775.05,-1671.13,-3147.57
1251928870186504960,2020-04,201.55,3698.44,3653.96,1288.11,-1131.04,-4278.61
1251928870186504960,2020-05,3527.02,2135.17,2272.76,3593.87,70.74,-4207.87
1251928870186504960,2020-06,0,776.77,0,1417.38,-2194.15,-6402.02
1251928870186504960,2020-07,5835.35,212.18,815.3,187.29,6251.18,-150.84
1251928870186504960,2020-08,4771.08,0,4499.86,4424.77,4846.17,4695.33
1251928870186504960,2020-09,544.19,6404.64,0,384.84,-6245.29,-1549.96
1251928870186504960,2020-10,1078.97,4101.37,3587.95,1307.96,-742.41,-2292.37
1251928870186504960,2020-11,2156.36,4478.39,65.63,4120.25,-6376.65,-8669.02
1251928870186504960,2020-12,2014.84,2498.39,2692.79,6174.81,-3965.57,-12634.59
1254109614846334720,2020-01,3149.62,1548.01,4387.53,6773.54,-784.4,-784.4
1254109614846334720,2020-02,1616.86,3621.01,2269.69,6173.43,-5907.89,-6692.29
1254109614846334720,2020-03,7160.98,2236.09,7073.98,3421.59,8577.28,1884.99
1254109614846334720,2020-04,1954.76,7940.84,1996.92,7817.61,-11806.77,-9921.78
1254109614846334720,2020-05,1912.99,4109.72,5174.6,12894.15,-9916.28,-19838.06
1254109614846334720,2020-06,5866.23,4230.64,7145.53,2718.32,6062.8,-13775.26
1254109614846334720,2020-07,4763.59,6049.63,5825.13,1448.72,3090.37,-10684.89
1254109614846334720,2020-08,1214.55,6259.41,6802.58,4656.52,-2898.8,-13583.69
1254109614846334720,2020-09,7990.91,9602.22,13992.51,3241.36,9139.84,-4443.85
1254109614846334720,2020-10,2178.22,8393.11,2918.71,8149.89,-11446.07,-15889.92
1254109614846334720,2020-11,7532.84,5439.14,0,6878.57,-4784.87,-20674.79
1254109614846334720,2020-12,9398.52,5427.22,1990.38,4888.01,1073.67,-19601.12
1254353277517269248,2020-01,2370.01,1519.71,8027.86,5882.5,2995.66,2995.66
1254353277517269248,2020-02,1021.97,3228.11,3459.78,1849.92,-596.28,2399.38
1254353277517269248,2020-03,3861.73,4010.95,2308.22,4315.99,-2156.99,242.39
1254353277517269248,2020-04,2917.82,5224.09,5877.59,1921.87,1649.45,1891.84
1254353277517269248,2020-05,1191.06,6472.65,5815.97,4453.42,-3919.04,-2027.2
1254353277517269248,2020-06,1656.06,2094.44,1997.64,5160.6,-3601.34,-5628.54
1254353277517269248,2020-07,5936.43,288.28,4596.14,5389.84,4854.45,-774.09
1254353277517269248,2020-08,3665.5,9271.31,1570.09,5013.39,-9049.11,-9823.2
1254353277517269248,2020-09,2829.1,5486.49,4075.29,7191.15,-5773.25,-15596.45
1254353277517269248,2020-10,5788.69,2977.15,5746.75,2822.27,5736.02,-9860.43
1254353277517269248,2020-11,3791.86,2274.61,2917.74,2836.21,1598.78,-8261.65
1254353277517269248,2020-12,4555.16,2651.49,2411.44,5131.72,-816.61,-9078.26
1256388216455991296,2020-01,2159.85,0,6696.76,0,8856.61,8856.61
1256388216455991296,2020-02,2171.55,1367.93,1804.07,0,2607.69,11464.3
1256388216455991296,2020-03,1742.84,0,4065.46,1921.2,3887.1,15351.4
1256388216455991296,2020-04,2560.9,0,2389.12,1697.74,3252.28,18603.68
1256388216455991296,2020-05,2548.18,461.1,2083.86,905.53,3265.41,21869.09
1256388216455991296,2020-06,3839.24,0,699.51,1505.57,3033.18,24902.27
1256388216455991296,2020-07,3610.21,859.41,4305.21,5640.92,1415.09,26317.36
1256388216455991296,2020-08,820.41,3673.38,4263.28,4722.46,-3312.15,23005.21
1256388216455991296,2020-09,2860.01,2502.35,2577.28,588.71,2346.23,25351.44
1256388216455991296,2020-10,6608.81,1743.34,2381.72,1071.18,6176.01,31527.45
1256388216455991296,2020-11,3375.48,1305.1,2490.06,3194.3,1366.14,32893.59
1256388216455991296,2020-12,1702.84,0,2558.05,4559.02,-298.13,32595.46
1260574981861203968,2020-01,1917.2,2612.64,2426.33,0,1730.89,1730.89
1260574981861203968,2020-02,2490.9,1878.82,3306.44,2266.45,1652.07,3382.96
1260574981861203968,2020-03,3243.71,1637.11,3996.92,1436.1,4167.42,7550.38
1260574981861203968,2020-04,1334.41,339.46,1317.11,1841.11,470.95,8021.33
1260574981861203968,2020-05,2729,4034.52,3323.28,1836.34,181.42,8202.75
1260574981861203968,2020-06,5085.28,5599.74,885.67,201.2,170.01,8372.76
1260574981861203968,2020-07,0,3627.12,367.56,3896.52,-7156.08,1216.68
1260574981861203968,2020-08,6275.94,3078.97,972,1307.4,2861.57,4078.25
1260574981861203968,2020-09,1353.1,5350.48,2890.2,2456.52,-3563.7,514.55
1260574981861203968,2020-10,4997.74,5002.35,9724.43,1412.47,8307.35,8821.9
1260574981861203968,2020-11,495.7,0,961.75,968.99,488.46,9310.36
1260574981861203968,2020-12,3543.63,1785.96,6579.53,557.87,7779.33,17089.69
1261065807084123136,2020-01,219.25,2930.2,5086.74,3360.81,-985.02,-985.02
1261065807084123136,2020-02,4514.82,4554.82,1259.17,680.72,538.45,-446.57
1261065807084123136,2020-03,10261.13,6733.29,2520.92,5710.76,338,-108.57
1261065807084123136,2020-04,2127.94,5352.13,2744.25,6515.27,-6995.21,-7103.78
1261065807084123136,2020-05,7763.4,5512.02,2373.03,2932.14,1692.27,-5411.51
1261065807084123136,2020-06,5832.32,2066.68,625.71,1072.18,3319.17,-2092.34
1261065807084123136,2020-07,1391.03,5025.35,6462.66,0,2828.34,736
1261065807084123136,2020-08,3908.56,1649.85,0,4693.5,-2434.79,-1698.79
1261065807084123136,2020-09,7972.97,2702.39,1809.83,4249.13,2831.28,1132.49
1261065807084123136,2020-10,2026.06,816.36,6145.32,5748.09,1606.93,2739.42
1261065807084123136,2020-11,1898.02,2580.57,3307.61,3993.54,-1368.48,1370.94
1261065807084123136,2020-12,2839.41,385.84,6591.48,2767.76,6277.29,7648.23
1261233074591738368,2020-01,6631.89,6630.84,4454.38,1785.65,2669.78,2669.78
1261233074591738368,2020-02,1791.76,2523.86,4089.55,5213.44,-1855.99,813.79
1261233074591738368,2020-03,5129.9,3356.02,5675.15,2703.45,4745.58,5559.37
1261233074591738368,2020-04,1992.62,272.51,4679.03,3790.36,2608.78,8168.15
1261233074591738368,2020-05,3550.61,2925.61,5887.38,3741.69,2770.69,10938.84
1261233074591738368,2020-06,6185.11,5068.65,7632.36,7564.44,1184.38,12123.22
1261233074591738368,2020-07,4835.93,5307.42,7517.75,1645.08,5401.18,17524.4
1261233074591738368,2020-08,1248.01,5340.32,3829.42,3156.41,-3419.3,14105.1
1261233074591738368,2020-09,3964.66,2658.25,2311.35,3037.28,580.48,14685.58
1261233074591738368,2020-10,6376.49,6689.34,1320.46,2380.57,-1372.96,13312.62
1261233074591738368,2020-11,3566.23,4711.1,1753.7,717.39,-108.56,13204.06
1261233074591738368,2020-12,1000.37,3678.2,2139.12,973.62,-1512.33,11691.73
1263335813788286464,2020-01,4954.8,2472.76,3018.32,3382.04,2118.32,2118.32
1263335813788286464,2020-02,1814.72,237.76,276.28,1122.99,730.25,2848.57
1263335813788286464,2020-03,2030.85,760.29,3555.8,3532.39,1293.97,4142.54
1263335813788286464,2020-04,2547.76,4875.17,2411.46,4163.48,-4079.43,63.11
1263335813788286464,2020-05,4429.37,3362.45,1842.2,4643.28,-1734.16,-1671.05
1263335813788286464,2020-06,1556.99,1920.89,1942.26,3239.1,-1660.74,-3331.79
1263335813788286464,2020-07,1526.58,1244.67,2716.62,2990.86,7.67,-3324.12
1263335813788286464,2020-08,486.63,0,4222.97,0,4709.6,1385.48
1263335813788286464,2020-09,1414.47,0,585.75,0,2000.22,3385.7
1263335813788286464,2020-10,1134.14,3424.82,2602.28,123.42,188.18,3573.88
1263335813788286464,2020-11,1980.68,179.37,0,2055.46,-254.15,3319.73
1263335813788286464,2020-12,1278.36,1148.21,7560.64,713.32,6977.47,10297.2
1263891529623043840,2020-01,1263,335.44,5623.42,233.34,6317.64,6317.64
1263891529623043840,2020-02,2978.76,1042.06,0,5947.91,-4011.21,2306.43
1263891529623043840,2020-03,4391.45,1999.21,2653.5,1819.08,3226.66,5533.09
1263891529623043840,2020-04,3737.49,1916.97,3337.23,1023.17,4134.58,9667.67
1263891529623043840,2020-05,2936.91,579.37,3331.1,3244.04,2444.6,12112.27
1263891529623043840,2020-06,5766.11,1988.33,0,2238.91,1538.87,13651.14
1263891529623043840,2020-07,3376.63,1627.56,4280.43,2769.69,3259.81,16910.95
1263891529623043840,2020-08,7725.45,1555.76,2547.48,54.46,8662.71,25573.66
1263891529623043840,2020-10,5737.98,3274.3,3541.7,1360.53,4644.85,30218.51
1263891529623043840,2020-11,1963.76,3038.57,88.29,1960.14,-2946.66,27271.85
1263891529623043840,2020-12,3749.36,2343.3,2775.71,4716.89,-535.12,26736.73
1263907934571037184,2020-02,2174.37,0,43.11,0,2217.48,2217.48
1263907934571037184,2020-03,2728.57,0,1704.59,0,4433.16,6650.64
1263907934571037184,2020-04,2193.4,0,0,0,2193.4,8844.04
1263907934571037184,2020-05,659.67,0,1423.71,0,2083.38,10927.42
1263907934571037184,2020-06,2830.89,0,2353.6,1662.89,3521.6,14449.02
1263907934571037184,2020-08,1646.3,0,0,1260.55,385.75,14834.77
1263907934571037184,2020-10,0,1124.36,0,0,-1124.36,13710.41
1264835318326348800,2020-01,0,1123.43,0,0,-1123.43,-1123.43
1264835318326348800,2020-02,0,1039.8,0,890.88,-1930.68,-3054.11
1264835318326348800,2020-03,2488.88,1919.02,2515.85,0,3085.71,31.6
1264835318326348800,2020-04,1500.53,957.12,0,0,543.41,575.01
1264835318326348800,2020-05,1602.62,0,2312.9,1022.75,2892.77,3467.78
1264835318326348800,2020-06,568.16,0,0,92.36,475.8,3943.58
1264835318326348800,2020-07,729.7,0,1720.29,0,2449.99,6393.57
1264835318326348800,2020-08,0,2411.37,1378.06,104.26,-1137.57,5256
1264835318326348800,2020-09,1057.92,0,0,0,1057.92,6313.92
1264835318326348800,2020-10,0,155,280.6,1914.53,-1788.93,4524.99
1264965486982716928,2020-01,6856.74,0,3551.4,2069.58,8338.56,8338.56
1264965486982716928,2020-02,1832.28,0,4215.42,3438.74,2608.96,10947.52
1264965486982716928,2020-03,0,2434.94,3950.52,5208.14,-3692.56,7254.96
1264965486982716928,2020-04,1653.99,2345.47,2531.31,2668.42,-828.59,6426.37
1264965486982716928,2020-05,1836.77,5310.6,1916.92,5889.14,-7446.05,-1019.68
1264965486982716928,2020-06,1655.28,794.39,1904,1903.11,861.78,-157.9
1264965486982716928,2020-07,3880.22,2168.78,4528.2,0,6239.64,6081.74
1264965486982716928,2020-08,2715.73,5980.91,3821.26,3625.17,-3069.09,3012.65
1264965486982716928,2020-09,1540.42,2299.39,1325.59,5699.19,-5132.57,-2119.92
1264965486982716928,2020-10,458.97,2716.84,0,1274.45,-3532.32,-5652.24
1264965486982716928,2020-11,1848.79,3180.31,4456.19,2187.29,937.38,-4714.86
1264965486982716928,2020-12,2859.19,1929.36,9330.26,2354.67,7905.42,3190.56
1265077858622271232,2020-01,3059.16,954.41,4925.61,2565.66,4464.7,4464.7
1265077858622271232,2020-02,3101.07,969.58,2804.28,6865.92,-1930.15,2534.55
1265077858622271232,2020-03,4505.8,5753.07,7497.4,4561.87,1688.26,4222.81
1265077858622271232,2020-04,8409.21,3663.19,7504.94,3532.6,8718.36,12941.17
1265077858622271232,2020-05,3180.58,3789.68,485.76,4371.16,-4494.5,8446.67
1265077858622271232,2020-06,2803.26,5703.29,2252.55,7554.63,-8202.11,244.56
1265077858622271232,2020-07,8252.18,3085.76,501.51,5382.22,285.71,530.27
1265077858622271232,2020-08,10964.47,304.39,5746.48,3593.3,12813.26,13343.53
1265077858622271232,2020-09,3012.47,4455.2,3533.09,4647.42,-2557.06,10786.47
1265077858622271232,2020-10,1535.51,10141.87,2699.91,3797.78,-9704.23,1082.24
1265077858622271232,2020-11,5093.48,9233.71,6823.23,5909.87,-3226.87,-2144.63
1265077858622271232,2020-12,5506.46,3001.17,2638.33,2007.86,3135.76,991.13
1265317351166418944,2020-04,0,1044.62,0,0,-1044.62,-1044.62
1265317351166418944,2020-05,0,1094.85,0,1271.49,-2366.34,-3410.96
1265317351166418944,2020-08,1140.2,0,0,0,1140.2,-2270.76
1265414401054377728,2020-01,199.09,1244.63,0,212.93,-1258.47,-1258.47
1265414401054377728,2020-02,1398.26,0,2086.7,1155.17,2329.79,1071.32
1265414401054377728,2020-03,397.87,983.02,0,980.42,-1565.57,-494.25
1265414401054377728,2020-04,1101.93,2845.96,832.75,1589.57,-2500.85,-2995.1
1265414401054377728,2020-05,4078.87,1094.28,289.13,0,3273.72,278.62
1265414401054377728,2020-06,3510.51,1781.42,1911.71,2280.38,1360.42,1639.04
1265414401054377728,2020-07,1529.45,928.81,1109.19,2913.12,-1203.29,435.75
1265414401054377728,2020-08,1887.63,0,0,0,1887.63,2323.38
1265414401054377728,2020-09,1238.92,1202.38,0,667.59,-631.05,1692.33
1265414401054377728,2020-10,0,1492.72,4702.71,0,3209.99,4902.32
1265414401054377728,2020-11,1605.13,978.37,2315.94,0,2942.7,7845.02
1265414401054377728,2020-12,738.58,414.87,804.02,2681.34,-1553.61,6291.41
1265516708570929408,2020-01,0,715.35,1636.73,1008.77,-87.39,-87.39
1265516708570929408,2020-02,0,1380.1,0,0,-1380.1,-1467.49
1265516708570929408,2020-03,311.21,0,459.26,1043.79,-273.32,-1740.81
1265516708570929408,2020-04,0,1411.69,99.96,0,-1311.73,-3052.54
1265516708570929408,2020-05,0,1629.45,73.64,0,-1555.81,-4608.35
1265516708570929408,2020-06,667.89,0,820.56,0,1488.45,-3119.9
1265516708570929408,2020-07,1358.92,1799.55,0,2747.71,-3188.34,-6308.24
1265516708570929408,2020-08,1882,1957.45,880.26,0,804.81,-5503.43
1265516708570929408,2020-09,0,1643.13,1329.93,0,-313.2,-5816.63
1265516708570929408,2020-10,803.1,1327.52,0,0,-524.42,-6341.05
1265516708570929408,2020-11,974.18,2629.45,0,0,-1655.27,-7996.32
1265516708570929408,2020-12,87.7,1676.85,1349.58,692.35,-931.92,-8928.24
1265648901804451072,2020-01,3859.63,784.12,5341.09,2399.03,6017.57,6017.57
1265648901804451072,2020-02,3112.73,5670.56,0,1722.8,-4280.63,1736.94
1265648901804451072,2020-03,234.81,1792.79,2010.98,0,453,2189.94
1265648901804451072,2020-04,4598.09,0,4007.81,969.01,7636.89,9826.83
1265648901804451072,2020-05,5913.86,2612.58,2671.36,1230.09,4742.55,14569.38
1265648901804451072,2020-06,2159.17,1335.54,5815.5,3465.78,3173.35,17742.73
1265648901804451072,2020-07,4628.13,5272.01,5503.21,5597.45,-738.12,17004.61
1265648901804451072,2020-08,859.28,5429.03,0,408.86,-4978.61,12026
1265648901804451072,2020-09,4786.56,2341.44,3234.74,1736.58,3943.28,15969.28
1265648901804451072,2020-10,5989.64,1909.92,3416.01,4121.58,3374.15,19343.43
1265648901804451072,2020-11,1855.19,1217.76,2822.18,2484.91,974.7,20318.13
1265648901804451072,2020-12,1569.9,2866.4,3473.96,210.61,1966.85,22284.98
1266795607355434240,2020-01,7208.58,6177.4,2539.92,6881.53,-3310.43,-3310.43
1266795607355434240,2020-02,1227.11,1406.27,6067.9,4633.49,1255.25,-2055.18
1266795607355434240,2020-03,1750.65,3977.95,5620.24,293.34,3099.6,1044.42
1266795607355434240,2020-04,4001.69,2039.05,2668.17,6117.86,-1487.05,-442.63
1266795607355434240,2020-05,1732.23,3302.47,8435.69,1482.91,5382.54,4939.91
1266795607355434240,2020-06,862.03,3906.79,4600.21,9393.02,-7837.57,-2897.66
1266795607355434240,2020-07,4332.43,6923.41,1577.07,397.31,-1411.22,-4308.88
1266795607355434240,2020-08,4601,7229.73,6324.84,6632.81,-2936.7,-7245.58
1266795607355434240,2020-09,3770.6,1776.86,5462.66,7170.9,285.5,-6960.08
1266795607355434240,2020-10,3638.15,4447.55,3273.34,4097.21,-1633.27,-8593.35
1266795607355434240,2020-11,2031.69,3680.48,4724.79,7126.82,-4050.82,-12644.17
1266795607355434240,2020-12,4284.85,2628.94,2133.63,2726.62,1062.92,-11581.25
1267090049386623232,2020-01,2592.93,4023.31,4392.49,1348.3,1613.81,1613.81
1267090049386623232,2020-02,3106,4603.78,1879.67,2431.1,-2049.21,-435.4
1267090049386623232,2020-03,0,4013.1,3423.31,0,-589.79,-1025.19
1267090049386623232,2020-04,1202.54,2865.25,1977.75,1505.97,-1190.93,-2216.12
1267090049386623232,2020-05,167.1,2720.86,5372.36,3060.42,-241.82,-2457.94
1267090049386623232,2020-06,3195.23,2677.8,4255.16,1875.47,2897.12,439.18
1267090049386623232,2020-07,1089.91,2018.31,5804.23,1800.34,3075.49,3514.67
1267090049386623232,2020-08,1951.22,0,1333.48,4199.44,-914.74,2599.93
1267090049386623232,2020-09,0,1467.78,1438.96,1952.1,-1980.92,619.01
1267090049386623232,2020-10,5674.42,4753.83,4088.07,3191.18,1817.48,2436.49
1267090049386623232,2020-11,2095.77,1218.32,502.17,1578.78,-199.16,2237.33
1267090049386623232,2020-12,6261.66,2047.63,1611.65,2462.65,3363.03,5600.36
1268258183375556608,2020-01,9.45,0,0,309.34,-299.89,-299.89
1268258183375556608,2020-02,367.63,0,0,1383.42,-1015.79,-1315.68
1268258183375556608,2020-03,0,2044.49,611.83,813.21,-2245.87,-3561.55
1268258183375556608,2020-04,1805.58,1701.6,1905.83,0,2009.81,-1551.74
1268258183375556608,2020-05,928.99,0,0,0,928.99,-622.75
1268258183375556608,2020-06,2933.63,1752.6,0,0,1181.03,558.28
1268258183375556608,2020-07,1170.9,1228.01,0,0,-57.11,501.17
1268258183375556608,2020-08,1343.22,1482.83,0,1858.08,-1997.69,-1496.52
1268258183375556608,2020-09,2377.41,0,0,4700.86,-2323.45,-3819.97
1268258183375556608,2020-10,697.3,3006.81,0,0,-2309.51,-6129.48
1268258183375556608,2020-11,0,1086.24,1257.43,1123.02,-951.83,-7081.31
1268258183375556608,2020-12,1265.45,0,2532.35,993.83,2803.97,-4277.34
1268407383499190016,2020-01,9056.69,2557.72,2181.04,3889.45,4790.56,4790.56
1268407383499190016,2020-02,2598.71,3925.43,0,2518.34,-3845.06,945.5
1268407383499190016,2020-03,2689,22.02,876.95,1762.61,1781.32,2726.82
1268407383499190016,2020-04,3039.82,8842.65,2475.24,207.01,-3534.6,-807.78
1268407383499190016,2020-05,5059.4,2722.46,556.57,4798.61,-1905.1,-2712.88
1268407383499190016,2020-06,2009.95,371.47,1066.05,1053.61,1650.92,-1061.96
1268407383499190016,2020-07,3877.34,0,2576.33,1102,5351.67,4289.71
1268407383499190016,2020-08,614.5,2200.92,0,1195.77,-2782.19,1507.52
1268407383499190016,2020-09,2868.06,1936.11,0,2346.42,-1414.47,93.05
1268407383499190016,2020-10,2388.51,1364.55,4838.64,3370.7,2491.9,2584.95
1268407383499190016,2020-11,1845.87,3041.05,4387.26,0,3192.08,5777.03
1268407383499190016,2020-12,2847.51,958.83,2088.98,311.97,3665.69,9442.72
1268855830970081024,2020-01,2134.4,4559.33,5986.98,2172.46,1389.59,1389.59
1268855830970081024,2020-02,2581.49,2431.7,1158.82,2162.07,-853.46,536.13
1268855830970081024,2020-03,1601.43,5149.41,2214.93,5996.62,-7329.67,-6793.54
1268855830970081024,2020-04,4822.9,3971.64,5060.68,0,5911.94,-881.6
1268855830970081024,2020-05,1500.96,3481.21,865.21,2379.89,-3494.93,-4376.53
1268855830970081024,2020-06,1294.08,1220.24,9.99,2814.42,-2730.59,-7107.12
1268855830970081024,2020-07,0,1525.56,0,3592.52,-5118.08,-12225.2
1268855830970081024,2020-08,4744.94,4235.47,4054.81,1522.55,3041.73,-9183.47
1268855830970081024,2020-09,4776.25,510.86,2148.29,1183.65,5230.03,-3953.44
1268855830970081024,2020-10,1357.63,4018.15,2768.22,3254.54,-3146.84,-7100.28
1268855830970081024,2020-11,3275.67,2600.78,1933.26,1526.4,1081.75,-6018.53
1268855830970081024,2020-12,1402.85,2404.26,3198.79,3096.31,-898.93,-6917.46
1269972999925683200,2020-01,2531.43,1873.7,4535.57,7053.69,-1860.39,-1860.39
1269972999925683200,2020-02,5862.59,5087.81,8524.6,3355.75,5943.63,4083.24
1269972999925683200,2020-03,6943.98,2200.66,4579.2,4244.88,5077.64,9160.88
1269972999925683200,2020-04,7749.67,3633.23,2066,1374.9,4807.54,13968.42
1269972999925683200,2020-05,4614.67,7437.48,2628.85,6956.37,-7150.33,6818.09
1269972999925683200,2020-06,4643.49,2681.26,2695.07,4655.43,1.87,6819.96
1269972999925683200,2020-07,3768.42,5471.32,1195.34,6672.95,-7180.51,-360.55
1269972999925683200,2020-08,2141.6,973.13,5357.94,2985.09,3541.32,3180.77
1269972999925683200,2020-09,9880.57,3752.36,1169.15,5657.45,1639.91,4820.68
1269972999925683200,2020-10,7783.71,4333.29,2109.66,3662.45,1897.63,6718.31
1269972999925683200,2020-11,4027.55,2117.26,7016.37,4196.35,4730.31,11448.62
1269972999925683200,2020-12,5175.26,4102.85,6681.12,3434.03,4319.5,15768.12
1271066043070129408,2020-01,4049.21,1917.98,6191.33,833.14,7489.42,7489.42
1271066043070129408,2020-02,3604.36,6140,3959.77,3000.17,-1576.04,5913.38
1271066043070129408,2020-03,2076.96,4330.38,995.43,2595.03,-3853.02,2060.36
1271066043070129408,2020-04,1720.84,5313.53,3797.45,1164.93,-960.17,1100.19
1271066043070129408,2020-05,711.01,3515.53,4483.95,2266.84,-587.41,512.78
1271066043070129408,2020-06,1390.33,1239.25,1037.55,1142.6,46.03,558.81
1271066043070129408,2020-07,4001.54,2101.63,3929.86,3507.91,2321.86,2880.67
1271066043070129408,2020-08,2850.19,3099.99,928.27,7941.23,-7262.76,-4382.09
1271066043070129408,2020-09,5488.25,208.63,76.96,50.25,5306.33,924.24
1271066043070129408,2020-10,1335.06,2034.6,2240.58,0,1541.04,2465.28
1271066043070129408,2020-11,2084.28,1156.99,1782.8,1293.2,1416.89,3882.17
1271066043070129408,2020-12,62.12,1540.74,2393.43,2456.88,-1542.07,2340.1
1271087079200614144,2020-01,0,200.44,2343.6,1207.22,935.94,935.94
1271087079200614144,2020-02,524.04,0,0,1900.58,-1376.54,-440.6
1271087079200614144,2020-03,1417.07,150.38,0,3973.19,-2706.5,-3147.1
1271087079200614144,2020-05,1591.59,266.97,505.72,1216.82,613.52,-2533.58
1271087079200614144,2020-06,1946.64,2835,1497.84,341.48,268,-2265.58
1271087079200614144,2020-07,1280.32,1965.75,456.13,2751.47,-2980.77,-5246.35
1271087079200614144,2020-08,3037.13,1312.41,461.45,1031.97,1154.2,-4092.15
1271087079200614144,2020-09,2458.59,1187.75,0,3485.61,-2214.77,-6306.92
1271087079200614144,2020-10,1778.94,7342.18,773.05,1741.93,-6532.12,-12839.04
1271087079200614144,2020-11,1990.49,5815.44,1536.89,1165.41,-3453.47,-16292.51
1271087079200614144,2020-12,3721.4,3862.89,2416.91,715.89,1559.53,-14732.98
1273649266161571584,2020-01,5229.16,3318.6,8359.87,5723.74,4546.69,4546.69
1273649266161571584,2020-02,1793.85,2355.3,4098.05,2154.33,1382.27,5928.96
1273649266161571584,2020-03,540.92,3262.82,5879.51,1500.57,1657.04,7586
1273649266161571584,2020-04,3321.1,3285.91,1661.6,2577.34,-880.55,6705.45
1273649266161571584,2020-05,3985.41,3778.07,1837.72,6207.73,-4162.67,2542.78
1273649266161571584,2020-06,2775.35,2886.08,6226.75,4036.84,2079.18,4621.96
1273649266161571584,2020-07,2229.28,4876.2,2928.06,3333.81,-3052.67,1569.29
1273649266161571584,2020-08,1624.59,6029.83,3770.37,6949.52,-7584.39,-6015.1
1273649266161571584,2020-09,7426.41,4044.36,3466.34,3996.43,2851.96,-3163.14
1273649266161571584,2020-10,1814.62,6241.49,2516.29,3537.77,-5448.35,-8611.49
1273649266161571584,2020-11,1189.52,2575.3,7259.85,2276.1,3597.97,-5013.52
1273649266161571584,2020-12,4299.38,4293.62,5203.4,3522.44,1686.72,-3326.8
1274287818230967808,2020-01,1593.82,0,3412.36,873.31,4132.87,4132.87
1274287818230967808,2020-02,1663.61,1873.55,0,1683.09,-1893.03,2239.84
1274287818230967808,2020-03,0,440.1,454.03,1079.66,-1065.73,1174.11
1274287818230967808,2020-05,1927.43,2619.93,0,1348.08,-2040.58,-866.47
1274287818230967808,2020-06,3093.13,3614.27,1645.1,4287.74,-3163.78,-4030.25
1274287818230967808,2020-07,2175.87,3967.28,0,372.91,-2164.32,-6194.57
1274287818230967808,2020-08,865.49,2902.2,0,2954.89,-4991.6,-11186.17
1274287818230967808,2020-09,1958.93,3632.92,1970.27,2806.14,-2509.86,-13696.03
1274287818230967808,2020-10,4698.21,1867.31,1367.45,3443.76,754.59,-12941.44
1274287818230967808,2020-11,1677.62,1242.53,2847.56,3610.76,-328.11,-13269.55
1274287818230967808,2020-12,125.35,2183.35,0,3798.9,-5856.9,-19126.45
1274687628637620480,2020-01,4183.82,548.6,4417.63,4239.89,3812.96,3812.96
1274687628637620480,2020-02,4534.33,1873.5,4810.17,1503.29,5967.71,9780.67
1274687628637620480,2020-03,2873.86,10269.22,2718.38,3290.85,-7967.83,1812.84
1274687628637620480,2020-05,2914.71,4896.13,4307.09,5076.3,-2750.63,-937.79
1274687628637620480,2020-06,5283.37,3365.34,4389.15,4161.55,2145.63,1207.84
1274687628637620480,2020-07,5060.23,4435.05,5732.74,3627.3,2730.62,3938.46
1274687628637620480,2020-08,1959.09,4829.37,2923.05,1511.52,-1458.75,2479.71
1274687628637620480,2020-09,5618.5,2957.04,2721.84,0,5383.3,7863.01
1274687628637620480,2020-10,3468.8,1946.03,1305.14,1785.01,1042.9,8905.91
1274687628637620480,2020-11,5299.97,3740.38,955.03,5304.02,-2789.4,6116.51
1274687628637620480,2020-12,5179.31,3637.09,4869.85,2397.02,4015.05,10131.56
1275071511112185856,2020-01,2219.65,2488.28,3551.52,3103.63,179.26,179.26
1275071511112185856,2020-02,2657.45,3535.03,1960.45,2691.54,-1608.67,-1429.41
1275071511112185856,2020-03,9408.04,4130.74,4473.8,5583.7,4167.4,2737.99
1275071511112185856,2020-04,2673,4939.55,3396.11,4759.92,-3630.36,-892.37
1275071511112185856,2020-05,2449.95,2210.92,4391.81,3247.48,1383.36,490.99
1275071511112185856,2020-06,1905.34,3615.9,3327.24,5054.62,-3437.94,-2946.95
1275071511112185856,2020-07,2557.59,2937.17,5322.29,1812.07,3130.64,183.69
1275071511112185856,2020-08,3505.37,7290.35,5819.01,3357.28,-1323.25,-1139.56
1275071511112185856,2020-09,7157.04,5911.81,3392.91,3725.71,912.43,-227.13
1275071511112185856,2020-10,3538.69,9140.43,6711.87,3248.86,-2138.73,-2365.86
1275071511112185856,2020-11,5164.8,2538.34,2244.44,3028.12,1842.78,-523.08
1275071511112185856,2020-12,4696.58,1346.61,7460.78,681.8,10128.95,9605.87
1276495318521736960,2020-01,4848.71,5125.52,7460.56,2861.65,4322.1,4322.1
1276495318521736960,2020-02,4800.01,4140.66,4251.24,4119.05,791.54,5113.64
1276495318521736960,2020-03,0,4143.63,5962.7,2021.42,-202.35,4911.29
1276495318521736960,2020-04,7920.07,26.52,667.47,6330.57,2230.45,7141.74
1276495318521736960,2020-05,2707.44,4693.84,2455.64,8156.28,-7687.04,-545.3
1276495318521736960,2020-06,6264.88,4020.08,2986.52,5100.15,131.17,-414.13
1276495318521736960,2020-07,2558.09,8395.2,4900.41,1408.36,-2345.06,-2759.19
1276495318521736960,2020-08,2535.54,2045.22,3981.35,3552.62,919.05,-1840.14
1276495318521736960,2020-09,4134.21,5988.87,4388.64,3407.44,-873.46,-2713.6
1276495318521736960,2020-10,3173.59,1977.16,5434.93,5245.11,1386.25,-1327.35
1276495318521736960,2020-11,8923.15,3556.41,6900.26,4753.65,7513.35,6186
1276495318521736960,2020-12,4949.04,5740.79,7580.25,3673.28,3115.22,9301.22
1279426175705112576,2020-01,7364.73,2209.29,6424.91,1124.18,10456.17,10456.17
1279426175705112576,2020-02,2951.99,6895.31,4438.36,2387.09,-1892.05,8564.12
1279426175705112576,2020-03,3045.99,5422.3,2052.37,3362.46,-3686.4,4877.72
1279426175705112576,2020-04,5646.43,5837.9,7143.2,6604.15,347.58,5225.3
1279426175705112576,2020-05,2280.78,6536.47,6019.86,2764.17,-1000,4225.3
1279426175705112576,2020-06,0,7397.05,1745.27,6224.79,-11876.57,-7651.27
1279426175705112576,2020-07,5124.1,3884.07,2662.64,6669.32,-2766.65,-10417.92
1279426175705112576,2020-08,1972.85,2312.8,4960.32,6278.58,-1658.21,-12076.13
1279426175705112576,2020-09,807.27,5808.1,533.92,683.06,-5149.97,-17226.1
1279426175705112576,2020-10,2315.87,4136.01,2670.79,3758.89,-2908.24,-20134.34
1279426175705112576,2020-11,1944.15,3104.24,4206.25,4152.13,-1105.97,-21240.31
1279426175705112576,2020-12,4674.24,2470.76,2459.67,2158.3,2504.85,-18735.46
1280242765825734144,2020-01,290.32,405.17,0,714.9,-829.75,-829.75
1280242765825734144,2020-02,740.81,1046.68,44.33,2310.2,-2571.74,-3401.49
1280242765825734144,2020-03,1836.02,0,1959.56,0,3795.58,394.09
1280242765825734144,2020-04,0,602.4,4497.9,113.64,3781.86,4175.95
1280242765825734144,2020-06,1933.88,1566.63,237.28,2218.07,-1613.54,2562.41
1280242765825734144,2020-07,0,33.36,0,1563.85,-1597.21,965.2
1280242765825734144,2020-08,0,873.28,2005.44,0,1132.16,2097.36
1280242765825734144,2020-09,1530.15,0,0,4809.79,-3279.64,-1182.28
1280242765825734144,2020-10,0,1218.65,32.55,0,-1186.1,-2368.38
1280242765825734144,2020-11,2219.46,994.45,1745.05,1501.01,1469.05,-899.33
1281583092480934656,2020-01,4828.43,773.03,3924.35,471.7,7508.05,7508.05
1281583092480934656,2020-02,5264.01,2149.14,4084.82,863.33,6336.36,13844.41
1281583092480934656,2020-03,1087.92,1735.42,3753.49,395.5,2710.49,16554.9
1281583092480934656,2020-04,3834.29,1177.47,1145.5,3456.26,346.06,16900.96
1281583092480934656,2020-05,1019.99,5687.16,924.89,0,-3742.28,13158.68
1281583092480934656,2020-06,2579.95,969.59,2067.24,4398.97,-721.37,12437.31
1281583092480934656,2020-07,31.49,3846.23,1526.85,0,-2287.89,10149.42
1281583092480934656,2020-08,449.78,2667.3,2455.89,209.84,28.53,10177.95
1281583092480934656,2020-09,1703.71,0,1479.44,850.98,2332.17,12510.12
1281583092480934656,2020-10,1384.72,1119.19,1157.46,5010.84,-3587.85,8922.27
1281583092480934656,2020-11,2102.13,4185.44,5233.28,3689.41,-539.44,8382.83
1281583092480934656,2020-12,1082.19,4281.79,2555.92,3501.68,-4145.36,4237.47
1286130023396809216,2020-01,2793.32,1433.71,4870.12,3066.84,3162.89,3162.89
1286130023396809216,2020-02,2746.91,1749.56,5452.71,711.62,5738.44,8901.33
1286130023396809216,2020-03,4470.38,3539.55,6747.11,3397.55,4280.39,13181.72
1286130023396809216,2020-04,8948.92,2940.61,4107.51,3850.18,6265.64,19447.36
1286130023396809216,2020-05,4788.36,774.19,2098.7,1294.13,4818.74,24266.1
1286130023396809216,2020-06,2295.85,3157.22,6378.67,5214.91,302.39,24568.49
1286130023396809216,2020-07,5341.63,6509.37,4204.52,6158.47,-3121.69,21446.8
1286130023396809216,2020-08,4459.08,4715.2,2841.78,6030.95,-3445.29,18001.51
1286130023396809216,2020-09,9719.49,7004.36,2133.56,2767.05,2081.64,20083.15
1286130023396809216,2020-10,4719.99,0,4932.79,4559.31,5093.47,25176.62
1286130023396809216,2020-11,3401.44,3947.71,3481.79,3177.85,-242.33,24934.29
1286130023396809216,2020-12,0,2119.58,2407.93,6732.22,-6443.87,18490.42
1287484297503140864,2020-01,5685.72,8231.25,3575.66,2275.07,-1244.94,-1244.94
1287484297503140864,2020-02,6848.54,2735.59,6342.49,2157.38,8298.06,7053.12
1287484297503140864,2020-03,4627.51,3920.54,11893.87,8155.45,4445.39,11498.51
1287484297503140864,2020-04,5320.76,10289.73,4893.43,2524.19,-2599.73,8898.78
1287484297503140864,2020-05,6888.11,1184.21,2897.74,5888.56,2713.08,11611.86
1287484297503140864,2020-06,5642.82,9254.5,5033.71,5704.5,-4282.47,7329.39
1287484297503140864,2020-07,4490.79,6251.18,6068.55,6113.17,-1805.01,5524.38
1287484297503140864,2020-08,4203.65,5301.92,9173.28,1996.69,6078.32,11602.7
1287484297503140864,2020-09,3417.28,2238.1,2042.91,1036.34,2185.75,13788.45
1287484297503140864,2020-10,4859.31,4839.92,4974.68,6060.44,-1066.37,12722.08
1287484297503140864,2020-11,2453.11,6467.81,4536.4,6211.67,-5689.97,7032.11
1287484297503140864,2020-12,1859.03,2132.11,2596.41,1748.15,575.18,7607.29
1290572864069776128,2020-01,6112.77,1004.58,3262.61,2060.61,6310.19,6310.19
1290572864069776128,2020-02,6102.16,4192.61,1868.18,8588.91,-4811.18,1499.01
1290572864069776128,2020-03,4570.78,2456.45,10244.6,4288.26,8070.67,9569.68
1290572864069776128,2020-04,4279.59,626.3,4961.57,3165.7,5449.16,15018.84
1290572864069776128,2020-05,2478.05,472.74,1870.18,6390.74,-2515.25,12503.59
1290572864069776128,2020-06,6548.26,3454.33,2391.7,3846.08,1639.55,14143.14
1290572864069776128,2020-07,4210.8,775.91,3148.75,3408.74,3174.9,17318.04
1290572864069776128,2020-08,2865.72,701.07,4613.34,8747.95,-1969.96,15348.08
1290572864069776128,2020-09,2636.35,2984.71,2121.26,7893.3,-6120.4,9227.68
1290572864069776128,2020-10,848.45,9798.49,56.77,4057.32,-12950.59,-3722.91
1290572864069776128,2020-11,4950.13,3515.24,3027.48,1370.24,3092.13,-630.78
1290572864069776128,2020-12,2001.77,8060.33,1787.24,5049.45,-9320.77,-9951.55
1291510744095379712,2020-08,312.85,0,0,1755.47,-1442.62,-1442.62
1291510744095379712,2020-09,1835.76,0,0,0,1835.76,393.14
1291807757940000256,2020-01,4624.43,7093.25,788.77,2380.89,-4060.94,-4060.94
1291807757940000256,2020-02,2518.42,1738.93,3224.15,4795.01,-791.37,-4852.31
1291807757940000256,2020-03,726.67,3559.37,119.36,5888.35,-8601.69,-13454
1291807757940000256,2020-04,3117.87,2667.41,7003.19,2085.22,5368.43,-8085.57
1291807757940000256,2020-05,6836.74,760.56,3796.29,2712.29,7160.18,-925.39
1291807757940000256,2020-06,3378.54,1650.01,316.43,4590.37,-2545.41,-3470.8
1291807757940000256,2020-07,3548.56,6665.49,811.72,2946.27,-5251.48,-8722.28
1291807757940000256,2020-08,4139.94,4191.58,1805.08,5973.68,-4220.24,-12942.52
1291807757940000256,2020-09,597.29,48.61,5431.47,5663.27,316.88,-12625.64
1291807757940000256,2020-10,3625.26,3631.69,3544.67,0,3538.24,-9087.4
1291807757940000256,2020-11,3286.84,2572.32,4684.5,4775.2,623.82,-8463.58
1291807757940000256,2020-12,1500.28,1929.16,486.53,3261.55,-3203.9,-11667.48
1292285505317674240,2020-02,0,793.3,1516.02,0,722.72,722.72
1292285505317674240,2020-03,0,741.67,0,0,-741.67,-18.95
1292285505317674240,2020-04,0,655.52,0,0,-655.52,-674.47
1292285505317674240,2020-08,0,1520.16,0,0,-1520.16,-2194.63
1292285505317674240,2020-11,631.43,1667.7,0,0,-1036.27,-3230.9
1292579669853481216,2020-01,0,1875.25,0,1414.3,-3289.55,-3289.55
1292579669853481216,2020-02,364.28,1705.41,1895.58,0,554.45,-2735.1
1292579669853481216,2020-03,1965.92,1883.33,808.45,0,891.04,-1844.06
1292579669853481216,2020-04,1751.84,3578.61,3592.46,918.51,847.18,-996.88
1292579669853481216,2020-05,1844.06,2915.65,2995.35,617.15,1306.61,309.73
1292579669853481216,2020-06,0,2585.96,1726.69,3580.99,-4440.26,-4130.53
1292579669853481216,2020-07,1954.97,2225.57,1541.54,0,1270.94,-2859.59
1292579669853481216,2020-08,393.43,1080,0,370.03,-1056.6,-3916.19
1292579669853481216,2020-09,1701.32,0,2739.99,14.05,4427.26,511.07
1292579669853481216,2020-10,523.89,1416.39,0,429.94,-1322.44,-811.37
1292579669853481216,2020-11,1844.49,5603,737.57,1455.78,-4476.72,-5288.09
1292579669853481216,2020-12,1784.93,1995.42,901.51,0,691.02,-4597.07
1293322747315032064,2020-01,747.33,0,1992.78,0,2740.11,2740.11
1293322747315032064,2020-03,1255.83,0,0,0,1255.83,3995.94
1293322747315032064,2020-08,0,1062.56,0,0,-1062.56,2933.38
1293322747315032064,2020-11,0,1899.54,0,0,-1899.54,1033.84
1293431270570676224,2020-01,6070.36,5762.29,11124.95,5117.27,6315.75,6315.75
1293431270570676224,2020-02,4529.55,3309.69,1117.95,5691.03,-3353.22,2962.53
1293431270570676224,2020-03,2307.73,3789.1,8817.3,6210.29,1125.64,4088.17
1293431270570676224,2020-04,868.41,9041.99,2441.77,9354,-15085.81,-10997.64
1293431270570676224,2020-05,2765.98,7967.69,5627.17,7441.14,-7015.68,-18013.32
1293431270570676224,2020-06,7392.68,2018.3,2649.22,1128.51,6895.09,-11118.23
1293431270570676224,2020-07,8547.42,3461.09,2473.93,5285.25,2275.01,-8843.22
1293431270570676224,2020-08,6549.89,9401.91,2748.69,4106.04,-4209.37,-13052.59
1293431270570676224,2020-09,2238.92,4388.11,4229.18,2268.39,-188.4,-13240.99
1293431270570676224,2020-10,7582.48,6003.2,3555.21,2856.01,2278.48,-10962.51
1293431270570676224,2020-11,4823.36,9537.49,5004.74,2462.94,-2172.33,-13134.84
1293431270570676224,2020-12,2919.59,8235.22,700.53,2969.58,-7584.68,-20719.52
1294042862303319296,2020-01,5391.15,3444.87,8241.07,3028.07,7159.28,7159.28
1294042862303319296,2020-02,2778.54,2240.54,1157,3382.23,-1687.23,5472.05
1294042862303319296,2020-03,6451.72,5578.66,3243.76,5815.99,-1699.17,3772.88
1294042862303319296,2020-04,6692.29,4644.4,3448.06,4951.26,544.69,4317.57
1294042862303319296,2020-05,5074.59,4506.36,4346.59,5388.93,-474.11,3843.46
1294042862303319296,2020-06,5146.66,207.45,4467.31,3011.29,6395.23,10238.69
1294042862303319296,2020-07,0,3378.58,6493.77,6380.97,-3265.78,6972.91
1294042862303319296,2020-08,3577.73,9432.56,5157.95,860.15,-1557.03,5415.88
1294042862303319296,2020-09,4967.14,2209.9,0,2467.78,289.46,5705.34
1294042862303319296,2020-10,1293.1,3767.53,4942.89,752.04,1716.42,7421.76
1294042862303319296,2020-11,4868.03,101.88,2400.23,5172.07,1994.31,9416.07
1294042862303319296,2020-12,3053.34,3285.24,0,313,-544.9,8871.17
1295878338325011456,2020-01,2830.91,8777.82,5715.77,3688.45,-3919.59,-3919.59
1295878338325011456,2020-02,3896.58,4287.39,504.91,1911.84,-1797.74,-5717.33
1295878338325011456,2020-03,7209.24,2566.17,1253.27,1968.62,3927.72,-1789.61
1295878338325011456,2020-04,1332.09,1261.4,769.77,5042.15,-4201.69,-5991.3
1295878338325011456,2020-05,2486.23,3384.49,8605.27,5860.25,1846.76,-4144.54
1295878338325011456,2020-06,2868.62,2840.67,4710.67,2626.91,2111.71,-2032.83
1295878338325011456,2020-07,1994.72,1706.64,998.69,0,1286.77,-746.06
1295878338325011456,2020-08,1680.43,6876.95,7198.02,7196.97,-5195.47,-5941.53
1295878338325011456,2020-09,0,4527.94,2168.49,3566.85,-5926.3,-11867.83
1295878338325011456,2020-10,5378.16,1212.09,6966.66,3508.67,7624.06,-4243.77
1295878338325011456,2020-11,6598.42,1958.59,2772.46,2610.82,4801.47,557.7
1295878338325011456,2020-12,149.98,261.17,730.75,4573.86,-3954.3,-3396.6
1295903460963459072,2020-01,1951.09,0,1752.16,0,3703.25,3703.25
1295903460963459072,2020-02,0,1407.93,0,2317.1,-3725.03,-21.78
1295903460963459072,2020-03,6415.08,3265.28,0,3593.87,-444.07,-465.85
1295903460963459072,2020-04,1076.77,1430.85,1725.99,4131.49,-2759.58,-3225.43
1295903460963459072,2020-05,1660.85,2185.55,1702.16,2363.32,-1185.86,-4411.29
1295903460963459072,2020-06,3098.69,814.16,1707.7,3902.29,89.94,-4321.35
1295903460963459072,2020-07,2469.63,696.13,882.09,3425.73,-770.14,-5091.49
1295903460963459072,2020-08,1276.94,2843.74,0,3461.27,-5028.07,-10119.56
1295903460963459072,2020-09,1575.07,1819.44,1513.6,538.73,730.5,-9389.06
1295903460963459072,2020-10,3837.25,2190.82,2834.95,1803.48,2677.9,-6711.16
1295903460963459072,2020-11,204.53,6771.55,4375.47,2265.93,-4457.48,-11168.64
1295903460963459072,2020-12,0,3181.82,1633.53,807.01,-2355.3,-13523.94
1296050040601823744,2020-01,1946.8,1110.41,87.77,1417.03,-492.87,-492.87
1296050040601823744,2020-02,2132.06,1675.53,0,0,456.53,-36.34
1296050040601823744,2020-03,1362.63,1068.05,0,162.34,132.24,95.9
1296050040601823744,2020-04,2582.99,854.17,3207.9,4729.05,207.67,303.57
1296050040601823744,2020-05,420.7,657.89,4097.38,2688.92,1171.27,1474.84
1296050040601823744,2020-06,1512.81,1424.91,2169.01,3513.43,-1256.52,218.32
1296050040601823744,2020-07,581.12,1572.54,2012.39,1799.4,-778.43,-560.11
1296050040601823744,2020-08,0,1366.62,2719.38,0,1352.76,792.65
1296050040601823744,2020-09,3268.18,2484.02,0,1813.27,-1029.11,-236.46
1296050040601823744,2020-10,4424.43,602.39,1350.54,0,5172.58,4936.12
1296050040601823744,2020-11,0,2347.71,1056.51,2449.11,-3740.31,1195.81
1296050040601823744,2020-12,0,2421.84,3715.3,243.56,1049.9,2245.71
1297262328016654080,2020-01,1877.01,0,1248.19,725.22,2399.98,2399.98
1297262328016654080,2020-02,5469.53,2800.35,318.29,0,2987.47,5387.45
1297262328016654080,2020-03,1684.63,1647.51,3319.78,1720.02,1636.88,7024.33
1297262328016654080,2020-04,7737,2867.26,1207.24,636.12,5440.86,12465.19
1297262328016654080,2020-05,608.25,1296.39,2141.69,2676.12,-1222.57,11242.62
1297262328016654080,2020-06,0,1693.63,2316.5,2819.2,-2196.33,9046.29
1297262328016654080,2020-07,4751.9,1452.98,4113.35,4523.94,2888.33,11934.62
1297262328016654080,2020-08,3032.69,1407.84,3245.23,6389.98,-1519.9,10414.72
1297262328016654080,2020-09,4007.34,4104.14,1367.59,1957.51,-686.72,9728
1297262328016654080,2020-10,1970.93,2201.99,916.13,1087.8,-402.73,9325.27
1297262328016654080,2020-11,2578.71,3321.28,531.09,1749.77,-1961.25,7364.02
1297262328016654080,2020-12,2630.6,1786.73,0,2616.74,-1772.87,5591.15
1297862076081032704,2020-01,3618.33,2220.06,3582.09,6671.03,-1690.67,-1690.67
1297862076081032704,2020-02,6046.38,2543.44,7370.75,2920.59,7953.1,6262.43
1297862076081032704,2020-03,595.29,2314.44,3320.94,3758.52,-2156.73,4105.7
1297862076081032704,2020-04,2798.33,1720.77,3167.93,6483.22,-2237.73,1867.97
1297862076081032704,2020-05,7047.72,6152.67,6653.38,10021.36,-2472.93,-604.96
1297862076081032704,2020-06,8847.5,1307.59,566.83,7098.43,1008.31,403.35
1297862076081032704,2020-07,6646.64,524.55,4994.68,4194.77,6922,7325.35
1297862076081032704,2020-08,5256.1,3769.84,6192.71,8411.93,-732.96,6592.39
1297862076081032704,2020-09,6444.81,2996.06,5023.05,8591.69,-119.89,6472.5
1297862076081032704,2020-10,5202.76,1540.07,6799.92,1972.1,8490.51,14963.01
1297862076081032704,2020-11,3413.15,6735.8,3732.93,5173.7,-4763.42,10199.59
1297862076081032704,2020-12,4405.03,6314.01,3804.95,4137.73,-2241.76,7957.83
1299482816693197824,2020-01,1562.96,985.79,3347,0,3924.17,3924.17
1299482816693197824,2020-02,2340.2,805.85,2436.33,226.09,3744.59,7668.76
1299482816693197824,2020-03,507.03,2744.42,1166.21,5097.23,-6168.41,1500.35
1299482816693197824,2020-04,1518.81,2059.07,1953.78,884.7,528.82,2029.17
1299482816693197824,2020-05,3571.3,3032.19,3782.34,3620.81,700.64,2729.81
1299482816693197824,2020-06,1131.42,0,3734.17,829.8,4035.79,6765.6
1299482816693197824,2020-07,1876.19,2666.94,3348.81,5419.87,-2861.81,3903.79
1299482816693197824,2020-08,0,1602.41,4797.19,3146.62,48.16,3951.95
1299482816693197824,2020-09,1100.73,4085.98,6038.82,552.76,2500.81,6452.76
1299482816693197824,2020-10,4557.1,1931.72,2131.8,2334.36,2422.82,8875.58
1299482816693197824,2020-11,0,5974.05,2986.42,0,-2987.63,5887.95
1299482816693197824,2020-12,0,1329.41,3219.01,2295.97,-406.37,5481.58
1300383533041650688,2020-01,918.23,6003.38,2387.04,5404.89,-8103,-8103
1300383533041650688,2020-02,1835.04,8108.05,3373.28,5625.52,-8525.25,-16628.25
1300383533041650688,2020-03,5810.58,1705.18,9327.92,4775.98,8657.34,-7970.91
1300383533041650688,2020-04,2001.66,5003.76,4230.1,3032.45,-1804.45,-9775.36
1300383533041650688,2020-05,4620.83,4421.55,8053.51,9080.7,-827.91,-10603.27
1300383533041650688,2020-06,5161.71,4801.76,1016.25,11286.05,-9909.85,-20513.12
1300383533041650688,2020-07,976.39,3108.72,6836.61,4914.92,-210.64,-20723.76
1300383533041650688,2020-08,5812.7,4419.88,5429.44,5559.64,1262.62,-19461.14
1300383533041650688,2020-09,6395.34,3865.99,1077.4,691.21,2915.54,-16545.6
1300383533041650688,2020-10,4963.45,3257.04,3655.95,4060.4,1301.96,-15243.64
1300383533041650688,2020-11,2599.55,4305.29,9506.6,946.3,6854.56,-8389.08
1300383533041650688,2020-12,2015.28,2847,4447.52,12944.89,-9329.09,-17718.17
1301969213890651392,2020-01,2136.63,5680.89,5197.32,1921.87,-268.81,-268.81
1301969213890651392,2020-02,4172.64,3623.1,5401.24,8379.13,-2428.35,-2697.16
1301969213890651392,2020-03,6433.98,2223.35,7197.58,2896.26,8511.95,5814.79
1301969213890651392,2020-04,6537.05,1054.61,4682.94,4880.52,5284.86,11099.65
1301969213890651392,2020-05,7298.93,1856.03,8071.81,2988.13,10526.58,21626.23
1301969213890651392,2020-06,4467.75,5311.38,3361.47,4793.33,-2275.49,19350.74
1301969213890651392,2020-07,6611.22,4756.47,2129.11,4439.92,-456.06,18894.68
1301969213890651392,2020-08,6354.99,3681.05,5344.62,3885.24,4133.32,23028
1301969213890651392,2020-09,5104.99,4223.52,2767.26,4752.86,-1104.13,21923.87
1301969213890651392,2020-10,7295.53,1275.21,4265.3,6297.74,3987.88,25911.75
1301969213890651392,2020-11,2919.44,2641.64,1832.3,2530.07,-419.97,25491.78
1301969213890651392,2020-12,3427.45,5299.42,2921.24,7835.02,-6785.75,18706.03
1302057829811040768,2020-01,0,6702.75,3496.64,5841.01,-9047.12,-9047.12
1302057829811040768,2020-02,4055.05,4631.3,6077.55,4945.58,555.72,-8491.4
1302057829811040768,2020-03,4188.72,3451.06,3140.38,1196.31,2681.73,-5809.67
1302057829811040768,2020-04,3733.05,9462.03,2588.09,4243.14,-7384.03,-13193.7
1302057829811040768,2020-05,1290.01,5416.29,686.56,2342.41,-5782.13,-18975.83
1302057829811040768,2020-06,6780.27,1195.43,5243.22,5112.18,5715.88,-13259.95
1302057829811040768,2020-07,4414.62,4165.55,1492.07,5046.35,-3305.21,-16565.16
1302057829811040768,2020-08,2385.34,1987.68,2768.95,5023.28,-1856.67,-18421.83
1302057829811040768,2020-09,2490.65,1744.21,1051.56,1688.84,109.16,-18312.67
1302057829811040768,2020-10,3613.12,6122.45,2191.11,8029.41,-8347.63,-26660.3
1302057829811040768,2020-11,3512.42,5775.73,1879.21,3786.02,-4170.12,-30830.42
1302057829811040768,2020-12,0,4147.25,8269.83,2573.31,1549.27,-29281.15
1303453712708750592,2020-10,699.22,0,0,0,699.22,699.22
1303453712708750592,2020-11,0,1749.36,1704.53,192.15,-236.98,462.24
1303453712708750592,2020-12,0,868.18,0,1334.05,-2202.23,-1739.99
1304562713001272832,2020-04,1384.74,0,0,1161.51,223.23,223.23
1304562713001272832,2020-06,0,1142.29,0,0,-1142.29,-919.06
1304562713001272832,2020-10,0,1147.19,0,0,-1147.19,-2066.25
1304903573347649024,2020-01,2184.41,2091.28,2656.91,7609.33,-4859.29,-4859.29
1304903573347649024,2020-02,26,6589.88,4480.71,2863.76,-4946.93,-9806.22
1304903573347649024,2020-03,1729.79,4801.3,2336.22,4407.37,-5142.66,-14948.88
1304903573347649024,2020-04,5034.85,1608.26,4992.28,2766.35,5652.52,-9296.36
1304903573347649024,2020-05,3781.27,2969.2,460.46,717.66,554.87,-8741.49
1304903573347649024,2020-06,1851.94,4403.45,1871.79,1372.5,-2052.22,-10793.71
1304903573347649024,2020-07,1749.47,4265.75,703.14,4634.24,-6447.38,-17241.09
1304903573347649024,2020-08,3295.06,2858.7,3580.51,2777.85,1239.02,-16002.07
1304903573347649024,2020-09,8044.75,5083.51,1678.63,1063.46,3576.41,-12425.66
1304903573347649024,2020-10,5177.91,3022.87,610.54,3658.69,-893.11,-13318.77
1304903573347649024,2020-11,2978.89,3242.12,2106.2,2395.37,-552.4,-13871.17
1304903573347649024,2020-12,3084.62,2859.95,5626.93,4097.45,1754.15,-12117.02
1304908104716074240,2020-01,2130.49,1941.05,623.28,1954.98,-1142.26,-1142.26
1304908104716074240,2020-02,1950.6,1822.18,2519.04,0,2647.46,1505.2
1304908104716074240,2020-03,0,2526.03,1795.18,2421.19,-3152.04,-1646.84
1304908104716074240,2020-04,1107.25,2650.56,3189.87,1431.2,215.36,-1431.48
1304908104716074240,2020-05,3940.44,5510.18,1386.35,59.1,-242.49,-1673.97
1304908104716074240,2020-06,1311.54,1807.43,2212.3,1257.05,459.36,-1214.61
1304908104716074240,2020-07,1607.43,266.57,2569.86,0,3910.72,2696.11
1304908104716074240,2020-08,874.37,3025.27,321.03,449.33,-2279.2,416.91
1304908104716074240,2020-09,0,1389.83,0,972.98,-2362.81,-1945.9
1304908104716074240,2020-10,238.8,1533.06,1352.69,502.62,-444.19,-2390.09
1304908104716074240,2020-11,3543.81,875.87,47.58,2856,-140.48,-2530.57
1304908104716074240,2020-12,0,1515.48,3092.68,3541.86,-1964.66,-4495.23
1305691642190616832,2020-01,6331.06,2998.13,2825.66,1909.69,4248.9,4248.9
1305691642190616832,2020-02,2712.15,4154.09,1583.62,4093.49,-3951.81,297.09
1305691642190616832,2020-03,5764.31,3334.7,6110.79,1667.85,6872.55,7169.64
1305691642190616832,2020-04,2927.88,3531.93,4331.39,3691.22,36.12,7205.76
1305691642190616832,2020-05,2452.17,2318.59,2306.31,4012.24,-1572.35,5633.41
1305691642190616832,2020-06,6998.98,962.26,4601.41,5055.21,5582.92,11216.33
1305691642190616832,2020-07,4274.3,6513.29,7744.49,2879.91,2625.59,13841.92
1305691642190616832,2020-08,163.58,8696.88,2449.01,3965.83,-10050.12,3791.8
1305691642190616832,2020-09,9227.43,3689.63,6698.18,0,12235.98,16027.78
1305691642190616832,2020-10,4612.27,6409.2,2055.56,3658.73,-3400.1,12627.68
1305691642190616832,2020-11,2575.11,5139.7,1677.04,2447.02,-3334.57,9293.11
1305691642190616832,2020-12,1774.8,5391.77,0,6555.77,-10172.74,-879.63
1305722722368621056,2020-01,1065,2954.44,1503.96,0,-385.48,-385.48
1305722722368621056,2020-02,0,738.45,562.7,603.03,-778.78,-1164.26
1305722722368621056,2020-03,199.39,0,0,332.78,-133.39,-1297.65
1305722722368621056,2020-04,1902.58,697.98,1300.52,1992.17,512.95,-784.7
1305722722368621056,2020-05,1482.72,0,1677.96,1601.76,1558.92,774.22
1305722722368621056,2020-06,0,544.58,0,1943.51,-2488.09,-1713.87
1305722722368621056,2020-07,1212.71,2542.49,0,1578.47,-2908.25,-4622.12
1305722722368621056,2020-08,0,858.6,0,0,-858.6,-5480.72
1305722722368621056,2020-09,1650.07,0,1834.4,0,3484.47,-1996.25
1305722722368621056,2020-10,0,681.16,0,3665.86,-4347.02,-6343.27
1305722722368621056,2020-11,3478.85,0,31.25,0,3510.1,-2833.17
1305722722368621056,2020-12,0,1985.87,0,1126.78,-3112.65,-5945.82
1306572879193403904,2020-01,4208.88,4128.32,8740.51,6819.86,2001.21,2001.21
1306572879193403904,2020-02,9390.45,932.53,168.52,5924.94,2701.5,4702.71
1306572879193403904,2020-03,5859.93,5778.26,3258.9,4245.22,-904.65,3798.06
1306572879193403904,2020-04,12585.43,7653.55,5858.62,6102.8,4687.7,8485.76
1306572879193403904,2020-05,6327.73,8969.48,9675.38,7724.8,-691.17,7794.59
1306572879193403904,2020-06,2146.33,3923.12,1736.6,2700.37,-2740.56,5054.03
1306572879193403904,2020-07,5323.84,4997.56,8935.18,24.92,9236.54,14290.57
1306572879193403904,2020-08,2128.39,5507.31,9332.35,4775.69,1177.74,15468.31
1306572879193403904,2020-09,902.21,5799.26,3403.08,6237.26,-7731.23,7737.08
1306572879193403904,2020-10,543.34,2247.07,2052.7,4181.37,-3832.4,3904.68
1306572879193403904,2020-11,4321.36,2363.66,5941.49,5191.88,2707.31,6611.99
1306572879193403904,2020-12,4720.51,3524.41,8615.58,5765.74,4045.94,10657.93
1308733329046531072,2020-01,1736.47,2167.76,2496.42,7695.21,-5630.08,-5630.08
1308733329046531072,2020-02,3107.99,2086.53,2909.55,2997.56,933.45,-4696.63
1308733329046531072,2020-03,2428.81,6471.82,4210.31,1365.9,-1198.6,-5895.23
1308733329046531072,2020-04,9618.24,3497.77,5768.9,2545.13,9344.24,3449.01
1308733329046531072,2020-05,4719.66,5006.05,3047.92,4206.53,-1445,2004.01
1308733329046531072,2020-06,5808.21,5807.57,7273.98,4903.48,2371.14,4375.15
1308733329046531072,2020-07,2578.58,4197.56,5936.57,1738.13,2579.46,6954.61
1308733329046531072,2020-08,6945.06,6731.34,4711.46,3209.98,1715.2,8669.81
1308733329046531072,2020-09,4832.33,5289.1,4437.51,1771.1,2209.64,10879.45
1308733329046531072,2020-10,4885.45,2815.34,375.29,4973.59,-2528.19,8351.26
1308733329046531072,2020-11,1789.13,7875.54,5034.04,7935.27,-8987.64,-636.38
1308733329046531072,2020-12,2111.05,1686.82,2929.54,184.79,3168.98,2532.6
1308770574406036224,2020-01,0,2806.9,1127,544.73,-2224.63,-2224.63
1308770574406036224,2020-02,2475.54,513.04,0,224.34,1738.16,-486.47
1308770574406036224,2020-03,577.55,0,1551.64,8.93,2120.26,1633.79
1308770574406036224,2020-04,1859.73,0,0,1388.05,471.68,2105.47
1308770574406036224,2020-06,2289.3,0,1759.63,621.57,3427.36,5532.83
1308770574406036224,2020-07,188.55,1993.7,0,0,-1805.15,3727.68
1308770574406036224,2020-08,0,2566,0,1271.55,-3837.55,-109.87
1308770574406036224,2020-09,2268.49,0,52.59,0,2321.08,2211.21
1308770574406036224,2020-10,0,1345.31,408.62,0,-936.69,1274.52
1308770574406036224,2020-11,1886.05,1175.14,0,0,710.91,1985.43
1308770574406036224,2020-12,681.15,758.01,2989.47,2848.76,63.85,2049.28
1309303800661990656,2020-01,2939.5,3451.61,2553.22,1427.9,613.21,613.21
1309303800661990656,2020-02,4476.8,1803.51,4301.97,941.62,6033.64,6646.85
1309303800661990656,2020-03,1830.05,0,0,343.51,1486.54,8133.39
1309303800661990656,2020-04,1485.78,1255.81,0,2342.61,-2112.64,6020.75
1309303800661990656,2020-05,4278.52,1990.18,3030.37,3243.06,2075.65,8096.4
1309303800661990656,2020-06,104.71,0,1762.76,3281.4,-1413.93,6682.47
1309303800661990656,2020-07,3245.61,287.05,758.05,0,3716.61,10399.08
1309303800661990656,2020-08,2468.24,0,5884.69,1721.22,6631.71,17030.79
1309303800661990656,2020-09,963.39,1937.4,1928.22,3624.57,-2670.36,14360.43
1309303800661990656,2020-10,774.03,653.51,6214.72,1779.64,4555.6,18916.03
1309303800661990656,2020-11,5462.2,611.26,460.66,2867.56,2444.04,21360.07
1309303800661990656,2020-12,1422.73,3990.9,3927.1,0,1358.93,22719
1310223798871125760,2020-01,7177.19,1816.96,1769.85,2277.3,4852.78,4852.78
1310223798871125760,2020-02,195.47,3055.48,6063.11,8452.94,-5249.84,-397.06
1310223798871125760,2020-03,6027.55,7877.17,1035.23,5987.38,-6801.77,-7198.83
1310223798871125760,2020-04,6944.28,3585.87,3089.44,3505.56,2942.29,-4256.54
1310223798871125760,2020-05,4132.96,5489.53,1399.66,5145.63,-5102.54,-9359.08
1310223798871125760,2020-06,4676.11,1999.11,4411.03,1208.62,5879.41,-3479.67
1310223798871125760,2020-07,3861.36,2205.27,6579.92,6750.31,1485.7,-1993.97
1310223798871125760,2020-08,10238.3,633.12,4779.37,2634.19,11750.36,9756.39
1310223798871125760,2020-09,4478.13,2026.66,5482.4,1793.91,6139.96,15896.35
1310223798871125760,2020-10,0,923.69,5922.68,4972.93,26.06,15922.41
1310223798871125760,2020-11,947.26,6147.49,2814.9,4777.32,-7162.65,8759.76
1310223798871125760,2020-12,4382.53,6716.47,6083,3625.57,123.49,8883.25
1312347015083651840,2020-01,2048.7,876.92,314.11,2441.46,-955.57,-955.57
1312347015083651840,2020-03,1877.24,2608.07,1165.07,902.31,-468.07,-1423.64
1312347015083651840,2020-04,2055.11,767.9,510.97,2798.31,-1000.13,-2423.77
1312347015083651840,2020-05,1833.25,1332.09,1170.93,1037.98,634.11,-1789.66
1312347015083651840,2020-06,0,1921.8,1597.35,1190.05,-1514.5,-3304.16
1312347015083651840,2020-07,4147.05,2737.97,2929.48,2287.72,2050.84,-1253.32
1312347015083651840,2020-08,2814.43,0,4777.32,939.69,6652.06,5398.74
1312347015083651840,2020-09,1277.62,3598.99,0,852.14,-3173.51,2225.23
1312347015083651840,2020-10,1790.37,3898.32,2601.35,1.67,491.73,2716.96
1312347015083651840,2020-11,48.5,0,0,1199.25,-1150.75,1566.21
1312347015083651840,2020-12,3105.95,2158.05,2125.09,207.02,2865.97,4432.18
1312752446780624384,2020-01,3497.88,2762.82,8703.47,0,9438.53,9438.53
1312752446780624384,2020-02,3802.33,1047.34,3493.1,2028.25,4219.84,13658.37
1312752446780624384,2020-03,4773.83,6120.82,2915.63,8858.51,-7289.87,6368.5
1312752446780624384,2020-04,3223.93,2421.16,2393.83,719.09,2477.51,8846.01
1312752446780624384,2020-05,2447.76,1369.69,0,797.48,280.59,9126.6
1312752446780624384,2020-06,3450.69,2147.33,2747.33,3609.71,440.98,9567.58
1312752446780624384,2020-07,2726.67,4144.04,3415.37,4302.78,-2304.78,7262.8
1312752446780624384,2020-08,5698.22,2501.26,2315.89,3845.58,1667.27,8930.07
1312752446780624384,2020-09,1354.8,6622.98,2569.22,4923.51,-7622.47,1307.6
1312752446780624384,2020-10,1882.75,4742.45,0,1667.86,-4527.56,-3219.96
1312752446780624384,2020-11,4069.35,4745.16,4261.91,3201.55,384.55,-2835.41
1312752446780624384,2020-12,1383.22,0,4488.42,1435.82,4435.82,1600.41
1312941847963101696,2020-01,3866.47,2714.96,7032.04,4723.7,3459.85,3459.85
1312941847963101696,2020-02,2783.56,4148.5,2246.24,1635.08,-753.78,2706.07
1312941847963101696,2020-03,8385.72,10223.16,5647.75,5047.62,-1237.31,1468.76
1312941847963101696,2020-04,7651.27,3222.09,6255.31,7354.59,3329.9,4798.66
1312941847963101696,2020-05,3003.03,1424.74,6600.53,4594.51,3584.31,8382.97
1312941847963101696,2020-06,3915.48,7061.22,3513.23,750,-382.51,8000.46
1312941847963101696,2020-07,4768.01,3799.21,3497.58,4232.22,234.16,8234.62
1312941847963101696,2020-08,7765.1,7345.31,7714.06,4853.57,3280.28,11514.9
1312941847963101696,2020-09,2468.57,4492.64,6220.4,4046.03,150.3,11665.2
1312941847963101696,2020-10,5838.63,6243.42,2485.68,2801.92,-721.03,10944.17
1312941847963101696,2020-11,1496.34,4173.14,2090.29,6693.06,-7279.57,3664.6
1312941847963101696,2020-12,6273.84,7814.52,7964.36,1724.04,4699.64,8364.24
1313471562796828416,2020-01,1952.23,2002.8,3623.85,886.39,2686.89,2686.89
1313471562796828416,2020-02,0,2298.7,2588.44,1777.63,-1487.89,1199
1313471562796828416,2020-03,584.23,4448.85,1965.34,2537.71,-4436.99,-3237.99
1313471562796828416,2020-04,3508.38,1209.89,377.22,1931.5,744.21,-2493.78
1313471562796828416,2020-05,317.62,3736.53,1092.14,2773.83,-5100.6,-7594.38
1313471562796828416,2020-06,0,1784.99,918.61,0,-866.38,-8460.76
1313471562796828416,2020-07,2046.7,361.32,0,0,1685.38,-6775.38
1313471562796828416,2020-08,3476.76,1264.48,580.65,1021.83,1771.1,-5004.28
1313471562796828416,2020-10,1467.71,0,0,1531.28,-63.57,-5067.85
1313471562796828416,2020-11,1349.81,1937.08,0,3392.05,-3979.32,-9047.17
1313471562796828416,2020-12,0,1201.98,625.28,0,-576.7,-9623.87
1314654042677529344,2020-01,1705.83,4047.36,4060.82,2933.98,-1214.69,-1214.69
1314654042677529344,2020-02,1955.84,645.15,1391.31,0,2702,1487.31
1314654042677529344,2020-03,1353.88,1098.88,2059.07,0,2314.07,3801.38
1314654042677529344,2020-04,2095.63,1994.47,5293.79,1543.66,3851.29,7652.67
1314654042677529344,2020-05,3300.04,1609.01,1303.01,1533.23,1460.81,9113.48
1314654042677529344,2020-06,3539.97,2804.06,1024.89,2274.78,-513.98,8599.5
1314654042677529344,2020-07,2940.38,2706.98,5646.13,1921.99,3957.54,12557.04
1314654042677529344,2020-08,6194.35,4594.76,1683.71,0,3283.3,15840.34
1314654042677529344,2020-09,2100.86,3712.44,3687.18,3489.63,-1414.03,14426.31
1314654042677529344,2020-10,5702.55,0,2027.43,2499.55,5230.43,19656.74
1314654042677529344,2020-11,2267.9,871.7,1277,355.11,2318.09,21974.83
1314654042677529344,2020-12,3600.52,1240.31,1380.86,4478.74,-737.67,21237.16
1314973797055915776,2020-01,4073.3,0,1881.29,3230.51,2724.08,2724.08
1314973797055915776,2020-02,6427.43,813.21,2271.71,116.76,7769.17,10493.25
1314973797055915776,2020-03,2640.53,592.34,5755.07,4308.49,3494.77,13988.02
1314973797055915776,2020-04,811.27,2247.08,4890.25,5130.21,-1675.77,12312.25
1314973797055915776,2020-05,3886.35,5907.96,157.14,4310.99,-6175.46,6136.79
1314973797055915776,2020-06,6196.93,1438.25,0,1780.18,2978.5,9115.29
1314973797055915776,2020-07,0,4023.51,1318.34,3384.47,-6089.64,3025.65
1314973797055915776,2020-08,1785.4,3435.81,4614.45,2294.31,669.73,3695.38
1314973797055915776,2020-09,3302.32,1982.48,5163.55,1855.11,4628.28,8323.66
1314973797055915776,2020-10,3173.28,3380.96,1414.36,2375.38,-1168.7,7154.96
1314973797055915776,2020-11,0,4370.29,0,1100.92,-5471.21,1683.75
1314973797055915776,2020-12,695.01,2770.36,6722.28,2472.95,2173.98,3857.73
1314999743158984704,2020-01,7509.06,0,895.98,3398.49,5006.55,5006.55
1314999743158984704,2020-02,69.78,3041.71,3540.24,6315.87,-5747.56,-741.01
1314999743158984704,2020-03,4831.57,1975.29,1019.28,4136.58,-261.02,-1002.03
1314999743158984704,2020-04,7634.37,183.18,4399.27,6452.36,5398.1,4396.07
1314999743158984704,2020-05,1097.71,9432.9,7705.72,6332.18,-6961.65,-2565.58
1314999743158984704,2020-06,3164.88,5849.27,4189.17,5869.33,-4364.55,-6930.13
1314999743158984704,2020-07,3424.22,1213.42,1651.04,7432.08,-3570.24,-10500.37
1314999743158984704,2020-08,5839.5,7816.37,9636.83,4514.72,3145.24,-7355.13
1314999743158984704,2020-09,4556.37,2499.33,6039.48,876.85,7219.67,-135.46
1314999743158984704,2020-10,2675.17,6852.42,6886.02,4791.41,-2082.64,-2218.1
1314999743158984704,2020-11,8597.66,6422.08,3930.74,6348.95,-242.63,-2460.73
1314999743158984704,2020-12,2307.58,2528.78,5780.23,6870.58,-1311.55,-3772.28
1316442317435692032,2020-01,3423.55,1028.37,1073.98,6315.19,-2846.03,-2846.03
1316442317435692032,2020-02,1853.61,1245.53,882.41,8962.5,-7472.01,-10318.04
1316442317435692032,2020-03,287.02,1522.61,5714.35,1094.33,3384.43,-6933.61
1316442317435692032,2020-04,301.34,5806.21,4026.57,2262.28,-3740.58,-10674.19
1316442317435692032,2020-05,2188.15,2830.74,5329.55,2688.48,1998.48,-8675.71
1316442317435692032,2020-06,4667.79,8916.92,7607.8,547.21,2811.46,-5864.25
1316442317435692032,2020-07,8947.62,5755.12,3682.11,4005.72,2868.89,-2995.36
1316442317435692032,2020-08,3983.52,3733.53,8389.2,3961.11,4678.08,1682.72
1316442317435692032,2020-09,2200.24,5792.7,5408.45,2007.67,-191.68,1491.04
1316442317435692032,2020-10,4957.36,4692.57,31.17,2902.77,-2606.81,-1115.77
1316442317435692032,2020-11,7540.21,4222.41,2577.11,6414.13,-519.22,-1634.99
1316442317435692032,2020-12,6493.6,3624.53,3193.08,3856.76,2205.39,570.4
1319328517104191232,2020-01,4898.16,4251.72,6494.25,3543.01,3597.68,3597.68
1319328517104191232,2020-02,2704.54,6287.86,6185.84,6286.6,-3684.08,-86.4
1319328517104191232,2020-03,1645.23,2514.7,0,4107.28,-4976.75,-5063.15
1319328517104191232,2020-04,442.7,1875.45,2666.65,5261.02,-4027.12,-9090.27
1319328517104191232,2020-05,5720.74,2262.27,1954.3,4736.4,676.37,-8413.9
1319328517104191232,2020-06,3221.99,2861.51,3921.75,3216.84,1065.39,-7348.51
1319328517104191232,2020-07,1455.66,2771.19,1458.61,2942.16,-2799.08,-10147.59
1319328517104191232,2020-08,2967.77,1850.5,1551.1,2191.85,476.52,-9671.07
1319328517104191232,2020-09,3792.95,148.89,3269.72,6984.51,-70.73,-9741.8
1319328517104191232,2020-10,517.1,3298.27,9858.8,7963.88,-886.25,-10628.05
1319328517104191232,2020-11,7279.08,3903.64,7062.72,3403.18,7034.98,-3593.07
1319328517104191232,2020-12,5890.48,3331.65,3346.36,3334.99,2570.2,-1022.87
1320401525072306688,2020-04,2534.42,0,0,0,2534.42,2534.42
1320401525072306688,2020-07,1488.89,0,0,0,1488.89,4023.31
1320401525072306688,2020-08,1229.34,0,0,0,1229.34,5252.65
1320401525072306688,2020-12,1445.49,0,0,0,1445.49,6698.14
1322079868574707712,2020-01,0,70.65,0,0,-70.65,-70.65
1322079868574707712,2020-03,0,856.73,0,0,-856.73,-927.38
1322079868574707712,2020-04,0,314.25,0,0,-314.25,-1241.63
1322079868574707712,2020-06,69.29,0,0,1699.52,-1630.23,-2871.86
1322079868574707712,2020-08,736,0,0,181.79,554.21,-2317.65
1322079868574707712,2020-09,0,3711.46,1542.52,0,-2168.94,-4486.59
1322079868574707712,2020-10,1914.79,0,0,0,1914.79,-2571.8
1322156118912871680,2020-03,1874.82,0,0,0,1874.82,1874.82
1322156118912871680,2020-04,942.4,0,0,0,942.4,2817.22
1322156118912871680,2020-07,1306.93,0,0,0,1306.93,4124.15
1322674422364130048,2020-01,150.38,6041.02,6181.85,3846.6,-3555.39,-3555.39
1322674422364130048,2020-02,5185.98,2395.49,2215.99,6128.55,-1122.07,-4677.46
1322674422364130048,2020-03,15049.19,2192.05,2520.59,3973.05,11404.68,6727.22
1322674422364130048,2020-04,1475.51,2687.93,2216.74,4474.3,-3469.98,3257.24
1322674422364130048,2020-05,1807.98,0,4367.37,2184.13,3991.22,7248.46
1322674422364130048,2020-06,4580.59,3112.55,7178.44,3193.45,5453.03,12701.49
1322674422364130048,2020-07,732.72,11490.65,4366.82,6002.77,-12393.88,307.61
1322674422364130048,2020-08,4572.99,8759.53,2769.26,4404.75,-5822.03,-5514.42
1322674422364130048,2020-09,5279.58,5264.48,2850.81,265.25,2600.66,-2913.76
1322674422364130048,2020-10,3345.82,3230.19,3181.65,7664.3,-4367.02,-7280.78
1322674422364130048,2020-11,5491.97,2778.57,6285.34,1874.79,7123.95,-156.83
1322674422364130048,2020-12,0,6861.87,2400.6,2933.19,-7394.46,-7551.29
1323415085978317568,2020-05,1854,0,0,0,1854,1854
1323415085978317568,2020-07,0,112.83,0,0,-112.83,1741.17
1323415085978317568,2020-11,0,81.54,0,0,-81.54,1659.63
1323573918253598976,2020-07,0,919.59,0,0,-919.59,-919.59
1323573918253598976,2020-10,0,1135.54,0,0,-1135.54,-2055.13
1323760126522413056,2020-01,1866.77,2666.39,93.05,1193.09,-1899.66,-1899.66
1323760126522413056,2020-02,1165.95,1739.2,534.11,1568.51,-1607.65,-3507.31
1323760126522413056,2020-03,1787.42,203.45,0,0,1583.97,-1923.34
1323760126522413056,2020-04,0,4987.5,0,0,-4987.5,-6910.84
1323760126522413056,2020-05,443.42,4907.11,1185.13,1958.99,-5237.55,-12148.39
1323760126522413056,2020-06,0,2136.56,1154.35,0,-982.21,-13130.6
1323760126522413056,2020-07,1047.77,1664.15,2077.08,1404.06,56.64,-13073.96
1323760126522413056,2020-08,1191.09,0,86.69,0,1277.78,-11796.18
1323760126522413056,2020-09,2647.65,1675.4,3000.28,362.33,3610.2,-8185.98
1323760126522413056,2020-10,557.61,1154.53,3859.71,0,3262.79,-4923.19
1323760126522413056,2020-11,1849.55,2233.86,3719.59,0,3335.28,-1587.91
1323760126522413056,2020-12,3811.78,0,227.37,541.78,3497.37,1909.46
1324615138431755008,2020-01,3895.02,0,4942.09,1436.83,7400.28,7400.28
1324615138431755008,2020-02,1288.4,5933.81,4851.84,4937.39,-4730.96,2669.32
1324615138431755008,2020-03,3832.38,2770.09,9495.1,6438.72,4118.67,6787.99
1324615138431755008,2020-04,1921.17,1014.96,6551.33,2762.04,4695.5,11483.49
1324615138431755008,2020-05,732.94,3634.85,3339.8,6481.34,-6043.45,5440.04
1324615138431755008,2020-06,3470.1,7888.03,4017.08,1539.31,-1940.16,3499.88
1324615138431755008,2020-07,4412.45,1274.04,21.94,2838.88,321.47,3821.35
1324615138431755008,2020-08,2808.07,5324.26,4269.48,4996.67,-3243.38,577.97
1324615138431755008,2020-09,3668.94,4177.97,0,5559.35,-6068.38,-5490.41
1324615138431755008,2020-10,7559.17,6324.32,3504.41,3400.53,1338.73,-4151.68
1324615138431755008,2020-11,6023.41,6159.28,4516.16,5766.76,-1386.47,-5538.15
1324615138431755008,2020-12,1040.62,3561.32,1667.32,0,-853.38,-6391.53
1324850853391996160,2020-01,3588.83,2969.28,3943.08,8276.11,-3713.48,-3713.48
1324850853391996160,2020-02,5998.13,8747.67,3615.01,3699.94,-2834.47,-6547.95
1324850853391996160,2020-03,2539.93,433.68,4651.08,6600.23,157.1,-6390.85
1324850853391996160,2020-04,6460.36,7098.97,6335.18,6279.42,-582.85,-6973.7
1324850853391996160,2020-05,7840.3,5730.02,4973.81,4491.61,2592.48,-4381.22
1324850853391996160,2020-06,4137.05,1431.79,8191.68,4260.11,6636.83,2255.61
1324850853391996160,2020-07,5307.76,8557.13,5148.75,2759.68,-860.3,1395.31
1324850853391996160,2020-08,3337.21,3332.48,11309.39,4663.44,6650.68,8045.99
1324850853391996160,2020-09,7037.13,2302.27,5129.63,2575.48,7289.01,15335
1324850853391996160,2020-10,5217.75,4659.66,4142.44,1935.99,2764.54,18099.54
1324850853391996160,2020-11,4930.21,5108.88,3957.05,6802.06,-3023.68,15075.86
1324850853391996160,2020-12,2672.93,5640.47,2460.94,5326.25,-5832.85,9243.01
1326144360427294976,2020-01,1295.29,1756.68,6009.74,2972.85,2575.5,2575.5
1326144360427294976,2020-02,1216.57,3879.05,2558.63,3657.24,-3761.09,-1185.59
1326144360427294976,2020-03,1665.72,3524.87,3558.77,1607.3,92.32,-1093.27
1326144360427294976,2020-04,1080.92,647.93,2344.61,2342.87,434.73,-658.54
1326144360427294976,2020-05,6601.22,6985.67,2290.5,2101.61,-195.56,-854.1
1326144360427294976,2020-06,7108.81,3879.13,1480.67,7968.48,-3258.13,-4112.23
1326144360427294976,2020-07,2620.99,5383.94,8766.76,6286.08,-282.27,-4394.5
1326144360427294976,2020-08,5199.23,2057.62,4328.56,2267.42,5202.75,808.25
1326144360427294976,2020-09,3404.27,6277.37,3889.83,7446.22,-6429.49,-5621.24
1326144360427294976,2020-10,3815.99,3961.67,1782.16,5099.11,-3462.63,-9083.87
1326144360427294976,2020-11,2234.95,6455.25,3352.64,5282.19,-6149.85,-15233.72
1326144360427294976,2020-12,4102.75,5860.13,2543.35,3944.82,-3158.85,-18392.57
1327524688343100672,2020-01,5110.53,5344.07,321.6,252.62,-164.56,-164.56
1327524688343100672,2020-02,415.49,1883.31,4379.59,1111.27,1800.5,1635.94
1327524688343100672,2020-03,5300.95,4344.74,9004.53,257.82,9702.92,11338.86
1327524688343100672,2020-04,1955.1,3815.55,4522.39,2460.02,201.92,11540.78
1327524688343100672,2020-05,7152.85,2174.04,6596.19,2957.77,8617.23,20158.01
1327524688343100672,2020-06,7094.98,1719.49,4025.75,2185.49,7215.75,27373.76
1327524688343100672,2020-07,2000.14,7931.69,12192.36,4229.87,2030.94,29404.7
1327524688343100672,2020-08,6760.54,7109.43,2994.53,3671.56,-1025.92,28378.78
1327524688343100672,2020-09,5844.28,2348.49,2940.57,8337.49,-1901.13,26477.65
1327524688343100672,2020-10,2776.76,3091.17,4168.38,1057.54,2796.43,29274.08
1327524688343100672,2020-11,2448.01,3110.93,4850.72,4190.77,-2.97,29271.11
1327524688343100672,2020-12,5818.08,2835.39,733.81,4619.21,-902.71,28368.4
1327575133606343936,2020-01,4048.88,3417.64,2837.49,2572.13,896.6,896.6
1327575133606343936,2020-02,8273.43,3613.34,4287.76,3078.26,5869.59,6766.19
1327575133606343936,2020-03,1059.66,7389.36,2559.05,2290.49,-6061.14,705.05
1327575133606343936,2020-04,2375.1,2549.42,1162.47,1299.7,-311.55,393.5
1327575133606343936,2020-05,2795.02,5948.87,0,1332.93,-4486.78,-4093.28
1327575133606343936,2020-06,365.82,616.18,1406.23,0,1155.87,-2937.41
1327575133606343936,2020-07,2309.81,2298.44,1943.13,1516.63,437.87,-2499.54
1327575133606343936,2020-08,1818.16,2536.03,1871.6,2722.82,-1569.09,-4068.63
1327575133606343936,2020-09,1540.95,5299.55,2016.68,1806.23,-3548.15,-7616.78
1327575133606343936,2020-10,6715.36,2399.24,3426.73,4616.64,3126.21,-4490.57
1327575133606343936,2020-11,1612.62,617.22,1005.31,3607.16,-1606.45,-6097.02
1327575133606343936,2020-12,112.75,2657.23,2546.72,3199.95,-3197.71,-9294.73
1327892369165032448,2020-01,5941.03,5372.65,7497.09,618.74,7446.73,7446.73
1327892369165032448,2020-02,818.83,5024.23,2834.87,4598.2,-5968.73,1478
1327892369165032448,2020-03,2326.36,10472.27,3300.24,6459.72,-11305.39,-9827.39
1327892369165032448,2020-04,6100.08,425.78,5667.41,4245.96,7095.75,-2731.64
1327892369165032448,2020-05,2195.81,4704.38,3927.09,5991.09,-4572.57,-7304.21
1327892369165032448,2020-06,10580.32,3369.55,2149.63,4712.47,4647.93,-2656.28
1327892369165032448,2020-07,4779.18,6304.76,5237.07,8646.77,-4935.28,-7591.56
1327892369165032448,2020-08,3822.61,2242.27,7362.6,3186.38,5756.56,-1835
1327892369165032448,2020-09,710.41,3485.92,3453.68,4540.28,-3862.11,-5697.11
1327892369165032448,2020-10,4328.49,6274.18,4009.06,10504.43,-8441.06,-14138.17
1327892369165032448,2020-11,3083.63,929.14,7564.09,3502.41,6216.17,-7922
1327892369165032448,2020-12,3347.48,5398.42,5468.68,2030.19,1387.55,-6534.45
1329593259723634688,2020-01,0,711.28,1999.63,0,1288.35,1288.35
1329593259723634688,2020-03,317.54,4502.89,1514,0,-2671.35,-1383
1329593259723634688,2020-04,2360.56,0,0,404.55,1956.01,573.01
1329593259723634688,2020-06,1142.09,3303.51,1677.41,0,-484.01,89
1329593259723634688,2020-07,1727.42,980.56,91.71,0,838.57,927.57
1329593259723634688,2020-08,688.36,2552.68,1975.52,0,111.2,1038.77
1329593259723634688,2020-09,1600.71,524.36,0,2826,-1749.65,-710.88
1329593259723634688,2020-10,0,3182.53,741.57,1605.65,-4046.61,-4757.49
1329593259723634688,2020-11,1735.91,3057.59,2078.51,183.09,573.74,-4183.75
1332473996215070464,2020-01,325.33,1834.59,2555.65,1869.45,-823.06,-823.06
1332473996215070464,2020-02,915.39,4135.3,3135.71,3647.43,-3731.63,-4554.69
1332473996215070464,2020-03,0,1817.62,1885.44,3038.22,-2970.4,-7525.09
1332473996215070464,2020-04,3322.74,4080.93,2293.17,5422.7,-3887.72,-11412.81
1332473996215070464,2020-05,620.45,3241.32,246.05,1120.35,-3495.17,-14907.98
1332473996215070464,2020-06,0,3918.59,991.64,5858.94,-8785.89,-23693.87
1332473996215070464,2020-07,2445.73,4276.11,4041.05,2486.17,-275.5,-23969.37
1332473996215070464,2020-08,2124.48,4811.56,4751.07,3712,-1648.01,-25617.38
1332473996215070464,2020-09,481.83,2818.08,2169.91,4852.82,-5019.16,-30636.54
1332473996215070464,2020-10,2611.43,3501.09,5008.21,1363.3,2755.25,-27881.29
1332473996215070464,2020-11,4248.06,1767.06,3737.9,2257.38,3961.52,-23919.77
1332473996215070464,2020-12,4914.23,730.5,2722.62,2670.3,4236.05,-19683.72
1332534353625450496,2020-07,489.14,0,0,0,489.14,489.14
1332534353625450496,2020-10,1028.57,0,0,0,1028.57,1517.71
1332534353625450496,2020-11,796.66,0,0,0,796.66,2314.37
1332752874714118144,2020-01,1866.32,3518.41,2827.15,4358.73,-3183.67,-3183.67
1332752874714118144,2020-02,3387.66,2465.07,1447.58,1167.18,1202.99,-1980.68
1332752874714118144,2020-03,9573.56,1065.8,2028.77,1794.99,8741.54,6760.86
1332752874714118144,2020-04,6469.58,5291.85,3307.38,3293.04,1192.07,7952.93
1332752874714118144,2020-05,5258.89,2663.58,5356.61,4186.32,3765.6,11718.53
1332752874714118144,2020-06,2412.22,284.41,5277.66,5726.8,1678.67,13397.2
1332752874714118144,2020-07,1106.15,3216.97,6551.86,7370.81,-2929.77,10467.43
1332752874714118144,2020-08,7618.6,3312.9,3572.58,2482.12,5396.16,15863.59
1332752874714118144,2020-09,3228.44,7327.36,1016.06,4088.4,-7171.26,8692.33
1332752874714118144,2020-10,8586.56,3119.64,5934.24,2801.69,8599.47,17291.8
1332752874714118144,2020-11,0,2734.19,4197.21,4253.42,-2790.4,14501.4
1332752874714118144,2020-12,9026.91,3038.73,2046.75,3038.64,4996.29,19497.69
1333755685567094784,2020-01,1897.97,5675.18,225.59,3088.25,-6639.87,-6639.87
1333755685567094784,2020-02,3532.2,0,1815.46,1942.67,3404.99,-3234.88
1333755685567094784,2020-03,1655.99,246,1803.44,5488.39,-2274.96,-5509.84
1333755685567094784,2020-04,0,1573.36,1320.62,0,-252.74,-5762.58
1333755685567094784,2020-05,0,2626.62,3208.92,265.71,316.59,-5445.99
1333755685567094784,2020-06,2363.17,2718.7,1927.44,0,1571.91,-3874.08
1333755685567094784,2020-07,1899.55,4539.48,277.28,1630.9,-3993.55,-7867.63
1333755685567094784,2020-08,1920.04,1157.53,4596.08,1095.72,4262.87,-3604.76
1333755685567094784,2020-09,0,1478.65,535.4,1834.82,-2778.07,-6382.83
1333755685567094784,2020-10,2873.45,5106.33,0,2523.11,-4755.99,-11138.82
1333755685567094784,2020-11,2480.89,288.16,4231.09,2875.95,3547.87,-7590.95
1333755685567094784,2020-12,4010.93,0,2547.34,488.7,6069.57,-1521.38
1334338111454209024,2020-01,3169.72,5185.34,6429.99,6808.13,-2393.76,-2393.76
1334338111454209024,2020-02,4320.87,3280.64,7148.31,1404.54,6784,4390.24
1334338111454209024,2020-03,2531.94,5631.26,3509.26,8314.25,-7904.31,-3514.07
1334338111454209024,2020-04,6244.31,3014.78,2781.96,525.91,5485.58,1971.51
1334338111454209024,2020-05,5693.66,1943.88,1606.52,1077.8,4278.5,6250.01
1334338111454209024,2020-06,2963.84,3775.09,3045.77,10148.81,-7914.29,-1664.28
1334338111454209024,2020-07,1621.51,8688.73,4661.9,4287.66,-6692.98,-8357.26
1334338111454209024,2020-08,4186.81,668.92,3222.71,1813.64,4926.96,-3430.3
1334338111454209024,2020-09,3919.09,4823.73,4476.45,3175.57,396.24,-3034.06
1334338111454209024,2020-10,6297.02,3872.98,1664.64,4022.42,66.26,-2967.8
1334338111454209024,2020-11,4434.84,7389.98,3081.84,1673.34,-1546.64,-4514.44
1334338111454209024,2020-12,1726.03,3142.02,1052.23,5566.53,-5930.29,-10444.73
1335718728513578240,2020-01,0,4162.7,1336.09,2491.1,-5317.71,-5317.71
1335718728513578240,2020-02,1271.06,2222.31,4147.45,554.67,2641.53,-2676.18
1335718728513578240,2020-03,305.92,708.06,3565.53,1670.93,1492.46,-1183.72
1335718728513578240,2020-04,1734.47,1877.69,2939.17,6888.18,-4092.23,-5275.95
1335718728513578240,2020-05,1004.97,7920,2493.54,4117.16,-8538.65,-13814.6
1335718728513578240,2020-06,795.83,3790.95,7947.53,1704.66,3247.75,-10566.85
1335718728513578240,2020-07,4641.18,696.8,702.05,2306.64,2339.79,-8227.06
1335718728513578240,2020-08,1546.07,1856.26,2399.94,0,2089.75,-6137.31
1335718728513578240,2020-09,1108.85,2580.05,4009.46,6267.8,-3729.54,-9866.85
1335718728513578240,2020-10,5839.96,3052.9,6477.59,4359.48,4905.17,-4961.68
1335718728513578240,2020-11,3054.12,903.75,6113.26,2777.18,5486.45,524.77
1335718728513578240,2020-12,3738.47,2641.73,1865.41,4990.64,-2028.49,-1503.72
1336116213179660032,2020-01,4675.65,3485.72,3421.45,0,4611.38,4611.38
1336116213179660032,2020-02,2284.57,1208.64,2306.61,5379.88,-1997.34,2614.04
1336116213179660032,2020-03,368.48,865.65,0,429,-926.17,1687.87
1336116213179660032,2020-04,1096.92,353.44,5417.92,595.6,5565.8,7253.67
1336116213179660032,2020-05,2946.7,1863.16,2011.94,1657.75,1437.73,8691.4
1336116213179660032,2020-06,6314.34,1245.24,3488.99,1624.39,6933.7,15625.1
1336116213179660032,2020-07,0,1826.02,2620.7,4695.39,-3900.71,11724.39
1336116213179660032,2020-08,1637.48,4878.04,3673.01,2390.85,-1958.4,9765.99
1336116213179660032,2020-09,1191.76,898.12,4641.88,801.53,4133.99,13899.98
1336116213179660032,2020-10,1205.7,4725.2,104.91,1399.16,-4813.75,9086.23
1336116213179660032,2020-11,1919.58,4802.8,571.01,3357.05,-5669.26,3416.97
1336116213179660032,2020-12,275.48,165.22,4920.24,0,5030.5,8447.47
1336312550534084864,2020-01,7871.13,5801.22,335.14,3864.21,-1459.16,-1459.16
1336312550534084864,2020-02,4596.99,4008.07,6200.73,6563.78,225.87,-1233.29
1336312550534084864,2020-03,3782.87,4812.85,4350.92,5830.1,-2509.16,-3742.45
1336312550534084864,2020-04,2638.57,5700.51,5634.47,4649.65,-2077.12,-5819.57
1336312550534084864,2020-05,1539.21,1801.78,2578.5,3937.7,-1621.77,-7441.34
1336312550534084864,2020-06,5906.62,3825.91,4229.53,3151.22,3159.02,-4282.32
1336312550534084864,2020-07,1965.35,5620.89,6463.73,4094.53,-1286.34,-5568.66
1336312550534084864,2020-08,1857.47,10110.46,1688.65,9715.12,-16279.46,-21848.12
1336312550534084864,2020-09,2485.99,4852.43,295.55,4164.95,-6235.84,-28083.96
1336312550534084864,2020-10,4449.13,5246.67,3747.71,4256.06,-1305.89,-29389.85
1336312550534084864,2020-11,1435.04,4166.53,0,5860.99,-8592.48,-37982.33
1336312550534084864,2020-12,5721.96,6325.52,1514.92,4377.37,-3466.01,-41448.34
1337957268686666752,2020-01,1253.91,0,0,5135.04,-3881.13,-3881.13
1337957268686666752,2020-02,834.65,0,69.19,170.73,733.11,-3148.02
1337957268686666752,2020-03,2353.85,705.42,1398.65,2175.19,871.89,-2276.13
1337957268686666752,2020-04,776.06,0,427.74,2327.86,-1124.06,-3400.19
1337957268686666752,2020-05,730.66,999.21,984.34,2251.67,-1535.88,-4936.07
1337957268686666752,2020-06,0,5491.49,1692.15,3268.68,-7068.02,-12004.09
1337957268686666752,2020-07,0,2706.4,0,1329.62,-4036.02,-16040.11
1337957268686666752,2020-08,1843.55,1140.44,2943.45,1856.28,1790.28,-14249.83
1337957268686666752,2020-09,956.29,1454.92,933.58,0,434.95,-13814.88
1337957268686666752,2020-10,1286.76,2204.72,1891.31,0,973.35,-12841.53
1337957268686666752,2020-11,2765.22,0,225.62,0,2990.84,-9850.69
1337957268686666752,2020-12,0,2320.12,4786.1,1196.03,1269.95,-8580.74
1338251370684656128,2020-01,1679.49,4475.84,4680.9,162.38,1722.17,1722.17
1338251370684656128,2020-02,1371.63,3817.11,3220.21,241.63,533.1,2255.27
1338251370684656128,2020-03,2359,610.49,1126.48,2403.95,471.04,2726.31
1338251370684656128,2020-04,1613.86,0,1319,1197.57,1735.29,4461.6
1338251370684656128,2020-05,2028.14,1113.89,0,2629.13,-1714.88,2746.72
1338251370684656128,2020-06,0,6100.21,3589.31,3978.65,-6489.55,-3742.83
1338251370684656128,2020-07,1889.33,0,0,0,1889.33,-1853.5
1338251370684656128,2020-08,0,3304.96,1528.87,0,-1776.09,-3629.59
1338251370684656128,2020-09,2963.04,657.63,3003.11,1978.4,3330.12,-299.47
1338251370684656128,2020-10,2626.51,3352.24,2940.28,2597.12,-382.57,-682.04
1338251370684656128,2020-11,5431.28,0,417.12,214.71,5633.69,4951.65
1338251370684656128,2020-12,2114.75,3478.18,3389.39,5644.93,-3618.97,1332.68
1340724681377305600,2020-01,2387.11,2192.08,2801.07,3265.74,-269.64,-269.64
1340724681377305600,2020-02,6362.71,4046.13,1400.27,3299.46,417.39,147.75
1340724681377305600,2020-03,3839.36,2329.08,2587.89,4770.91,-672.74,-524.99
1340724681377305600,2020-04,4235.18,2465.47,2120.53,1574.53,2315.71,1790.72
1340724681377305600,2020-05,2279.13,5236.29,6691.95,4752.45,-1017.66,773.06
1340724681377305600,2020-06,10267.7,878.09,298.37,6140.7,3547.28,4320.34
1340724681377305600,2020-07,5521.87,9574.84,3723.08,7436.01,-7765.9,-3445.56
1340724681377305600,2020-08,1396.78,1983.16,4472.31,7342.73,-3456.8,-6902.36
1340724681377305600,2020-09,2123.8,1815.77,2270.77,3334.87,-756.07,-7658.43
1340724681377305600,2020-10,4033.95,3933.39,2400.54,3458.9,-957.8,-8616.23
1340724681377305600,2020-11,2338.22,4026.73,2657.4,5856.21,-4887.32,-13503.55
1340724681377305600,2020-12,437.95,5120.53,6312.05,1447.99,181.48,-13322.07
1341067564703300096,2020-01,1633.76,1571.89,0,1319.74,-1257.87,-1257.87
1341067564703300096,2020-02,2532.27,4676.02,3565.75,1773.5,-351.5,-1609.37
1341067564703300096,2020-03,3759.91,0,2905.97,2091.04,4574.84,2965.47
1341067564703300096,2020-04,3929.74,3047.85,0,0,881.89,3847.36
1341067564703300096,2020-05,1419.8,1120.31,1811.02,5965.09,-3854.58,-7.22
1341067564703300096,2020-06,5699.37,325.59,1374.7,4184,2564.48,2557.26
1341067564703300096,2020-07,5969.07,766.92,1122.48,2632.5,3692.13,6249.39
1341067564703300096,2020-08,768.03,7522.2,2776.57,289.57,-4267.17,1982.22
1341067564703300096,2020-09,3040.26,3990.62,2042.73,7717.15,-6624.78,-4642.56
1341067564703300096,2020-10,868.2,902.53,1631.07,1488.77,107.97,-4534.59
1341067564703300096,2020-11,1882.92,1586.71,2130.48,446.71,1979.98,-2554.61
1341067564703300096,2020-12,1944.93,0,4476.88,3979.35,2442.46,-112.15
1343712518406757120,2020-02,2792.26,0,990.11,2636.54,1145.83,1145.83
1343712518406757120,2020-04,161.7,0,0,1967.28,-1805.58,-659.75
1343712518406757120,2020-05,570.4,0,0,0,570.4,-89.35
1343712518406757120,2020-06,1416.77,1512.95,0,0,-96.18,-185.53
1343712518406757120,2020-09,1013.92,1082.56,2348.58,0,2279.94,2094.41
1343712518406757120,2020-10,1367.28,4213.78,5042.04,2202.98,-7.44,2086.97
1343712518406757120,2020-12,1957.95,0,358.07,0,2316.02,4402.99
1344739429913106432,2020-05,773.22,1614.49,0,1408.33,-2249.6,-2249.6
1344739429913106432,2020-06,481.15,0,0,0,481.15,-1768.45
1344739429913106432,2020-08,300.75,0,0,0,300.75,-1467.7
1346146688887935744,2020-01,1511.09,756.97,580.99,708.11,627,627
1346146688887935744,2020-02,1633.33,2044.13,2075.28,2787.01,-1122.53,-495.53
1346146688887935744,2020-03,5772.41,4170.14,293.55,1560.06,335.76,-159.77
1346146688887935744,2020-04,3808.79,1229.99,2566.05,1008.33,4136.52,3976.75
1346146688887935744,2020-05,154.89,2707.46,172.38,2441.03,-4821.22,-844.47
1346146688887935744,2020-06,286.47,67.35,3385.36,1398.65,2205.83,1361.36
1346146688887935744,2020-07,3690.95,0,0,1478.11,2212.84,3574.2
1346146688887935744,2020-08,1184.66,216.97,3686.36,2115.61,2538.44,6112.64
1346146688887935744,2020-09,0,2446.79,0,832.72,-3279.51,2833.13
1346146688887935744,2020-10,2003.63,4569.13,1138.73,1411.64,-2838.41,-5.28
1346146688887935744,2020-11,895.35,1661.44,550.25,0,-215.84,-221.12
1346146688887935744,2020-12,1125.54,1521.52,7518.68,107.77,7014.93,6793.81
1346150832676714240,2020-01,788.85,0,2888.53,2216.81,1460.57,1460.57
1346150832676714240,2020-02,4781.62,3686.62,10850.78,2347.24,9598.54,11059.11
1346150832676714240,2020-03,5740.95,4412.72,7123.51,5545.95,2905.79,13964.9
1346150832676714240,2020-04,4213.08,4984.06,6540.16,6791.24,-1022.06,12942.84
1346150832676714240,2020-05,7312.78,1060.66,5327.65,2153.75,9426.02,22368.86
1346150832676714240,2020-06,1978.22,4068.34,3547.91,3250.28,-1792.49,20576.37
1346150832676714240,2020-07,5133.5,1244.59,8415.25,2087.77,10216.39,30792.76
1346150832676714240,2020-08,4883.4,6466.07,4203.71,2921.59,-300.55,30492.21
1346150832676714240,2020-09,6815.64,8205.59,1377.93,1562.99,-1575.01,28917.2
1346150832676714240,2020-10,3958.66,3364.21,5995.02,1847.95,4741.52,33658.72
1346150832676714240,2020-11,6900.6,4673.31,4853.79,6514.01,567.07,34225.79
1346150832676714240,2020-12,3860.34,5397.61,1201.88,3323.08,-3658.47,30567.32
1348826691126864128,2020-01,4864.87,5967.43,5095.45,7611.51,-3618.62,-3618.62
1348826691126864128,2020-02,6230.09,3656.85,1944.58,4778.98,-261.16,-3879.78
1348826691126864128,2020-03,5482.79,3205.58,2901.89,3573.27,1605.83,-2273.95
1348826691126864128,2020-04,2340.04,7172.86,2497.7,6427.35,-8762.47,-11036.42
1348826691126864128,2020-05,5131.51,7720.5,2730.06,5404.58,-5263.51,-16299.93
1348826691126864128,2020-06,6650.81,7900.15,929.07,1928.67,-2248.94,-18548.87
1348826691126864128,2020-07,4235.49,3193.15,5366.09,6178.65,229.78,-18319.09
1348826691126864128,2020-08,3529.22,9206.14,1561.27,4812.72,-8928.37,-27247.46
1348826691126864128,2020-09,7720.91,4043.3,7583.52,4026.17,7234.96,-20012.5
1348826691126864128,2020-10,3132.72,3057.12,4156.16,0,4231.76,-15780.74
1348826691126864128,2020-11,5063.46,5941.42,8811.08,3184.54,4748.58,-11032.16
1348826691126864128,2020-12,5677.89,1822.29,9378.22,2807.37,10426.45,-605.71
1351077043089979648,2020-01,6682.05,2928.6,7087.84,8471.32,2369.97,2369.97
1351077043089979648,2020-02,945.03,2849.15,2525.56,5868.21,-5246.77,-2876.8
1351077043089979648,2020-03,6240.43,1104.74,6023.99,1996.86,9162.82,6286.02
1351077043089979648,2020-04,1130.63,1669.59,5194.28,2256.55,2398.77,8684.79
1351077043089979648,2020-05,3573.98,3941.35,6010.4,1819.61,3823.42,12508.21
1351077043089979648,2020-06,2222.44,2819.86,4518.92,7539.54,-3618.04,8890.17
1351077043089979648,2020-07,576.48,5304.27,9948.21,4656.19,564.23,9454.4
1351077043089979648,2020-08,4387.5,9517.25,3806.28,6851.61,-8175.08,1279.32
1351077043089979648,2020-09,2578.68,4273.62,2489.76,5890.66,-5095.84,-3816.52
1351077043089979648,2020-10,2245.06,4487.49,1526.76,6915.12,-7630.79,-11447.31
1351077043089979648,2020-11,7620.13,5122.19,4584.25,4183.16,2899.03,-8548.28
1351077043089979648,2020-12,2968.45,5671.35,1916.95,5193.68,-5979.63,-14527.91
1351103668197853184,2020-01,989.46,0,0,286.15,703.31,703.31
1351103668197853184,2020-04,334.3,3250.53,0,0,-2916.23,-2212.92
1351103668197853184,2020-10,2014.26,0,225.71,0,2239.97,27.05
1351103668197853184,2020-12,1464.83,0,56.32,1741.12,-219.97,-192.92
1351197457133259520,2020-01,2223.37,0,2849.49,0,5072.86,5072.86
1351197457133259520,2020-02,1249.87,1028.33,0,2720.58,-2499.04,2573.82
1351197457133259520,2020-03,3172.73,3223.95,3950.61,2987.22,912.17,3485.99
1351197457133259520,2020-04,0,779.04,2471.19,3394.12,-1701.97,1784.02
1351197457133259520,2020-05,896.2,3016.77,2308.15,3628.3,-3440.72,-1656.7
1351197457133259520,2020-06,1773.97,0,1258.26,2402.5,629.73,-1026.97
1351197457133259520,2020-07,3623.69,2972.3,0,0,651.39,-375.58
1351197457133259520,2020-08,1490.05,2878.49,3943.69,5195.72,-2640.47,-3016.05
1351197457133259520,2020-09,1626.31,2802.51,720.39,0,-455.81,-3471.86
1351197457133259520,2020-10,1708.36,1598.73,399.73,5895.05,-5385.69,-8857.55
1351197457133259520,2020-11,4385.82,3891.11,1352.05,603.86,1242.9,-7614.65
1351197457133259520,2020-12,1582.82,2546.47,2074.64,1895.52,-784.53,-8399.18
1351402546334391040,2020-01,1927.01,1521.44,4841.34,3812.03,1434.88,1434.88
1351402546334391040,2020-02,0,2581.16,7697.02,370.07,4745.79,6180.67
1351402546334391040,2020-03,2846.86,3651.96,2262.36,2495,-1037.74,5142.93
1351402546334391040,2020-04,0,1750.93,5316.53,869.16,2696.44,7839.37
1351402546334391040,2020-05,438.59,130.96,6705.66,3371,3642.29,11481.66
1351402546334391040,2020-06,2614.92,1949.35,2514.83,7207.49,-4027.09,7454.57
1351402546334391040,2020-07,4239.72,0,3946.42,0,8186.14,15640.71
1351402546334391040,2020-08,0,545.91,2356.96,1952.71,-141.66,15499.05
1351402546334391040,2020-09,3184.09,5392.41,1565.78,1482.34,-2124.88,13374.17
1351402546334391040,2020-10,1583.16,9478.23,5098.29,1362.04,-4158.82,9215.35
1351402546334391040,2020-11,4171.15,2590.01,3344.47,2496.19,2429.42,11644.77
1351402546334391040,2020-12,722.4,1020.89,0,747.76,-1046.25,10598.52
1351974655305477120,2020-01,2309.79,2122.91,2293.42,6796.49,-4316.19,-4316.19
1351974655305477120,2020-02,6494.73,6261.64,10576.21,2778.06,8031.24,3715.05
1351974655305477120,2020-03,8089.17,7691.85,846.44,5902.27,-4658.51,-943.46
1351974655305477120,2020-04,3169.14,8832.33,2755.92,3656.94,-6564.21,-7507.67
1351974655305477120,2020-05,8737.57,1080.96,0,9229.77,-1573.16,-9080.83
1351974655305477120,2020-06,4224.39,1940.7,1203.94,8557.99,-5070.36,-14151.19
1351974655305477120,2020-07,1477.62,5526.42,6378.03,1852.67,476.56,-13674.63
1351974655305477120,2020-08,6137.36,6704.97,6045.88,1078.39,4399.88,-9274.75
1351974655305477120,2020-09,4461.72,5535.1,6763.99,3470.39,2220.22,-7054.53
1351974655305477120,2020-10,7062.02,12814.97,5602.65,4330.39,-4480.69,-11535.22
1351974655305477120,2020-11,3718.83,4705.17,3614.01,2413.89,213.78,-11321.44
1351974655305477120,2020-12,3903.55,8512.79,8863.07,1814.54,2439.29,-8882.15
1352129882127601920,2020-01,0,1041.58,941.94,0,-99.64,-99.64
1352129882127601920,2020-02,0,1197.1,292.27,589.94,-1494.77,-1594.41
1352129882127601920,2020-03,1478.94,0,0,0,1478.94,-115.47
1352129882127601920,2020-08,0,1484.9,927.78,0,-557.12,-672.59
1352129882127601920,2020-12,1648.96,723.47,0,0,925.49,252.9
1352388792618962688,2020-01,7163.82,5190.68,4330.25,7483.38,-1179.99,-1179.99
1352388792618962688,2020-02,6508.89,3886.01,3944.86,3616.27,2951.47,1771.48
1352388792618962688,2020-03,5635.44,2380.13,6654.67,7112.93,2797.05,4568.53
1352388792618962688,2020-04,4507.57,7134.53,3443.96,2213.64,-1396.64,3171.89
1352388792618962688,2020-05,6246.41,5108.07,6515.14,2131.57,5521.91,8693.8
1352388792618962688,2020-06,2094.53,8515.75,4321.21,3986.36,-6086.37,2607.43
1352388792618962688,2020-07,4739.76,1746.08,5295.42,6311.94,1977.16,4584.59
1352388792618962688,2020-08,3776.73,8439.62,2327.42,5821.41,-8156.88,-3572.29
1352388792618962688,2020-09,1144.34,4780.94,4582.84,1487.43,-541.19,-4113.48
1352388792618962688,2020-10,4103.33,5754.94,6939.46,4720.46,567.39,-3546.09
1352388792618962688,2020-11,7197.79,8094.42,4968.87,5526.05,-1453.81,-4999.9
1352388792618962688,2020-12,3103.82,6413,8838.8,3690.85,1838.77,-3161.13
1353048749197508352,2020-01,3426.73,3289.16,6931.02,5645.98,1422.61,1422.61
1353048749197508352,2020-02,6763.52,4316.95,1843.63,0,4290.2,5712.81
1353048749197508352,2020-03,1655.92,1868.48,8302.82,3739.75,4350.51,10063.32
1353048749197508352,2020-04,7391.19,2899.51,6643,3705.55,7429.13,17492.45
1353048749197508352,2020-05,1541.54,4336.56,1097.3,2378.05,-4075.77,13416.68
1353048749197508352,2020-06,2330.86,1940.17,4044.38,1740.86,2694.21,16110.89
1353048749197508352,2020-07,3607.71,5057.74,4909.36,3160.69,298.64,16409.53
1353048749197508352,2020-08,7157.39,5862.27,4536.65,1942.28,3889.49,20299.02
1353048749197508352,2020-09,0,2814.73,2172.98,2839.59,-3481.34,16817.68
1353048749197508352,2020-10,2567.08,4204.86,7750.37,10131.1,-4018.51,12799.17
1353048749197508352,2020-11,4164.7,5556.69,2487.48,3908.42,-2812.93,9986.24
1353048749197508352,2020-12,2921.98,3675.85,2328.66,3628.64,-2053.85,7932.39
1354644409768621056,2020-02,1646.49,0,0,0,1646.49,1646.49
1354644409768621056,2020-06,0,1429.71,0,0,-1429.71,216.78
1354644409768621056,2020-07,0,884.02,0,0,-884.02,-667.24
1354644409768621056,2020-08,913.47,0,0,0,913.47,246.23
1354644409768621056,2020-11,0,3014.04,0,0,-3014.04,-2767.81
1356474428261629440,2020-01,0,1718.25,5090.02,0,3371.77,3371.77
1356474428261629440,2020-02,0,2245.48,2703.88,3585.36,-3126.96,244.81
1356474428261629440,2020-03,0,1386.73,0,712.66,-2099.39,-1854.58
1356474428261629440,2020-04,301.17,2480.17,2427.85,5475.36,-5226.51,-7081.09
1356474428261629440,2020-05,1500.3,0,0,836.26,664.04,-6417.05
1356474428261629440,2020-07,313.31,1013.56,519.4,1763.13,-1943.98,-8361.03
1356474428261629440,2020-08,1939.51,1145.29,2748.15,2391.07,1151.3,-7209.73
1356474428261629440,2020-09,1387.27,286.79,2834.36,54.3,3880.54,-3329.19
1356474428261629440,2020-11,3030.76,1777.46,674.61,1771.78,156.13,-3173.06
1356474428261629440,2020-12,256.77,0,150.21,0,406.98,-2766.08
1357004243335761152,2020-01,1205.1,6795.92,6276.66,8081.77,-7395.93,-7395.93
1357004243335761152,2020-02,4957.41,1971.66,2341.65,1797.44,3529.96,-3865.97
1357004243335761152,2020-03,2556.5,1611.75,3842.28,1947.88,2839.15,-1026.82
1357004243335761152,2020-04,9868.15,1255.1,5248.12,782.45,13078.72,12051.9
1357004243335761152,2020-05,1625.21,4211.11,3277.15,4904.77,-4213.52,7838.38
1357004243335761152,2020-06,2662.02,8691.02,4182.27,3413.13,-5259.86,2578.52
1357004243335761152,2020-07,5849.33,2769.42,5163.32,2249.57,5993.66,8572.18
1357004243335761152,2020-08,1997.76,5797.01,1590.71,6414.07,-8622.61,-50.43
1357004243335761152,2020-09,7928.32,2002.79,2373.05,1606.11,6692.47,6642.04
1357004243335761152,2020-10,4699.97,401.7,9768.39,5989.1,8077.56,14719.6
1357004243335761152,2020-11,6047.91,805.3,1215.13,5362.29,1095.45,15815.05
1357004243335761152,2020-12,2615.21,181.8,9534.36,2537.95,9429.82,25244.87
1361263586584360960,2020-01,3386.76,4149.55,5580.93,1148.57,3669.57,3669.57
1361263586584360960,2020-02,1813.65,1486.53,4157.13,6770.94,-2286.69,1382.88
1361263586584360960,2020-03,3946.24,4947.05,3224.66,5215.36,-2991.51,-1608.63
1361263586584360960,2020-04,0,3525.87,3404.7,2015.24,-2136.41,-3745.04
1361263586584360960,2020-05,1837.09,1612.89,2712.53,1091.48,1845.25,-1899.79
1361263586584360960,2020-06,7508.27,1162.54,3058.66,9080.19,324.2,-1575.59
1361263586584360960,2020-07,1397.04,5163.29,1112.66,1960.5,-4614.09,-6189.68
1361263586584360960,2020-08,1463.58,2235.13,7240.77,2010.23,4458.99,-1730.69
1361263586584360960,2020-09,2062.55,5355.36,2221.97,5352.59,-6423.43,-8154.12
1361263586584360960,2020-10,4433.7,1697.31,1668.96,5731.82,-1326.47,-9480.59
1361263586584360960,2020-11,2673.7,5304.46,3809.87,3228.17,-2049.06,-11529.65
1361263586584360960,2020-12,3034.55,3491.12,7867,3270.87,4139.56,-7390.09
1361509285059948032,2020-01,8146.3,4254.53,703.59,4042.58,552.78,552.78
1361509285059948032,2020-02,1953.45,8028.26,3968.22,6566.37,-8672.96,-8120.18
1361509285059948032,2020-03,2188.96,797.26,3052.48,5170.07,-725.89,-8846.07
1361509285059948032,2020-04,6602.92,7326.98,5279.53,8236.35,-3680.88,-12526.95
1361509285059948032,2020-05,1451.9,4814.3,7265.24,8280.38,-4377.54,-16904.49
1361509285059948032,2020-06,3093.29,5550.79,3331.78,3254.1,-2379.82,-19284.31
1361509285059948032,2020-07,4815.07,6133.01,4868.33,0,3550.39,-15733.92
1361509285059948032,2020-08,11140.82,4205.39,1716.15,3468.58,5183,-10550.92
1361509285059948032,2020-09,5399.84,6424.31,3152.94,5383.75,-3255.28,-13806.2
1361509285059948032,2020-10,6339.6,648.81,3058.25,5035.82,3713.22,-10092.98
1361509285059948032,2020-11,9856.61,1883.07,2818.98,3317.28,7475.24,-2617.74
1361509285059948032,2020-12,3486.67,4015.86,5548.97,3515.87,1503.91,-1113.83
1361594430041759232,2020-01,2252.09,1501.68,2380.06,2161.12,969.35,969.35
1361594430041759232,2020-02,5269.33,119.51,607.56,4263.5,1493.88,2463.23
1361594430041759232,2020-03,4725.8,4573.84,785.08,4496.12,-3559.08,-1095.85
1361594430041759232,2020-04,2485.36,2793.3,3148.34,4978.07,-2137.67,-3233.52
1361594430041759232,2020-05,999.48,400.88,5024.59,3779.66,1843.53,-1389.99
1361594430041759232,2020-06,3448.26,3189.6,3062.13,5091.6,-1770.81,-3160.8
1361594430041759232,2020-07,1973.58,4795.87,1389.78,3999.82,-5432.33,-8593.13
1361594430041759232,2020-08,3519.2,5555.58,2549.37,4274,-3761.01,-12354.14
1361594430041759232,2020-09,1242.74,2979.81,6502.74,6746.66,-1980.99,-14335.13
1361594430041759232,2020-10,6177.36,1885.86,2931.66,5244.95,1978.21,-12356.92
1361594430041759232,2020-11,4643.22,4243.25,683.91,7640.86,-6556.98,-18913.9
1361594430041759232,2020-12,2079.59,3329.92,5392.31,1758.41,2383.57,-16530.33
1362180065090705664,2020-01,5812.93,9802.46,6111.65,5322.34,-3200.22,-3200.22
1362180065090705664,2020-02,768.94,156.54,2951.67,6182.52,-2618.45,-5818.67
1362180065090705664,2020-03,3357.22,4557,5241.56,4120.33,-78.55,-5897.22
1362180065090705664,2020-04,4233.47,2764.62,3193.39,3332.17,1330.07,-4567.15
1362180065090705664,2020-05,4162.36,4967.15,1509.54,4079.51,-3374.76,-7941.91
1362180065090705664,2020-06,7654,7861.3,1964.25,4236.48,-2479.53,-10421.44
1362180065090705664,2020-07,4709.42,4800.66,11793.28,9611.22,2090.82,-8330.62
1362180065090705664,2020-08,5508.62,3938.87,3786.75,6151.37,-794.87,-9125.49
1362180065090705664,2020-09,2822.55,9736.61,87.04,3678.04,-10505.06,-19630.55
1362180065090705664,2020-10,2112.07,7683.53,4709.96,3397.01,-4258.51,-23889.06
1362180065090705664,2020-11,6174.58,1120.79,3395.81,4204.42,4245.18,-19643.88
1362180065090705664,2020-12,3106.54,2387.58,6337.32,1251.55,5804.73,-13839.15
1362463487647511040,2020-04,864.49,0,0,169.17,695.32,695.32
1362463487647511040,2020-11,0,1085.53,2128.68,0,1043.15,1738.47
1366286101878677504,2020-01,3197.41,0,2007.66,0,5205.07,5205.07
1366286101878677504,2020-02,1500.01,4098.66,5208.19,1450.61,1158.93,6364
1366286101878677504,2020-03,3068.68,4009.59,2042.45,2792.35,-1690.81,4673.19
1366286101878677504,2020-04,2417.84,6853.08,4664.97,6025,-5795.27,-1122.08
1366286101878677504,2020-05,4543.37,3808.39,0,669.17,65.81,-1056.27
1366286101878677504,2020-06,1954.6,949.2,0,3233.02,-2227.62,-3283.89
1366286101878677504,2020-07,5311.37,669.02,5758.89,8515.25,1885.99,-1397.9
1366286101878677504,2020-08,4460.92,2891.56,4195.22,0,5764.58,4366.68
1366286101878677504,2020-09,3864.17,4090.52,2476.15,6038.28,-3788.48,578.2
1366286101878677504,2020-10,178.73,2669.59,7277.18,394.62,4391.7,4969.9
1366286101878677504,2020-11,4101.34,812.29,4877.22,4012.44,4153.83,9123.73
1366286101878677504,2020-12,2876.79,7156.65,1240.77,2441.13,-5480.22,3643.51
1366691526419534080,2020-01,2335.76,1779.85,3934.07,3471.15,1018.83,1018.83
1366691526419534080,2020-02,0,1113.59,1340.14,4482.66,-4256.11,-3237.28
1366691526419534080,2020-03,1678.99,3712.72,2475.55,4380.62,-3938.8,-7176.08
1366691526419534080,2020-04,2247.66,2323.6,3087.61,5890.93,-2879.26,-10055.34
1366691526419534080,2020-05,1060.5,5972.09,10802.36,6296.38,-405.61,-10460.95
1366691526419534080,2020-06,3537.3,1178.99,1086.11,5321.59,-1877.17,-12338.12
1366691526419534080,2020-07,2816.94,2998.55,1888.68,0,1707.07,-10631.05
1366691526419534080,2020-08,2993.77,1367.23,2358.94,1465.64,2519.84,-8111.21
1366691526419534080,2020-09,4298.27,3741.62,316.66,5904.16,-5030.85,-13142.06
1366691526419534080,2020-10,2082.92,4885.57,1853.06,3586.2,-4535.79,-17677.85
1366691526419534080,2020-11,4781.25,5027.91,8107.1,8410.87,-550.43,-18228.28
1366691526419534080,2020-12,5341.65,7387.73,1694.17,4850,-5201.91,-23430.19
1368253831773550336,2020-01,8741.65,3164.83,7001.97,2454,10124.79,10124.79
1368253831773550336,2020-02,1159.74,0,10541.63,4082,7619.37,17744.16
1368253831773550336,2020-03,3325.01,1690.78,3850.6,1796.37,3688.46,21432.62
1368253831773550336,2020-04,5801.57,4535.26,6980.76,1460.78,6786.29,28218.91
1368253831773550336,2020-05,4193.95,3121.42,3047.1,4071.59,48.04,28266.95
1368253831773550336,2020-06,1693.21,1168.43,7209.38,3600.25,4133.91,32400.86
1368253831773550336,2020-07,2622.1,2159.51,5250.29,3794.88,1918,34318.86
1368253831773550336,2020-08,9417.2,5712.43,5097.09,4020.66,4781.2,39100.06
1368253831773550336,2020-09,7024.86,5383.17,4471.82,6842.94,-729.43,38370.63
1368253831773550336,2020-10,9142.61,3007.52,5916.31,4535.36,7516.04,45886.67
1368253831773550336,2020-11,3315.91,2415.18,3913.43,5424.7,-610.54,45276.13
1368253831773550336,2020-12,5457.23,7047.54,1748.83,5293.31,-5134.79,40141.34
1369309278281786624,2020-01,1305.77,1489.77,6659.08,5436.82,1038.26,1038.26
1369309278281786624,2020-02,9358.09,1526.64,3385.88,2466.62,8750.71,9788.97
1369309278281786624,2020-03,2395.52,4468.92,7515.07,7635.38,-2193.71,7595.26
1369309278281786624,2020-04,575.13,4128.86,9022.54,3642.98,1825.83,9421.09
1369309278281786624,2020-05,3279.81,3132.18,3883.37,3208.22,822.78,10243.87
1369309278281786624,2020-06,3716.28,10803.15,3112.05,9335.27,-13310.09,-3066.22
1369309278281786624,2020-07,8526.11,2559.51,3497.92,4471.57,4992.95,1926.73
1369309278281786624,2020-08,9251.3,11286.62,5229.57,574.09,2620.16,4546.89
1369309278281786624,2020-09,6220.8,11830.71,5542.99,3075.22,-3142.14,1404.75
1369309278281786624,2020-10,7272.92,5430.79,3652.29,7814.23,-2319.81,-915.06
1369309278281786624,2020-11,1454.01,5123.28,3748.03,1772.21,-1693.45,-2608.51
1369309278281786624,2020-12,4085.74,3807.84,2888.29,4782.34,-1616.15,-4224.66
1369801467553889536,2020-01,2133.78,4876.27,3844.81,2476.08,-1373.76,-1373.76
1369801467553889536,2020-02,2565.33,4458.19,0,4137.37,-6030.23,-7403.99
1369801467553889536,2020-03,3102.25,1398.4,2831.44,2765.76,1769.53,-5634.46
1369801467553889536,2020-04,4093.2,2987.96,2782.37,2243.96,1643.65,-3990.81
1369801467553889536,2020-05,3125.9,862.07,5044.91,2167.42,5141.32,1150.51
1369801467553889536,2020-06,4635.11,1189.97,2387.65,1009.74,4823.05,5973.56
1369801467553889536,2020-07,1303.16,499,1569.19,1946.94,426.41,6399.97
1369801467553889536,2020-08,5064.52,2705.4,3190.06,4075.35,1473.83,7873.8
1369801467553889536,2020-09,7152.67,3196.21,1923.78,6173.72,-293.48,7580.32
1369801467553889536,2020-10,1324.35,6152.37,4294.73,2608.78,-3142.07,4438.25
1369801467553889536,2020-11,2709.8,1363.41,2473.67,4446.69,-626.63,3811.62
1369801467553889536,2020-12,5172.16,2524.39,2309.15,4141.82,815.1,4626.72
1371314886543239936,2020-01,966.25,5190.39,2501.55,391.06,-2113.65,-2113.65
1371314886543239936,2020-02,1066.96,1896.68,2790.83,2472.07,-510.96,-2624.61
1371314886543239936,2020-03,282.54,6609.8,993.27,1619.93,-6953.92,-9578.53
1371314886543239936,2020-04,1985.62,2534.47,111.25,4465.04,-4902.64,-14481.17
1371314886543239936,2020-05,200.14,0,2694.73,2234.96,659.91,-13821.26
1371314886543239936,2020-06,3840.69,3502.47,1062.41,3167.54,-1766.91,-15588.17
1371314886543239936,2020-07,0,1022.89,1758.05,2341.61,-1606.45,-17194.62
1371314886543239936,2020-08,3186.76,953.42,1294.61,3188.61,339.34,-16855.28
1371314886543239936,2020-09,4294.58,1318.46,1013.94,3709.54,280.52,-16574.76
1371314886543239936,2020-10,0,1132.49,2444.14,659.3,652.35,-15922.41
1371314886543239936,2020-11,2872.68,659.83,6043.07,6898.58,1357.34,-14565.07
1371314886543239936,2020-12,3217.74,1794.71,2056.18,1221.46,2257.75,-12307.32
1373612039791942400,2020-01,1412.45,3488.65,2014.39,6947.04,-7008.85,-7008.85
1373612039791942400,2020-02,614.31,4391.99,7365.09,3113.48,473.93,-6534.92
1373612039791942400,2020-03,8727.29,10241.07,6176.1,6608.05,-1945.73,-8480.65
1373612039791942400,2020-04,2840.59,304.53,3570.53,4093.18,2013.41,-6467.24
1373612039791942400,2020-05,777.45,5780.85,4753.29,6241.62,-6491.73,-12958.97
1373612039791942400,2020-06,5288.23,4733.96,6823.87,3534.72,3843.42,-9115.55
1373612039791942400,2020-07,5624.97,5727.8,5212.81,3661.72,1448.26,-7667.29
1373612039791942400,2020-08,3215.64,3445.96,5906.12,1292.81,4382.99,-3284.3
1373612039791942400,2020-09,3228.01,3912.27,10215.39,5382.88,4148.25,863.95
1373612039791942400,2020-10,1149.68,3430.9,1553.22,2531.13,-3259.13,-2395.18
1373612039791942400,2020-11,5964.19,2997.69,7926.73,2525.82,8367.41,5972.23
1373612039791942400,2020-12,4562.1,4125.29,2058.96,4256.23,-1760.46,4211.77
1375475061730239488,2020-01,4769.96,3246.47,5402.62,1323.6,5602.51,5602.51
1375475061730239488,2020-02,4123.19,5715.36,2852.77,4333.68,-3073.08,2529.43
1375475061730239488,2020-03,4940.83,8392.21,3135.64,7160.73,-7476.47,-4947.04
1375475061730239488,2020-04,2190.47,1492.36,4215.87,2582.52,2331.46,-2615.58
1375475061730239488,2020-05,1050.97,3783.31,3506.67,2305.56,-1531.23,-4146.81
1375475061730239488,2020-06,1027.97,2209.41,2494.63,5200.46,-3887.27,-8034.08
1375475061730239488,2020-07,3716.27,2600.68,0,2549.29,-1433.7,-9467.78
1375475061730239488,2020-08,3720.91,1740.94,5829.18,2621.32,5187.83,-4279.95
1375475061730239488,2020-09,3703.06,6566.38,2461.3,3906.55,-4308.57,-8588.52
1375475061730239488,2020-10,7581.2,6640.24,3693.86,3587.47,1047.35,-7541.17
1375475061730239488,2020-11,2763.83,5082.91,3377.1,2941.77,-1883.75,-9424.92
1375475061730239488,2020-12,2951.04,3086.31,1295.45,686.43,473.75,-8951.17
1375559125382595840,2020-02,1108.17,27.09,369.44,652.47,798.05,798.05
1375559125382595840,2020-03,3351.33,0,0,3063.91,287.42,1085.47
1375559125382595840,2020-04,0,1181.02,1470.09,36.68,252.39,1337.86
1375559125382595840,2020-05,703.31,3003.35,2879.05,0,579.01,1916.87
1375559125382595840,2020-06,153.57,2404,1791.78,0,-458.65,1458.22
1375559125382595840,2020-07,1592.51,1606.03,0,453.8,-467.32,990.9
1375559125382595840,2020-08,1776.28,1132.52,1355.33,0,1999.09,2989.99
1375559125382595840,2020-09,0,3849.14,1099.54,0,-2749.6,240.39
1375559125382595840,2020-10,0,2299.49,1555.81,0,-743.68,-503.29
1375559125382595840,2020-11,635.17,627.54,1634.51,0,1642.14,1138.85
1375559125382595840,2020-12,1785.29,0,4067.39,168.45,5684.23,6823.08
1376020672576190720,2020-01,4384.41,3085.44,1110.52,1349.59,1059.9,1059.9
1376020672576190720,2020-02,0,1315.77,1376.79,2109.56,-2048.54,-988.64
1376020672576190720,2020-03,3492.99,1862.15,1982.63,2129.95,1483.52,494.88
1376020672576190720,2020-04,4624.57,3028.75,1415.5,5615.82,-2604.5,-2109.62
1376020672576190720,2020-05,4204.59,1876.26,1998.89,265.89,4061.33,1951.71
1376020672576190720,2020-06,7336.77,1807.31,2996.79,3688.89,4837.36,6789.07
1376020672576190720,2020-07,2446.29,4249.36,1016.27,3351.66,-4138.46,2650.61
1376020672576190720,2020-08,1907.54,1637.41,5315.27,2855.02,2730.38,5380.99
1376020672576190720,2020-09,3661.63,7846.41,0,352.85,-4537.63,843.36
1376020672576190720,2020-10,5186.21,3039.04,2578.73,0,4725.9,5569.26
1376020672576190720,2020-11,1697.8,2675.43,22.59,0,-955.04,4614.22
1376020672576190720,2020-12,1246.39,1767.95,4587.42,4536.27,-470.41,4143.81
1376713309012763136,2020-01,1264.29,1681.1,1810.61,1912.73,-518.93,-518.93
1376713309012763136,2020-02,0,1494.87,0,1746.98,-3241.85,-3760.78
1376713309012763136,2020-03,1339.71,2920.58,3520.97,1781.43,158.67,-3602.11
1376713309012763136,2020-04,2005.62,0,152.34,1982.02,175.94,-3426.17
1376713309012763136,2020-05,541.59,843.07,1636.39,1924.59,-589.68,-4015.85
1376713309012763136,2020-06,1695.91,1577.75,1087.97,2868.11,-1661.98,-5677.83
1376713309012763136,2020-07,4319.48,0,4635.35,1679.44,7275.39,1597.56
1376713309012763136,2020-08,3229.41,2800.94,1863.21,153.94,2137.74,3735.3
1376713309012763136,2020-09,1472.82,2339.78,1946.78,505.75,574.07,4309.37
1376713309012763136,2020-10,7508.97,0,1871.84,944.01,8436.8,12746.17
1376713309012763136,2020-11,3737.9,1246.83,1872.15,832.76,3530.46,16276.63
1376713309012763136,2020-12,913.69,1322.67,0,6651.58,-7060.56,9216.07
1377309626495503872,2020-01,6448.07,3225.3,2072.13,146.93,5147.97,5147.97
1377309626495503872,2020-02,3647.69,3742.48,1160.2,4344.11,-3278.7,1869.27
1377309626495503872,2020-03,4899.82,0,6521.94,4451.62,6970.14,8839.41
1377309626495503872,2020-04,5422.07,9067.46,1823.48,8345.73,-10167.64,-1328.23
1377309626495503872,2020-05,1825.35,6494.07,663.35,1600.73,-5606.1,-6934.33
1377309626495503872,2020-06,1283.58,3061.57,2077.99,5257.66,-4957.66,-11891.99
1377309626495503872,2020-07,5787.97,1729.87,4887.37,0,8945.47,-2946.52
1377309626495503872,2020-08,4205.5,5783.08,1496.61,6721.39,-6802.36,-9748.88
1377309626495503872,2020-09,2465.79,2182.58,196.28,2494.91,-2015.42,-11764.3
1377309626495503872,2020-10,3642.94,2860.36,4392.25,1416.19,3758.64,-8005.66
1377309626495503872,2020-11,4142.89,3239.87,2584.95,857.08,2630.89,-5374.77
1377309626495503872,2020-12,7235.66,131.24,3265.95,2060.09,8310.28,2935.51
1380574374455910400,2020-01,53.65,0,0,2363.8,-2310.15,-2310.15
1380574374455910400,2020-02,1388.67,1044.41,1560.19,982.35,922.1,-1388.05
1380574374455910400,2020-03,0,1385.95,0,2887.96,-4273.91,-5661.96
1380574374455910400,2020-04,1121.82,2007.19,1797.59,1953.85,-1041.63,-6703.59
1380574374455910400,2020-05,4897.3,1825.58,54.1,0,3125.82,-3577.77
1380574374455910400,2020-06,0,1507.57,768.43,2189.85,-2928.99,-6506.76
1380574374455910400,2020-07,1210.51,2001.94,1657.26,1017.95,-152.12,-6658.88
1380574374455910400,2020-08,1658.97,3545.97,1637.69,104.42,-353.73,-7012.61
1380574374455910400,2020-09,966.19,0,3551.17,2536.14,1981.22,-5031.39
1380574374455910400,2020-10,1232.88,0,949.74,1423.04,759.58,-4271.81
1380574374455910400,2020-11,2793.98,1798.45,1829.8,1325.18,1500.15,-2771.66
1380574374455910400,2020-12,3302.07,1768.82,819.64,0,2352.89,-418.77
1380926242944391424,2020-02,990.17,0,933.55,0,1923.72,1923.72
1380926242944391424,2020-03,58.49,1430.06,0,0,-1371.57,552.15
1380926242944391424,2020-04,0,314.42,0,0,-314.42,237.73
1380926242944391424,2020-05,619.77,0,1301.27,0,1921.04,2158.77
1380926242944391424,2020-06,0,1152.53,0,0,-1152.53,1006.24
1380926242944391424,2020-07,1414.17,664.67,0,2365.43,-1615.93,-609.69
1380926242944391424,2020-08,716.8,0,1168.84,0,1885.64,1275.95
1380926242944391424,2020-10,480.39,0,0,479.98,0.41,1276.36
1380926242944391424,2020-12,0,2933.34,0,1921.62,-4854.96,-3578.6
1381800396358309632,2020-01,2034,1066.89,0,2308.41,-1341.3,-1341.3
1381800396358309632,2020-02,706.54,951.39,0,2540.91,-2785.76,-4127.06
1381800396358309632,2020-03,796.89,3082.02,822.86,533.03,-1995.3,-6122.36
1381800396358309632,2020-04,0,1788.43,2319.07,1332.91,-802.27,-6924.63
1381800396358309632,2020-05,3062.73,3570.02,0,0,-507.29,-7431.92
1381800396358309632,2020-06,4432.27,635.43,1883.41,2069.2,3611.05,-3820.87
1381800396358309632,2020-07,2838.88,1271.87,1447.48,3664.5,-650.01,-4470.88
1381800396358309632,2020-08,0,1609.57,2370.16,230.14,530.45,-3940.43
1381800396358309632,2020-09,0,74.39,777.75,0,703.36,-3237.07
1381800396358309632,2020-10,103.86,2368.18,34.32,3770.53,-6000.53,-9237.6
1381800396358309632,2020-11,1030.26,384.13,3477.97,621.3,3502.8,-5734.8
1381800396358309632,2020-12,5670.9,1109.21,1058.51,2710.11,2910.09,-2824.71
1381970081738273792,2020-01,2977.63,5224.42,1930.36,1480.04,-1796.47,-1796.47
1381970081738273792,2020-02,1136.64,2850.04,839.23,0,-874.17,-2670.64
1381970081738273792,2020-03,0,3620.07,1425.67,7656.41,-9850.81,-12521.45
1381970081738273792,2020-04,359.58,0,0,0,359.58,-12161.87
1381970081738273792,2020-05,0,1921.21,3820.22,784,1115.01,-11046.86
1381970081738273792,2020-06,2772.38,1216.83,0,0,1555.55,-9491.31
1381970081738273792,2020-07,0,1593.81,0,900.1,-2493.91,-11985.22
1381970081738273792,2020-08,1963.4,1824.05,2453.65,0,2593,-9392.22
1381970081738273792,2020-09,0,988.4,79.03,1979.76,-2889.13,-12281.35
1381970081738273792,2020-10,4122.93,1794.76,1643.18,26.51,3944.84,-8336.51
1381970081738273792,2020-11,1824.59,0,914.23,0,2738.82,-5597.69
1381970081738273792,2020-12,0,1228.22,0,261.78,-1490,-7087.69
1383634243798468864,2020-01,3190.86,3255.78,1972.33,0,1907.41,1907.41
1383634243798468864,2020-02,2445.49,844.45,4919.69,1339.78,5180.95,7088.36
1383634243798468864,2020-03,1546.54,3536.48,4341.35,4010.73,-1659.32,5429.04
1383634243798468864,2020-04,3391.71,0,1288.89,4354.65,325.95,5754.99
1383634243798468864,2020-05,1351.5,4187.63,3367.95,2358.12,-1826.3,3928.69
1383634243798468864,2020-06,1309.99,0,6067.19,2016.82,5360.36,9289.05
1383634243798468864,2020-07,3434.83,720.7,3347.48,1919.67,4141.94,13430.99
1383634243798468864,2020-08,3433.79,5201.83,3011.2,3657.68,-2414.52,11016.47
1383634243798468864,2020-09,2167.99,2718.23,6620,3825.94,2243.82,13260.29
1383634243798468864,2020-10,1883.41,3348.95,3144.68,5014.46,-3335.32,9924.97
1383634243798468864,2020-11,1202.26,2926.89,0,0,-1724.63,8200.34
1383634243798468864,2020-12,964.75,0,3304.38,725.31,3543.82,11744.16
1384202027359099904,2020-01,1543.04,978.97,0,3107.33,-2543.26,-2543.26
1384202027359099904,2020-02,3178.22,0,0,988.33,2189.89,-353.37
1384202027359099904,2020-03,1895.21,1980.62,0,361.35,-446.76,-800.13
1384202027359099904,2020-04,2403.18,0,3409.85,0,5813.03,5012.9
1384202027359099904,2020-05,0,1501.29,1415.9,896.2,-981.59,4031.31
1384202027359099904,2020-06,408.39,1978.3,412.24,0,-1157.67,2873.64
1384202027359099904,2020-07,2641.43,0,4508.15,655.91,6493.67,9367.31
1384202027359099904,2020-08,0,663.9,3945.79,3989.52,-707.63,8659.68
1384202027359099904,2020-09,1470.01,1358.65,37.94,0,149.3,8808.98
1384202027359099904,2020-10,1668.85,0,1765.69,2508.41,926.13,9735.11
1384202027359099904,2020-11,1155.57,0,0,1958.6,-803.03,8932.08
1384202027359099904,2020-12,0,603.07,301.58,1389.85,-1691.34,7240.74
1384219964981240576,2020-05,1950.84,0,1910.56,1079.35,2782.05,2782.05
1384219964981240576,2020-09,1900.51,0,0,0,1900.51,4682.56
1385081109348057344,2020-01,3090.52,3871.96,5355.97,2199.78,2374.75,2374.75
1385081109348057344,2020-02,4803.55,832.07,6568.02,5705.41,4834.09,7208.84
1385081109348057344,2020-03,6070.35,6778.37,4398.01,7819.07,-4129.08,3079.76
1385081109348057344,2020-04,2149.32,1851.29,4010.72,7262.47,-2953.72,126.04
1385081109348057344,2020-05,9491.23,4910.52,2947.23,3517.31,4010.63,4136.67
1385081109348057344,2020-06,1745.49,9088.86,4639.23,6205.62,-8909.76,-4773.09
1385081109348057344,2020-07,7012.93,8611.68,960.03,4851.22,-5489.94,-10263.03
1385081109348057344,2020-08,7995.91,3906.6,0,5348.31,-1259,-11522.03
1385081109348057344,2020-09,7657.04,0,6064.89,3998.16,9723.77,-1798.26
1385081109348057344,2020-10,2190.27,7252.58,4072.04,1353.74,-2344.01,-4142.27
1385081109348057344,2020-11,2158.48,7413.82,3710.2,5764.09,-7309.23,-11451.5
1385081109348057344,2020-12,3383.37,4752.69,4052.55,6437.44,-3754.21,-15205.71
1386077111489375488,2020-02,0,761.49,0,446.15,-1207.64,-1207.64
1386899931541515776,2020-01,0,1407.5,0,1322.98,-2730.48,-2730.48
1386899931541515776,2020-02,0,1355.83,0,2449.74,-3805.57,-6536.05
1386899931541515776,2020-03,158.71,0,0,0,158.71,-6377.34
1386899931541515776,2020-04,0,1805.93,0,0,-1805.93,-8183.27
1386899931541515776,2020-05,0,537.27,2282.67,0,1745.4,-6437.87
1386899931541515776,2020-06,946.27,0,1776.02,1968.76,753.53,-5684.34
1386899931541515776,2020-07,1870.83,2063.73,0,21.17,-214.07,-5898.41
1386899931541515776,2020-09,0,325.14,0,3172.12,-3497.26,-9395.67
1386899931541515776,2020-10,1076.74,665.33,1520.37,0,1931.78,-7463.89
1386899931541515776,2020-12,0,350.14,545.53,2239.87,-2044.48,-9508.37
1388635784925697280,2020-01,417.84,1624.73,0,1233.08,-2439.97,-2439.97
1388635784925697280,2020-02,1765.44,0,0,1905.64,-140.2,-2580.17
1388635784925697280,2020-03,622.2,0,0,0,622.2,-1957.97
1388635784925697280,2020-04,1619.46,0,1764.41,1983.56,1400.31,-557.66
1388635784925697280,2020-05,1899.05,0,1081.76,0,2980.81,2423.15
1388635784925697280,2020-06,2289.49,0,1483.75,819.06,2954.18,5377.33
1388635784925697280,2020-07,2598.81,1070.57,1844.98,548.77,2824.45,8201.78
1388635784925697280,2020-08,0,853.8,1262.57,3131.93,-2723.16,5478.62
1388635784925697280,2020-11,2516.43,0,965.02,1899.19,1582.26,7060.88
1388635784925697280,2020-12,1424.96,0,1269.13,1391.67,1302.42,8363.3
1389563431296665344,2020-01,549.69,1277.61,1169,2595.93,-2154.85,-2154.85
1389563431296665344,2020-02,1687.21,123.35,0,275.14,1288.72,-866.13
1389563431296665344,2020-03,1699.59,0,2559.05,1350.02,2908.62,2042.49
1389563431296665344,2020-05,1831.34,1917.5,0,1448.24,-1534.4,508.09
1389563431296665344,2020-06,27.29,0,0,0,27.29,535.38
1389563431296665344,2020-07,2265.73,0,3169.44,1804.69,3630.48,4165.86
1389563431296665344,2020-08,0,493.46,1392.12,2788.41,-1889.75,2276.11
1389563431296665344,2020-09,3133.36,1651.98,2033.65,0,3515.03,5791.14
1389563431296665344,2020-10,2135.76,1048.86,0,0,1086.9,6878.04
1389563431296665344,2020-11,468.35,0,0,885.99,-417.64,6460.4
1389563431296665344,2020-12,2128.49,0,0,1074.61,1053.88,7514.28
1389823488389597184,2020-01,3423.5,3834.7,4347.42,4374.11,-437.89,-437.89
1389823488389597184,2020-02,3576,1145.96,1174.22,0,3604.26,3166.37
1389823488389597184,2020-03,623.99,3496.7,4032.3,3977.54,-2817.95,348.42
1389823488389597184,2020-04,3761.94,2163.41,4474.69,5683.33,389.89,738.31
1389823488389597184,2020-05,7416.42,3790.51,5184,4045.92,4763.99,5502.3
1389823488389597184,2020-06,6734.87,2052.89,5227.61,3714.16,6195.43,11697.73
1389823488389597184,2020-07,4923.83,5378.52,2103.61,1692.18,-43.26,11654.47
1389823488389597184,2020-08,1921.73,3630.69,917.24,6186.52,-6978.24,4676.23
1389823488389597184,2020-09,7452.39,5535.08,1590.38,7252.13,-3744.44,931.79
1389823488389597184,2020-10,1493.4,4284.64,1546.71,5773.18,-7017.71,-6085.92
1389823488389597184,2020-11,2015.84,0,3990.25,4866.26,1139.83,-4946.09
1389823488389597184,2020-12,978.64,1370.15,4069.61,2873.76,804.34,-4141.75
1391317459874718976,2020-01,3010.52,437.26,404.62,1455.32,1522.56,1522.56
1391317459874718976,2020-02,2249.79,4308.16,4113.8,695.8,1359.63,2882.19
1391317459874718976,2020-03,8204.56,2679.39,2767.56,0,8292.73,11174.92
1391317459874718976,2020-04,2065.5,814.92,1365.62,1340.28,1275.92,12450.84
1391317459874718976,2020-05,1122.29,2098.09,944.37,1927.63,-1959.06,10491.78
1391317459874718976,2020-06,3392.19,4938.24,3470.52,2869.38,-944.91,9546.87
1391317459874718976,2020-07,2407.35,2216.28,5738.44,0,5929.51,15476.38
1391317459874718976,2020-08,4207.71,2061.42,3092.39,1967.49,3271.19,18747.57
1391317459874718976,2020-09,994.81,2740.68,1873.08,4264.41,-4137.2,14610.37
1391317459874718976,2020-10,1631.57,1348.9,4799.02,7850.06,-2768.37,11842
1391317459874718976,2020-11,3141.54,5767.92,6085.23,1907.74,1551.11,13393.11
1391317459874718976,2020-12,4534.53,4384.31,1616.95,2733.36,-966.19,12426.92
1391362718805854976,2020-01,2388.63,4795.11,3693.94,855.32,432.14,432.14
1391362718805854976,2020-02,5354.45,5706,6591.71,3850.19,2389.97,2822.11
1391362718805854976,2020-03,0,3394.68,3758.09,1643.13,-1279.72,1542.39
1391362718805854976,2020-04,8041.54,1877.64,5889.84,1568.34,10485.4,12027.79
1391362718805854976,2020-05,5775.45,1655.87,2803.18,3649.92,3272.84,15300.63
1391362718805854976,2020-06,1774.42,390.29,1104.51,4314.24,-1825.6,13475.03
1391362718805854976,2020-07,3819.62,3179.67,2537.24,2541.72,635.47,14110.5
1391362718805854976,2020-08,5990,3610.52,5871.2,243.34,8007.34,22117.84
1391362718805854976,2020-09,4534.85,1451.27,5046.15,128.48,8001.25,30119.09
1391362718805854976,2020-10,3340.44,2597.52,5047.95,2126.49,3664.38,33783.47
1391362718805854976,2020-11,3598.29,3589.44,1961.56,2184.79,-214.38,33569.09
1391362718805854976,2020-12,4104.97,3698.84,1022.01,4847.01,-3418.87,30150.22
1391758237203656448,2020-01,0,640.82,0,1044.59,-1685.41,-1685.41
1391758237203656448,2020-02,1408.1,435.39,669.99,564.27,1078.43,-606.98
1391758237203656448,2020-03,1094.01,5635.82,798.02,0,-3743.79,-4350.77
1391758237203656448,2020-04,2494.57,1884.46,0,947.54,-337.43,-4688.2
1391758237203656448,2020-05,1781.89,3397.4,3016.2,4710.97,-3310.28,-7998.48
1391758237203656448,2020-06,922.53,1912.72,947.49,3718.34,-3761.04,-11759.52
1391758237203656448,2020-07,3898.11,4321.52,1073.98,0,650.57,-11108.95
1391758237203656448,2020-08,2079.68,4275.6,2740.01,0,544.09,-10564.86
1391758237203656448,2020-09,13.25,5516.93,1673.89,4722.21,-8552,-19116.86
1391758237203656448,2020-10,1110.88,0,4757.02,3431.23,2436.67,-16680.19
1391758237203656448,2020-11,1418.73,0,0,2078.87,-660.14,-17340.33
1391758237203656448,2020-12,3183.53,0,0,3771.78,-588.25,-17928.58
1391983922362069504,2020-01,4294.67,2986.21,3644.06,7238.11,-2285.59,-2285.59
1391983922362069504,2020-02,5513,2213.45,3205.51,3841.71,2663.35,377.76
1391983922362069504,2020-03,7336.02,6010.43,4610.9,7171.08,-1234.59,-856.83
1391983922362069504,2020-04,4548.47,7623.93,2227.57,3135.26,-3983.15,-4839.98
1391983922362069504,2020-05,5433.69,10772.62,10066.77,2960.12,1767.72,-3072.26
1391983922362069504,2020-06,5671,1895.41,784.53,2686.21,1873.91,-1198.35
1391983922362069504,2020-07,2587.36,3893.64,6455.65,2382.73,2766.64,1568.29
1391983922362069504,2020-08,7314.37,3590.57,3618.06,5154.87,2186.99,3755.28
1391983922362069504,2020-09,3292.61,5739.39,2382.92,2538.73,-2602.59,1152.69
1391983922362069504,2020-10,2154.93,6005.71,0,4888,-8738.78,-7586.09
1391983922362069504,2020-11,582.22,1883.13,1877.2,3587.68,-3011.39,-10597.48
1391983922362069504,2020-12,7649.35,1285.99,6662.28,3891.79,9133.85,-1463.63
1393152531082305792,2020-01,0,720.35,1726.05,1467.12,-461.42,-461.42
1393152531082305792,2020-02,0,1607.06,1433.05,1057.98,-1231.99,-1693.41
1393152531082305792,2020-03,2854.9,1349.99,228.52,1634.57,98.86,-1594.55
1393152531082305792,2020-04,0,1292.22,1042.75,0,-249.47,-1844.02
1393152531082305792,2020-05,2346.62,1425.29,2637.87,2516.36,1042.84,-801.18
1393152531082305792,2020-06,1935.99,0,0,1306.39,629.6,-171.58
1393152531082305792,2020-07,2321.84,273.65,784.14,2920.88,-88.55,-260.13
1393152531082305792,2020-09,4346.9,3833.67,1070.51,0,1583.74,1323.61
1393152531082305792,2020-10,3302.45,3209.94,367.67,7215.68,-6755.5,-5431.89
1393152531082305792,2020-11,2516.96,304.06,1189.92,0,3402.82,-2029.07
1395532935996938496,2020-01,365.19,963.92,3422.08,1158.01,1665.34,1665.34
1395532935996938496,2020-02,933.84,2411.53,825.77,1831.15,-2483.07,-817.73
1395532935996938496,2020-03,3428.71,307.52,1591.27,1841.7,2870.76,2053.03
1395532935996938496,2020-04,1029.74,2010.88,0,618.29,-1599.43,453.6
1395532935996938496,2020-05,1351.68,340.85,0,0,1010.83,1464.43
1395532935996938496,2020-06,2089.58,213.15,0,3013.1,-1136.67,327.76
1395532935996938496,2020-07,1342.52,538.66,2809.53,477.72,3135.67,3463.43
1395532935996938496,2020-08,1580.27,1743.86,642.69,3506.08,-3026.98,436.45
1395532935996938496,2020-09,339.64,1412.69,1571.27,0,498.22,934.67
1395532935996938496,2020-10,1981.47,2039.47,0,0,-58,876.67
1395532935996938496,2020-12,1903.37,2359.48,0,197.18,-653.29,223.38
1396334580564904704,2020-01,0,1862.68,651.87,1581.12,-2791.93,-2791.93
1396334580564904704,2020-02,2840.39,1773.95,254.3,0,1320.74,-1471.19
1396334580564904704,2020-03,861.68,904.31,1115.14,2010.23,-937.72,-2408.91
1396334580564904704,2020-04,1895.99,0,1644.5,875.64,2664.85,255.94
1396334580564904704,2020-05,3294.6,4387.12,2305.31,3600.26,-2387.47,-2131.53
1396334580564904704,2020-06,877.75,1025.48,2453.42,186.72,2118.97,-12.56
1396334580564904704,2020-07,1456.02,1193.63,395.15,1354.86,-697.32,-709.88
1396334580564904704,2020-08,6826.97,1588.88,3588.75,3397.13,5429.71,4719.83
1396334580564904704,2020-09,5857.88,1960.7,1848.01,1712.35,4032.84,8752.67
1396334580564904704,2020-10,3368.66,797.87,2945.1,0,5515.89,14268.56
1396334580564904704,2020-11,1893.09,1073.77,1360.29,1984.43,195.18,14463.74
1396334580564904704,2020-12,1322.59,2943.27,4641.9,0,3021.22,17484.96
1397177479155428864,2020-01,776.52,6566.3,358.38,0,-5431.4,-5431.4
1397177479155428864,2020-02,1100.24,1662.34,216.26,4117.42,-4463.26,-9894.66
1397177479155428864,2020-03,1246.13,1872.15,1144.04,1996.76,-1478.74,-11373.4
1397177479155428864,2020-04,473.77,3069.8,1364.22,1044.25,-2276.06,-13649.46
1397177479155428864,2020-05,1337.34,931.14,1308.08,597.21,1117.07,-12532.39
1397177479155428864,2020-06,1638.96,1689.94,0,695.88,-746.86,-13279.25
1397177479155428864,2020-07,1302.97,2750.39,77.5,3384.69,-4754.61,-18033.86
1397177479155428864,2020-08,0,1200.39,2389.09,4528.97,-3340.27,-21374.13
1397177479155428864,2020-09,3042.62,652.54,0,283.59,2106.49,-19267.64
1397177479155428864,2020-10,700.42,5740.74,0,660.64,-5700.96,-24968.6
1397177479155428864,2020-11,3832.99,2753.29,4225.52,4376.17,929.05,-24039.55
1397177479155428864,2020-12,575.17,3306.73,0,4102.32,-6833.88,-30873.43
1398683693131074048,2020-01,2380.55,2177.67,0,1358.63,-1155.75,-1155.75
1398683693131074048,2020-02,2972.49,989.72,2672.46,2244.31,2410.92,1255.17
1398683693131074048,2020-03,3746.21,5472.58,1801.48,6318.54,-6243.43,-4988.26
1398683693131074048,2020-04,1504.01,5161.06,7325.7,177.26,3491.39,-1496.87
1398683693131074048,2020-05,4331.98,3633.25,2038.71,3087.24,-349.8,-1846.67
1398683693131074048,2020-06,3143.98,1678.06,606.69,3070.75,-998.14,-2844.81
1398683693131074048,2020-07,1667.56,3741.42,3844.86,917.94,853.06,-1991.75
1398683693131074048,2020-08,3595.12,663.85,4466.93,1631.41,5766.79,3775.04
1398683693131074048,2020-09,3589.95,3166.19,0,2432.65,-2008.89,1766.15
1398683693131074048,2020-10,1734.57,977.02,2285.15,1679.45,1363.25,3129.4
1398683693131074048,2020-11,1578.46,1802.64,4181.45,1298.26,2659.01,5788.41
1398683693131074048,2020-12,3997.96,3000.17,1764.34,4543.85,-1781.72,4006.69
1398795355506447104,2020-01,3720.43,3470.81,1184.52,2259.14,-825,-825
1398795355506447104,2020-02,982.58,951.78,1714.88,3495.65,-1749.97,-2574.97
1398795355506447104,2020-03,779.45,144.73,4036.7,1658.78,3012.64,437.67
1398795355506447104,2020-04,4470.69,1234.98,4788.22,1630.35,6393.58,6831.25
1398795355506447104,2020-05,666.27,3060.52,0,1452.67,-3846.92,2984.33
1398795355506447104,2020-06,4121.51,2719.33,148.78,2833.56,-1282.6,1701.73
1398795355506447104,2020-07,3690.82,630.77,1760.73,1338.86,3481.92,5183.65
1398795355506447104,2020-08,1591.14,5539.94,1734.74,2312.54,-4526.6,657.05
1398795355506447104,2020-09,1769.92,1637.16,1968.99,1255.7,846.05,1503.1
1398795355506447104,2020-10,3720.77,0,2001.18,5118.53,603.42,2106.52
1398795355506447104,2020-11,965.83,4541.57,5238.26,3196.87,-1534.35,572.17
1398795355506447104,2020-12,2773.64,755.44,1224.31,1695.3,1547.21,2119.38
1399484328192764160,2020-01,10987.68,5754.73,5198.05,3363.4,7067.6,7067.6
1399484328192764160,2020-02,2926.36,2579.69,8713.02,4571.86,4487.83,11555.43
1399484328192764160,2020-03,7755.39,6299.3,3158.47,4279.67,334.89,11890.32
1399484328192764160,2020-04,9505.25,3496.07,1395.21,5354.55,2049.84,13940.16
1399484328192764160,2020-05,2975.22,6682.99,3152.73,5902.47,-6457.51,7482.65
1399484328192764160,2020-06,8113.92,1851.42,4112.24,3010.7,7364.04,14846.69
1399484328192764160,2020-07,3377.34,3451.97,5538.54,5743.18,-279.27,14567.42
1399484328192764160,2020-08,1533.74,7256.39,3440.59,2497.11,-4779.17,9788.25
1399484328192764160,2020-09,1674.58,2496.64,3317.92,2375.29,120.57,9908.82
1399484328192764160,2020-10,4577.24,5495.4,3148.17,4665.49,-2435.48,7473.34
1399484328192764160,2020-11,2207.53,5879.94,1979.81,3736.18,-5428.78,2044.56
1399484328192764160,2020-12,2324.2,5922.7,4154.98,8223.46,-7666.98,-5622.42
1399539637953662464,2020-01,2139.18,1685.77,1864.96,2518.39,-200.02,-200.02
1399539637953662464,2020-02,1613.58,4687.76,3666.36,592.61,-0.43,-200.45
1399539637953662464,2020-03,2875.26,4859.99,5954.43,802.14,3167.56,2967.11
1399539637953662464,2020-04,516.73,3164.08,2505.31,136.86,-278.9,2688.21
1399539637953662464,2020-05,121.61,1536.32,1495.53,45.7,35.12,2723.33
1399539637953662464,2020-06,2127.63,3163.37,1879.29,1784.15,-940.6,1782.73
1399539637953662464,2020-07,504.15,167.56,2685.78,2532.96,489.41,2272.14
1399539637953662464,2020-08,644.35,2223.46,79.81,2523.9,-4023.2,-1751.06
1399539637953662464,2020-09,113.5,1658.03,48.18,3739.99,-5236.34,-6987.4
1399539637953662464,2020-10,2915.79,1273.52,3640.47,2789.66,2493.08,-4494.32
1399539637953662464,2020-11,3423.84,0,0,2399.2,1024.64,-3469.68
1399539637953662464,2020-12,2581.28,417.94,3446.56,1770.62,3839.28,369.6
1399590869447784704,2020-01,0,114.69,1585.53,0,1470.84,1470.84
1399590869447784704,2020-02,2534.92,2145.47,3422.61,2322.49,1489.57,2960.41
1399590869447784704,2020-03,4979.97,715.56,3998.38,9569.94,-1307.15,1653.26
1399590869447784704,2020-04,2323.14,2687.04,0,0,-363.9,1289.36
1399590869447784704,2020-05,1426.76,1356.1,1024.02,4000.27,-2905.59,-1616.23
1399590869447784704,2020-06,5138.03,281.84,0,1961.12,2895.07,1278.84
1399590869447784704,2020-07,0,2020.61,325.11,1826.94,-3522.44,-2243.6
1399590869447784704,2020-08,2454.73,3622.54,43.69,0,-1124.12,-3367.72
1399590869447784704,2020-09,5132.71,3441.17,2805.11,3877.2,619.45,-2748.27
1399590869447784704,2020-10,4573.04,0,2246.11,4558.52,2260.63,-487.64
1399590869447784704,2020-11,689.14,3845.39,1309.01,3226.02,-5073.26,-5560.9
1399590869447784704,2020-12,3469.85,695.02,2106.15,3781.82,1099.16,-4461.74
1401584755745057792,2020-01,2339.27,4869.6,182.48,3520.61,-5868.46,-5868.46
1401584755745057792,2020-02,3420.58,4234.85,3334.92,0,2520.65,-3347.81
1401584755745057792,2020-03,0,1056.87,2627.37,1581.91,-11.41,-3359.22
1401584755745057792,2020-04,5081.29,3711.87,3772.6,7586.29,-2444.27,-5803.49
1401584755745057792,2020-05,2392.18,1556.8,411.3,0,1246.68,-4556.81
1401584755745057792,2020-06,4890.57,2706.4,2900.32,1377.68,3706.81,-850
1401584755745057792,2020-07,2020.19,3233.55,6466.38,1128.82,4124.2,3274.2
1401584755745057792,2020-08,1659.61,2162.04,7706.52,4363.53,2840.56,6114.76
1401584755745057792,2020-09,6920.78,3930.91,1880.89,644.28,4226.48,10341.24
1401584755745057792,2020-10,1231.56,8416.3,5643,3922.55,-5464.29,4876.95
1401584755745057792,2020-11,0,1639.09,2884.61,3085.21,-1839.69,3037.26
1401584755745057792,2020-12,1035.35,4516.6,9075.35,8649.07,-3054.97,-17.71
1401667317776158976,2020-01,4818.19,5108.29,4573.41,0,4283.31,4283.31
1401667317776158976,2020-02,740.3,1301.9,8814.77,8553.94,-300.77,3982.54
1401667317776158976,2020-03,9064.13,2115.96,5497.05,3987.57,8457.65,12440.19
1401667317776158976,2020-04,6135.4,3528.5,1699.21,5486.35,-1180.24,11259.95
1401667317776158976,2020-05,320.34,7472.65,7631.77,9535.39,-9055.93,2204.02
1401667317776158976,2020-06,7344.5,2326.5,5615.88,802.13,9831.75,12035.77
1401667317776158976,2020-07,11761.23,2204.82,6571.5,6633.27,9494.64,21530.41
1401667317776158976,2020-08,3338.41,5056.15,3472.15,6615.51,-4861.1,16669.31
1401667317776158976,2020-09,2838.49,3631.9,0,3600.13,-4393.54,12275.77
1401667317776158976,2020-10,6586.88,2992.73,5201.42,3578.58,5216.99,17492.76
1401667317776158976,2020-11,8235.59,2640.73,8284.25,2554.77,11324.34,28817.1
1401667317776158976,2020-12,3835,484.49,2238.66,4528.7,1060.47,29877.57
1401994282835416576,2020-01,0,1725.14,0,1445.93,-3171.07,-3171.07
1401994282835416576,2020-02,2995.61,3479.01,1211.07,0,727.67,-2443.4
1401994282835416576,2020-03,0,1624.41,3648.53,1900.68,123.44,-2319.96
1401994282835416576,2020-04,3129.67,932.37,2098.11,926.14,3369.27,1049.31
1401994282835416576,2020-05,3709.72,1788.14,0,2325.41,-403.83,645.48
1401994282835416576,2020-06,4477.38,0,1572.16,126.76,5922.78,6568.26
1401994282835416576,2020-07,3250.8,3390.99,2359.12,2610.86,-391.93,6176.33
1401994282835416576,2020-08,3048.1,3426.95,1880.31,665.48,835.98,7012.31
1401994282835416576,2020-09,6544.78,1541.05,831.17,1821.17,4013.73,11026.04
1401994282835416576,2020-10,2303.18,2898.25,1842.49,2290.98,-1043.56,9982.48
1401994282835416576,2020-11,1330.82,4643.57,4603.21,1398.48,-108.02,9874.46
1401994282835416576,2020-12,4348.28,0,171.2,5119.43,-599.95,9274.51
1402303096017294080,2020-01,5172.51,5640.51,5791.35,3740.54,1582.81,1582.81
1402303096017294080,2020-02,5087.78,8309.02,4988.76,2046.34,-278.82,1303.99
1402303096017294080,2020-03,1355.71,3107.5,2448.23,2598.41,-1901.97,-597.98
1402303096017294080,2020-04,4241.83,5569.09,2547.19,3196.9,-1976.97,-2574.95
1402303096017294080,2020-05,0,4950.92,1457.08,4046.34,-7540.18,-10115.13
1402303096017294080,2020-06,0,3676.83,3977.89,2053,-1751.94,-11867.07
1402303096017294080,2020-07,4180.13,3872.21,1683.21,5725.64,-3734.51,-15601.58
1402303096017294080,2020-08,2342.18,2106.55,5009.08,1943.77,3300.94,-12300.64
1402303096017294080,2020-09,1585.22,6241.66,1154.94,4795.61,-8297.11,-20597.75
1402303096017294080,2020-10,3491.94,1334.28,2026.01,4347.39,-163.72,-20761.47
1402303096017294080,2020-11,2277.42,3866.48,5950.29,7435.82,-3074.59,-23836.06
1402303096017294080,2020-12,5387.63,1034.37,7348.25,8239.71,3461.8,-20374.26
1403571591123570688,2020-01,7004.24,1093.92,3927.43,3500.38,6337.37,6337.37
1403571591123570688,2020-02,4165.82,5532.24,4270.59,2838.37,65.8,6403.17
1403571591123570688,2020-03,989.27,1916.08,3852.51,5653.41,-2727.71,3675.46
1403571591123570688,2020-04,2331.2,3047.72,1973.41,3031.41,-1774.52,1900.94
1403571591123570688,2020-05,4097.03,1909.34,5536.04,3962.95,3760.78,5661.72
1403571591123570688,2020-06,4936.29,7992.91,7153.42,3270.69,826.11,6487.83
1403571591123570688,2020-07,4195.94,3532.69,2940.21,4015.48,-412.02,6075.81
1403571591123570688,2020-08,3879.62,3127.98,4262.53,6235.33,-1221.16,4854.65
1403571591123570688,2020-09,2936.67,6693.77,4811.16,0,1054.06,5908.71
1403571591123570688,2020-10,4400.65,2736.41,4915.79,5922.53,657.5,6566.21
1403571591123570688,2020-11,837.13,2865.73,4477.75,3604.22,-1155.07,5411.14
1403571591123570688,2020-12,5337.03,13849.88,1498.34,1751.23,-8765.74,-3354.6
1404296739460182272,2020-01,135.74,1116.29,5470.63,6921,-2430.92,-2430.92
1404296739460182272,2020-02,2779.8,4947.06,10021.13,9943.57,-2089.7,-4520.62
1404296739460182272,2020-03,10393.96,4228.97,4274.51,3193.18,7246.32,2725.7
1404296739460182272,2020-04,2712.02,3134.95,5164.2,312.39,4428.88,7154.58
1404296739460182272,2020-05,8514.39,6125.98,1498.72,7253.24,-3366.11,3788.47
1404296739460182272,2020-06,3661.04,4465.47,1530.14,4931.15,-4205.44,-416.97
1404296739460182272,2020-07,7293.68,4168.21,4184.33,8178.32,-868.52,-1285.49
1404296739460182272,2020-08,4908.77,1830.3,4431.94,4110.37,3400.04,2114.55
1404296739460182272,2020-09,1742.6,2306.86,1235.52,5400.54,-4729.28,-2614.73
1404296739460182272,2020-10,842.54,3762.88,7026.69,4832.71,-726.36,-3341.09
1404296739460182272,2020-11,5379.09,7854.37,5532.08,3036.1,20.7,-3320.39
1404296739460182272,2020-12,3076.37,451.18,3089.81,4897.04,817.96,-2502.43
1404786862524718592,2020-01,8371.08,4541.25,4175.91,2772.67,5233.07,5233.07
1404786862524718592,2020-02,7779.93,128.26,6163.92,3536.81,10278.78,15511.85
1404786862524718592,2020-03,476.97,2140.72,4751.16,4452.59,-1365.18,14146.67
1404786862524718592,2020-04,1595.41,3995.86,3434.73,7839.08,-6804.8,7341.87
1404786862524718592,2020-05,7216.47,4738.17,5595.17,3928.89,4144.58,11486.45
1404786862524718592,2020-06,4552.28,5161.19,6607.93,4066.57,1932.45,13418.9
1404786862524718592,2020-07,13450.95,7204.93,1846.05,4412.56,3679.51,17098.41
1404786862524718592,2020-08,9097.85,6895.96,1264.45,4858.49,-1392.15,15706.26
1404786862524718592,2020-09,1365.66,2644.29,3626.62,4793.99,-2446,13260.26
1404786862524718592,2020-10,54.27,4557.59,3006.59,9269.3,-10766.03,2494.23
1404786862524718592,2020-11,2471.21,6790.29,2983.88,7901.53,-9236.73,-6742.5
1404786862524718592,2020-12,1820.05,2462.09,5321.3,77.5,4601.76,-2140.74
1405027679368980992,2020-01,3270.32,7317.37,4560.12,4428.64,-3915.57,-3915.57
1405027679368980992,2020-02,2310.36,2041.92,1297.39,5765,-4199.17,-8114.74
1405027679368980992,2020-03,1430.85,1341.82,784.31,1667.44,-794.1,-8908.84
1405027679368980992,2020-04,6658.1,1819.07,4337.85,1789.2,7387.68,-1521.16
1405027679368980992,2020-05,9011.72,2733.2,3039.29,5885.34,3432.47,1911.31
1405027679368980992,2020-06,5701.45,4798.28,4052.94,2615.64,2340.47,4251.78
1405027679368980992,2020-07,1854.82,4970.32,2638.68,3293.12,-3769.94,481.84
1405027679368980992,2020-08,5361.79,4630.29,1447.63,228.61,1950.52,2432.36
1405027679368980992,2020-09,3480.53,6756,978.36,340.67,-2637.78,-205.42
1405027679368980992,2020-10,10593.17,1710.07,0,2428.61,6454.49,6249.07
1405027679368980992,2020-11,9343.54,1450.15,6000.33,1879.71,12014.01,18263.08
1405027679368980992,2020-12,2590.68,1697.22,4201.47,1847.58,3247.35,21510.43
1406040507782190848,2020-01,2878.27,3237.81,4101.96,6447.4,-2704.98,-2704.98
1406040507782190848,2020-02,5366.77,7123.2,857.01,2805.86,-3705.28,-6410.26
1406040507782190848,2020-03,3299.06,8744.7,792.25,5106.46,-9759.85,-16170.11
1406040507782190848,2020-04,2965.12,2543.35,6741.39,6391.86,771.3,-15398.81
1406040507782190848,2020-05,2623.74,949.97,5092.43,8021.51,-1255.31,-16654.12
1406040507782190848,2020-06,8394.34,2793.99,2325.74,1050.05,6876.04,-9778.08
1406040507782190848,2020-07,3098.71,6015.78,2458.34,3842.14,-4300.87,-14078.95
1406040507782190848,2020-08,3354.68,5214.64,2788.07,3418.62,-2490.51,-16569.46
1406040507782190848,2020-09,6790.91,3296.54,1704.15,3751.63,1446.89,-15122.57
1406040507782190848,2020-10,1601.27,3555.77,2221.88,4822.72,-4555.34,-19677.91
1406040507782190848,2020-11,5934.93,0,2786.79,4748.86,3972.86,-15705.05
1406040507782190848,2020-12,2958,8522.92,2487.77,4955.58,-8032.73,-23737.78
1406172294229111296,2020-01,0,232.91,0,3588.92,-3821.83,-3821.83
1406172294229111296,2020-02,1405.94,0,1226.01,478.89,2153.06,-1668.77
1406172294229111296,2020-03,1535.51,1859.7,6412.02,1300.64,4787.19,3118.42
1406172294229111296,2020-05,1725.17,2309.5,1494.97,3532.41,-2621.77,496.65
1406172294229111296,2020-06,131.7,3756.2,2810.54,212.8,-1026.76,-530.11
1406172294229111296,2020-07,4987.9,1563.79,1720.65,207.02,4937.74,4407.63
1406172294229111296,2020-08,589.81,2439.38,891.72,1573.25,-2531.1,1876.53
1406172294229111296,2020-09,1635.86,496.57,0,1835.87,-696.58,1179.95
1406172294229111296,2020-10,2990.64,4076.46,0,1673.64,-2759.46,-1579.51
1406172294229111296,2020-11,1667.44,540.1,2278.6,2767.34,638.6,-940.91
1406172294229111296,2020-12,936.78,3834.53,3623.52,795.53,-69.76,-1010.67
1410599324640218368,2020-01,1208.32,3529.04,8681.25,2865.82,3494.71,3494.71
1410599324640218368,2020-02,8022.25,9266.26,3009.1,202.2,1562.89,5057.6
1410599324640218368,2020-03,2183.58,1576.45,8196.77,5379.78,3424.12,8481.72
1410599324640218368,2020-04,5190.61,4525.54,6344.87,3974.25,3035.69,11517.41
1410599324640218368,2020-05,6117.98,2553.07,6537.38,7240.2,2862.09,14379.5
1410599324640218368,2020-06,9265.73,3972.91,5609.85,9276.01,1626.66,16006.16
1410599324640218368,2020-07,1992.86,3137.58,8769.29,3190.65,4433.92,20440.08
1410599324640218368,2020-08,1649.45,102.04,8355.35,7848.82,2053.94,22494.02
1410599324640218368,2020-09,8410.1,5526.06,1849.22,5260.84,-527.58,21966.44
1410599324640218368,2020-10,1863.26,2612.61,2174.27,5137.44,-3712.52,18253.92
1410599324640218368,2020-11,1641.25,0,5686.38,2069.41,5258.22,23512.14
1410599324640218368,2020-12,4085.66,9026.77,3609.92,2601.71,-3932.9,19579.24
1410738303977820160,2020-01,0,1409.15,1299.16,2165.51,-2275.5,-2275.5
1410738303977820160,2020-02,1100.66,8967.27,1133.54,2662.68,-9395.75,-11671.25
1410738303977820160,2020-03,2982.3,2426.55,4550.88,4136.75,969.88,-10701.37
1410738303977820160,2020-04,2230.66,1191.21,572.85,852.53,759.77,-9941.6
1410738303977820160,2020-05,1044.64,4071.41,3712.41,2178.58,-1492.94,-11434.54
1410738303977820160,2020-06,1551.2,1286.24,4847.65,2920.69,2191.92,-9242.62
1410738303977820160,2020-07,1035.76,1959.33,2360.89,3827.29,-2389.97,-11632.59
1410738303977820160,2020-08,1944.7,2341.86,0,0,-397.16,-12029.75
1410738303977820160,2020-09,3349.32,3270.82,0,0,78.5,-11951.25
1410738303977820160,2020-10,2660.46,3879.44,5793.23,207.02,4367.23,-7584.02
1410738303977820160,2020-11,1171.97,3903.53,0,0,-2731.56,-10315.58
1410738303977820160,2020-12,2058.41,4975.33,0,3855.11,-6772.03,-17087.61
1411429076410695168,2020-01,375.97,6688.09,5469.66,2117.98,-2960.44,-2960.44
1411429076410695168,2020-02,3076.24,5416.78,3852.85,4116.34,-2604.03,-5564.47
1411429076410695168,2020-03,6014.98,8710.21,5995.08,4819.66,-1519.81,-7084.28
1411429076410695168,2020-04,5153.03,4148.62,7999.73,4282.79,4721.35,-2362.93
1411429076410695168,2020-05,4913.64,6134.5,4229.09,3099.22,-90.99,-2453.92
1411429076410695168,2020-06,8664.36,4782.66,1021.93,3537.05,1366.58,-1087.34
1411429076410695168,2020-07,1641.77,1585.03,0,4595.24,-4538.5,-5625.84
1411429076410695168,2020-08,3447.01,4018.28,9119.29,3991.94,4556.08,-1069.76
1411429076410695168,2020-09,4444.36,4566.26,4903.83,6712.68,-1930.75,-3000.51
1411429076410695168,2020-10,8672.96,1037.1,4022.26,2215.98,9442.14,6441.63
1411429076410695168,2020-11,5364.05,4738.18,4341.51,0,4967.38,11409.01
1411429076410695168,2020-12,6508.56,854.58,802.03,1550.65,4905.36,16314.37
1411443745236337152,2020-01,54.26,4280.44,5095.57,5230.94,-4361.55,-4361.55
1411443745236337152,2020-02,0,1726.87,1646.08,4195.15,-4275.94,-8637.49
1411443745236337152,2020-03,2401.2,261.96,3963.01,1593.61,4508.64,-4128.85
1411443745236337152,2020-04,1724.94,1991.09,5865.08,1606.78,3992.15,-136.7
1411443745236337152,2020-05,3529.56,0,0,5998.62,-2469.06,-2605.76
1411443745236337152,2020-06,3258.78,1082.64,693.01,3999.15,-1130,-3735.76
1411443745236337152,2020-07,3478.61,4609.87,1579.71,3133.24,-2684.79,-6420.55
1411443745236337152,2020-08,0,4275.1,3193.65,4687.89,-5769.34,-12189.89
1411443745236337152,2020-09,0,3167.25,3713.57,1489.64,-943.32,-13133.21
1411443745236337152,2020-10,2470.5,1873.31,3609.73,883.09,3323.83,-9809.38
1411443745236337152,2020-11,1161.87,5156.84,6303.22,1892.87,415.38,-9394
1411443745236337152,2020-12,4972.43,708.18,4918.63,1716.63,7466.25,-1927.75
1411541802555112192,2020-01,2601.32,1157.26,2921.78,1812.67,2553.17,2553.17
1411541802555112192,2020-02,1148.51,1963.8,1982.66,1706.44,-539.07,2014.1
1411541802555112192,2020-03,4466.63,4201.96,1219.79,603.14,881.32,2895.42
1411541802555112192,2020-04,1266.55,1294.74,4713.31,1411.97,3273.15,6168.57
1411541802555112192,2020-05,1186.89,1144.78,479.71,3145.81,-2623.99,3544.58
1411541802555112192,2020-06,0,3051.89,7597.22,2438.15,2107.18,5651.76
1411541802555112192,2020-07,3289.38,0,1864.2,3963.72,1189.86,6841.62
1411541802555112192,2020-08,2504.14,2542.18,1467.64,4082.32,-2652.72,4188.9
1411541802555112192,2020-09,0,455.02,0,0,-455.02,3733.88
1411541802555112192,2020-10,649.94,0,1792.02,1961.1,480.86,4214.74
1411541802555112192,2020-11,413.44,1451.15,1354.9,2571.53,-2254.34,1960.4
1411541802555112192,2020-12,5983.93,656.17,3861.89,4846.08,4343.57,6303.97
1412620033190532352,2020-01,5027.39,7229.32,2540.84,4851.41,-4512.5,-4512.5
1412620033190532352,2020-02,4626.36,4270.74,4543.35,6494.75,-1595.78,-6108.28
1412620033190532352,2020-03,5580.51,5509.2,2959.47,7115.31,-4084.53,-10192.81
1412620033190532352,2020-04,6884.71,2625.51,5348.05,1654.13,7953.12,-2239.69
1412620033190532352,2020-05,1953.89,3803.96,5217.58,4798.59,-1431.08,-3670.77
1412620033190532352,2020-06,1984.72,6217.67,4430.17,5092.07,-4894.85,-8565.62
1412620033190532352,2020-07,5032.69,3214.57,1809.09,4233.06,-605.85,-9171.47
1412620033190532352,2020-08,3991.45,8098.05,2880,5746.26,-6972.86,-16144.33
1412620033190532352,2020-09,5302.14,4092.63,3820.25,1597.46,3432.3,-12712.03
1412620033190532352,2020-10,4206.84,0,4323.88,4632.58,3898.14,-8813.89
1412620033190532352,2020-11,6290.19,3809.22,2704.82,0,5185.79,-3628.1
1412620033190532352,2020-12,1374.1,5986.81,3355.72,2112.54,-3369.53,-6997.63
1413750164460007936,2020-01,5574.51,2764.86,0,3059.98,-250.33,-250.33
1413750164460007936,2020-02,1576.59,3326.06,0,1950.19,-3699.66,-3949.99
1413750164460007936,2020-03,636.2,3624.49,2988.1,4463.86,-4464.05,-8414.04
1413750164460007936,2020-04,72.89,3172.17,6345.98,2644.96,601.74,-7812.3
1413750164460007936,2020-05,2034.46,3286.75,2810.26,1406.67,151.3,-7661
1413750164460007936,2020-06,3198.84,1729.86,3867.29,862.24,4474.03,-3186.97
1413750164460007936,2020-07,0,3228.75,1529.26,1868.75,-3568.24,-6755.21
1413750164460007936,2020-08,7011.92,0,3172.21,5597.66,4586.47,-2168.74
1413750164460007936,2020-09,3542.58,2904.49,2012.16,901.88,1748.37,-420.37
1413750164460007936,2020-10,183.38,7232.99,876.32,0,-6173.29,-6593.66
1413750164460007936,2020-11,0,1871.47,457.47,3685.79,-5099.79,-11693.45
1413750164460007936,2020-12,4080.29,6052.61,1773.16,1384.72,-1583.88,-13277.33
1415121686008316416,2020-01,1430.61,8245.41,7515.89,4618.06,-3916.97,-3916.97
1415121686008316416,2020-02,4674.85,2926.33,4546.71,3396.29,2898.94,-1018.03
1415121686008316416,2020-03,2192.7,4574.97,2167.35,5843.33,-6058.25,-7076.28
1415121686008316416,2020-04,6241.94,3057.83,7907.28,3672.63,7418.76,342.48
1415121686008316416,2020-05,5912.16,1078.51,1947.16,6127.45,653.36,995.84
1415121686008316416,2020-06,3793.11,1704.49,3824.72,2339.01,3574.33,4570.17
1415121686008316416,2020-07,3828.33,4940.42,6496.17,8717.81,-3333.73,1236.44
1415121686008316416,2020-08,9882.85,5432.15,7687.94,4141.22,7997.42,9233.86
1415121686008316416,2020-09,2286.33,4561.9,10088.15,1861.88,5950.7,15184.56
1415121686008316416,2020-10,6165.11,3270.85,3174.02,6990.99,-922.71,14261.85
1415121686008316416,2020-11,4676.76,4256.86,2462.62,1128.93,1753.59,16015.44
1415121686008316416,2020-12,5135.5,826.83,4373.72,5843.44,2838.95,18854.39
1415848802015030016,2020-01,34.14,2848.53,1000.59,3486.58,-5300.38,-5300.38
1415848802015030016,2020-02,1832.96,3982.95,0,3956.82,-6106.81,-11407.19
1415848802015030016,2020-03,4566.52,1807.61,192.16,3373.97,-422.9,-11830.09
1415848802015030016,2020-04,1263.19,1908.07,2643.97,3257.8,-1258.71,-13088.8
1415848802015030016,2020-05,3661.1,3508.48,5801.21,1275,4678.83,-8409.97
1415848802015030016,2020-06,2082.47,4212.11,782.68,848.02,-2194.98,-10604.95
1415848802015030016,2020-07,6781.34,5147.95,2763.05,3784,612.44,-9992.51
1415848802015030016,2020-08,1446.23,3492.41,3620.11,754.62,819.31,-9173.2
1415848802015030016,2020-09,0,3046.64,0,3032.84,-6079.48,-15252.68
1415848802015030016,2020-11,2783.33,3389.94,1992.42,4161.11,-2775.3,-18027.98
1415848802015030016,2020-12,6430.2,0,5038.46,3021.29,8447.37,-9580.61
1416322820614377728,2020-01,434.93,0,920.74,0,1355.67,1355.67
1416322820614377728,2020-02,678.21,0,0,1734.87,-1056.66,299.01
1416322820614377728,2020-03,1705.2,0,3299.99,1954.1,3051.09,3350.1
1416322820614377728,2020-04,1601.59,0,0,1848.09,-246.5,3103.6
1416322820614377728,2020-05,2664.76,2125.75,1914.3,504.9,1948.41,5052.01
1416322820614377728,2020-06,0,1824,0,0,-1824,3228.01
1416322820614377728,2020-07,702.06,0,3155.44,0,3857.5,7085.51
1416322820614377728,2020-08,3872.33,994.65,0,0,2877.68,9963.19
1416322820614377728,2020-10,535.66,420.21,337.11,1213.14,-760.58,9202.61
1416322820614377728,2020-12,1306.44,0,0,1092.28,214.16,9416.77
1416443814225121024,2020-01,4589.08,6659.11,3839.89,1263.33,506.53,506.53
1416443814225121024,2020-02,3442.63,54.55,3163.81,3319.23,3232.66,3739.19
1416443814225121024,2020-03,1379.5,3636.97,6092,4695.95,-861.42,2877.77
1416443814225121024,2020-04,1249.03,3466.07,5225.9,4821.4,-1812.54,1065.23
1416443814225121024,2020-05,0,8430.38,4980.2,4631.61,-8081.79,-7016.56
1416443814225121024,2020-06,0,2605.17,2666.86,2215.59,-2153.9,-9170.46
1416443814225121024,2020-07,1896.72,3648.17,5194.81,2353.8,1089.56,-8080.9
1416443814225121024,2020-08,1092.58,2259.99,4026.5,831.35,2027.74,-6053.16
1416443814225121024,2020-09,5748.36,1694.23,2639.9,417.11,6276.92,223.76
1416443814225121024,2020-10,950.83,10658.59,2061.25,2438.61,-10085.12,-9861.36
1416443814225121024,2020-11,3550.6,2437.59,3558.82,1603.19,3068.64,-6792.72
1416443814225121024,2020-12,631.68,5336.05,2493.04,1848.06,-4059.39,-10852.11
1417307719091127040,2020-09,0,226.4,0,0,-226.4,-226.4
1417307719091127040,2020-10,0,826.73,0,903.06,-1729.79,-1956.19
1417307719091127040,2020-11,393.91,0,0,0,393.91,-1562.28
1418422147970056960,2020-01,636.97,4432.77,2672.72,343.96,-1467.04,-1467.04
1418422147970056960,2020-02,5927.44,10136.43,4680.81,6608.55,-6136.73,-7603.77
1418422147970056960,2020-03,4576.2,3057.7,7326.12,1669.1,7175.52,-428.25
1418422147970056960,2020-04,2409.03,3502.52,3908.58,1721.13,1093.96,665.71
1418422147970056960,2020-05,1343.22,4368.26,499.31,3292.62,-5818.35,-5152.64
1418422147970056960,2020-06,0,1547.39,3753.11,7416.79,-5211.07,-10363.71
1418422147970056960,2020-07,5069.46,812.07,3296.26,3839.25,3714.4,-6649.31
1418422147970056960,2020-08,5020.62,7943.17,8381.17,2783.07,2675.55,-3973.76
1418422147970056960,2020-09,6506.42,7009.15,466.63,3095.32,-3131.42,-7105.18
1418422147970056960,2020-10,2481.22,8807.86,8344.12,3444.21,-1426.73,-8531.91
1418422147970056960,2020-11,6525.62,3529.78,4684.75,2194.02,5486.57,-3045.34
1418422147970056960,2020-12,7406.89,2109.26,4891.93,4135.21,6054.35,3009.01
1419999787247943680,2020-01,8451.68,7104.27,12048.64,6436.26,6959.79,6959.79
1419999787247943680,2020-02,6196.84,4616.35,7146.24,8039.4,687.33,7647.12
1419999787247943680,2020-03,4433.62,7621.89,9575.91,5105.36,1282.28,8929.4
1419999787247943680,2020-04,3884.8,4385.72,6626.2,2673.93,3451.35,12380.75
1419999787247943680,2020-05,6626.03,4188.55,6449.75,5785.41,3101.82,15482.57
1419999787247943680,2020-06,469.72,6472.53,6141.99,1527.59,-1388.41,14094.16
1419999787247943680,2020-07,6666.03,2653.26,5304.98,6860.81,2456.94,16551.1
1419999787247943680,2020-08,7984.52,5539.35,1477.9,5091.44,-1168.37,15382.73
1419999787247943680,2020-09,5442.7,1860.12,4751.46,3327.28,5006.76,20389.49
1419999787247943680,2020-10,3440.6,5411.8,9585.35,2815.7,4798.45,25187.94
1419999787247943680,2020-11,8031.83,2470.07,2207.48,5259.69,2509.55,27697.49
1419999787247943680,2020-12,1884.42,4379.78,712.18,4905.51,-6688.69,21008.8
1421258948797699072,2020-01,5446.64,3287.1,0,1611.32,548.22,548.22
1421258948797699072,2020-02,1784.03,2344.92,6353.86,2345.69,3447.28,3995.5
1421258948797699072,2020-03,2192.98,2537.8,8762.44,1258.89,7158.73,11154.23
1421258948797699072,2020-04,6283.74,2036.71,3733.67,4940.18,3040.52,14194.75
1421258948797699072,2020-05,2680.11,542.38,1117.77,416.06,2839.44,17034.19
1421258948797699072,2020-06,3314.29,1135.08,846.65,12108.69,-9082.83,7951.36
1421258948797699072,2020-07,451.85,3903.86,4227.18,4422.16,-3646.99,4304.37
1421258948797699072,2020-08,3497.29,7679.92,5941.99,8911.17,-7151.81,-2847.44
1421258948797699072,2020-09,5790.66,5629.64,5081.42,1931.24,3311.2,463.76
1421258948797699072,2020-10,942.88,1263.63,5362.46,2653.92,2387.79,2851.55
1421258948797699072,2020-11,3234.17,3473.76,10032.65,5923.41,3869.65,6721.2
1421258948797699072,2020-12,7070.79,5779.66,2557.37,914.76,2933.74,9654.94
1422730352963620608,2020-01,7772.38,2543.48,4021.97,3019.58,6231.29,6231.29
1422730352963620608,2020-02,2600.02,5755.79,4096.47,8849.58,-7908.88,-1677.59
1422730352963620608,2020-03,2741.31,1957.03,2265.58,9469.33,-6419.47,-8097.06
1422730352963620608,2020-04,8083.93,1438.41,3161.26,3311.99,6494.79,-1602.27
1422730352963620608,2020-05,5696.61,4378.18,1279.96,3874.61,-1276.22,-2878.49
1422730352963620608,2020-06,5583.7,1749.51,4097.43,7495.2,436.42,-2442.07
1422730352963620608,2020-07,3430.74,6244.88,4705.43,4722.05,-2830.76,-5272.83
1422730352963620608,2020-08,5609.4,2571.24,4212.64,3919.09,3331.71,-1941.12
1422730352963620608,2020-09,3700.17,5775.65,9325.04,2904.79,4344.77,2403.65
1422730352963620608,2020-10,4677.27,5491.65,1469.97,6683.35,-6027.76,-3624.11
1422730352963620608,2020-11,2341.36,3308.01,4185.57,12245.7,-9026.78,-12650.89
1422730352963620608,2020-12,4163.97,880.26,9128.89,7624.87,4787.73,-7863.16
1423219004881648640,2020-01,5384.43,5429.76,5396.58,6102.44,-751.19,-751.19
1423219004881648640,2020-02,2010.38,4450.58,5328.1,1734.69,1153.21,402.02
1423219004881648640,2020-03,3789.28,3928.1,6124.22,4945.91,1039.49,1441.51
1423219004881648640,2020-04,0,6274.79,2461.97,8205.91,-12018.73,-10577.22
1423219004881648640,2020-05,2815.13,3781.91,6616.48,9909.9,-4260.2,-14837.42
1423219004881648640,2020-06,2922.68,2058.12,5768.02,4133.42,2499.16,-12338.26
1423219004881648640,2020-07,5402.61,3236.51,1818.88,1447.39,2537.59,-9800.67
1423219004881648640,2020-08,4433.27,7030.41,8423.82,4711.3,1115.38,-8685.29
1423219004881648640,2020-09,5748.03,5424.79,4590.03,4990.13,-76.86,-8762.15
1423219004881648640,2020-10,6970.53,6859.11,6342.86,4003.19,2451.09,-6311.06
1423219004881648640,2020-11,9332.28,1524.08,965.44,1173.81,7599.83,1288.77
1423219004881648640,2020-12,4252.62,1822.07,2153.57,6165.43,-1581.31,-292.54
1424846277912245760,2020-01,6615.86,5598.6,5584.76,2814.44,3787.58,3787.58
1424846277912245760,2020-02,7084.07,3961.91,1731.38,1971.5,2882.04,6669.62
1424846277912245760,2020-03,1835.25,6547.69,2232.72,4973.45,-7453.17,-783.55
1424846277912245760,2020-04,3877.93,3203.77,7757.67,3436.52,4995.31,4211.76
1424846277912245760,2020-05,1704.49,7065.41,2984.77,5620.68,-7996.83,-3785.07
1424846277912245760,2020-06,1736.91,5128.01,3042.6,8563.92,-8912.42,-12697.49
1424846277912245760,2020-07,1625.79,4819.15,5785.92,0,2592.56,-10104.93
1424846277912245760,2020-08,5825.6,5860.63,3941.3,310.92,3595.35,-6509.58
1424846277912245760,2020-09,4412.81,5222.93,1843.6,1233.95,-200.47,-6710.05
1424846277912245760,2020-10,5293.47,2881.06,4167.14,3794.67,2784.88,-3925.17
1424846277912245760,2020-11,3036.2,2560.89,5926.27,3082.45,3319.13,-606.04
1424846277912245760,2020-12,2085.92,10388.14,8625.45,3332.76,-3009.53,-3615.57
1424880170623528192,2020-01,4528.72,1411.22,3506.89,870.25,5754.14,5754.14
1424880170623528192,2020-02,2631.74,2055.23,1152.46,1790.17,-61.2,5692.94
1424880170623528192,2020-03,4969.19,928.82,2221.22,1217.97,5043.62,10736.56
1424880170623528192,2020-04,3047.22,8782.84,3025.02,1581.55,-4292.15,6444.41
1424880170623528192,2020-05,1630.4,653.78,160.41,612.58,524.45,6968.86
1424880170623528192,2020-06,1942.62,1092.69,1044.39,2464.01,-569.69,6399.17
1424880170623528192,2020-07,3932.52,1901.16,1813.65,4046.27,-201.26,6197.91
1424880170623528192,2020-08,0,4163.09,44.11,501.19,-4620.17,1577.74
1424880170623528192,2020-09,2978.27,1934.69,3370.3,2577.7,1836.18,3413.92
1424880170623528192,2020-10,3528.28,5472.72,1251.38,4238.71,-4931.77,-1517.85
1424880170623528192,2020-11,734.91,3649.99,3580.43,272.76,392.59,-1125.26
1424880170623528192,2020-12,0,1376.06,0,1357.94,-2734,-3859.26
1426797317465988608,2020-01,1211.09,0,1442.44,0,2653.53,2653.53
1426797317465988608,2020-03,0,1907.11,0,681.23,-2588.34,65.19
1426797317465988608,2020-04,4841.8,0,0,1430.8,3411,3476.19
1426797317465988608,2020-05,0,1276.9,257.29,0,-1019.61,2456.58
1426797317465988608,2020-07,1215.82,1237.63,2964.09,307.62,2634.66,5091.24
1426797317465988608,2020-09,0,1801.85,621.92,461.17,-1641.1,3450.14
1426797317465988608,2020-12,0,1123.77,1816.44,187.64,505.03,3955.17
1426920379439800320,2020-01,2801.4,1693.82,5293.45,2828.47,3572.56,3572.56
1426920379439800320,2020-02,651.69,1717.38,3741.45,0,2675.76,6248.32
1426920379439800320,2020-03,38.9,6170.26,1462.31,3771.41,-8440.46,-2192.14
1426920379439800320,2020-04,4603.04,2889.23,3852.35,4413.38,1152.78,-1039.36
1426920379439800320,2020-05,3704.12,2906.96,4401.61,5132.36,66.41,-972.95
1426920379439800320,2020-06,6066.47,4728.02,522.24,6608.42,-4747.73,-5720.68
1426920379439800320,2020-07,3846.42,4855.18,3134.92,1646.42,479.74,-5240.94
1426920379439800320,2020-08,0,4583.35,3107.37,3384.84,-4860.82,-10101.76
1426920379439800320,2020-09,4152.65,5668.83,2565.28,1993.21,-944.11,-11045.87
1426920379439800320,2020-10,8804.7,2644.63,2413.75,3174.64,5399.18,-5646.69
1426920379439800320,2020-11,7863.98,6354.05,1648.21,6532.78,-3374.64,-9021.33
1426920379439800320,2020-12,0,3554.76,5541.47,2705.99,-719.28,-9740.61
1427506329223202304,2020-01,3715.87,6985.98,558.41,1376.83,-4088.53,-4088.53
1427506329223202304,2020-02,5875.96,1987.07,8272.59,10723.41,1438.07,-2650.46
1427506329223202304,2020-03,4201.93,4097.27,4275.54,4220.68,159.52,-2490.94
1427506329223202304,2020-04,6497.47,3064.26,4695.64,3524.38,4604.47,2113.53
1427506329223202304,2020-05,1619.33,8243.49,353.1,7067.84,-13338.9,-11225.37
1427506329223202304,2020-06,5041.19,2332.25,8372.56,11542.42,-460.92,-11686.29
1427506329223202304,2020-07,8608.35,4881.18,8310.71,2631.16,9406.72,-2279.57
1427506329223202304,2020-08,4374.51,2583.11,3497.28,7143.66,-1854.98,-4134.55
1427506329223202304,2020-09,4051.31,1695.77,6531.08,1211.81,7674.81,3540.26
1427506329223202304,2020-10,9571.81,13845.63,9573.22,4074.74,1224.66,4764.92
1427506329223202304,2020-11,8451.85,2750.42,2128.42,10320.35,-2490.5,2274.42
1427506329223202304,2020-12,8263.42,2601.26,2759.71,2258.43,6163.44,8437.86
1429551243963490560,2020-01,7276.49,5565.54,1391.54,3980.1,-877.61,-877.61
1429551243963490560,2020-02,8191.52,2695.67,5066.06,5355.07,5206.84,4329.23
1429551243963490560,2020-03,2061.41,8574.67,7017.61,985.47,-481.12,3848.11
1429551243963490560,2020-04,2599.96,2027.71,3326.93,7655.81,-3756.63,91.48
1429551243963490560,2020-05,3047.68,8383.79,5081.17,2434.72,-2689.66,-2598.18
1429551243963490560,2020-06,5416.4,3255.58,4458.97,3638.22,2981.57,383.39
1429551243963490560,2020-07,15.3,1011.06,7728.59,4256.33,2476.5,2859.89
1429551243963490560,2020-08,9795.21,3612.52,5206.95,1226.36,10163.28,13023.17
1429551243963490560,2020-09,3393.36,451.29,1169.26,2991.16,1120.17,14143.34
1429551243963490560,2020-10,5403.66,8475.16,5601.57,2333.22,196.85,14340.19
1429551243963490560,2020-11,4952.24,9375.22,5747,3160.81,-1836.79,12503.4
1429551243963490560,2020-12,1995.92,5124.02,3444.96,4860.41,-4543.55,7959.85
1433171499450532608,2020-01,0,181.26,616.94,822.18,-386.5,-386.5
1433171499450532608,2020-02,3.71,1525.38,2300.55,0,778.88,392.38
1433171499450532608,2020-03,1404.51,2184.11,0,1931.95,-2711.55,-2319.17
1433171499450532608,2020-04,2887.08,1238.26,0,3057.57,-1408.75,-3727.92
1433171499450532608,2020-05,0,3696.07,1904.03,0,-1792.04,-5519.96
1433171499450532608,2020-06,0,1843.1,2676.93,3504.55,-2670.72,-8190.68
1433171499450532608,2020-07,1539.95,1377.18,2733.74,3921.99,-1025.48,-9216.16
1433171499450532608,2020-08,2107.85,0,1213.3,2643.02,678.13,-8538.03
1433171499450532608,2020-09,0,991.5,2886.84,239.1,1656.24,-6881.79
1433171499450532608,2020-10,1315.06,0,5296.45,691.58,5919.93,-961.86
1433171499450532608,2020-12,610.4,0,0,1250.38,-639.98,-1601.84
1433942275821296384,2020-01,391.34,3413.39,1209.62,1898.37,-3710.8,-3710.8
1433942275821296384,2020-02,1697.14,1118.99,1796.79,2197.54,177.4,-3533.4
1433942275821296384,2020-03,2423.21,7526.15,1352.87,3780.55,-7530.62,-11064.02
1433942275821296384,2020-04,3165.52,5073.1,1730.78,3658.69,-3835.49,-14899.51
1433942275821296384,2020-05,4855.31,284.67,1921.2,1279.69,5212.15,-9687.36
1433942275821296384,2020-06,6737.53,4088.84,3856.36,1965.72,4539.33,-5148.03
1433942275821296384,2020-07,1940.5,3003.85,54.94,2030.15,-3038.56,-8186.59
1433942275821296384,2020-08,4959.25,2627.71,3842.13,0,6173.67,-2012.92
1433942275821296384,2020-09,2797.24,4179.51,506.64,4342.49,-5218.12,-7231.04
1433942275821296384,2020-10,2952.23,1330.97,6402.75,2926.25,5097.76,-2133.28
1433942275821296384,2020-11,1913.37,1134.57,647.59,911.54,514.85,-1618.43
1433942275821296384,2020-12,1276.16,676.18,3484.59,2066.56,2018.01,399.58
1434203263498683904,2020-01,724.77,3545.42,1042.4,2705.63,-4483.88,-4483.88
1434203263498683904,2020-02,4320.08,0,0,731.92,3588.16,-895.72
1434203263498683904,2020-03,1801.85,1989.79,1710.11,471.84,1050.33,154.61
1434203263498683904,2020-04,749.52,1684.51,0,3208.04,-4143.03,-3988.42
1434203263498683904,2020-05,2814.83,5882.2,4448.56,1519.43,-138.24,-4126.66
1434203263498683904,2020-06,3951.05,917.2,5386.69,0,8420.54,4293.88
1434203263498683904,2020-07,0,3000.08,2529.28,1191.87,-1662.67,2631.21
1434203263498683904,2020-08,8.32,1833.74,0,8708.42,-10533.84,-7902.63
1434203263498683904,2020-09,3252.09,1974.01,5723.72,7563.89,-562.09,-8464.72
1434203263498683904,2020-10,0,2268.63,346.83,876.58,-2798.38,-11263.1
1434203263498683904,2020-11,1258.61,1218.03,4370.2,5361.65,-950.87,-12213.97
1434203263498683904,2020-12,2594.73,1871.74,3438.83,550.43,3611.39,-8602.58
1434376877102618368,2020-01,2248.17,403.68,3851.2,1885.12,3810.57,3810.57
1434376877102618368,2020-02,2961.71,3161.68,0,310.64,-510.61,3299.96
1434376877102618368,2020-03,2598.24,2139.88,2586.44,2365.54,679.26,3979.22
1434376877102618368,2020-04,5997.37,559.12,0,1354.5,4083.75,8062.97
1434376877102618368,2020-05,4936.82,3129.43,1123.08,3559.2,-628.73,7434.24
1434376877102618368,2020-06,6232.44,0,0,2336.18,3896.26,11330.5
1434376877102618368,2020-07,2979.52,3815.85,6811.72,585.95,5389.44,16719.94
1434376877102618368,2020-08,6336.05,3688.01,747.81,1235.51,2160.34,18880.28
1434376877102618368,2020-09,3631.67,2449.34,3412.63,1263.28,3331.68,22211.96
1434376877102618368,2020-10,2059.35,3162.14,3806.09,2030.86,672.44,22884.4
1434376877102618368,2020-11,7562.28,5443.9,0,4833.42,-2715.04,20169.36
1434376877102618368,2020-12,2590.97,0,2468,8418.27,-3359.3,16810.06
1434453903689645824,2020-01,1785.44,1257.58,834.43,771.12,591.17,591.17
1434453903689645824,2020-02,0,5175.8,2917.46,911.95,-3170.29,-2579.12
1434453903689645824,2020-03,171.68,4116.76,4346.56,3139.89,-2738.41,-5317.53
1434453903689645824,2020-04,4187.13,3458.27,3484.65,1144.85,3068.66,-2248.87
1434453903689645824,2020-05,0,4429.97,7749.85,6152.79,-2832.91,-5081.78
1434453903689645824,2020-06,2434.2,5299.92,3057.04,573.5,-382.18,-5463.96
1434453903689645824,2020-07,1250.58,7332.86,2220.18,3687.62,-7549.72,-13013.68
1434453903689645824,2020-08,2819.93,1032.99,5316.17,2660.54,4442.57,-8571.11
1434453903689645824,2020-09,3301.67,1103.85,6689.3,3079.51,5807.61,-2763.5
1434453903689645824,2020-10,2978.84,4128.18,3555.65,8816.58,-6410.27,-9173.77
1434453903689645824,2020-11,7623.32,212.25,2662.72,3061.02,7012.77,-2161
1434453903689645824,2020-12,960.34,2205.23,4261.79,0,3016.9,855.9
1435655754043223552,2020-01,956.41,822.99,2765.22,338.91,2559.73,2559.73
1435655754043223552,2020-02,2162.36,0,5450.55,0,7612.91,10172.64
1435655754043223552,2020-03,811.44,0,0,0,811.44,10984.08
1435655754043223552,2020-04,2376.85,1477.9,2869.53,2894.93,873.55,11857.63
1435655754043223552,2020-05,0,1478.99,0,0,-1478.99,10378.64
1435655754043223552,2020-06,0,1320.28,0,1724.39,-3044.67,7333.97
1435655754043223552,2020-07,152.35,1637.14,0,337.5,-1822.29,5511.68
1435655754043223552,2020-08,1954.73,0,454.94,0,2409.67,7921.35
1435655754043223552,2020-09,1527.74,1765.99,2720.6,1727.52,754.83,8676.18
1435655754043223552,2020-10,2396.28,490.85,2980.57,0,4886,13562.18
1435655754043223552,2020-11,3234.89,1513.07,1335.29,0,3057.11,16619.29
1435655754043223552,2020-12,1862.06,0,0,0,1862.06,18481.35
1435819488134744576,2020-01,0,1764.92,923.31,2023.69,-2865.3,-2865.3
1435819488134744576,2020-02,1985.63,1027.06,3283,1890.7,2350.87,-514.43
1435819488134744576,2020-03,3508.78,2446.21,4816.78,2607.54,3271.81,2757.38
1435819488134744576,2020-04,490.79,4372.47,479.79,990.26,-4392.15,-1634.77
1435819488134744576,2020-05,1218.81,0,403.83,1969.17,-346.53,-1981.3
1435819488134744576,2020-06,3929.48,1636.27,1202.31,899.72,2595.8,614.5
1435819488134744576,2020-07,3161.66,823.85,1393.26,276.46,3454.61,4069.11
1435819488134744576,2020-08,1267.42,3070.06,3480.4,0,1677.76,5746.87
1435819488134744576,2020-09,744.81,1914.05,777.64,3678.14,-4069.74,1677.13
1435819488134744576,2020-10,2372.69,0,294.5,3561.76,-894.57,782.56
1435819488134744576,2020-11,2678.12,796.47,1618.01,2514.39,985.27,1767.83
1435819488134744576,2020-12,1984.34,1812.95,6898.77,2276.46,4793.7,6561.53
1437783819005538560,2020-01,0,6464.17,4778.96,6940.74,-8625.95,-8625.95
1437783819005538560,2020-02,1108.1,1961.41,2484.5,4352.93,-2721.74,-11347.69
1437783819005538560,2020-03,1807,0,0,1085.63,721.37,-10626.32
1437783819005538560,2020-04,4109.2,463.13,5428.14,3615.18,5459.03,-5167.29
1437783819005538560,2020-05,1584.74,0,488.39,5372.2,-3299.07,-8466.36
1437783819005538560,2020-06,900.51,643.26,0,125.2,132.05,-8334.31
1437783819005538560,2020-07,936.57,1000.12,5308.03,1020.64,4223.84,-4110.47
1437783819005538560,2020-09,4083.4,2391.39,3797.63,4968.22,521.42,-3589.05
1437783819005538560,2020-10,4122.87,1059.98,1043.56,2349.86,1756.59,-1832.46
1437783819005538560,2020-11,5793.52,3211.77,588.41,3299.41,-129.25,-1961.71
1439140698601006592,2020-01,2852.19,0,3257.16,6509.78,-400.43,-400.43
1439140698601006592,2020-02,4191.88,6889.81,6002.57,3940,-635.36,-1035.79
1439140698601006592,2020-03,6450.14,944.5,7399.85,2516.11,10389.38,9353.59
1439140698601006592,2020-04,2709.75,3597.13,5834.18,6767.95,-1821.15,7532.44
1439140698601006592,2020-05,4709.9,7063.11,7377.09,5728,-704.12,6828.32
1439140698601006592,2020-06,2005.58,1584.66,1692.4,0,2113.32,8941.64
1439140698601006592,2020-07,6065.25,4748.92,6046.32,4459.17,2903.48,11845.12
1439140698601006592,2020-08,4417.44,2300.8,6914.64,4325.41,4705.87,16550.99
1439140698601006592,2020-09,2838.06,2919.63,1802.32,1459.73,261.02,16812.01
1439140698601006592,2020-10,5747.36,6107.49,0,2013.55,-2373.68,14438.33
1439140698601006592,2020-11,4449.32,3654.67,2165.72,0,2960.37,17398.7
1439140698601006592,2020-12,5163.3,1168.7,2257.88,6310.87,-58.39,17340.31
1440296825725104128,2020-01,0,1547.16,130.21,1916.46,-3333.41,-3333.41
1440296825725104128,2020-02,1540.2,1909.7,2777.33,0,2407.83,-925.58
1440296825725104128,2020-04,2974.73,0,1048.81,1558.45,2465.09,1539.51
1440296825725104128,2020-06,0,529.54,635.01,0,105.47,1644.98
1440296825725104128,2020-07,1122.57,0,0,0,1122.57,2767.55
1440296825725104128,2020-08,1609.46,87.41,0,0,1522.05,4289.6
1440296825725104128,2020-10,226.68,0,0,0,226.68,4516.28
1440296825725104128,2020-11,3058.62,0,0,0,3058.62,7574.9
1440296825725104128,2020-12,142.98,157.62,0,0,-14.64,7560.26
1440995936166818560,2020-01,0,2377.28,3488.67,1505.93,-394.54,-394.54
1440995936166818560,2020-02,1842.57,1287.33,0,191.15,364.09,-30.45
1440995936166818560,2020-04,1625.19,0,965.4,1695.9,894.69,864.24
1440995936166818560,2020-05,0,1434.06,1898.07,0,464.01,1328.25
1440995936166818560,2020-06,964.75,0,0,86.8,877.95,2206.2
1440995936166818560,2020-07,1531.82,2166.48,2146.75,0,1512.09,3718.29
1440995936166818560,2020-08,0,2606.26,0,111.25,-2717.51,1000.78
1440995936166818560,2020-09,1234.16,0,1234.14,1347.25,1121.05,2121.83
1440995936166818560,2020-10,2074.79,974.13,2875.04,2835.98,1139.72,3261.55
1440995936166818560,2020-11,2609.08,5017.18,1989.92,711.13,-1129.31,2132.24
1440995936166818560,2020-12,2018.15,1564.71,0,3427.7,-2974.26,-842.02
1441053190659418368,2020-01,6231.08,7436.88,0,12610.53,-13816.33,-13816.33
1441053190659418368,2020-02,6056.98,3333.18,7919.22,5197.37,5445.65,-8370.68
1441053190659418368,2020-03,3889.5,3944.77,2789.71,1709.71,1024.73,-7345.95
1441053190659418368,2020-04,3181.63,2400.97,6024.71,1539.5,5265.87,-2080.08
1441053190659418368,2020-05,4381.9,9642.96,5126.78,6243.38,-6377.66,-8457.74
1441053190659418368,2020-06,2997.25,11082.06,3189.38,10394.53,-15289.96,-23747.7
1441053190659418368,2020-07,9710.15,8320.96,2103.15,4331.41,-839.07,-24586.77
1441053190659418368,2020-08,4636.15,615.6,3434.39,2839.35,4615.59,-19971.18
1441053190659418368,2020-09,5477.77,2715.65,6994.79,5228.45,4528.46,-15442.72
1441053190659418368,2020-10,5397.41,4664.68,4966.65,4544,1155.38,-14287.34
1441053190659418368,2020-11,6569.86,9243.54,2745.31,2830.9,-2759.27,-17046.61
1441053190659418368,2020-12,1045.26,4596.91,703.07,3983.65,-6832.23,-23878.84
1441144224969951744,2020-01,3243.07,3222.73,4375,1808.44,2586.9,2586.9
1441144224969951744,2020-02,4897.93,4324.4,857.63,2132.02,-700.86,1886.04
1441144224969951744,2020-03,5059.45,5247.82,2624.63,4827.9,-2391.64,-505.6
1441144224969951744,2020-04,4669.9,10032.03,1307.73,4018.85,-8073.25,-8578.85
1441144224969951744,2020-05,1896.5,5459.57,5628.42,2044.62,20.73,-8558.12
1441144224969951744,2020-06,1503.47,1676.05,1919.34,699.54,1047.22,-7510.9
1441144224969951744,2020-07,2940.44,3804.26,3778.55,1351.54,1563.19,-5947.71
1441144224969951744,2020-08,7093.1,5823.95,440.47,4846.05,-3136.43,-9084.14
1441144224969951744,2020-09,4168.51,2798.02,8727.65,3644.96,6453.18,-2630.96
1441144224969951744,2020-10,6307.43,1240.37,5286.01,0,10353.07,7722.11
1441144224969951744,2020-11,3102.51,6229.09,1797,6133.6,-7463.18,258.93
1441144224969951744,2020-12,2247.62,3635.36,3756.85,5177.99,-2808.88,-2549.95
1441148117622947840,2020-01,2316.24,3135.77,2114.04,6213.68,-4919.17,-4919.17
1441148117622947840,2020-02,4737.45,2046.84,5996.37,0,8686.98,3767.81
1441148117622947840,2020-03,5162.03,6002.29,1920.32,7893.9,-6813.84,-3046.03
1441148117622947840,2020-04,2937.36,8243.85,1745.61,8227.82,-11788.7,-14834.73
1441148117622947840,2020-05,5685.22,1602.39,0,813.3,3269.53,-11565.2
1441148117622947840,2020-06,6141.65,4005.97,4644.93,10471.6,-3690.99,-15256.19
1441148117622947840,2020-07,5154.69,3760.91,3907.16,9626.8,-4325.86,-19582.05
1441148117622947840,2020-08,5605.4,7470.47,3688.28,5391.71,-3568.5,-23150.55
1441148117622947840,2020-09,4048.83,1280.07,3113.47,8709.95,-2827.72,-25978.27
1441148117622947840,2020-10,4020.95,3693.97,5476.53,12345.2,-6541.69,-32519.96
1441148117622947840,2020-11,1177.38,6651.2,2564.13,8755.83,-11665.52,-44185.48
1441148117622947840,2020-12,5190.53,5311.08,9428.37,2537.98,6769.84,-37415.64
1441660945218883328,2020-01,6025.35,7126.62,4857.5,4593.52,-837.29,-837.29
1441660945218883328,2020-02,2092.78,2562.06,4526.34,5705.08,-1648.02,-2485.31
1441660945218883328,2020-03,5274.94,4064.01,2416.04,4088.86,-461.89,-2947.2
1441660945218883328,2020-04,4760.07,303.63,2903.12,5531.03,1828.53,-1118.67
1441660945218883328,2020-05,7362.17,1381.19,4173.81,7631.75,2523.04,1404.37
1441660945218883328,2020-06,2095.03,4339.81,2407.68,1111.78,-948.88,455.49
1441660945218883328,2020-07,249.42,7459.12,6933.59,13188.53,-13464.64,-13009.15
1441660945218883328,2020-08,2290.76,5694.58,9040.67,4892.72,744.13,-12265.02
1441660945218883328,2020-09,7485.03,2927.97,6377.4,4134.2,6800.26,-5464.76
1441660945218883328,2020-10,4344.01,5926.85,2020.97,1898.58,-1460.45,-6925.21
1441660945218883328,2020-11,4795.9,6785.25,801.11,1795.1,-2983.34,-9908.55
1441660945218883328,2020-12,4387.77,4320.44,7299.96,0,7367.29,-2541.26
1444728808845374464,2020-01,2641.54,1818.08,1245.06,1908.63,159.89,159.89
1444728808845374464,2020-02,3770.2,245.98,3355.11,0,6879.33,7039.22
1444728808845374464,2020-03,3495.17,3663.19,877.6,0,709.58,7748.8
1444728808845374464,2020-04,2090.72,2977.74,2664.71,1989.92,-212.23,7536.57
1444728808845374464,2020-05,1191.09,1615.39,6385.76,6239.3,-277.84,7258.73
1444728808845374464,2020-06,2967.77,5458.64,1870.55,2852.45,-3472.77,3785.96
1444728808845374464,2020-07,1029.41,1972.54,1111.27,358.85,-190.71,3595.25
1444728808845374464,2020-08,2723.27,0,1997.96,282.2,4439.03,8034.28
1444728808845374464,2020-09,2617.04,906.68,0,3522.82,-1812.46,6221.82
1444728808845374464,2020-10,3410.62,565.53,2052.12,1625.22,3271.99,9493.81
1444728808845374464,2020-11,0,3347.59,894.22,0,-2453.37,7040.44
1444728808845374464,2020-12,1871.96,1226.61,2723.98,2307.12,1062.21,8102.65
1447073915856445184,2020-01,6612.68,6223.72,1310.23,3440.17,-1740.98,-1740.98
1447073915856445184,2020-02,2358.81,7143.01,3481.63,2948.49,-4251.06,-5992.04
1447073915856445184,2020-03,1028.33,1127.52,3136.8,8066.42,-5028.81,-11020.85
1447073915856445184,2020-04,2411.65,3138.56,1581.8,923.45,-68.56,-11089.41
1447073915856445184,2020-05,3247.52,3563.73,2487.89,233.57,1938.11,-9151.3
1447073915856445184,2020-06,4613.11,3512.98,4110.46,1979.76,3230.83,-5920.47
1447073915856445184,2020-07,2761.38,0,3744.81,627.76,5878.43,-42.04
1447073915856445184,2020-08,1297.55,170.38,4749.29,179.7,5696.76,5654.72
1447073915856445184,2020-09,642.04,2780.87,5438.88,0,3300.05,8954.77
1447073915856445184,2020-10,2556.28,3055.2,665.78,4132.28,-3965.42,4989.35
1447073915856445184,2020-11,2775.26,2317.43,3277.77,3497.06,238.54,5227.89
1447073915856445184,2020-12,4195.8,3534.1,8181.83,2320.08,6523.45,11751.34
1447576352112581888,2020-01,3944.85,2014.16,1845.7,2039.59,1736.8,1736.8
1447576352112581888,2020-02,2821.17,260.11,3687.58,1552.74,4695.9,6432.7
1447576352112581888,2020-03,2280.05,832.19,1071.82,4206.97,-1687.29,4745.41
1447576352112581888,2020-04,1067.14,0,6431.18,3672.86,3825.46,8570.87
1447576352112581888,2020-05,3593.09,4752.78,1734.82,3218.82,-2643.69,5927.18
1447576352112581888,2020-06,4473.44,781.74,5057,2211.25,6537.45,12464.63
1447576352112581888,2020-07,3379.3,1883.56,3220.56,2778.79,1937.51,14402.14
1447576352112581888,2020-08,3566.1,4270.56,1774.75,766.42,303.87,14706.01
1447576352112581888,2020-09,1943.72,5146.81,2176.17,7508.43,-8535.35,6170.66
1447576352112581888,2020-10,3492.45,2467.11,5356.08,6457.72,-76.3,6094.36
1447576352112581888,2020-11,4120.21,1236.34,1224.31,4773.41,-665.23,5429.13
1447576352112581888,2020-12,2962.78,3604.63,3275.79,1536.05,1097.89,6527.02
1448762830406193152,2020-01,3984.97,2582.97,1888.75,4616.06,-1325.31,-1325.31
1448762830406193152,2020-02,1178.42,0,1298.18,4753.03,-2276.43,-3601.74
1448762830406193152,2020-03,3728.65,0,4766.38,7082.47,1412.56,-2189.18
1448762830406193152,2020-04,0,7747.57,3526.03,3939.16,-8160.7,-10349.88
1448762830406193152,2020-05,5257.86,2759.15,284.36,6367.35,-3584.28,-13934.16
1448762830406193152,2020-06,2932.66,2849.16,3795.03,2820.76,1057.77,-12876.39
1448762830406193152,2020-07,3522.34,4924.57,4043.97,1885.25,756.49,-12119.9
1448762830406193152,2020-08,564.21,4185.33,1526.4,6508.55,-8603.27,-20723.17
1448762830406193152,2020-09,7029.24,2295.02,2862.53,1590.83,6005.92,-14717.25
1448762830406193152,2020-10,4983.33,3830.34,6185.05,1524.41,5813.63,-8903.62
1448762830406193152,2020-11,5653.63,3391.09,1464.84,2254.98,1472.4,-7431.22
1448762830406193152,2020-12,4065.65,2757.26,5540.63,2947.52,3901.5,-3529.72
1449375066214038016,2020-01,1071.2,2345.16,4356.93,1601,1481.97,1481.97
1449375066214038016,2020-02,1975.74,3074.93,0,1143.27,-2242.46,-760.49
1449375066214038016,2020-03,0,643.06,2044.2,0,1401.14,640.65
1449375066214038016,2020-04,3532.82,703.13,1027.17,6755.21,-2898.35,-2257.7
1449375066214038016,2020-05,1283.63,1844.01,577.61,2708.14,-2690.91,-4948.61
1449375066214038016,2020-06,698.11,2862.75,2829.32,0,664.68,-4283.93
1449375066214038016,2020-07,258.84,0,350.27,604.65,4.46,-4279.47
1449375066214038016,2020-08,1409.86,2335.24,2478.83,1617.84,-64.39,-4343.86
1449375066214038016,2020-09,1686.98,1926.86,1898.56,2681.62,-1022.94,-5366.8
1449375066214038016,2020-10,1823.43,1419.53,3879.69,567.3,3716.29,-1650.51
1449375066214038016,2020-11,2614.86,536.62,1338.08,4250.81,-834.49,-2485
1449375066214038016,2020-12,3693.03,3114.99,0,5399.74,-4821.7,-7306.7
1449654163258910720,2020-01,3285.94,700.93,3297,1268,4614.01,4614.01
1449654163258910720,2020-02,4796.75,4514.79,3916.53,2993.64,1204.85,5818.86
1449654163258910720,2020-03,2911.26,2244.76,1959.34,2737.23,-111.39,5707.47
1449654163258910720,2020-04,3306.64,1017.71,1742.54,4454.45,-422.98,5284.49
1449654163258910720,2020-05,1322.71,1645.85,5459.6,1180.17,3956.29,9240.78
1449654163258910720,2020-06,7094.35,5845.95,1772.99,4525.62,-1504.23,7736.55
1449654163258910720,2020-07,10912.63,1645.16,9290.34,5410.03,13147.78,20884.33
1449654163258910720,2020-08,946.71,6189.78,2599.4,5177.81,-7821.48,13062.85
1449654163258910720,2020-09,8922.31,2792.29,2188.43,466.46,7851.99,20914.84
1449654163258910720,2020-10,5259.65,1936.15,1892.41,2376.7,2839.21,23754.05
1449654163258910720,2020-11,7556.4,3212.27,3182.19,7428.62,97.7,23851.75
1449654163258910720,2020-12,3889.65,4515.93,6961.5,3552.96,2782.26,26634.01
1450366231705029632,2020-01,2878.32,3845.85,7943.6,2415.05,4561.02,4561.02
1450366231705029632,2020-02,2627.61,1826.79,1052.33,1454.9,398.25,4959.27
1450366231705029632,2020-03,5885.65,1252.26,3081.48,4367.05,3347.82,8307.09
1450366231705029632,2020-04,6140.23,3264.8,3785.17,2792.5,3868.1,12175.19
1450366231705029632,2020-05,5.04,2185.15,8436.65,3150.97,3105.57,15280.76
1450366231705029632,2020-06,0,2754.53,1457.47,2351.52,-3648.58,11632.18
1450366231705029632,2020-07,1863.65,465.65,5038.87,4583.46,1853.41,13485.59
1450366231705029632,2020-08,588.92,6467.75,3797.79,1954.33,-4035.37,9450.22
1450366231705029632,2020-09,770.41,5066.07,5100.54,3474.37,-2669.49,6780.73
1450366231705029632,2020-10,0,489,1318.44,0,829.44,7610.17
1450366231705029632,2020-11,3831.36,3496.01,1839.77,5875.37,-3700.25,3909.92
1450366231705029632,2020-12,3709,2256.05,3215.82,2345.21,2323.56,6233.48
1450829686320384256,2020-01,8127.88,2348.17,4428.36,3205.15,7002.92,7002.92
1450829686320384256,2020-02,2375.09,2603.08,5728.4,694.22,4806.19,11809.11
1450829686320384256,2020-03,2931.6,895.71,2826.99,1371.18,3491.7,15300.81
1450829686320384256,2020-04,1589.78,646.21,1759.56,1838.83,864.3,16165.11
1450829686320384256,2020-05,283.03,0,2126.61,45.98,2363.66,18528.77
1450829686320384256,2020-06,889.53,4719.34,4500.33,5787.84,-5117.32,13411.45
1450829686320384256,2020-07,2944.26,1715.24,976.65,5267.17,-3061.5,10349.95
1450829686320384256,2020-08,2781.73,1439.28,4731.51,666.67,5407.29,15757.24
1450829686320384256,2020-09,1702.19,2662.95,873.01,3553.55,-3641.3,12115.94
1450829686320384256,2020-10,2933.74,4159.63,3979.73,10.44,2743.4,14859.34
1450829686320384256,2020-11,0,2106.68,2906.03,1294.63,-495.28,14364.06
1450829686320384256,2020-12,1177.12,0,2994.55,2172.27,1999.4,16363.46
1454266535462902016,2020-01,2790.41,3847.23,2120.77,2571.24,-1507.29,-1507.29
1454266535462902016,2020-02,1279.09,2428.33,742.51,2638.28,-3045.01,-4552.3
1454266535462902016,2020-03,1624.04,266.28,2082,0,3439.76,-1112.54
1454266535462902016,2020-04,983.87,0,151.12,4069.72,-2934.73,-4047.27
1454266535462902016,2020-06,0,4222.23,1964.15,0,-2258.08,-6305.35
1454266535462902016,2020-07,880.72,144.84,1736.2,0,2472.08,-3833.27
1454266535462902016,2020-08,0,3801.18,358.55,451.09,-3893.72,-7726.99
1454266535462902016,2020-09,375.74,5255.89,1501.09,3844.76,-7223.82,-14950.81
1454266535462902016,2020-10,2031.47,61.89,1394.45,850.06,2513.97,-12436.84
1454266535462902016,2020-11,3487.77,2117.52,1216.3,1559.7,1026.85,-11409.99
1454266535462902016,2020-12,3878.31,0,3971.53,4409.35,3440.49,-7969.5
1454276179988763392,2020-01,4078.37,5244.95,3610.12,4950.28,-2506.74,-2506.74
1454276179988763392,2020-02,6347.15,8963.61,4952.11,5150.01,-2814.36,-5321.1
1454276179988763392,2020-03,2334.78,2931.97,3679.76,6318.96,-3236.39,-8557.49
1454276179988763392,2020-04,12133.79,6482.84,5697.02,4244.42,7103.55,-1453.94
1454276179988763392,2020-05,4333.71,1699.69,5241.21,6244.1,1631.13,177.19
1454276179988763392,2020-06,4169.19,4827.13,5741.1,7900.95,-2817.79,-2640.6
1454276179988763392,2020-07,10737.77,3380.88,5344.29,485.9,12215.28,9574.68
1454276179988763392,2020-08,2644.85,1249.24,883.33,6838.33,-4559.39,5015.29
1454276179988763392,2020-09,8376.43,1799.86,5147.05,6871.51,4852.11,9867.4
1454276179988763392,2020-10,1617.36,2068.6,2183.07,9127.85,-7396.02,2471.38
1454276179988763392,2020-11,1748.67,4578.51,4005.62,3765.01,-2589.23,-117.85
1454276179988763392,2020-12,6805.89,4485.23,4256.7,939.57,5637.79,5519.94
1454378402674204928,2020-01,5785.76,5232.1,8537.61,5883.91,3207.36,3207.36
1454378402674204928,2020-02,4808.55,1277.71,499.75,4969.64,-939.05,2268.31
1454378402674204928,2020-03,4738.72,3804.89,4267.97,579.27,4622.53,6890.84
1454378402674204928,2020-04,2455.75,5596.09,8325.13,2984.08,2200.71,9091.55
1454378402674204928,2020-05,593.21,3406.3,5954.46,1275.79,1865.58,10957.13
1454378402674204928,2020-06,4552.53,4940.86,4601.85,3259.87,953.65,11910.78
1454378402674204928,2020-07,2274.68,1592.52,1295.18,8841.08,-6863.74,5047.04
1454378402674204928,2020-08,2598.31,3867.75,0,5086.43,-6355.87,-1308.83
1454378402674204928,2020-09,6897,5296.83,7904.6,3846.35,5658.42,4349.59
1454378402674204928,2020-10,4212.58,7219,972.62,8408.37,-10442.17,-6092.58
1454378402674204928,2020-11,9416.1,3881.95,2375.9,6959.31,950.74,-5141.84
1454378402674204928,2020-12,7409.82,3065.44,1683.61,4701.43,1326.56,-3815.28
1454509215099263744,2020-01,1189.38,0,0,0,1189.38,1189.38
1454509215099263744,2020-03,1592.13,0,0,0,1592.13,2781.51
1454509215099263744,2020-07,1989.02,0,0,0,1989.02,4770.53
1454509215099263744,2020-08,0,1489.86,0,1410.72,-2900.58,1869.95
1454509215099263744,2020-10,239.31,0,0,0,239.31,2109.26
1454672655395069696,2020-01,5822.49,5365.67,5332.95,1301.24,4488.53,4488.53
1454672655395069696,2020-02,3956.03,9222.67,2338.55,2638.88,-5566.97,-1078.44
1454672655395069696,2020-03,3816.3,3667.77,2919.34,5413.77,-2345.9,-3424.34
1454672655395069696,2020-04,5061.22,3495.19,3922.61,3112.42,2376.22,-1048.12
1454672655395069696,2020-05,4902.88,3993.49,5224.38,8908.98,-2775.21,-3823.33
1454672655395069696,2020-06,4673.77,4514.69,5091.86,3346.35,1904.59,-1918.74
1454672655395069696,2020-07,1775.57,3491.76,3872.57,1972.84,183.54,-1735.2
1454672655395069696,2020-08,3477.25,3574.01,3548.45,6874.2,-3422.51,-5157.71
1454672655395069696,2020-09,0,6377.22,2919.32,2387.67,-5845.57,-11003.28
1454672655395069696,2020-10,9322.94,3027.64,3981.71,3579.34,6697.67,-4305.61
1454672655395069696,2020-11,4357.1,8764.47,2614.91,6193.32,-7985.78,-12291.39
1454672655395069696,2020-12,7377.7,4365.68,5898.2,2853.82,6056.4,-6234.99
1454867973669480192,2020-01,6280.56,5049.44,1663.36,6186.92,-3292.44,-3292.44
1454867973669480192,2020-02,1533.25,4112.89,4706.41,5655.72,-3528.95,-6821.39
1454867973669480192,2020-03,6739.36,3752.18,5374.05,840.94,7520.29,698.9
1454867973669480192,2020-04,10350.3,1291.56,8040.7,6559.48,10539.96,11238.86
1454867973669480192,2020-05,4044.6,3065.38,3494.23,3600.7,872.75,12111.61
1454867973669480192,2020-06,7021.28,4237.3,4174.33,2466.62,4491.69,16603.3
1454867973669480192,2020-07,3246.79,13224.52,1693.79,5564.93,-13848.87,2754.43
1454867973669480192,2020-08,2606.44,6542.56,298.5,6840.23,-10477.85,-7723.42
1454867973669480192,2020-09,3093.35,5882.11,10666.79,2621.43,5256.6,-2466.82
1454867973669480192,2020-10,4123.02,4041.92,5411.63,4877.32,615.41,-1851.41
1454867973669480192,2020-11,5877.18,7927.22,3991.44,0,1941.4,89.99
1454867973669480192,2020-12,495.4,0,3818.59,2376.2,1937.79,2027.78
1455366862692454656,2020-01,7658,1637.54,2666.15,4353.14,4333.47,4333.47
1455366862692454656,2020-02,2126.92,188.43,2384.88,4077.93,245.44,4578.91
1455366862692454656,2020-03,3963.54,789.53,9348.51,2831.14,9691.38,14270.29
1455366862692454656,2020-04,3367.19,7870.42,7463.43,5048.65,-2088.45,12181.84
1455366862692454656,2020-05,3587.06,6792.61,865.6,3418.97,-5758.92,6422.92
1455366862692454656,2020-06,7482.63,2201.84,6003.21,1775.35,9508.65,15931.57
1455366862692454656,2020-07,5752.65,9330.16,5732.82,1339.48,815.83,16747.4
1455366862692454656,2020-08,2055.34,7587.64,4281.28,4213.06,-5464.08,11283.32
1455366862692454656,2020-09,4346.1,8770.71,714.75,773.82,-4483.68,6799.64
1455366862692454656,2020-10,1915.21,9978.17,7378.33,4864.63,-5549.26,1250.38
1455366862692454656,2020-11,8318.86,7903.03,3830.83,9675.97,-5429.31,-4178.93
1455366862692454656,2020-12,4098.34,4137.18,2544.54,5286.82,-2781.12,-6960.05
1456343166488076032,2020-01,1515.22,2697.4,1278.4,4581.76,-4485.54,-4485.54
1456343166488076032,2020-02,1822.4,4776.21,6624.27,0,3670.46,-815.08
1456343166488076032,2020-03,483.73,2283.77,1571.53,1079.59,-1308.1,-2123.18
1456343166488076032,2020-05,2913.94,3038.21,3259.74,0,3135.47,1012.29
1456343166488076032,2020-06,5929.4,0,1790.83,967.85,6752.38,7764.67
1456343166488076032,2020-07,3996.18,3063.22,4653.61,3432.13,2154.44,9919.11
1456343166488076032,2020-08,1425.09,0,5477.02,1129.42,5772.69,15691.8
1456343166488076032,2020-09,2021.93,0,2728.98,163.64,4587.27,20279.07
1456343166488076032,2020-10,3050.52,1943.5,3457.4,941.3,3623.12,23902.19
1456343166488076032,2020-11,1427.5,6454.6,711.96,5084.29,-9399.43,14502.76
1456343166488076032,2020-12,828.35,2313.03,1172.84,3437.22,-3749.06,10753.7
1457199443174257152,2020-01,7091.12,3581.96,3770.75,2530.13,4749.78,4749.78
1457199443174257152,2020-02,918.98,4931.68,1894.5,5318.19,-7436.39,-2686.61
1457199443174257152,2020-03,4043.28,2300.98,5700.63,14237.49,-6794.56,-9481.17
1457199443174257152,2020-04,4167.36,4050.48,5702.29,6120.7,-301.53,-9782.7
1457199443174257152,2020-05,2821.01,2777.54,3581.71,4299.56,-674.38,-10457.08
1457199443174257152,2020-06,7888.06,3150.28,2681.46,6421,998.24,-9458.84
1457199443174257152,2020-07,2604,1119.14,3832.23,478.1,4838.99,-4619.85
1457199443174257152,2020-08,5268.4,5914.03,2418,2512.09,-739.72,-5359.57
1457199443174257152,2020-09,2712.71,3971.62,6013.38,4083.93,670.54,-4689.03
1457199443174257152,2020-10,4729.32,6721.84,2941.67,3188.2,-2239.05,-6928.08
1457199443174257152,2020-11,4831.63,5352.99,3139.5,4653.69,-2035.55,-8963.63
1457199443174257152,2020-12,4147.03,1810.78,1398.57,3314.96,419.86,-8543.77
1457456014045031168,2020-01,3180.73,1599.63,4541.24,954.33,5168.01,5168.01
1457456014045031168,2020-02,2642.86,1285.19,1009.41,4485.27,-2118.19,3049.82
1457456014045031168,2020-03,547.6,5030.55,1745.66,2119.46,-4856.75,-1806.93
1457456014045031168,2020-04,2152.65,4428.04,3662.98,1032.8,354.79,-1452.14
1457456014045031168,2020-05,2976.6,6555.02,1126.14,3969.09,-6421.37,-7873.51
1457456014045031168,2020-06,2401.62,4092.35,2784.41,5043.74,-3950.06,-11823.57
1457456014045031168,2020-07,4224.29,2819.82,2848.77,3507.95,745.29,-11078.28
1457456014045031168,2020-08,2577.8,1195.19,1958.31,3233.43,107.49,-10970.79
1457456014045031168,2020-09,2149.66,2814.03,3560.36,3170.69,-274.7,-11245.49
1457456014045031168,2020-10,5970.44,1754.31,1423.58,2468.32,3171.39,-8074.1
1457456014045031168,2020-11,3148.43,3070.74,2706.88,2380.83,403.74,-7670.36
1457456014045031168,2020-12,4021.04,2509.3,3403.22,4315.04,599.92,-7070.44
1459343989079564544,2020-01,3893.36,2918.08,8087.75,6127.44,2935.59,2935.59
1459343989079564544,2020-02,2278.34,5240.57,7357.62,4692.91,-297.52,2638.07
1459343989079564544,2020-03,1902.54,5945.12,2066.25,3774.16,-5750.49,-3112.42
1459343989079564544,2020-04,3163.86,6527.79,5829.28,2512.78,-47.43,-3159.85
1459343989079564544,2020-05,2345.92,7640.35,2270.05,483.46,-3507.84,-6667.69
1459343989079564544,2020-06,2057.76,8220.04,5883.06,773.27,-1052.49,-7720.18
1459343989079564544,2020-07,3046.77,1555.21,2988.47,1678.88,2801.15,-4919.03
1459343989079564544,2020-08,3184.75,2512.64,1841.71,6105.7,-3591.88,-8510.91
1459343989079564544,2020-09,5558.35,6545.95,790.66,2647.83,-2844.77,-11355.68
1459343989079564544,2020-10,6343.22,6267,2735.84,3769.21,-957.15,-12312.83
1459343989079564544,2020-11,2002.11,1764.02,1202.81,4209.14,-2768.24,-15081.07
1459343989079564544,2020-12,9247.67,3295.38,1424.35,4491.99,2884.65,-12196.42
1460306208076323584,2020-01,2974.58,0,0,2157.36,817.22,817.22
1460306208076323584,2020-02,58.06,923.08,0,0,-865.02,-47.8
1460306208076323584,2020-03,1263.54,1818.06,3557.51,957.13,2045.86,1998.06
1460306208076323584,2020-04,834.21,0,0,1798.43,-964.22,1033.84
1460306208076323584,2020-05,503.94,1348.28,2124.61,0,1280.27,2314.11
1460306208076323584,2020-07,244.35,2068.62,599.73,0,-1224.54,1089.57
1460306208076323584,2020-09,527.93,2781.55,1629.52,0,-624.1,465.47
1460306208076323584,2020-10,831.3,0,978.64,0,1809.94,2275.41
1460306208076323584,2020-11,96.65,0,243.86,568.73,-228.22,2047.19
1460306208076323584,2020-12,2005.89,1265.63,636.07,1375.83,0.5,2047.69
1460434710731157504,2020-01,1017.05,2594.88,1886.91,1072.29,-763.21,-763.21
1460434710731157504,2020-02,4764.72,4822.65,3994.12,332.97,3603.22,2840.01
1460434710731157504,2020-03,1420.71,0,0,5250.6,-3829.89,-989.88
1460434710731157504,2020-04,2040.86,919.12,4942.09,818.76,5245.07,4255.19
1460434710731157504,2020-05,354.72,4601.75,2840.19,1878.32,-3285.16,970.03
1460434710731157504,2020-06,0,905.97,469.57,4956.19,-5392.59,-4422.56
1460434710731157504,2020-07,3151.81,1410.07,3913.44,0,5655.18,1232.62
1460434710731157504,2020-08,2262.61,1469.83,0,1812.21,-1019.43,213.19
1460434710731157504,2020-09,1041.19,6209.9,2353.75,3302.51,-6117.47,-5904.28
1460434710731157504,2020-10,1599.43,2458.62,2863.57,2176.96,-172.58,-6076.86
1460434710731157504,2020-11,4022.09,4006.35,2768.84,1538.5,1246.08,-4830.78
1460434710731157504,2020-12,6129.72,3498.51,4365.46,5311.15,1685.52,-3145.26
1460581181922262784,2020-01,1684.08,893.28,0,0,790.8,790.8
1460581181922262784,2020-05,1244.49,1611.02,0,515.93,-882.46,-91.66
1460581181922262784,2020-06,1741.91,0,1167.48,0,2909.39,2817.73
1460581181922262784,2020-07,335,0,1767.98,0,2102.98,4920.71
1460581181922262784,2020-08,4408.61,0,0,0,4408.61,9329.32
1460581181922262784,2020-09,1714.35,0,0,0,1714.35,11043.67
1460720213133506304,2020-01,2186.56,1157.12,1024.37,522.47,1531.34,1531.34
1460720213133506304,2020-02,1532.04,1195.41,0,5056.95,-4720.32,-3188.98
1460720213133506304,2020-03,2.36,2011.73,1870.6,2463.24,-2602.01,-5790.99
1460720213133506304,2020-04,712.9,1875.49,1417.02,1769.58,-1515.15,-7306.14
1460720213133506304,2020-05,1425.49,5791.74,348.07,1947.94,-5966.12,-13272.26
1460720213133506304,2020-06,300.53,3596.4,1992.64,5995,-7298.23,-20570.49
1460720213133506304,2020-07,0,2565.88,4110.84,723.57,821.39,-19749.1
1460720213133506304,2020-08,0,1498.62,1079.13,5672.78,-6092.27,-25841.37
1460720213133506304,2020-09,974.75,477.44,1754.51,1926.51,325.31,-25516.06
1460720213133506304,2020-10,1505.73,1510.97,7578.54,0,7573.3,-17942.76
1460720213133506304,2020-11,5465.97,175.17,3589.91,1670.76,7209.95,-10732.81
1460720213133506304,2020-12,0,5597.52,1262.31,1562.28,-5897.49,-16630.3
1460778276916265728,2020-01,775.7,3008.39,0,0,-2232.69,-2232.69
1460778276916265728,2020-02,1013.78,1670.58,0,2068.96,-2725.76,-4958.45
1460778276916265728,2020-03,1996.78,2937.59,0,3282.92,-4223.73,-9182.18
1460778276916265728,2020-05,4392.97,0,5784.13,1317.96,8859.14,-323.04
1460778276916265728,2020-06,520.59,2152.39,0,1009.18,-2640.98,-2964.02
1460778276916265728,2020-07,2296.82,921.09,3683.42,5925.98,-866.83,-3830.85
1460778276916265728,2020-08,0,1229.7,3054.78,775.74,1049.34,-2781.51
1460778276916265728,2020-09,1750.28,4552.82,2846.62,3370.79,-3326.71,-6108.22
1460778276916265728,2020-10,2315.72,1085.24,3383.47,3823.03,790.92,-5317.3
1460778276916265728,2020-11,586.78,1326.68,2955.44,3053.16,-837.62,-6154.92
1460778276916265728,2020-12,1375.86,663.23,0,3319.63,-2607,-8761.92
1463657070501962240,2020-01,1326.71,3700.07,3482.54,3072.13,-1962.95,-1962.95
1463657070501962240,2020-02,2594.1,2040,1086.54,6299.24,-4658.6,-6621.55
1463657070501962240,2020-03,2787.64,1546.83,2431.88,5400.49,-1727.8,-8349.35
1463657070501962240,2020-04,2492.68,4407.12,5485.78,3127.41,443.93,-7905.42
1463657070501962240,2020-05,3705.74,2483.83,1700.24,0,2922.15,-4983.27
1463657070501962240,2020-06,4743.15,5075.93,2549.81,2395.58,-178.55,-5161.82
1463657070501962240,2020-07,7730.4,5247.92,1217.6,6713.95,-3013.87,-8175.69
1463657070501962240,2020-08,273.15,588.89,1315.98,2685.8,-1685.56,-9861.25
1463657070501962240,2020-09,615.73,1977.72,130.09,4692.18,-5924.08,-15785.33
1463657070501962240,2020-10,2331.71,1166.24,3123.73,4349.52,-60.32,-15845.65
1463657070501962240,2020-11,769.4,858.31,3926.39,5572.35,-1734.87,-17580.52
1463657070501962240,2020-12,6698.12,2424.55,2545.32,4687.84,2131.05,-15449.47
1464045352276699136,2020-01,4153.96,7766.44,4430.22,1956.68,-1138.94,-1138.94
1464045352276699136,2020-02,2369.34,2577.48,415.28,4516.28,-4309.14,-5448.08
1464045352276699136,2020-03,4986.12,2363.97,1674.66,5270.87,-974.06,-6422.14
1464045352276699136,2020-04,1749.92,5405.31,5535.55,4792.43,-2912.27,-9334.41
1464045352276699136,2020-05,5104.38,2941.75,7822.28,3779.38,6205.53,-3128.88
1464045352276699136,2020-06,2534.7,3756.47,3910.4,582.23,2106.4,-1022.48
1464045352276699136,2020-07,4065.08,2765.98,2111.9,4225.27,-814.27,-1836.75
1464045352276699136,2020-08,5925.82,4744.93,7806.19,1464.48,7522.6,5685.85
1464045352276699136,2020-09,4945.92,2823.16,3615.87,424.4,5314.23,11000.08
1464045352276699136,2020-10,11198.04,3397.36,6772.83,9249.83,5323.68,16323.76
1464045352276699136,2020-11,4295.58,4601.39,7507.49,7492.43,-290.75,16033.01
1464045352276699136,2020-12,2140.11,4850.64,4529.99,5585.34,-3765.88,12267.13
1464280070608479744,2020-01,5770.91,6516.21,2992.1,5338.94,-3092.14,-3092.14
1464280070608479744,2020-02,653.68,5963.16,3073.21,1631.83,-3868.1,-6960.24
1464280070608479744,2020-03,12678.67,3607.51,7341.84,5324.9,11088.1,4127.86
1464280070608479744,2020-04,3338.59,4713.6,0,5407.43,-6782.44,-2654.58
1464280070608479744,2020-05,5106.11,2457.71,5925.2,2424.59,6149.01,3494.43
1464280070608479744,2020-06,2809.09,6492.37,2841.73,6791.9,-7633.45,-4139.02
1464280070608479744,2020-07,11022.73,1478.74,4490.81,3603.29,10431.51,6292.49
1464280070608479744,2020-08,5571.85,5418.43,3969.66,3135.6,987.48,7279.97
1464280070608479744,2020-09,1052.82,3325.49,4961.76,1224.81,1464.28,8744.25
1464280070608479744,2020-10,1214.04,793.05,655.38,1466.41,-390.04,8354.21
1464280070608479744,2020-11,5259.51,1623.07,6909.78,422,10124.22,18478.43
1464280070608479744,2020-12,5325.54,1855.26,7076.84,4424.96,6122.16,24600.59
1464307209104691456,2020-04,0,594.76,645.8,1071.32,-1020.28,-1020.28
1464307209104691456,2020-07,1851.46,2308.56,247.83,387.12,-596.39,-1616.67
1464307209104691456,2020-08,0,52.81,1809.3,0,1756.49,139.82
1464307209104691456,2020-09,2236.01,1752.54,0,0,483.47,623.29
1464307209104691456,2020-10,955.25,1756.22,1802.78,0,1001.81,1625.1
1464307209104691456,2020-11,1681.82,678.09,2742.33,0,3746.06,5371.16
1464307209104691456,2020-12,0,153.51,738.85,1819.89,-1234.55,4136.61
1465760807941043456,2020-01,977.12,1212.71,5293.43,2263.01,2794.83,2794.83
1465760807941043456,2020-02,902.63,2480.76,311.6,0,-1266.53,1528.3
1465760807941043456,2020-03,1838.95,1989.28,3295.95,2889.43,256.19,1784.49
1465760807941043456,2020-04,0,835.51,0,685.15,-1520.66,263.83
1465760807941043456,2020-05,0,2711.32,1158.39,1716.21,-3269.14,-3005.31
1465760807941043456,2020-06,699.83,0,3151.29,1686.05,2165.07,-840.24
1465760807941043456,2020-07,301.5,1976.43,1744.44,0,69.51,-770.73
1465760807941043456,2020-08,0,928.77,5763.76,0,4834.99,4064.26
1465760807941043456,2020-09,1885.01,0,1484.32,0,3369.33,7433.59
1465760807941043456,2020-10,10.75,1117.59,0,1949.11,-3055.95,4377.64
1465760807941043456,2020-11,2313.21,0,463.63,1340.4,1436.44,5814.08
1465760807941043456,2020-12,1616.86,0,3798.78,0,5415.64,11229.72
1465875098219134208,2020-02,1343.53,56.22,0,0,1287.31,1287.31
1465875098219134208,2020-04,0,488.5,0,0,-488.5,798.81
1465875098219134208,2020-09,1652.41,996.12,0,123.1,533.19,1332
1465875098219134208,2020-12,0,371.37,0,0,-371.37,960.63
1466224360583417600,2020-11,0,1715.32,0,0,-1715.32,-1715.32
1466878427305472512,2020-01,199.5,1298.52,1438.85,1461.2,-1121.37,-1121.37
1466878427305472512,2020-02,142.56,1950.14,0,492.87,-2300.45,-3421.82
1466878427305472512,2020-03,477.14,430.05,0,2781.6,-2734.51,-6156.33
1466878427305472512,2020-04,1479.18,953,0,1886.36,-1360.18,-7516.51
1466878427305472512,2020-05,750.22,434.24,2545.47,2349.04,512.41,-7004.1
1466878427305472512,2020-06,0,2223.75,0,968.89,-3192.64,-10196.74
1466878427305472512,2020-07,1609.17,0,0,0,1609.17,-8587.57
1466878427305472512,2020-08,914.93,0,0,1923.3,-1008.37,-9595.94
1466878427305472512,2020-09,6.29,1837.55,0,0,-1831.26,-11427.2
1466878427305472512,2020-10,1881.94,2698.57,0,523.11,-1339.74,-12766.94
1466878427305472512,2020-11,447.27,0.29,0,0,446.98,-12319.96
1466878427305472512,2020-12,872.9,0,0,0,872.9,-11447.06
1469496729815507456,2020-01,3503,1617.97,1411.62,418.13,2878.52,2878.52
1469496729815507456,2020-02,3636.11,1553.91,4129.01,4276.16,1935.05,4813.57
1469496729815507456,2020-03,8637.19,1804.92,1761.21,4979.54,3613.94,8427.51
1469496729815507456,2020-04,1412.48,3298.98,2592.64,1925.08,-1218.94,7208.57
1469496729815507456,2020-05,3688.98,2820.05,803.52,1246.97,425.48,7634.05
1469496729815507456,2020-06,931.31,819.55,381.87,5880.96,-5387.33,2246.72
1469496729815507456,2020-07,6395.63,4106.43,3288.25,6213.33,-635.88,1610.84
1469496729815507456,2020-08,3740.1,480.74,3506.11,237.59,6527.88,8138.72
1469496729815507456,2020-09,2457.09,2158.11,2305.36,166.02,2438.32,10577.04
1469496729815507456,2020-10,8052.21,3736.64,1469.98,3772.63,2012.92,12589.96
1469496729815507456,2020-11,1554.12,11592.39,3994.34,783.83,-6827.76,5762.2
1469496729815507456,2020-12,1147.3,3392.31,211.11,0,-2033.9,3728.3
1469833453452055040,2020-01,835,0,4830.61,3611.7,2053.91,2053.91
1469833453452055040,2020-02,2224.89,0,1570.91,96.04,3699.76,5753.67
1469833453452055040,2020-03,5488.72,641.5,3830.32,1097.72,7579.82,13333.49
1469833453452055040,2020-04,4408.04,1135.6,4195.31,2824.01,4643.74,17977.23
1469833453452055040,2020-05,3209.67,6816.41,634.97,595.73,-3567.5,14409.73
1469833453452055040,2020-06,4161.11,6106.63,4925.51,7799.5,-4819.51,9590.22
1469833453452055040,2020-07,2697.95,3060.02,5168.44,3314.18,1492.19,11082.41
1469833453452055040,2020-08,5479.8,3345.6,6003.31,5960.6,2176.91,13259.32
1469833453452055040,2020-09,9208.03,4822.15,1859.84,1076.19,5169.53,18428.85
1469833453452055040,2020-10,4446.73,5204.51,2256.68,1867.21,-368.31,18060.54
1469833453452055040,2020-11,6169.12,4322.08,2129.1,10324.92,-6348.78,11711.76
1469833453452055040,2020-12,1859.83,2976.73,3286.44,1077.53,1092.01,12803.77
1471477446185023488,2020-01,2114.25,5688.74,1860.71,1516.91,-3230.69,-3230.69
1471477446185023488,2020-02,5200.96,5555.65,3275.77,4646.94,-1725.86,-4956.55
1471477446185023488,2020-03,6652.18,1629.3,6480.49,1036.69,10466.68,5510.13
1471477446185023488,2020-04,11479.14,5736.72,5459.43,4285.93,6915.92,12426.05
1471477446185023488,2020-05,5159.33,2649.1,6069.25,2765.33,5814.15,18240.2
1471477446185023488,2020-06,1788.88,3953.45,7899.43,3574.67,2160.19,20400.39
1471477446185023488,2020-07,2229.01,1151.67,4333.47,6130.21,-719.4,19680.99
1471477446185023488,2020-08,6447.85,3097.56,4880.28,2994.76,5235.81,24916.8
1471477446185023488,2020-09,1851.09,4399.29,3547.1,6830.23,-5831.33,19085.47
1471477446185023488,2020-10,3712.61,10666.03,5559.83,3796.51,-5190.1,13895.37
1471477446185023488,2020-11,1107.75,4687.07,4615.55,6896.85,-5860.62,8034.75
1471477446185023488,2020-12,6057.44,4170.35,1523.34,4850.78,-1440.35,6594.4
1472560058919836160,2020-01,1121.75,235.44,1137.75,0,2024.06,2024.06
1472560058919836160,2020-03,0,1952.71,0,0,-1952.71,71.35
1472560058919836160,2020-05,453.05,0,850.48,0,1303.53,1374.88
1472560058919836160,2020-11,0,1328.99,0,0,-1328.99,45.89
1472560058919836160,2020-12,0,1384.29,952.02,444.37,-876.64,-830.75
1473492541530060288,2020-01,6017.28,1144.63,8408.18,379.58,12901.25,12901.25
1473492541530060288,2020-02,5324.13,5626.95,5478.51,3542.37,1633.32,14534.57
1473492541530060288,2020-03,2688.88,3085.78,2249.55,7700.64,-5847.99,8686.58
1473492541530060288,2020-04,2275.05,5273.19,3135.65,7888.33,-7750.82,935.76
1473492541530060288,2020-05,574.3,7983.62,6653.9,6483.61,-7239.03,-6303.27
1473492541530060288,2020-06,5646.99,5148.54,5262.84,4056.09,1705.2,-4598.07
1473492541530060288,2020-07,4855.5,4736.85,5331.89,6506.46,-1055.92,-5653.99
1473492541530060288,2020-08,3758.8,9098.38,3145.78,5561.13,-7754.93,-13408.92
1473492541530060288,2020-09,4838.3,5706.56,1601.64,4894.02,-4160.64,-17569.56
1473492541530060288,2020-10,6752.75,3345.33,7904.04,4349.07,6962.39,-10607.17
1473492541530060288,2020-11,7197.03,3487.81,5399.2,6981.51,2126.91,-8480.26
1473492541530060288,2020-12,3837.36,4416.42,3857.15,2113.46,1164.63,-7315.63
1476366790753276160,2020-01,5326.34,4472.77,2136.45,2831.59,158.43,158.43
1476366790753276160,2020-02,3385.76,2308.58,754.1,4530.78,-2699.5,-2541.07
1476366790753276160,2020-03,2135.83,6326.18,3443.03,613.37,-1360.69,-3901.76
1476366790753276160,2020-04,3282.82,5090.64,3027.5,3252.33,-2032.65,-5934.41
1476366790753276160,2020-05,832.23,1781.88,3303.44,7634.05,-5280.26,-11214.67
1476366790753276160,2020-06,2853.25,3957.2,3017.66,7186.39,-5272.68,-16487.35
1476366790753276160,2020-07,3148.79,4100.36,1270.15,671.72,-353.14,-16840.49
1476366790753276160,2020-08,2536.93,6303.13,6458.28,1896.71,795.37,-16045.12
1476366790753276160,2020-09,0,3078.73,201.54,2739.91,-5617.1,-21662.22
1476366790753276160,2020-10,7216.71,3153.64,6023.47,1139.12,8947.42,-12714.8
1476366790753276160,2020-11,3655.85,0,2073.22,1237.93,4491.14,-8223.66
1476366790753276160,2020-12,2767.56,982.98,1209.88,3494.36,-499.9,-8723.56
1477095747112467200,2020-01,1456.62,570.42,1626.98,972.96,1540.22,1540.22
1477095747112467200,2020-02,1622.83,3243.8,298.55,325.48,-1647.9,-107.68
1477095747112467200,2020-03,1306.66,1014.22,380.12,0,672.56,564.88
1477095747112467200,2020-04,1143.73,0,0,0,1143.73,1708.61
1477095747112467200,2020-09,470.51,0,738.36,709.64,499.23,2207.84
1477095747112467200,2020-12,3758.46,1580.95,0,1517.61,659.9,2867.74
1477805853276352256,2020-01,2278.06,2354.98,290.28,1778.07,-1564.71,-1564.71
1477805853276352256,2020-02,2583.8,3165.6,2833.08,1103.58,1147.7,-417.01
1477805853276352256,2020-03,1955.49,0,7658.99,0,9614.48,9197.47
1477805853276352256,2020-04,0,2377.96,1984.02,2275.2,-2669.14,6528.33
1477805853276352256,2020-05,1309.95,3287.07,3356.24,0,1379.12,7907.45
1477805853276352256,2020-06,1913.43,3307.22,2986.97,4337.02,-2743.84,5163.61
1477805853276352256,2020-07,424.08,2329.66,1317.28,0,-588.3,4575.31
1477805853276352256,2020-08,3917.05,1227.4,3673.81,1813.46,4550,9125.31
1477805853276352256,2020-09,0,3130.23,1259.42,2353.69,-4224.5,4900.81
1477805853276352256,2020-10,1239.21,0,1360.69,2050.2,549.7,5450.51
1477805853276352256,2020-11,1783.07,2386.73,0,1518.59,-2122.25,3328.26
1477805853276352256,2020-12,2058.1,4849.39,979.19,5387.79,-7199.89,-3871.63
1478768539028224768,2020-01,4481.88,2764.04,3562.4,7579.31,-2299.07,-2299.07
1478768539028224768,2020-02,3179.72,377.67,4216.42,2824.36,4194.11,1895.04
1478768539028224768,2020-03,3156.53,399.44,5464.1,2354.55,5866.64,7761.68
1478768539028224768,2020-04,1843.61,7865.43,6069.42,7916.31,-7868.71,-107.03
1478768539028224768,2020-05,1482.48,1158.07,1227.22,2335.71,-784.08,-891.11
1478768539028224768,2020-06,2637.93,3412.48,4003.67,2828.59,400.53,-490.58
1478768539028224768,2020-07,5067.38,0,5993.11,3735.48,7325.01,6834.43
1478768539028224768,2020-08,1693.37,6538,4753.89,3057.44,-3148.18,3686.25
1478768539028224768,2020-09,4090.12,2370.82,495.68,4755.1,-2540.12,1146.13
1478768539028224768,2020-10,3100.43,4834.03,9074.26,4349.28,2991.38,4137.51
1478768539028224768,2020-11,7725.46,6237.59,7163.13,2831.15,5819.85,9957.36
1478768539028224768,2020-12,2190.54,5821.74,2237.35,4338.85,-5732.7,4224.66
1479060965714572800,2020-01,3620.63,2740.47,3686.67,3126.06,1440.77,1440.77
1479060965714572800,2020-02,3258.24,6069.11,7394.27,1957.59,2625.81,4066.58
1479060965714572800,2020-03,1688.1,0,8170.99,0,9859.09,13925.67
1479060965714572800,2020-04,1791.27,2481.36,5542.45,1428.78,3423.58,17349.25
1479060965714572800,2020-05,901.68,3529.64,0,1391.32,-4019.28,13329.97
1479060965714572800,2020-06,1981.23,3802.77,3129.19,2880.95,-1573.3,11756.67
1479060965714572800,2020-07,2615.88,2067.78,3735.21,2038.05,2245.26,14001.93
1479060965714572800,2020-08,1460.24,7430.57,4924.35,3061.6,-4107.58,9894.35
1479060965714572800,2020-09,7559.55,4318.72,4058.34,4727.41,2571.76,12466.11
1479060965714572800,2020-10,3596.26,6915.94,7379.9,7112.73,-3052.51,9413.6
1479060965714572800,2020-11,3448.83,1521.04,3743.44,202.23,5469,14882.6
1479060965714572800,2020-12,6923.48,5590.9,2610.14,2951.36,991.36,15873.96
1479197378962124032,2020-01,2506.47,300.86,2441.47,945.58,3701.5,3701.5
1479197378962124032,2020-02,1235.73,1206.05,4324.96,3144.08,1210.56,4912.06
1479197378962124032,2020-03,4940.86,1652.12,0,6487.03,-3198.29,1713.77
1479197378962124032,2020-04,1178.73,6297.09,1355.75,525.06,-4287.67,-2573.9
1479197378962124032,2020-05,1630.74,3533.19,5898.16,223.12,3772.59,1198.69
1479197378962124032,2020-06,459.14,4196.39,6676.4,4753.51,-1814.36,-615.67
1479197378962124032,2020-07,1058.4,2908.89,5341.77,1701.76,1789.52,1173.85
1479197378962124032,2020-08,5243.61,1033.28,2323.36,230.13,6303.56,7477.41
1479197378962124032,2020-09,2712.07,97.39,0,411.43,2203.25,9680.66
1479197378962124032,2020-10,6759.09,3692.59,739.55,219.18,3586.87,13267.53
1479197378962124032,2020-11,527.15,6045.5,5740.39,1379.39,-1157.35,12110.18
1479197378962124032,2020-12,1823.94,2748.62,3097.77,2450.2,-277.11,11833.07
1480484080313627904,2020-01,7812.34,637.51,1531.73,1534.97,7171.59,7171.59
1480484080313627904,2020-02,4988.32,1488.27,3652.31,18.06,7134.3,14305.89
1480484080313627904,2020-03,6759.79,0,4964.04,1827.13,9896.7,24202.59
1480484080313627904,2020-04,1904.37,1242.89,2968.7,1415.17,2215.01,26417.6
1480484080313627904,2020-05,959.95,3918.08,1616.62,1608.55,-2950.06,23467.54
1480484080313627904,2020-06,3495.06,915.08,2887.68,2646.98,2820.68,26288.22
1480484080313627904,2020-07,3534.17,3980.49,1538.12,3108.25,-2016.45,24271.77
1480484080313627904,2020-08,3221.1,774.7,7209.82,1921.72,7734.5,32006.27
1480484080313627904,2020-09,3274.61,1215.57,6753.78,2831.23,5981.59,37987.86
1480484080313627904,2020-10,1149.46,3750.59,363.08,8682.54,-10920.59,27067.27
1480484080313627904,2020-11,1692.47,4241.26,2188.71,0,-360.08,26707.19
1480484080313627904,2020-12,4392.7,6536.96,1105.75,1680.29,-2718.8,23988.39
1481021858971105536,2020-01,3892.09,4685.14,7069.97,2742.62,3534.3,3534.3
1481021858971105536,2020-02,4925.95,798.35,1525.9,0,5653.5,9187.8
1481021858971105536,2020-03,3758.9,1886.76,9075.56,4796.52,6151.18,15338.98
1481021858971105536,2020-04,5790.25,4069.95,1635.14,5101.51,-1746.07,13592.91
1481021858971105536,2020-05,5091.11,1455.37,1851.69,3124.09,2363.34,15956.25
1481021858971105536,2020-06,4013.09,2024.92,4999.59,2252.9,4734.86,20691.11
1481021858971105536,2020-07,6413.35,6956.05,3954.39,2566.47,845.22,21536.33
1481021858971105536,2020-08,717.87,5327.36,3486.36,3177.63,-4300.76,17235.57
1481021858971105536,2020-09,7236.32,2536.03,4309.14,10385.51,-1376.08,15859.49
1481021858971105536,2020-10,7036.73,5435.16,5345.48,1492.85,5454.2,21313.69
1481021858971105536,2020-11,2447.18,4781.17,3753.44,6776.55,-5357.1,15956.59
1481021858971105536,2020-12,2918.3,5722.38,1597.95,1634.53,-2840.66,13115.93
1481548554119176192,2020-01,948.37,0,0,1192.81,-244.44,-244.44
1481548554119176192,2020-06,0,903.79,0,0,-903.79,-1148.23
1481548554119176192,2020-07,0,41.31,1100.34,0,1059.03,-89.2
1481548554119176192,2020-08,0,270.68,0,0,-270.68,-359.88
1481548554119176192,2020-12,419.12,1452.26,0,0,-1033.14,-1393.02
1484240125005948672,2020-01,1252.63,0,0,491.51,761.12,761.12
1484240125005948672,2020-02,2645.1,0,0,1677.95,967.15,1728.27
1484240125005948672,2020-05,0,1311.36,0,0,-1311.36,416.91
1484240125005948672,2020-06,373.79,1422.87,0,0,-1049.08,-632.17
1484240125005948672,2020-08,0,1598.9,0,0,-1598.9,-2231.07
1484240125005948672,2020-09,415.31,2662.6,0,2447.68,-4694.97,-6926.04
1484240125005948672,2020-11,421.19,1233.23,0,0,-812.04,-7738.08
1484240125005948672,2020-12,794.03,0,1112.43,1561.43,345.03,-7393.05
1485049755119646208,2020-01,2261.09,4437.86,3629.98,2309.03,-855.82,-855.82
1485049755119646208,2020-02,6485.07,2676.21,5470.19,4326.65,4952.4,4096.58
1485049755119646208,2020-03,3307.48,1235.63,2025.85,820.24,3277.46,7374.04
1485049755119646208,2020-04,3064.45,2668.19,3232.28,4398.14,-769.6,6604.44
1485049755119646208,2020-05,2608.12,2038.54,116.34,3137.69,-2451.77,4152.67
1485049755119646208,2020-06,4553.45,2113.43,452.81,4683.3,-1790.47,2362.2
1485049755119646208,2020-07,3972.18,4888.69,1232.7,2056.86,-1740.67,621.53
1485049755119646208,2020-08,5731.47,1974.46,4549.12,1646.19,6659.94,7281.47
1485049755119646208,2020-09,6379.05,1163.24,5359.72,5342.26,5233.27,12514.74
1485049755119646208,2020-10,6510.61,5565.83,6846.61,1701.31,6090.08,18604.82
1485049755119646208,2020-11,6257.06,1319.84,3949.46,5142.59,3744.09,22348.91
1485049755119646208,2020-12,6206,3438.02,3495.79,1462.35,4801.42,27150.33
1485977868771803392,2020-01,4030.58,804.82,3465.27,4634.2,2056.83,2056.83
1485977868771803392,2020-02,2043.75,0,4301.4,5840.19,504.96,2561.79
1485977868771803392,2020-03,2241.8,1924.99,1298.59,8121.08,-6505.68,-3943.89
1485977868771803392,2020-04,2446.52,4119.08,2993.93,4156.31,-2834.94,-6778.83
1485977868771803392,2020-05,1548.63,1439.32,961.69,5826.94,-4755.94,-11534.77
1485977868771803392,2020-06,4392.94,2729.69,5768.91,9397.14,-1964.98,-13499.75
1485977868771803392,2020-07,7633,1678.81,5326.59,3194.64,8086.14,-5413.61
1485977868771803392,2020-08,12968.91,8374.46,2581.44,1838.93,5336.96,-76.65
1485977868771803392,2020-09,5653.9,2243.97,7688.01,1625.96,9471.98,9395.33
1485977868771803392,2020-10,3501.76,3843.26,4485.57,4327.55,-183.48,9211.85
1485977868771803392,2020-11,3306.94,1582.28,2294.58,160.08,3859.16,13071.01
1485977868771803392,2020-12,6035.82,0,6286.87,8383.87,3938.82,17009.83
1486432927608915456,2020-01,1712.62,3336.2,4197.9,8270.3,-5695.98,-5695.98
1486432927608915456,2020-02,2057.24,2940.88,1821.2,1676.99,-739.43,-6435.41
1486432927608915456,2020-03,5886.1,11956.34,5112.57,10150.3,-11107.97,-17543.38
1486432927608915456,2020-04,5759.99,4567.56,2244.14,5451.8,-2015.23,-19558.61
1486432927608915456,2020-05,4231.33,3773.8,3672.14,3755,374.67,-19183.94
1486432927608915456,2020-06,5634.12,3847.7,1681.17,8187.65,-4720.06,-23904
1486432927608915456,2020-07,2747.6,5512.97,2030.5,1806.75,-2541.62,-26445.62
1486432927608915456,2020-08,5675.79,2315.15,3579.89,3210.91,3729.62,-22716
1486432927608915456,2020-09,2285.77,1944.94,3287.13,5104.9,-1476.94,-24192.94
1486432927608915456,2020-10,12544.79,5323.29,2654.4,3576.51,6299.39,-17893.55
1486432927608915456,2020-11,2749.89,3871.93,513.43,4661.67,-5270.28,-23163.83
1486432927608915456,2020-12,3621.03,4105.05,4455.13,1278.41,2692.7,-20471.13
1486907990481238784,2020-01,3188.15,2207.45,168.06,2514.51,-1365.75,-1365.75
1486907990481238784,2020-02,1606.5,2133.79,5040.37,2613.56,1899.52,533.77
1486907990481238784,2020-03,1327.95,0,3890.56,3395.83,1822.68,2356.45
1486907990481238784,2020-04,1241.55,4855.48,135.22,1798.16,-5276.87,-2920.42
1486907990481238784,2020-05,816.49,1923,2110.06,0,1003.55,-1916.87
1486907990481238784,2020-06,4272.59,0,2590.95,890.08,5973.46,4056.59
1486907990481238784,2020-07,1532.75,0,2096.89,3168.67,460.97,4517.56
1486907990481238784,2020-08,6376.86,2552.91,1576.91,2559.58,2841.28,7358.84
1486907990481238784,2020-09,1569.02,2033.13,2263.26,1080.73,718.42,8077.26
1486907990481238784,2020-10,1925.86,2435.88,0,1598.48,-2108.5,5968.76
1486907990481238784,2020-11,3251.47,3086.48,0,2181.8,-2016.81,3951.95
1486907990481238784,2020-12,0,1325.47,2459.92,1375.41,-240.96,3710.99
1488541583909643520,2020-02,3526.49,1682.36,1921.35,713.34,3052.14,3052.14
1488541583909643520,2020-03,733.25,859.02,0,1398.07,-1523.84,1528.3
1488541583909643520,2020-04,0,1984.73,3161.64,1855.69,-678.78,849.52
1488541583909643520,2020-05,1714.34,0,2154.95,2275.59,1593.7,2443.22
1488541583909643520,2020-06,955.03,5081.01,1274.35,1207.36,-4058.99,-1615.77
1488541583909643520,2020-07,2083.78,2323.5,0,2063.26,-2302.98,-3918.75
1488541583909643520,2020-08,2964.27,362.49,372.88,2251.1,723.56,-3195.19
1488541583909643520,2020-09,0,1952.26,1514.11,1598.12,-2036.27,-5231.46
1488541583909643520,2020-10,2588.71,1728.93,3560.03,1188.8,3231.01,-2000.45
1488541583909643520,2020-11,805.74,1964.61,0,4496.96,-5655.83,-7656.28
1488541583909643520,2020-12,1680.69,3172.24,0,3196.49,-4688.04,-12344.32
1489101294075855872,2020-01,4264.06,7724.38,6088.99,7524.77,-4896.1,-4896.1
1489101294075855872,2020-02,1807.54,4506.82,5066.53,2115.6,251.65,-4644.45
1489101294075855872,2020-03,6146.52,5900.64,1199.07,4363.42,-2918.47,-7562.92
1489101294075855872,2020-04,6445.89,4685.49,1826.76,5489.16,-1902,-9464.92
1489101294075855872,2020-05,2736.82,7032.51,2704.1,4017.9,-5609.49,-15074.41
1489101294075855872,2020-06,1026.63,3700.56,1245.65,4589.16,-6017.44,-21091.85
1489101294075855872,2020-07,5130.57,1702.59,6742,6736.27,3433.71,-17658.14
1489101294075855872,2020-08,3576.5,3478.97,8229.23,8332.3,-5.54,-17663.68
1489101294075855872,2020-09,1987.35,1540.72,2895.4,1296.94,2045.09,-15618.59
1489101294075855872,2020-10,3546.21,7304.61,5284.25,3083.12,-1557.27,-17175.86
1489101294075855872,2020-11,10181.01,13669.28,1696.79,1773.71,-3565.19,-20741.05
1489101294075855872,2020-12,2662.56,3050.31,3101.13,3881.07,-1167.69,-21908.74
1489448365048909568,2020-01,5132.01,2270.97,3823.88,1900.45,4784.47,4784.47
1489448365048909568,2020-02,4477.78,1861.29,3074.44,3074.24,2616.69,7401.16
1489448365048909568,2020-03,1875.45,1475.32,2305.58,5576.9,-2871.19,4529.97
1489448365048909568,2020-04,2331.1,1019.57,3291.08,2099.08,2503.53,7033.5
1489448365048909568,2020-05,1969.72,1097.1,4213.85,1889.75,3196.72,10230.22
1489448365048909568,2020-06,6634.6,2992.14,1383.39,1656.99,3368.86,13599.08
1489448365048909568,2020-07,818.59,5437.91,1255.92,3301.59,-6664.99,6934.09
1489448365048909568,2020-08,1098.28,0,3879.13,1672.4,3305.01,10239.1
1489448365048909568,2020-09,2062.36,764.75,1342.08,1512.52,1127.17,11366.27
1489448365048909568,2020-10,1039.46,2786.84,3343.56,1884.63,-288.45,11077.82
1489448365048909568,2020-11,1921.98,2452.6,4074.56,1677.06,1866.88,12944.7
1489448365048909568,2020-12,0,1469.28,5330.8,2324.42,1537.1,14481.8
1490564557914153728,2020-01,3249.03,2215.89,2091.19,2719.4,404.93,404.93
1490564557914153728,2020-02,2056.34,1778.56,779.75,557.27,500.26,905.19
1490564557914153728,2020-03,3621.58,1560.29,432.62,3796.81,-1302.9,-397.71
1490564557914153728,2020-04,3199.73,4193.68,4113.03,2123.17,995.91,598.2
1490564557914153728,2020-05,7507.66,1672.96,3742.3,1191.58,8385.42,8983.62
1490564557914153728,2020-06,2786.72,1329.92,777.31,4188.39,-1954.28,7029.34
1490564557914153728,2020-07,4043.76,1128.75,1943.29,1670.23,3188.07,10217.41
1490564557914153728,2020-08,1212.28,0,1314.14,6198.96,-3672.54,6544.87
1490564557914153728,2020-09,3445.86,5130.8,1832.71,0,147.77,6692.64
1490564557914153728,2020-10,2883.14,555.56,0,4202.5,-1874.92,4817.72
1490564557914153728,2020-11,2108.96,3258.79,3862.34,2174.38,538.13,5355.85
1490564557914153728,2020-12,1536.19,1535.57,6803.24,2812.13,3991.73,9347.58
1491580794808108288,2020-01,174.64,1196.64,4577.69,143.62,3412.07,3412.07
1491580794808108288,2020-02,1239.72,6098.73,0,2819.77,-7678.78,-4266.71
1491580794808108288,2020-03,0,607.43,362.33,3918.88,-4163.98,-8430.69
1491580794808108288,2020-04,0,824.85,608.28,1297.14,-1513.71,-9944.4
1491580794808108288,2020-05,1569.94,953.66,1311.93,0,1928.21,-8016.19
1491580794808108288,2020-06,2372.31,0,1513.43,4299.47,-413.73,-8429.92
1491580794808108288,2020-07,142.38,2534.15,0,0,-2391.77,-10821.69
1491580794808108288,2020-08,25.38,716.53,1877.66,0,1186.51,-9635.18
1491580794808108288,2020-09,40.32,2105.16,142.07,0,-1922.77,-11557.95
1491580794808108288,2020-10,0,4755.72,385.7,0,-4370.02,-15927.97
1491580794808108288,2020-11,1776.34,0,0,0,1776.34,-14151.63
1491580794808108288,2020-12,3190.84,0,853.15,5128.94,-1084.95,-15236.58
1491894723356504320,2020-03,592.53,0,0,0,592.53,592.53
1491894723356504320,2020-05,840.38,0,0,0,840.38,1432.91
1491894723356504320,2020-06,1885.87,3139.59,0,0,-1253.72,179.19
1491894723356504320,2020-10,0,1376.66,0,617.27,-1993.93,-1814.74
1491894723356504320,2020-11,0,1772.95,0,0,-1772.95,-3587.69
1491894723356504320,2020-12,1269.77,0,0,0,1269.77,-2317.92
1492307590507023616,2020-01,1269.86,0,223.23,0,1493.09,1493.09
1492307590507023616,2020-02,0,1920.11,0,0,-1920.11,-427.02
1492307590507023616,2020-03,1310.4,1240.98,0,0,69.42,-357.6
1492307590507023616,2020-05,296.95,0,0,0,296.95,-60.65
1492307590507023616,2020-06,1476.46,1064.95,0,0,411.51,350.86
1492307590507023616,2020-08,3551.54,491.03,1685.1,0,4745.61,5096.47
1492307590507023616,2020-10,0,1818.92,0,715.66,-2534.58,2561.89
1494268112012713984,2020-01,2041.89,5394.94,7171.78,5728.17,-1909.44,-1909.44
1494268112012713984,2020-02,1008.11,3890.93,0,2155.87,-5038.69,-6948.13
1494268112012713984,2020-03,779.28,0,7302.3,262.96,7818.62,870.49
1494268112012713984,2020-04,4461.85,5656.9,1940.52,5737.29,-4991.82,-4121.33
1494268112012713984,2020-05,1670.09,1447.72,4687.17,2339.53,2570.01,-1551.32
1494268112012713984,2020-06,2650.87,1996.84,3356.13,3964.48,45.68,-1505.64
1494268112012713984,2020-07,5213.84,4436.59,4335.51,2820.44,2292.32,786.68
1494268112012713984,2020-08,1649.9,3122.84,2742.03,4381.06,-3111.97,-2325.29
1494268112012713984,2020-09,3724.85,6354.53,4378.45,1015.36,733.41,-1591.88
1494268112012713984,2020-10,3405.25,9124.16,3983.62,1612.74,-3348.03,-4939.91
1494268112012713984,2020-11,0,3838.63,801.57,5114.26,-8151.32,-13091.23
1494268112012713984,2020-12,5749.39,3045.67,1859.38,3520.37,1042.73,-12048.5
1494857863703537920,2020-01,796.87,2591.62,4435.63,3336.92,-696.04,-696.04
1494857863703537920,2020-02,2978.18,5415.3,6210.89,2193.1,1580.67,884.63
1494857863703537920,2020-03,2545.25,2845.47,1344.22,0,1044,1928.63
1494857863703537920,2020-04,4121.94,1316.97,4239.99,4975.89,2069.07,3997.7
1494857863703537920,2020-05,3490.43,906.94,2666.13,1954.24,3295.38,7293.08
1494857863703537920,2020-06,752.3,3215.54,2834.98,4602.52,-4230.78,3062.3
1494857863703537920,2020-07,1729.98,5255.83,2643.68,1939.17,-2821.34,240.96
1494857863703537920,2020-08,339.26,4994.14,1805.7,0,-2849.18,-2608.22
1494857863703537920,2020-09,1780.96,7000.03,5797.77,1705.33,-1126.63,-3734.85
1494857863703537920,2020-10,8520.94,8598.62,4887,5374.41,-565.09,-4299.94
1494857863703537920,2020-11,5115.3,723.15,0,5499.16,-1107.01,-5406.95
1494857863703537920,2020-12,5918.24,4607.34,4594.01,2456.27,3448.64,-1958.31
1495679069008862208,2020-02,0,1020.53,2853.01,614.22,1218.26,1218.26
1495679069008862208,2020-03,0,649.51,1511.83,1797.2,-934.88,283.38
1495679069008862208,2020-04,0,830.85,0,3140.09,-3970.94,-3687.56
1495679069008862208,2020-05,4079.2,519.24,2878.98,783.47,5655.47,1967.91
1495679069008862208,2020-06,457.39,1508.29,0,116.04,-1166.94,800.97
1495679069008862208,2020-07,4064.82,848.52,1818.16,400.77,4633.69,5434.66
1495679069008862208,2020-08,1047.79,1388.89,850.27,1390.54,-881.37,4553.29
1495679069008862208,2020-09,1910.45,0,6764.36,2513.61,6161.2,10714.49
1495679069008862208,2020-10,0,596.5,1903.68,0,1307.18,12021.67
1495679069008862208,2020-11,0,1305.54,0,0,-1305.54,10716.13
1495679069008862208,2020-12,1848.77,797.5,1742.93,0,2794.2,13510.33
1495774631874614528,2020-01,2393.93,2668.47,4706.19,1939.86,2491.79,2491.79
1495774631874614528,2020-02,1199.59,1836.42,2305.05,3622.15,-1953.93,537.86
1495774631874614528,2020-03,2674.67,1010.3,0,95.47,1568.9,2106.76
1495774631874614528,2020-04,1292.49,1875.45,1833.9,3453.14,-2202.2,-95.44
1495774631874614528,2020-05,1721.42,1707.9,2081.22,1358.14,736.6,641.16
1495774631874614528,2020-06,2364.51,0,4038.45,1786.86,4616.1,5257.26
1495774631874614528,2020-07,1034.33,3806.39,1131.08,1605.65,-3246.63,2010.63
1495774631874614528,2020-08,898.18,3752.41,1301.27,0,-1552.96,457.67
1495774631874614528,2020-09,920.75,1195.97,89.19,509.73,-695.76,-238.09
1495774631874614528,2020-10,1887.32,3336.25,1469.37,1459.18,-1438.74,-1676.83
1495774631874614528,2020-11,2874.27,0,0,624.72,2249.55,572.72
1495774631874614528,2020-12,2321.38,1982.62,3815.09,1437.7,2716.15,3288.87
1496534398219185664,2020-01,4497.69,603.99,1766.11,0,5659.81,5659.81
1496534398219185664,2020-02,4203.97,5452.56,4603.25,2036.66,1318,6977.81
1496534398219185664,2020-03,923.43,3213.8,1027.25,1596.21,-2859.33,4118.48
1496534398219185664,2020-04,5198.68,2499.49,3546.88,2394.01,3852.06,7970.54
1496534398219185664,2020-05,0,3957.93,2183.39,2552.02,-4326.56,3643.98
1496534398219185664,2020-07,10714.46,0,1904.33,3094.92,9523.87,13167.85
1496534398219185664,2020-08,3719.62,778.44,4652.54,3232.67,4361.05,17528.9
1496534398219185664,2020-09,828.11,3764.43,2479.79,4857.16,-5313.69,12215.21
1496534398219185664,2020-10,4078.2,5818.24,1775.71,3755.43,-3719.76,8495.45
1496534398219185664,2020-11,1746.46,2965.48,1440.7,3482.28,-3260.6,5234.85
1496534398219185664,2020-12,2088,1904.3,2982.57,4135.91,-969.64,4265.21
1496976975771070464,2020-01,941.7,2547.66,4929.16,1151.57,2171.63,2171.63
1496976975771070464,2020-02,135.15,4161.61,2720.02,627.07,-1933.51,238.12
1496976975771070464,2020-03,3746.48,2529.74,1240.38,6701.07,-4243.95,-4005.83
1496976975771070464,2020-04,5404.53,1170.66,4327.85,14.99,8546.73,4540.9
1496976975771070464,2020-05,5121.3,2523.17,5221.18,680.12,7139.19,11680.09
1496976975771070464,2020-06,3171.77,0,2066.94,4140.64,1098.07,12778.16
1496976975771070464,2020-07,2022.3,2597.09,2194.41,2576.63,-957.01,11821.15
1496976975771070464,2020-08,2686.36,1349.8,2146.44,3463.71,19.29,11840.44
1496976975771070464,2020-09,615.44,2973.1,3823.71,592.97,873.08,12713.52
1496976975771070464,2020-10,1834.1,1953.03,2669.58,472.28,2078.37,14791.89
1496976975771070464,2020-11,1615.71,1456.13,3283.73,612.18,2831.13,17623.02
1496976975771070464,2020-12,3441.45,1961.84,5790.63,2826.66,4443.58,22066.6
1497955559074832640,2020-01,4041.44,5813.34,3647.54,3098.08,-1222.44,-1222.44
1497955559074832640,2020-02,0,4929.8,275.1,4486.75,-9141.45,-10363.89
1497955559074832640,2020-03,7225.05,10735.5,3364.8,2745.44,-2891.09,-13254.98
1497955559074832640,2020-04,4507.46,2703.46,5556.1,7420.41,-60.31,-13315.29
1497955559074832640,2020-05,9527.79,4797.43,4073.83,4242.66,4561.53,-8753.76
1497955559074832640,2020-06,6449.24,7380.29,4704.33,1886.19,1887.09,-6866.67
1497955559074832640,2020-07,4814.23,8663.12,8139.22,4944.07,-653.74,-7520.41
1497955559074832640,2020-08,8856.09,4473.29,7774,4197.33,7959.47,439.06
1497955559074832640,2020-09,1486.9,4896.4,3362.3,2117.2,-2164.4,-1725.34
1497955559074832640,2020-10,8236.65,2178.08,7767.13,2968.01,10857.69,9132.35
1497955559074832640,2020-11,2157.53,4859.41,3458.01,7003.17,-6247.04,2885.31
1497955559074832640,2020-12,3057.96,5781.77,4029.21,6136.4,-4831,-1945.69
1499345188241916160,2020-01,462.89,3818.87,0,3641.03,-6997.01,-6997.01
1499345188241916160,2020-02,5009.19,2409.93,429.97,1103.66,1925.57,-5071.44
1499345188241916160,2020-03,6059.17,3492.74,5736.47,4799.13,3503.77,-1567.67
1499345188241916160,2020-04,4584.47,1755.75,3295,2276.78,3846.94,2279.27
1499345188241916160,2020-05,4087.63,7457.64,4232.29,8188.78,-7326.5,-5047.23
1499345188241916160,2020-06,3301.27,3678.14,999,543.22,78.91,-4968.32
1499345188241916160,2020-07,2120.79,4110.82,3960.57,4410.58,-2440.04,-7408.36
1499345188241916160,2020-08,1978.25,5597.47,4021.49,0,402.27,-7006.09
1499345188241916160,2020-09,6020.57,232.48,1921.6,2396.1,5313.59,-1692.5
1499345188241916160,2020-10,2677.21,1159.71,1711.68,4655.98,-1426.8,-3119.3
1499345188241916160,2020-11,2163.97,2947.4,2000.77,2895.72,-1678.38,-4797.68
1499345188241916160,2020-12,5412.95,8649.68,4323.65,2961.59,-1874.67,-6672.35
1499426379839918592,2020-02,0,578.88,0,0,-578.88,-578.88
1499426379839918592,2020-03,0,1546.05,0,954.18,-2500.23,-3079.11
1499426379839918592,2020-05,2242.94,0,1518.56,0,3761.5,682.39
1501045361881321472,2020-01,3142.12,1340.34,1794.71,1289.72,2306.77,2306.77
1501045361881321472,2020-02,1912.69,1233.55,0,3822.94,-3143.8,-837.03
1501045361881321472,2020-03,1289.22,719.9,5329.44,1743.02,4155.74,3318.71
1501045361881321472,2020-04,3109.66,975.24,2971.58,761.46,4344.54,7663.25
1501045361881321472,2020-05,0,1524.22,0,618.49,-2142.71,5520.54
1501045361881321472,2020-06,248.76,1967.24,1671.98,1460.78,-1507.28,4013.26
1501045361881321472,2020-07,1528.2,492.33,1592.48,1756.39,871.96,4885.22
1501045361881321472,2020-08,0,4210.26,1052.84,654.92,-3812.34,1072.88
1501045361881321472,2020-09,2828.52,1554.14,2243.75,2334.2,1183.93,2256.81
1501045361881321472,2020-10,1613.07,3471.55,0,241.93,-2100.41,156.4
1501045361881321472,2020-11,3046.03,642.33,2855.17,6319.92,-1061.05,-904.65
1501045361881321472,2020-12,1364.46,1619.87,0,0,-255.41,-1160.06
1501294882164024064,2020-01,4277.2,4678.31,9887.48,5655.38,3830.99,3830.99
1501294882164024064,2020-02,2835.13,5180.6,4593.69,4084.36,-1836.14,1994.85
1501294882164024064,2020-03,4390.45,4797,7278.02,934.21,5937.26,7932.11
1501294882164024064,2020-04,5028.27,14984.13,7911.94,8271.27,-10315.19,-2383.08
1501294882164024064,2020-05,2044,1942.86,6818.15,7146.38,-227.09,-2610.17
1501294882164024064,2020-06,2693.7,4824.48,2105.18,6840.92,-6866.52,-9476.69
1501294882164024064,2020-07,2764.83,4031.66,4047.5,5256.15,-2475.48,-11952.17
1501294882164024064,2020-08,2248.29,6836.82,6121.14,4561.86,-3029.25,-14981.42
1501294882164024064,2020-09,3542.54,3956.67,10480.64,8101.76,1964.75,-13016.67
1501294882164024064,2020-10,2243.68,4934.98,1347.51,6751.54,-8095.33,-21112
1501294882164024064,2020-11,2293.53,4708.43,4615.94,3891.17,-1690.13,-22802.13
1501294882164024064,2020-12,5379.18,7467.05,4145.57,1107.86,949.84,-21852.29
1501608907662963456,2020-01,2731.21,2090.87,0,5743.45,-5103.11,-5103.11
1501608907662963456,2020-02,2178.46,2680.05,2701.55,0,2199.96,-2903.15
1501608907662963456,2020-03,1807.29,1443.27,2420.06,1312.15,1471.93,-1431.22
1501608907662963456,2020-04,356.28,635.42,2024.03,84.52,1660.37,229.15
1501608907662963456,2020-05,1396.03,4936.36,4912.99,1596.86,-224.2,4.95
1501608907662963456,2020-06,3584.42,2315.89,1301.39,1945.1,624.82,629.77
1501608907662963456,2020-07,682.2,630.95,0,2766.69,-2715.44,-2085.67
1501608907662963456,2020-08,0,1560.12,1518.9,2428.43,-2469.65,-4555.32
1501608907662963456,2020-09,1942.62,189.31,3242.32,2601.52,2394.11,-2161.21
1501608907662963456,2020-10,2991.88,3242.69,0,0,-250.81,-2412.02
1501608907662963456,2020-11,1852.98,0,0,1780.34,72.64,-2339.38
1501608907662963456,2020-12,1436.94,1709.39,4178.01,2639.69,1265.87,-1073.51
1509522562878172416,2020-01,6294.08,0,1255.73,3158.34,4391.47,4391.47
1509522562878172416,2020-02,4817.68,3795.5,2640.99,612.77,3050.4,7441.87
1509522562878172416,2020-03,2876.63,4066.44,3658.75,2323.97,144.97,7586.84
1509522562878172416,2020-04,0,654.42,1346.43,270.32,421.69,8008.53
1509522562878172416,2020-05,3485.93,3254.29,912.98,580.68,563.94,8572.47
1509522562878172416,2020-06,2849.89,4843.48,1393.01,1815.71,-2416.29,6156.18
1509522562878172416,2020-07,3642.87,4319.41,1706.63,1694.77,-664.68,5491.5
1509522562878172416,2020-08,1756.47,1900.95,1791.22,554.41,1092.33,6583.83
1509522562878172416,2020-09,2219.15,1542.49,1966.22,1480.42,1162.46,7746.29
1509522562878172416,2020-10,4238.6,4214.02,3248,5413.63,-2141.05,5605.24
1509522562878172416,2020-11,1798.57,4729.69,759.19,2283.08,-4455.01,1150.23
1509522562878172416,2020-12,5518.04,6096.29,1900.56,2159.11,-836.8,313.43
1510853455410048768,2020-01,3494.98,2289.1,1929.95,3229.03,-93.2,-93.2
1510853455410048768,2020-02,5116.78,3071.23,7654.86,377.62,9322.79,9229.59
1510853455410048768,2020-03,683.14,1355.05,1479.02,1258.6,-451.49,8778.1
1510853455410048768,2020-04,5312.99,2930.44,2539.2,3694.34,1227.41,10005.51
1510853455410048768,2020-05,5571.44,2234.41,1230.09,3170.78,1396.34,11401.85
1510853455410048768,2020-06,3683.8,5336.2,933.05,2717.2,-3436.55,7965.3
1510853455410048768,2020-07,1669.03,7585.7,4102.45,1921.17,-3735.39,4229.91
1510853455410048768,2020-08,2133.46,0,4184,2808.15,3509.31,7739.22
1510853455410048768,2020-09,1551.1,1270.31,1098.5,4182.54,-2803.25,4935.97
1510853455410048768,2020-10,2818.19,1205.83,3530.94,2331.96,2811.34,7747.31
1510853455410048768,2020-11,4036.41,69.55,2071.81,1216.48,4822.19,12569.5
1510853455410048768,2020-12,2254.75,6027.33,10074.83,1325.6,4976.65,17546.15
1511610173462262784,2020-01,0,50.98,3011.38,1045.6,1914.8,1914.8
1511610173462262784,2020-02,4095.46,2797.74,1981.3,0,3279.02,5193.82
1511610173462262784,2020-03,1243.47,6335.14,1169.32,2969.04,-6891.39,-1697.57
1511610173462262784,2020-04,121.09,0,1368.24,3078.05,-1588.72,-3286.29
1511610173462262784,2020-05,1071.9,2068.37,0,3795.93,-4792.4,-8078.69
1511610173462262784,2020-07,3241.91,1929.92,2053.05,1263.12,2101.92,-5976.77
1511610173462262784,2020-08,0,1360.26,2949.11,2159.4,-570.55,-6547.32
1511610173462262784,2020-09,2149.99,0,0,3836.12,-1686.13,-8233.45
1511610173462262784,2020-10,2229.93,1062.76,0,2706.85,-1539.68,-9773.13
1511610173462262784,2020-11,1887.1,4102.97,0,0,-2215.87,-11989
1511610173462262784,2020-12,4914,952.18,5454.32,1388.42,8027.72,-3961.28
1511891645528019968,2020-01,4938.72,0,2336.51,440.99,6834.24,6834.24
1511891645528019968,2020-02,0,2004.7,994.96,1278.03,-2287.77,4546.47
1511891645528019968,2020-03,0,3206.91,4060.3,0,853.39,5399.86
1511891645528019968,2020-04,0,1458.73,0,3312.91,-4771.64,628.22
1511891645528019968,2020-06,1830.5,1083.65,0,1727.59,-980.74,-352.52
1511891645528019968,2020-07,1561.85,501.82,3074.63,0,4134.66,3782.14
1511891645528019968,2020-08,50.88,0,982.14,1209.01,-175.99,3606.15
1511891645528019968,2020-09,635.9,174.74,0,0,461.16,4067.31
1511891645528019968,2020-11,1161.15,3094.56,52.48,303.49,-2184.42,1882.89
1511891645528019968,2020-12,0,1045.69,1636.92,0,591.23,2474.12
1512203941702640384,2020-01,3898.38,5277.85,1370.95,3524.91,-3533.43,-3533.43
1512203941702640384,2020-02,4730.18,3405.07,4786.45,1692.94,4418.62,885.19
1512203941702640384,2020-03,3882.96,5090.12,1941.62,1370.12,-635.66,249.53
1512203941702640384,2020-04,4228.26,4794.44,4266.74,3652.31,48.25,297.78
1512203941702640384,2020-05,2712.19,1232.23,6092.55,3036.11,4536.4,4834.18
1512203941702640384,2020-06,3645.45,3162.05,4314.58,3219.35,1578.63,6412.81
1512203941702640384,2020-07,1791.89,267.59,8594.85,5577.69,4541.46,10954.27
1512203941702640384,2020-08,3947.32,5971.21,2316.37,2111.36,-1818.88,9135.39
1512203941702640384,2020-09,3060.82,2562.9,2694.43,3861.21,-668.86,8466.53
1512203941702640384,2020-10,8249.49,1693.9,6396.24,3803.52,9148.31,17614.84
1512203941702640384,2020-11,6643.16,7382.25,2758.2,3883.1,-1863.99,15750.85
1512203941702640384,2020-12,0,451,1559.05,3646.44,-2538.39,13212.46
1513068701380254464,2020-06,1264.4,0,0,89.94,1174.46,1174.46
1513343434018424320,2020-01,549.33,0,1143.2,3117.8,-1425.27,-1425.27
1513343434018424320,2020-02,1312.11,0,1039.42,1756.77,594.76,-830.51
1513343434018424320,2020-03,0,2120.24,2894.41,0,774.17,-56.34
1513343434018424320,2020-04,0,591.74,1634.22,0,1042.48,986.14
1513343434018424320,2020-05,0,1916.91,2089.37,207.11,-34.65,951.49
1513343434018424320,2020-06,464.89,3430.51,0,2773.7,-5739.32,-4787.83
1513343434018424320,2020-07,0,1594.21,239.74,145.33,-1499.8,-6287.63
1513343434018424320,2020-08,0,963.79,558.6,1849.67,-2254.86,-8542.49
1513343434018424320,2020-09,0,1764.73,1278.81,1817.9,-2303.82,-10846.31
1513343434018424320,2020-10,3159.79,1825.76,1727.3,4517,-1455.67,-12301.98
1513343434018424320,2020-11,0,892.16,726.34,1879.26,-2045.08,-14347.06
1513343434018424320,2020-12,0,3095.76,4013.77,669.39,248.62,-14098.44
1513478644922515456,2020-01,4245.78,4786.38,5092.23,1984.55,2567.08,2567.08
1513478644922515456,2020-02,5671.07,4187.08,6401.38,6589.3,1296.07,3863.15
1513478644922515456,2020-03,4039.99,6069.88,3944.94,6634.43,-4719.38,-856.23
1513478644922515456,2020-04,2147.62,2209.28,282.15,2744.85,-2524.36,-3380.59
1513478644922515456,2020-05,3071.2,935.97,3656.49,4600.56,1191.16,-2189.43
1513478644922515456,2020-06,6141.02,1639.34,5159.44,10538.59,-877.47,-3066.9
1513478644922515456,2020-07,3194.26,2746.73,4201.63,6405.58,-1756.42,-4823.32
1513478644922515456,2020-08,4888.26,2250.15,5238.72,2402.6,5474.23,650.91
1513478644922515456,2020-09,7899.04,8883.46,4804.42,4118.36,-298.36,352.55
1513478644922515456,2020-10,1197.61,1413.68,4561.5,1926.26,2419.17,2771.72
1513478644922515456,2020-11,1102.42,3649.63,3772.05,2596.98,-1372.14,1399.58
1513478644922515456,2020-12,4716.13,274.98,3156.72,1730.97,5866.9,7266.48
1514176474193112832,2020-01,2971.86,1667.94,0,2362.81,-1058.89,-1058.89
1514176474193112832,2020-02,1576.99,399.4,3170.83,3499.09,849.33,-209.56
1514176474193112832,2020-03,513.97,269.12,0,1967.78,-1722.93,-1932.49
1514176474193112832,2020-04,3668.47,2694.26,1054.58,3058.47,-1029.68,-2962.17
1514176474193112832,2020-05,1890.25,2118.81,5708.08,2778.18,2701.34,-260.83
1514176474193112832,2020-06,761.43,1564.39,355.21,5983.95,-6431.7,-6692.53
1514176474193112832,2020-07,3521.67,4311.84,4068.72,1022.55,2256,-4436.53
1514176474193112832,2020-08,0,3904.57,1686.53,5676.73,-7894.77,-12331.3
1514176474193112832,2020-09,2953.68,3715.82,2831.04,900.82,1168.08,-11163.22
1514176474193112832,2020-10,958.14,1653.45,1810.65,1629.45,-514.11,-11677.33
1514176474193112832,2020-11,751.04,0,283.53,2707.34,-1672.77,-13350.1
1514176474193112832,2020-12,3122.76,0,2533.85,1565.8,4090.81,-9259.29
1515369777821571072,2020-01,0,4714.86,690.19,317.48,-4342.15,-4342.15
1515369777821571072,2020-02,4746.59,1573.17,0,1758.77,1414.65,-2927.5
1515369777821571072,2020-03,3459.4,4966.35,259.34,1923.5,-3171.11,-6098.61
1515369777821571072,2020-04,5269.58,4449.94,2348.93,3384.61,-216.04,-6314.65
1515369777821571072,2020-05,1824.25,2440.31,3868.62,6450.1,-3197.54,-9512.19
1515369777821571072,2020-06,5681.26,1316.99,2445.19,1350.89,5458.57,-4053.62
1515369777821571072,2020-07,1566.03,59.55,2633.52,828.76,3311.24,-742.38
1515369777821571072,2020-08,1725.98,3206.65,1999.29,6313.62,-5795,-6537.38
1515369777821571072,2020-09,2267.09,7171.14,5023,1986.2,-1867.25,-8404.63
1515369777821571072,2020-10,1918.29,0,2614.15,2956.48,1575.96,-6828.67
1515369777821571072,2020-11,2190.09,2314.49,3349.17,1122.2,2102.57,-4726.1
1515369777821571072,2020-12,3986.98,4610.6,3135.91,10.64,2501.65,-2224.45
1516881219755529984,2020-01,3774.52,2853,3619.28,5421.01,-880.21,-880.21
1516881219755529984,2020-02,8210.95,3982.85,8035.92,3729.95,8534.07,7653.86
1516881219755529984,2020-03,3257.21,1164.61,609.73,7926.18,-5223.85,2430.01
1516881219755529984,2020-04,1679.59,4137.56,3722.48,7810.18,-6545.67,-4115.66
1516881219755529984,2020-05,9759.92,4051.56,2378.42,3691.25,4395.53,279.87
1516881219755529984,2020-06,6716.15,8175.62,4165.25,4736.37,-2030.59,-1750.72
1516881219755529984,2020-07,1093.22,6093.63,5048.8,1979.45,-1931.06,-3681.78
1516881219755529984,2020-08,2999.92,2322.09,1008.11,6097.59,-4411.65,-8093.43
1516881219755529984,2020-09,3087.13,4051.06,1142.22,1646.05,-1467.76,-9561.19
1516881219755529984,2020-10,224.58,3296.43,1493.05,3951.21,-5530.01,-15091.2
1516881219755529984,2020-11,2512.69,8425.69,5160.84,6392.13,-7144.29,-22235.49
1516881219755529984,2020-12,8494,1872.93,3660.94,624.72,9657.29,-12578.2
1518248494148252160,2020-01,1436.51,5014.29,4609.86,2933.02,-1900.94,-1900.94
1518248494148252160,2020-02,3128.6,2187.52,6344.92,5162.68,2123.32,222.38
1518248494148252160,2020-03,5230.35,6004.76,3362.89,4920.24,-2331.76,-2109.38
1518248494148252160,2020-04,2999.78,412.8,3993.75,3060.5,3520.23,1410.85
1518248494148252160,2020-05,3975.93,2832.91,4497.51,0,5640.53,7051.38
1518248494148252160,2020-06,6315.47,2456,2556.55,7530.52,-1114.5,5936.88
1518248494148252160,2020-07,1947.61,2547.42,6308.64,4111.57,1597.26,7534.14
1518248494148252160,2020-08,1798.27,0,2445.24,1221.21,3022.3,10556.44
1518248494148252160,2020-09,3724.22,2060.49,4180.49,2174.58,3669.64,14226.08
1518248494148252160,2020-10,6337.57,9769.64,2053.52,3025.98,-4404.53,9821.55
1518248494148252160,2020-11,0,866.92,7068.91,2502.01,3699.98,13521.53
1518248494148252160,2020-12,3488.63,3242.3,2243.67,2330.94,159.06,13680.59
1519518249603361280,2020-01,5223.81,3155.14,1358.65,2547.83,879.49,879.49
1519518249603361280,2020-02,2398.95,2577.31,1393.88,6874.66,-5659.14,-4779.65
1519518249603361280,2020-03,3520.44,960.61,2084.94,3078.45,1566.32,-3213.33
1519518249603361280,2020-04,4838.92,2618.19,1214.38,3917.1,-481.99,-3695.32
1519518249603361280,2020-05,2742.08,4404.99,4322.65,9140.93,-6481.19,-10176.51
1519518249603361280,2020-06,6191.12,5821.55,4088.5,626.83,3831.24,-6345.27
1519518249603361280,2020-07,4121.59,5880.26,3175.69,3302.98,-1885.96,-8231.23
1519518249603361280,2020-08,3705.97,1360.4,4686.98,3264.83,3767.72,-4463.51
1519518249603361280,2020-09,2742.33,10735.07,3544.93,17995.3,-22443.11,-26906.62
1519518249603361280,2020-10,2441.53,4035.14,8284.32,3755.83,2934.88,-23971.74
1519518249603361280,2020-11,3580.97,1475.32,2250.53,5785.37,-1429.19,-25400.93
1519518249603361280,2020-12,3689.11,1528.84,1295.83,3051.83,404.27,-24996.66
1519783602089274368,2020-03,0,1076.46,0,0,-1076.46,-1076.46
1519783602089274368,2020-04,888.78,0,0,0,888.78,-187.68
1519783602089274368,2020-05,1483.4,0,1528.21,0,3011.61,2823.93
1519783602089274368,2020-07,0,1588.27,0,323.89,-1912.16,911.77
1519783602089274368,2020-08,233.1,0,1024.06,1262.58,-5.42,906.35
1519783602089274368,2020-09,1591.25,130.54,0,979.88,480.83,1387.18
1519783602089274368,2020-10,663.44,1048.24,0,0,-384.8,1002.38
1519783602089274368,2020-11,687.77,0,0,1947.83,-1260.06,-257.68
1519783602089274368,2020-12,1513.17,0,0,0,1513.17,1255.49
1522670673066590208,2020-01,1491.4,0,1656.54,0,3147.94,3147.94
1522670673066590208,2020-02,2201.46,42.4,1359.36,0,3518.42,6666.36
1522670673066590208,2020-03,0,531.59,719.71,548.69,-360.57,6305.79
1522670673066590208,2020-04,0,142.33,553.16,645.9,-235.07,6070.72
1522670673066590208,2020-05,0,1492.01,0,0,-1492.01,4578.71
1522670673066590208,2020-07,1596.62,1170.1,1784.99,187.8,2023.71,6602.42
1522670673066590208,2020-08,982.65,1645.53,0,0,-662.88,5939.54
1522670673066590208,2020-09,832.96,1701.05,652.69,1533.63,-1749.03,4190.51
1522670673066590208,2020-10,1355.59,0,763.76,123.62,1995.73,6186.24
1522670673066590208,2020-12,1752.99,0,0,203.87,1549.12,7735.36
1523969530117124864,2020-01,0,1741.35,471.71,0,-1269.64,-1269.64
1523969530117124864,2020-05,0,1302.98,1305.42,0,2.44,-1267.2
1523969530117124864,2020-08,0,1737.85,0,0,-1737.85,-3005.05
1523969530117124864,2020-09,1840.76,0,0,0,1840.76,-1164.29
1523969530117124864,2020-10,3767.43,0,3359.63,0,7127.06,5962.77
1523969530117124864,2020-12,0,284.66,1218.49,782.12,151.71,6114.48
1524113744377262336,2020-01,1241.28,0,1909.58,0,3150.86,3150.86
1524113744377262336,2020-02,0,2113.49,158.46,0,-1955.03,1195.83
1524113744377262336,2020-03,0,1779.05,468.56,6816.86,-8127.35,-6931.52
1524113744377262336,2020-04,2371.38,1431.56,2184.88,227.2,2897.5,-4034.02
1524113744377262336,2020-05,0,1895.95,5115.51,2404.12,815.44,-3218.58
1524113744377262336,2020-06,0,1274.29,2002.47,3430.27,-2702.09,-5920.67
1524113744377262336,2020-07,765.97,329.85,655.03,0,1091.15,-4829.52
1524113744377262336,2020-08,0,3242.56,150.56,1017.27,-4109.27,-8938.79
1524113744377262336,2020-09,0,2546.15,3156.93,1306.57,-695.79,-9634.58
1524113744377262336,2020-10,0,847.94,3368.78,38.3,2482.54,-7152.04
1524113744377262336,2020-11,3298.7,1179.61,1131.65,1955.46,1295.28,-5856.76
1524113744377262336,2020-12,2183.81,1401.79,350.6,2051.59,-918.97,-6775.73
1525474525773414656,2020-01,1685.22,4007.94,0,554.77,-2877.49,-2877.49
1525474525773414656,2020-02,2349.88,132.48,1588.86,2215.32,1590.94,-1286.55
1525474525773414656,2020-04,2309.24,285.65,1453.27,492.51,2984.35,1697.8
1525474525773414656,2020-05,3281.05,728.69,3710.89,340.15,5923.1,7620.9
1525474525773414656,2020-06,3112.18,2066.58,2482.59,1809.15,1719.04,9339.94
1525474525773414656,2020-07,3947.16,4314.17,3457.81,5987.69,-2896.89,6443.05
1525474525773414656,2020-08,2576,1936.91,4711.34,2365.44,2984.99,9428.04
1525474525773414656,2020-09,2405.88,0,1082.89,1887.73,1601.04,11029.08
1525474525773414656,2020-10,1472.33,3077.97,5204.37,190.54,3408.19,14437.27
1525474525773414656,2020-11,3227.62,5580.6,628.67,1955.81,-3680.12,10757.15
1525474525773414656,2020-12,3154.48,1750.86,1904.44,1558.04,1750.02,12507.17
1526556092256880896,2020-01,2695.25,2186.03,1828.83,4144.27,-1806.22,-1806.22
1526556092256880896,2020-02,2370.94,586.59,1215.42,2224.93,774.84,-1031.38
1526556092256880896,2020-03,0,1083.24,7598.62,2884.18,3631.2,2599.82
1526556092256880896,2020-04,3694.15,1269.12,2848.56,561.73,4711.86,7311.68
1526556092256880896,2020-05,1713.18,4863.29,1922.38,6870.07,-8097.8,-786.12
1526556092256880896,2020-06,7607.96,5540.34,3390.17,5754.07,-296.28,-1082.4
1526556092256880896,2020-07,3470.15,3820.57,2396.41,11085.6,-9039.61,-10122.01
1526556092256880896,2020-08,1840.86,3140.57,7737.72,2366.13,4071.88,-6050.13
1526556092256880896,2020-09,2044.56,3275.51,1195.97,3109.5,-3144.48,-9194.61
1526556092256880896,2020-10,3573.27,4747.59,7783.38,4229.19,2379.87,-6814.74
1526556092256880896,2020-11,995.62,1595.76,5995.24,2624.44,2770.66,-4044.08
1526556092256880896,2020-12,6667.27,915.25,8089.42,6960.95,6880.49,2836.41
1528359819346983680,2020-01,1368.13,2652.32,2568.17,1822.88,-538.9,-538.9
1528359819346983680,2020-02,0,2012.23,1315.77,2318.24,-3014.7,-3553.6
1528359819346983680,2020-03,288.18,1640.86,2765.41,1913.55,-500.82,-4054.42
1528359819346983680,2020-04,3091.79,0,1273.46,1466.15,2899.1,-1155.32
1528359819346983680,2020-05,4719.02,2709.36,0,0,2009.66,854.34
1528359819346983680,2020-06,1897.37,2238.42,0,4406.55,-4747.6,-3893.26
1528359819346983680,2020-07,2403.13,1457.65,3324.09,1178.73,3090.84,-802.42
1528359819346983680,2020-08,900.97,1347.51,4287.22,2233.62,1607.06,804.64
1528359819346983680,2020-09,1272.79,3737.6,307.8,2105.64,-4262.65,-3458.01
1528359819346983680,2020-10,0,665.63,1268.07,670.98,-68.54,-3526.55
1528359819346983680,2020-11,2253.56,1401.46,1312.87,1341.15,823.82,-2702.73
1528359819346983680,2020-12,5644.27,2729.39,4261.41,0,7176.29,4473.56
1528696638764825600,2020-01,1763.94,0,0,0,1763.94,1763.94
1528696638764825600,2020-02,928.55,4366.52,879.5,0,-2558.47,-794.53
1528696638764825600,2020-03,1408.03,0,2525.69,577.93,3355.79,2561.26
1528696638764825600,2020-06,0,1552.71,0,0,-1552.71,1008.55
1528696638764825600,2020-07,1566.36,1418.53,0,0,147.83,1156.38
1528696638764825600,2020-08,0,253.44,4000.63,4506.82,-759.63,396.75
1528696638764825600,2020-09,19.75,946.83,604.34,807.75,-1130.49,-733.74
1528696638764825600,2020-10,1020.83,3321.73,0,0,-2300.9,-3034.64
1528696638764825600,2020-11,0,527.99,0,0,-527.99,-3562.63
1528696638764825600,2020-12,183.15,0,1813.42,0,1996.57,-1566.06
1529958866423532032,2020-01,1269.84,0,3446.1,2168.51,2547.43,2547.43
1529958866423532032,2020-02,2776.26,1971.98,2355.64,5101.36,-1941.44,605.99
1529958866423532032,2020-03,0,3768.76,1428.17,0,-2340.59,-1734.6
1529958866423532032,2020-04,1070.04,585.56,0,1766.61,-1282.13,-3016.73
1529958866423532032,2020-05,3275.83,329.22,400.02,3604.36,-257.73,-3274.46
1529958866423532032,2020-06,1237.03,1304.83,0,668.1,-735.9,-4010.36
1529958866423532032,2020-07,2429.02,3947.9,1700.28,0,181.4,-3828.96
1529958866423532032,2020-08,4512.61,2334.17,995.82,2438.53,735.73,-3093.23
1529958866423532032,2020-09,0,1531.71,933.41,65.46,-663.76,-3756.99
1529958866423532032,2020-11,844.67,1704.87,3189.87,3275.4,-945.73,-4702.72
1529958866423532032,2020-12,3138.63,992.36,94.15,2571.85,-331.43,-5034.15
1530650078450824448,2020-01,998.8,3001.42,2790.85,1976.21,-1187.98,-1187.98
1530650078450824448,2020-02,3112.51,3902.61,1531.84,1502.72,-760.98,-1948.96
1530650078450824448,2020-04,1465.6,651.12,1468.13,3265.76,-983.15,-2932.11
1530650078450824448,2020-05,2384.21,754.82,0,262.92,1366.47,-1565.64
1530650078450824448,2020-06,0,2866.3,2072.2,746.97,-1541.07,-3106.71
1530650078450824448,2020-07,868.48,1333.83,420.96,6438.09,-6482.48,-9589.19
1530650078450824448,2020-08,889.94,0,559.19,0,1449.13,-8140.06
1530650078450824448,2020-09,1737.92,145.69,1891.3,2412.59,1070.94,-7069.12
1530650078450824448,2020-10,2991.93,3486.75,629.56,2736.63,-2601.89,-9671.01
1530650078450824448,2020-11,2297.84,4973.77,2671.98,1928.68,-1932.63,-11603.64
1530650078450824448,2020-12,1792.15,3675.03,1337.82,3307.93,-3852.99,-15456.63
1532060019533014528,2020-01,6646.36,1366.26,3299.03,3806.76,4772.37,4772.37
1532060019533014528,2020-02,3032.46,3482.46,3100.08,1523.53,1126.55,5898.92
1532060019533014528,2020-03,3693.06,24.59,2151.12,4229.13,1590.46,7489.38
1532060019533014528,2020-04,3652,3811.81,2269.42,5531.62,-3422.01,4067.37
1532060019533014528,2020-05,2685.35,890.24,0,2431.25,-636.14,3431.23
1532060019533014528,2020-06,4352.75,8382.4,3549.32,7333,-7813.33,-4382.1
1532060019533014528,2020-07,1050.17,7993.4,2991.19,4572.31,-8524.35,-12906.45
1532060019533014528,2020-08,3426.12,6422.72,1522.1,6387.33,-7861.83,-20768.28
1532060019533014528,2020-09,4768.38,2801.24,2086.33,3784.74,268.73,-20499.55
1532060019533014528,2020-10,1821.33,4040.44,2808.55,871.91,-282.47,-20782.02
1532060019533014528,2020-11,3787.32,3678.63,4704.04,2566.58,2246.15,-18535.87
1532060019533014528,2020-12,5453.13,523.2,1349.22,0,6279.15,-12256.72
1532404898197711616,2020-01,348.87,2561.44,1461.51,894.04,-1645.1,-1645.1
1532404898197711616,2020-02,3937.8,2001.82,0,1365.74,570.24,-1074.86
1532404898197711616,2020-03,1718.88,814.48,1571.2,1587.39,888.21,-186.65
1532404898197711616,2020-04,812.28,765.81,0,724.37,-677.9,-864.55
1532404898197711616,2020-05,0,5609.91,3561.42,0,-2048.49,-2913.04
1532404898197711616,2020-06,3996.98,1379.81,0,1019.45,1597.72,-1315.32
1532404898197711616,2020-07,2768.12,0,2425.65,1752.39,3441.38,2126.06
1532404898197711616,2020-08,3182.08,1108.23,4669.99,0,6743.84,8869.9
1532404898197711616,2020-09,981.75,0,5711.55,0,6693.3,15563.2
1532404898197711616,2020-10,2988.18,1998.02,0,428.2,561.96,16125.16
1532404898197711616,2020-11,1801.72,3059.58,0,3502.88,-4760.74,11364.42
1532404898197711616,2020-12,29.27,0,1416.35,3917.37,-2471.75,8892.67
1534934559514399744,2020-01,0,21.81,0,292.31,-314.12,-314.12
1534934559514399744,2020-02,3501.83,876.43,704.42,0,3329.82,3015.7
1534934559514399744,2020-04,563.69,720.66,0,0,-156.97,2858.73
1534934559514399744,2020-05,0,232.82,37.54,0,-195.28,2663.45
1534934559514399744,2020-06,0,3774.34,2238.66,778.63,-2314.31,349.14
1534934559514399744,2020-08,25.41,0,0,1938.71,-1913.3,-1564.16
1534934559514399744,2020-09,1161.37,479.42,280.37,1189.16,-226.84,-1791
1534934559514399744,2020-10,0,257.95,200.82,0,-57.13,-1848.13
1534934559514399744,2020-11,313.66,2069.66,0,1752.32,-3508.32,-5356.45
1534934559514399744,2020-12,1790.39,302.71,0,0,1487.68,-3868.77
1536970354273940992,2020-01,2487.42,3600.15,4947.93,4326.87,-491.67,-491.67
1536970354273940992,2020-02,4110.76,3882.38,1115.37,2602.9,-1259.15,-1750.82
1536970354273940992,2020-03,4832.42,2719.2,0,2561.05,-447.83,-2198.65
1536970354273940992,2020-04,5043.67,2814.92,1177.72,3040.36,366.11,-1832.54
1536970354273940992,2020-05,1576.55,1653.65,1046.03,0,968.93,-863.61
1536970354273940992,2020-06,2103.54,3247.4,3189.2,6745.95,-4700.61,-5564.22
1536970354273940992,2020-07,3442.91,403.2,3138.36,3559.16,2618.91,-2945.31
1536970354273940992,2020-08,0,1721.56,2215.61,8572.95,-8078.9,-11024.21
1536970354273940992,2020-09,3474.28,1861.49,3978.85,4126.01,1465.63,-9558.58
1536970354273940992,2020-10,0,762.69,2033.43,2846.84,-1576.1,-11134.68
1536970354273940992,2020-11,2064.18,4010.89,1358.13,546.39,-1134.97,-12269.65
1536970354273940992,2020-12,3215.66,0,4541.48,4192.39,3564.75,-8704.9
1539301057237360128,2020-01,4995.89,1034.77,2520.6,4473.5,2008.22,2008.22
1539301057237360128,2020-02,0,2047.89,1006.03,539.19,-1581.05,427.17
1539301057237360128,2020-03,260.64,0,1161.22,0,1421.86,1849.03
1539301057237360128,2020-04,0,2881.04,915.12,643.55,-2609.47,-760.44
1539301057237360128,2020-05,1801.53,2706.04,5972.91,312.25,4756.15,3995.71
1539301057237360128,2020-06,1066.78,867.61,3936.43,2025.6,2110,6105.71
1539301057237360128,2020-07,2102.2,1472.8,430.31,418.31,641.4,6747.11
1539301057237360128,2020-08,1597.05,1076.04,868.78,0,1389.79,8136.9
1539301057237360128,2020-09,0,1329.34,721.6,0,-607.74,7529.16
1539301057237360128,2020-10,5997.53,2792.75,713.97,1666.09,2252.66,9781.82
1539301057237360128,2020-11,2993.36,1742.5,1930.54,0,3181.4,12963.22
1539301057237360128,2020-12,1616.38,2486.46,3412.81,4262.18,-1719.45,11243.77
1540994009165377536,2020-01,1449.99,1454.98,4334.28,6188.45,-1859.16,-1859.16
1540994009165377536,2020-02,855.88,3414.52,2937.77,986.82,-607.69,-2466.85
1540994009165377536,2020-03,1205.57,2161.84,3377.93,1841.59,580.07,-1886.78
1540994009165377536,2020-04,1385.83,4845.56,1629.94,0,-1829.79,-3716.57
1540994009165377536,2020-05,4213.16,2053.14,802,7629.76,-4667.74,-8384.31
1540994009165377536,2020-06,3067.13,1645.01,5676.67,276.26,6822.53,-1561.78
1540994009165377536,2020-07,3814.51,4090.5,3010.27,0,2734.28,1172.5
1540994009165377536,2020-08,3377.05,3513.22,4340.76,1011.03,3193.56,4366.06
1540994009165377536,2020-09,1334.33,1970.06,1261.55,495.03,130.79,4496.85
1540994009165377536,2020-10,0,2193.42,730.6,5936.17,-7398.99,-2902.14
1540994009165377536,2020-11,2685.11,1734.83,4272.75,1985.28,3237.75,335.61
1540994009165377536,2020-12,2928.69,3870.33,2138.75,809.03,388.08,723.69
1542101933366636544,2020-01,2820.43,1349.4,1688.29,736.04,2423.28,2423.28
1542101933366636544,2020-02,2280.75,0,2336.57,3213.63,1403.69,3826.97
1542101933366636544,2020-03,401.81,2853.2,4611.03,1232.41,927.23,4754.2
1542101933366636544,2020-04,348.07,4625.79,2233.39,0,-2044.33,2709.87
1542101933366636544,2020-05,317.77,1681.01,0,2968.67,-4331.91,-1622.04
1542101933366636544,2020-06,485.61,1431.52,3521.93,1868.09,707.93,-914.11
1542101933366636544,2020-07,126.81,1596.97,3532.96,1267.31,795.49,-118.62
1542101933366636544,2020-08,1911.35,1347.94,4831.59,201.14,5193.86,5075.24
1542101933366636544,2020-09,1657.1,1821.88,2408.94,0,2244.16,7319.4
1542101933366636544,2020-10,3667.03,3811.98,3390.45,0,3245.5,10564.9
1542101933366636544,2020-11,1691.45,233.04,0,3572.61,-2114.2,8450.7
1542101933366636544,2020-12,1571.04,0,2485.07,89.68,3966.43,12417.13
1542900245793389568,2020-01,821.41,7509.43,4047.89,1117.34,-3757.47,-3757.47
1542900245793389568,2020-02,1807.51,0,3602.57,293.85,5116.23,1358.76
1542900245793389568,2020-03,1210.95,4271.52,3001.04,0,-59.53,1299.23
1542900245793389568,2020-04,3898.26,1780.45,312.28,135.86,2294.23,3593.46
1542900245793389568,2020-05,2701.76,5502.31,2332.1,1709.09,-2177.54,1415.92
1542900245793389568,2020-06,1712.54,2595.23,5409.28,0,4526.59,5942.51
1542900245793389568,2020-07,0,1072.37,3117.6,0,2045.23,7987.74
1542900245793389568,2020-08,0,752.15,1830.24,3251.81,-2173.72,5814.02
1542900245793389568,2020-09,844.41,4048.98,0,573.35,-3777.92,2036.1
1542900245793389568,2020-10,478.63,2905.42,1662.04,4966.12,-5730.87,-3694.77
1542900245793389568,2020-11,2920.66,2487.22,5210.81,1748.24,3896.01,201.24
1542900245793389568,2020-12,1522.44,2336.8,3412.22,0,2597.86,2799.1
1544383750174618368,2020-01,4398.53,2213.96,3358.67,2808.77,2734.47,2734.47
1544383750174618368,2020-02,4699.03,3475.42,3839.26,11201.06,-6138.19,-3403.72
1544383750174618368,2020-03,2295.35,2718.91,3492.26,1971.42,1097.28,-2306.44
1544383750174618368,2020-04,4078.11,5143.07,3031.52,2725.68,-759.12,-3065.56
1544383750174618368,2020-05,4386.8,4810.78,975.36,4143.06,-3591.68,-6657.24
1544383750174618368,2020-06,3576.84,1290.01,6126.78,2475.71,5937.9,-719.34
1544383750174618368,2020-07,4933.75,5967.67,8568.41,1633.26,5901.23,5181.89
1544383750174618368,2020-08,1376.13,3081.26,3799.57,798.28,1296.16,6478.05
1544383750174618368,2020-09,1473.09,7243.24,3775.04,1290.07,-3285.18,3192.87
1544383750174618368,2020-10,2062.25,3427.42,1896.61,3548.16,-3016.72,176.15
1544383750174618368,2020-11,2454.33,1445.63,4868.15,4328.85,1548,1724.15
1544383750174618368,2020-12,4228.92,1965.57,2000.46,1313.4,2950.41,4674.56
1544735128301050880,2020-01,14118.13,6164.58,6818.51,9466.32,5305.74,5305.74
1544735128301050880,2020-02,6194.33,7159.84,1434.46,6080.47,-5611.52,-305.78
1544735128301050880,2020-03,4971.65,6457.01,9464.3,2405.3,5573.64,5267.86
1544735128301050880,2020-04,4155.88,0,3551.69,12275.74,-4568.17,699.69
1544735128301050880,2020-05,1624.32,6000.2,4363.96,7227.92,-7239.84,-6540.15
1544735128301050880,2020-06,3905.81,7921.68,4969.82,2933.15,-1979.2,-8519.35
1544735128301050880,2020-07,6344.95,5310.71,3632.24,6979.99,-2313.51,-10832.86
1544735128301050880,2020-08,3880.41,2956.42,3672.51,4602.56,-6.06,-10838.92
1544735128301050880,2020-09,5178.76,1893.58,545.54,2755.17,1075.55,-9763.37
1544735128301050880,2020-10,1781.26,6089.57,7625.56,1748.63,1568.62,-8194.75
1544735128301050880,2020-11,3896.25,5846.66,4947.57,6535.89,-3538.73,-11733.48
1544735128301050880,2020-12,5256.2,7887.74,4066,7362.69,-5928.23,-17661.71
1547632621207276288,2020-01,0,706.7,275.37,838.08,-1269.41,-1269.41
1547632621207276288,2020-02,0,158.9,0,0,-158.9,-1428.31
1547632621207276288,2020-04,2577.93,0,0,0,2577.93,1149.62
1547632621207276288,2020-06,0,1575.28,1582.79,0,7.51,1157.13
1547632621207276288,2020-07,1377.27,1517.53,1637.39,1513.39,-16.26,1140.87
1547632621207276288,2020-08,1551.92,0,0,3612.16,-2060.24,-919.37
1547632621207276288,2020-09,2611.57,3100.94,0,0,-489.37,-1408.74
1547632621207276288,2020-12,0,696.7,0,0,-696.7,-2105.44
1548553045059124736,2020-01,1310.54,1408.75,2354.39,3376.19,-1120.01,-1120.01
1548553045059124736,2020-02,2225.52,3061.28,369.29,1115.33,-1581.8,-2701.81
1548553045059124736,2020-03,4406.21,1648.47,2247.89,0,5005.63,2303.82
1548553045059124736,2020-04,982.03,1131.95,3103.32,2254.53,698.87,3002.69
1548553045059124736,2020-05,3603.72,2346.35,445.44,365.56,1337.25,4339.94
1548553045059124736,2020-06,3565.73,2634.63,0,5195.7,-4264.6,75.34
1548553045059124736,2020-07,3110.52,1122.93,2788.03,2353.53,2422.09,2497.43
1548553045059124736,2020-08,1899.19,0,3385.09,2042.87,3241.41,5738.84
1548553045059124736,2020-10,199.99,2766.41,1043.13,2557.33,-4080.62,1658.22
1548553045059124736,2020-11,1591.04,2325.46,2674.34,2509.22,-569.3,1088.92
1548553045059124736,2020-12,3198.66,449.58,4093.56,1161.49,5681.15,6770.07
1549057679995080704,2020-01,1166.67,977.11,2588.05,7261.7,-4484.09,-4484.09
1549057679995080704,2020-02,1168.86,799.4,5348.69,1927.88,3790.27,-693.82
1549057679995080704,2020-03,5214.69,1961.88,2007.7,4496.5,764.01,70.19
1549057679995080704,2020-04,1100.14,0,1021.33,4980.65,-2859.18,-2788.99
1549057679995080704,2020-05,1420.33,84.61,4476.23,3116.06,2695.89,-93.1
1549057679995080704,2020-06,4006.75,3945.59,1933.82,2937.19,-942.21,-1035.31
1549057679995080704,2020-07,1429.23,3640.49,3606.45,3610.44,-2215.25,-3250.56
1549057679995080704,2020-08,5108.26,3542,4984.65,2798.38,3752.53,501.97
1549057679995080704,2020-09,1316.34,2270.7,3736.38,5113.77,-2331.75,-1829.78
1549057679995080704,2020-10,6221.62,7355.35,3601.23,4318.33,-1850.83,-3680.61
1549057679995080704,2020-11,12976.61,6971.48,3768.15,4188.9,5584.38,1903.77
1549057679995080704,2020-12,2834.9,2795.2,2591.27,1088.69,1542.28,3446.05
1550862119853243648,2020-01,0,1567.66,838.39,0,-729.27,-729.27
1550862119853243648,2020-02,3373.15,0,0,1376.28,1996.87,1267.6
1550862119853243648,2020-03,4564.7,2874.07,0,1326.8,363.83,1631.43
1550862119853243648,2020-04,829.03,3058.44,4603.5,0,2374.09,4005.52
1550862119853243648,2020-05,0,1186.23,0,1211.68,-2397.91,1607.61
1550862119853243648,2020-06,1068.71,2730.54,2075.94,2215.63,-1801.52,-193.91
1550862119853243648,2020-07,0,1750.5,1284.51,609.43,-1075.42,-1269.33
1550862119853243648,2020-08,1934.26,336.86,1801.52,1324.41,2074.51,805.18
1550862119853243648,2020-10,2666.62,0,1539.83,673.54,3532.91,4338.09
1550862119853243648,2020-11,2784.3,2312.18,0,1739.92,-1267.8,3070.29
1551010190939437824,2020-01,1665.53,3677.72,1505.69,337.42,-843.92,-843.92
1551010190939437824,2020-02,87.64,5964.87,3017.04,5651.53,-8511.72,-9355.64
1551010190939437824,2020-03,3245.02,3311.64,1834.83,3976.9,-2208.69,-11564.33
1551010190939437824,2020-04,1385.5,4090.36,4579.4,2622.85,-748.31,-12312.64
1551010190939437824,2020-05,0,3776.12,3741.01,1918.06,-1953.17,-14265.81
1551010190939437824,2020-06,4333.18,7806.25,5653.16,3142.41,-962.32,-15228.13
1551010190939437824,2020-07,6035.84,2037.01,164.12,1891.39,2271.56,-12956.57
1551010190939437824,2020-08,1034.39,6409.38,3537.74,613.75,-2451,-15407.57
1551010190939437824,2020-09,670.32,3478.7,2887.3,1556.46,-1477.54,-16885.11
1551010190939437824,2020-10,2793.02,5690.45,4755.76,1552.21,306.12,-16578.99
1551010190939437824,2020-11,837.02,2572.8,5169.23,2719.98,713.47,-15865.52
1551010190939437824,2020-12,2803.51,3023.03,5296.66,563.23,4513.91,-11351.61
1551387418913939456,2020-01,2688.51,2709.65,1420.02,1287.09,111.79,111.79
1551387418913939456,2020-02,1255.06,0,0,0,1255.06,1366.85
1551387418913939456,2020-03,4258.51,2495.33,1698.14,3285.23,176.09,1542.94
1551387418913939456,2020-04,2840.49,584.62,2348.49,2841.52,1762.84,3305.78
1551387418913939456,2020-05,3220.06,1296.24,4196.89,3136.92,2983.79,6289.57
1551387418913939456,2020-06,1669.9,2254.32,0,3594.04,-4178.46,2111.11
1551387418913939456,2020-07,1286.12,73.5,2926.94,4462.76,-323.2,1787.91
1551387418913939456,2020-08,829.18,0,1998.65,2259.29,568.54,2356.45
1551387418913939456,2020-09,681.63,1966.41,3277.03,0,1992.25,4348.7
1551387418913939456,2020-10,1974.37,1064.79,2045.12,342.96,2611.74,6960.44
1551387418913939456,2020-11,1739.99,3525.87,606.96,5186.31,-6365.23,595.21
1551387418913939456,2020-12,2338.99,733.84,1991.66,1711.49,1885.32,2480.53
1554036876957794560,2020-01,2464.68,4680.45,1819.92,8990.04,-9385.89,-9385.89
1554036876957794560,2020-02,6196.11,5671.51,1096.74,4194.48,-2573.14,-11959.03
1554036876957794560,2020-03,4475.22,3702.64,2819.37,5463.61,-1871.66,-13830.69
1554036876957794560,2020-04,3615.36,3767.39,3458.75,5768.42,-2461.7,-16292.39
1554036876957794560,2020-05,2005.73,9529.13,396.48,4429.32,-11556.24,-27848.63
1554036876957794560,2020-06,1397.51,3616.05,1470.09,2084.15,-2832.6,-30681.23
1554036876957794560,2020-07,1307.76,1945.4,1156.21,3218.69,-2700.12,-33381.35
1554036876957794560,2020-08,3533.14,2117.79,4323.34,3485.87,2252.82,-31128.53
1554036876957794560,2020-09,4017.26,1365.24,5468.72,1681.74,6439,-24689.53
1554036876957794560,2020-10,1677.51,3525.18,4875.09,3948.48,-921.06,-25610.59
1554036876957794560,2020-11,2709.18,5164.33,6176.86,1792.02,1929.69,-23680.9
1554036876957794560,2020-12,6087.9,2950.79,4019.06,3382.96,3773.21,-19907.69
1554552852646432768,2020-01,2625.85,1566.21,972.46,1841.9,190.2,190.2
1554552852646432768,2020-02,498.86,0,418.12,822.69,94.29,284.49
1554552852646432768,2020-03,0,1766.97,3327.81,3122.54,-1561.7,-1277.21
1554552852646432768,2020-04,0,2078.32,0,1698.62,-3776.94,-5054.15
1554552852646432768,2020-05,2421.2,3386.43,0,842,-1807.23,-6861.38
1554552852646432768,2020-06,2997.15,342.58,1989.87,1594.14,3050.3,-3811.08
1554552852646432768,2020-07,3138.74,2112.58,3077.84,5260.6,-1156.6,-4967.68
1554552852646432768,2020-08,0,2004.02,1647.78,0,-356.24,-5323.92
1554552852646432768,2020-09,639.98,0,5043.27,4035.66,1647.59,-3676.33
1554552852646432768,2020-10,2222.42,0,3459.12,501.52,5180.02,1503.69
1554552852646432768,2020-11,702.93,0,2590.83,2036.88,1256.88,2760.57
1554552852646432768,2020-12,107.63,1543.4,469.39,0,-966.38,1794.19
1555215846128155392,2020-01,3752.92,4662.84,3107.42,2974.45,-776.95,-776.95
1555215846128155392,2020-02,3515.62,1541.48,0,4492.92,-2518.78,-3295.73
1555215846128155392,2020-03,2116.31,3699,1481.77,1492.55,-1593.47,-4889.2
1555215846128155392,2020-04,1937.84,0,733.35,4130.34,-1459.15,-6348.35
1555215846128155392,2020-05,834.87,4199.55,972.11,829.68,-3222.25,-9570.6
1555215846128155392,2020-06,0,3862.88,1240.76,1594.56,-4216.68,-13787.28
1555215846128155392,2020-07,1381.3,613.41,2380.15,3105.82,42.22,-13745.06
1555215846128155392,2020-08,2648.95,1613.2,0,3472.81,-2437.06,-16182.12
1555215846128155392,2020-09,3226.86,1600.85,2667.87,0,4293.88,-11888.24
1555215846128155392,2020-10,5370.73,2686.57,1327.37,1098.68,2912.85,-8975.39
1555215846128155392,2020-11,1729.75,0,920.78,1105.17,1545.36,-7430.03
1555215846128155392,2020-12,2151.14,0,1288.97,1410.16,2029.95,-5400.08
1555317396187085056,2020-01,1191.86,5464.92,959.59,3088.24,-6401.71,-6401.71
1555317396187085056,2020-02,4005.91,1210.58,3477.66,1075.44,5197.55,-1204.16
1555317396187085056,2020-03,6540.46,6004.7,2865.52,1314.09,2087.19,883.03
1555317396187085056,2020-04,1786.69,1219.98,946.46,3534.37,-2021.2,-1138.17
1555317396187085056,2020-05,1810.75,1078.66,2403.04,6754.17,-3619.04,-4757.21
1555317396187085056,2020-06,1806.63,3039.21,4042.95,4779.31,-1968.94,-6726.15
1555317396187085056,2020-07,1751.94,885.82,3331.85,2764.63,1433.34,-5292.81
1555317396187085056,2020-08,2705.89,6935.63,2522.88,3066.15,-4773.01,-10065.82
1555317396187085056,2020-09,5985.25,2409.44,1095.66,1507.03,3164.44,-6901.38
1555317396187085056,2020-10,3414.22,3017.69,2710.35,2513.15,593.73,-6307.65
1555317396187085056,2020-11,8194.65,3572.35,5089.05,4763.14,4948.21,-1359.44
1555317396187085056,2020-12,6039.44,4726.62,6336.44,0,7649.26,6289.82
1555361346259049728,2020-01,4212.28,5449.98,7097.62,1375.8,4484.12,4484.12
1555361346259049728,2020-02,3931.39,5234.08,7059.32,3960.71,1795.92,6280.04
1555361346259049728,2020-03,8213.73,2694.67,5028.63,8791.41,1756.28,8036.32
1555361346259049728,2020-04,4279.86,9632.79,4092.33,5149.08,-6409.68,1626.64
1555361346259049728,2020-05,5648.33,5171.4,9883.82,8304.63,2056.12,3682.76
1555361346259049728,2020-06,5014.86,5184.45,3243,3938.01,-864.6,2818.16
1555361346259049728,2020-07,5640.12,1961.75,6559.02,10928,-690.61,2127.55
1555361346259049728,2020-08,4880.23,3431.98,8679.91,3487.62,6640.54,8768.09
1555361346259049728,2020-09,8761.06,3121.89,1235.2,6061.36,813.01,9581.1
1555361346259049728,2020-10,3827.74,5253.75,878.5,4140.92,-4688.43,4892.67
1555361346259049728,2020-11,6258.82,3007.19,3368.08,2373.14,4246.57,9139.24
1555361346259049728,2020-12,2771.67,2003.98,3958.74,1995.78,2730.65,11869.89
1555429869388049920,2020-01,534.08,873.41,1688.91,1694.64,-345.06,-345.06
1555429869388049920,2020-02,388.09,1752.06,2260.68,1929.53,-1032.82,-1377.88
1555429869388049920,2020-03,5037.74,2149.01,0,0,2888.73,1510.85
1555429869388049920,2020-04,945.19,0,0,2480.85,-1535.66,-24.81
1555429869388049920,2020-05,1558.51,0,2745.3,2883.63,1420.18,1395.37
1555429869388049920,2020-06,1305.28,0,0,1109.79,195.49,1590.86
1555429869388049920,2020-08,640,1553.1,4208.67,0,3295.57,4886.43
1555429869388049920,2020-09,2927.44,17.6,904.48,0,3814.32,8700.75
1555429869388049920,2020-10,1774.09,208.49,3019.6,0,4585.2,13285.95
1555429869388049920,2020-11,0,1433.42,1395.19,0,-38.23,13247.72
1558252945903991040,2020-01,3231.86,2170.38,2832.14,8171.74,-4278.12,-4278.12
1558252945903991040,2020-02,3033.45,2076.51,8097.86,5736.36,3318.44,-959.68
1558252945903991040,2020-03,1003.78,4435.79,2731.12,7098.76,-7799.65,-8759.33
1558252945903991040,2020-04,4212.56,5817.24,2788.56,3910.82,-2726.94,-11486.27
1558252945903991040,2020-05,2529.32,0,4793.73,8254.44,-931.39,-12417.66
1558252945903991040,2020-06,1703.17,9998.53,4957.26,2907.36,-6245.46,-18663.12
1558252945903991040,2020-07,6902.04,7773.81,3329.92,6713.18,-4255.03,-22918.15
1558252945903991040,2020-08,4735.7,4508.78,6211.56,6184.25,254.23,-22663.92
1558252945903991040,2020-09,6313.41,3446.31,7542.59,5086.47,5323.22,-17340.7
1558252945903991040,2020-10,1806.51,3871.57,6386.77,4410.43,-88.72,-17429.42
1558252945903991040,2020-11,4881.03,3270.82,8548.73,0,10158.94,-7270.48
1558252945903991040,2020-12,2710.94,1215.77,4487.4,5584.01,398.56,-6871.92
1558822922835950592,2020-01,3695.93,3205.98,3351.62,2420.61,1420.96,1420.96
1558822922835950592,2020-02,0,1857.11,3113.48,1521.44,-265.07,1155.89
1558822922835950592,2020-03,2907.36,3139.14,3364.64,3160.97,-28.11,1127.78
1558822922835950592,2020-04,1178.65,1085.05,2421.67,4406.32,-1891.05,-763.27
1558822922835950592,2020-05,5580.89,1763.51,115.97,4148.59,-215.24,-978.51
1558822922835950592,2020-06,446.38,3237.41,3505.78,3907.44,-3192.69,-4171.2
1558822922835950592,2020-07,7289.73,1239.4,1810.21,2267.56,5592.98,1421.78
1558822922835950592,2020-08,1951.17,6499.09,2574.5,4143.27,-6116.69,-4694.91
1558822922835950592,2020-09,228.82,5682.67,4408.06,0,-1045.79,-5740.7
1558822922835950592,2020-10,47.51,3899.86,463.3,0,-3389.05,-9129.75
1558822922835950592,2020-11,3230.94,3614.09,5416.94,1637.87,3395.92,-5733.83
1558822922835950592,2020-12,9404.02,2529.85,1642.24,4377.8,4138.61,-1595.22
1559685886168767488,2020-01,4377.26,613.67,978.72,0,4742.31,4742.31
1559685886168767488,2020-02,0,461.67,2921.41,1824.02,635.72,5378.03
1559685886168767488,2020-03,761.69,683.53,1253.49,1320.34,11.31,5389.34
1559685886168767488,2020-04,0,2925.95,1559.89,366.06,-1732.12,3657.22
1559685886168767488,2020-06,1309.33,489.87,1906.03,3890.1,-1164.61,2492.61
1559685886168767488,2020-07,0,1794.2,1105.65,1311.97,-2000.52,492.09
1559685886168767488,2020-08,256.7,409.65,1591.24,1704.5,-266.21,225.88
1559685886168767488,2020-09,694.69,2301.75,2198.69,101.31,490.32,716.2
1559685886168767488,2020-10,1058.42,4975.97,972.54,0,-2945.01,-2228.81
1559685886168767488,2020-11,1437.09,0,971.31,954.36,1454.04,-774.77
1559685886168767488,2020-12,3409.99,0,1372.07,1928.26,2853.8,2079.03
1559977778735476224,2020-01,3023.94,1676.07,3562.28,1034.16,3875.99,3875.99
1559977778735476224,2020-02,1132.5,2866.65,2014.1,2880.76,-2600.81,1275.18
1559977778735476224,2020-03,0,2991.91,2158.97,0,-832.94,442.24
1559977778735476224,2020-04,4519.5,610.04,1591.2,1206.32,4294.34,4736.58
1559977778735476224,2020-05,0,541.59,1212,1428.24,-757.83,3978.75
1559977778735476224,2020-06,1977.37,1965.14,542.35,1164.06,-609.48,3369.27
1559977778735476224,2020-07,3006.64,1372.96,1626.65,1986.97,1273.36,4642.63
1559977778735476224,2020-08,1307.97,714.31,1265.43,1918.74,-59.65,4582.98
1559977778735476224,2020-09,1476.8,142.64,1550.64,2219.58,665.22,5248.2
1559977778735476224,2020-10,5502.81,3871.05,0,3383.53,-1751.77,3496.43
1559977778735476224,2020-11,1342.18,2855.12,2858.57,2714.48,-1368.85,2127.58
1559977778735476224,2020-12,1434.28,3897.58,2377.76,2754.69,-2840.23,-712.65
1560419686815516928,2020-03,0,109.61,0,0,-109.61,-109.61
1560419686815516928,2020-04,0,1582.19,1242.71,0,-339.48,-449.09
1560419686815516928,2020-05,0,1082.97,401.7,249.74,-931.01,-1380.1
1560419686815516928,2020-06,1494.3,0,0,1408.84,85.46,-1294.64
1560419686815516928,2020-08,0,509.58,557.55,2636.39,-2588.42,-3883.06
1560419686815516928,2020-09,0,2426.29,0,0,-2426.29,-6309.35
1560419686815516928,2020-10,1175.24,1445.47,0,1726.66,-1996.89,-8306.24
1560419686815516928,2020-11,0,1884.21,0,0,-1884.21,-10190.45
1560419686815516928,2020-12,0,841.5,0,1366.31,-2207.81,-12398.26
1561384317308532480,2020-01,0,1652.24,1015.61,0,-636.63,-636.63
1561384317308532480,2020-02,259.16,0,0,1885.04,-1625.88,-2262.51
1561384317308532480,2020-03,0,1668.39,683.16,4066.37,-5051.6,-7314.11
1561384317308532480,2020-04,0,2473.11,0,573.2,-3046.31,-10360.42
1561384317308532480,2020-05,2811.73,0,3393.05,1748.47,4456.31,-5904.11
1561384317308532480,2020-06,0,806.13,1752.9,2279.43,-1332.66,-7236.77
1561384317308532480,2020-07,2469.14,0,1395.09,362.32,3501.91,-3734.86
1561384317308532480,2020-08,0,481.57,391.67,3328.28,-3418.18,-7153.04
1561384317308532480,2020-09,669.98,0,0,0,669.98,-6483.06
1561384317308532480,2020-10,0,1396.55,2268.1,1430.3,-558.75,-7041.81
1561384317308532480,2020-11,3401.65,0,0,38.22,3363.43,-3678.38
1561384317308532480,2020-12,838.1,757.71,2647.08,0,2727.47,-950.91
1562533324859853568,2020-01,2261.66,1734.67,814.6,1209.77,131.82,131.82
1562533324859853568,2020-02,3260.12,3506.65,1077,627,203.47,335.29
1562533324859853568,2020-03,3967.6,2199.03,1055.52,5138.45,-2314.36,-1979.07
1562533324859853568,2020-04,2478.18,1719.93,1413.97,3416.9,-1244.68,-3223.75
1562533324859853568,2020-05,3132.26,2558.5,0,7226.67,-6652.91,-9876.66
1562533324859853568,2020-06,6016.69,2374.23,535.55,2574.34,1603.67,-8272.99
1562533324859853568,2020-07,6125.74,5569.73,1503.46,2067.13,-7.66,-8280.65
1562533324859853568,2020-08,3440.37,4728.07,2805.45,2848.27,-1330.52,-9611.17
1562533324859853568,2020-09,978.66,2021.78,0,1397.63,-2440.75,-12051.92
1562533324859853568,2020-10,1964.86,18.58,2815.67,4737,24.95,-12026.97
1562533324859853568,2020-11,3584.52,5127.21,3863.45,4534.41,-2213.65,-14240.62
1562533324859853568,2020-12,392.89,3108.58,6303.27,3722.53,-134.95,-14375.57
1563521594890284800,2020-01,127.83,0,1407.66,0,1535.49,1535.49
1563521594890284800,2020-02,1814.57,1698.23,2252.08,0,2368.42,3903.91
1563521594890284800,2020-03,303.61,0,244.53,1457.9,-909.76,2994.15
1563521594890284800,2020-04,1825.01,1730.45,0,589.45,-494.89,2499.26
1563521594890284800,2020-05,1068.49,1409.15,658.74,2159.87,-1841.79,657.47
1563521594890284800,2020-06,1110.19,0,878.65,0,1988.84,2646.31
1563521594890284800,2020-08,1377.21,0,2516.32,1093.31,2800.22,5446.53
1563521594890284800,2020-09,0,1905.73,1111.93,0,-793.8,4652.73
1563521594890284800,2020-10,611.04,1491.38,1547.7,0,667.36,5320.09
1563521594890284800,2020-11,1366.35,831.84,1285.92,1777.32,43.11,5363.2
1563521594890284800,2020-12,0,1799.6,1300.04,1007.9,-1507.46,3855.74
1564199360999852800,2020-01,1058.13,1842.69,0,0,-784.56,-784.56
1564199360999852800,2020-02,131.27,1736.84,0,0,-1605.57,-2390.13
1564199360999852800,2020-03,1188.74,0,0,0,1188.74,-1201.39
1564199360999852800,2020-05,729.46,0,1.86,0,731.32,-470.07
1564199360999852800,2020-07,1907.61,1373.97,207.52,0,741.16,271.09
1564199360999852800,2020-09,0,1125.14,0,0,-1125.14,-854.05
1564199360999852800,2020-10,1022.94,0,0,0,1022.94,168.89
1564199360999852800,2020-11,0,440.34,0,0,-440.34,-271.45
1565194540553274880,2020-01,1869.88,0,0,0,1869.88,1869.88
1565194540553274880,2020-02,1563.42,499.76,0,1047.53,16.13,1886.01
1565194540553274880,2020-03,310.32,1557.49,0,483.32,-1730.49,155.52
1565194540553274880,2020-04,0,1945.22,0,1092.24,-3037.46,-2881.94
1565194540553274880,2020-06,112.84,0,0,0,112.84,-2769.1
1565194540553274880,2020-07,706.98,1347.32,0,899.49,-1539.83,-4308.93
1565194540553274880,2020-08,1101.47,465.36,1234.69,890.04,980.76,-3328.17
1565194540553274880,2020-10,3126.23,0,0,0,3126.23,-201.94
1565194540553274880,2020-11,1630.66,1173.02,1972.1,0,2429.74,2227.8
1565489130346521856,2020-01,5229.55,2579.62,1921.54,7798.99,-3227.52,-3227.52
1565489130346521856,2020-02,8522.74,2316.78,3398.83,7053.75,2551.04,-676.48
1565489130346521856,2020-03,6663.38,4554.57,10612.07,1581.02,11139.86,10463.38
1565489130346521856,2020-04,6946.37,9646.76,5718.37,3579.46,-561.48,9901.9
1565489130346521856,2020-05,2178.05,5148.91,4458.06,3867.28,-2380.08,7521.82
1565489130346521856,2020-06,3810.9,4756.72,2771.73,2875.63,-1049.72,6472.1
1565489130346521856,2020-07,1714,7284.69,4999.56,507.76,-1078.89,5393.21
1565489130346521856,2020-08,3829.35,9067.83,3131.33,4471.2,-6578.35,-1185.14
1565489130346521856,2020-09,3653.45,883.7,5960.58,4870.86,3859.47,2674.33
1565489130346521856,2020-10,6688.88,1222.54,4733.02,4136.86,6062.5,8736.83
1565489130346521856,2020-11,4694.58,10778.35,3149.12,4003.87,-6938.52,1798.31
1565489130346521856,2020-12,5145.75,4337.77,5262.3,3009.01,3061.27,4859.58
1567461723947204096,2020-01,4561.87,4309.08,3413.45,3447.39,218.85,218.85
1567461723947204096,2020-02,4856.81,2580.16,5462.15,2511.17,5227.63,5446.48
1567461723947204096,2020-03,6478.01,3048.64,3916.72,3842.32,3503.77,8950.25
1567461723947204096,2020-04,2959.32,81.92,3006.24,0,5883.64,14833.89
1567461723947204096,2020-05,1228.58,2454.84,1824.36,1676.7,-1078.6,13755.29
1567461723947204096,2020-06,2048.49,1674.84,2713.84,2391.84,695.65,14450.94
1567461723947204096,2020-07,3041.32,3805.08,2313.97,3246.66,-1696.45,12754.49
1567461723947204096,2020-08,0,4535.15,1679.99,3030.12,-5885.28,6869.21
1567461723947204096,2020-09,1187.87,1743.93,3038.64,1170.54,1312.04,8181.25
1567461723947204096,2020-10,303.24,4293.75,2212.11,3895.07,-5673.47,2507.78
1567461723947204096,2020-11,5100.64,6910.05,6498.28,2969.66,1719.21,4226.99
1567461723947204096,2020-12,2285.62,3854.05,2377.86,1108.39,-298.96,3928.03
1567522714537208576,2020-01,3740.13,3521.7,2791.77,2758.89,251.31,251.31
1567522714537208576,2020-02,2397.14,1108.29,0,7149.63,-5860.78,-5609.47
1567522714537208576,2020-03,3546.55,0,3125.09,4563.45,2108.19,-3501.28
1567522714537208576,2020-04,3508.24,3447.25,2875.76,2142.19,794.56,-2706.72
1567522714537208576,2020-05,585.4,248.7,6610.47,611.29,6335.88,3629.16
1567522714537208576,2020-06,2884.47,2198.39,2689.41,3023.54,351.95,3981.11
1567522714537208576,2020-07,4160.76,4594.03,1911.55,3328.75,-1850.47,2130.64
1567522714537208576,2020-08,1852.69,2981.04,1776.56,1243.68,-595.47,1535.17
1567522714537208576,2020-09,3030.13,5003.66,7913.17,2958.75,2980.89,4516.06
1567522714537208576,2020-10,1573.88,8830.43,7252.37,3606.21,-3610.39,905.67
1567522714537208576,2020-11,3862.23,0,1850.29,2648.65,3063.87,3969.54
1567522714537208576,2020-12,6690.35,2625.95,3693.98,5312.48,2445.9,6415.44
1567634875267153152,2020-01,4485.82,3321.37,5029.69,8410.59,-2216.45,-2216.45
1567634875267153152,2020-02,2941.83,3157.87,11279.26,5929.57,5133.65,2917.2
1567634875267153152,2020-03,5280.19,3590.91,4608.28,4741.53,1556.03,4473.23
1567634875267153152,2020-04,3357.74,1189.51,8301.95,3304.59,7165.59,11638.82
1567634875267153152,2020-05,6503.67,6867.91,690.36,5252.7,-4926.58,6712.24
1567634875267153152,2020-06,517.1,4892.86,3140.24,807.59,-2043.11,4669.13
1567634875267153152,2020-07,709.98,5387.91,1740.19,7039.98,-9977.72,-5308.59
1567634875267153152,2020-08,2228.75,8560.4,3912.94,5543.44,-7962.15,-13270.74
1567634875267153152,2020-09,1890.68,1390.29,2168.79,4115.87,-1446.69,-14717.43
1567634875267153152,2020-10,4059.15,2941.71,1211.46,814.29,1514.61,-13202.82
1567634875267153152,2020-11,4417.88,3884.67,5770,9069.1,-2765.89,-15968.71
1567634875267153152,2020-12,5724.63,7535.7,3234.21,4200.59,-2777.45,-18746.16
1567859121090090752,2020-01,1854.93,3172.77,0,4908.38,-6226.22,-6226.22
1567859121090090752,2020-02,239.41,2847.48,241.31,546.02,-2912.78,-9139
1567859121090090752,2020-03,979.25,536.95,0,3103.78,-2661.48,-11800.48
1567859121090090752,2020-04,1438.19,3614.08,2231.61,4852.72,-4797,-16597.48
1567859121090090752,2020-05,4111.49,4862.43,929.29,1413.22,-1234.87,-17832.35
1567859121090090752,2020-06,5975.63,62.05,428.51,3652.96,2689.13,-15143.22
1567859121090090752,2020-07,2961.17,0,1286.43,647.55,3600.05,-11543.17
1567859121090090752,2020-08,298.37,1702.5,2449.31,3570.91,-2525.73,-14068.9
1567859121090090752,2020-09,1500.49,64.36,1840.48,1563.84,1712.77,-12356.13
1567859121090090752,2020-10,4554.2,4161.77,3760.93,898.05,3255.31,-9100.82
1567859121090090752,2020-11,3314.39,4792.25,1172.67,1567.01,-1872.2,-10973.02
1567859121090090752,2020-12,0,1034.97,1563.7,0,528.73,-10444.29
1567924721793524224,2020-01,2353.28,377.54,1278.8,3031.86,222.68,222.68
1567924721793524224,2020-02,719.71,5887.85,1296.31,169.44,-4041.27,-3818.59
1567924721793524224,2020-03,1210.24,518.03,1349.64,1542.93,498.92,-3319.67
1567924721793524224,2020-04,292.03,3223.95,2939.17,208.1,-200.85,-3520.52
1567924721793524224,2020-05,1472.73,3101.54,3051.13,6413.39,-4991.07,-8511.59
1567924721793524224,2020-06,2002.83,1081.96,4631.42,164.8,5387.49,-3124.1
1567924721793524224,2020-07,0,2613.45,821.59,3106.36,-4898.22,-8022.32
1567924721793524224,2020-08,1756.93,5531.31,2007.88,1801.95,-3568.45,-11590.77
1567924721793524224,2020-09,1847.33,153.12,3817.91,975.84,4536.28,-7054.49
1567924721793524224,2020-10,1775.79,371.49,2214.11,1855.17,1763.24,-5291.25
1567924721793524224,2020-11,5346.21,2053.95,2205.76,9339.44,-3841.42,-9132.67
1567924721793524224,2020-12,3512.43,1527.14,2938.63,532.24,4391.68,-4740.99
1569185230646907392,2020-01,4897.99,4196.77,4179.08,3304.53,1575.77,1575.77
1569185230646907392,2020-02,1682.61,1642.57,2525.57,1170.56,1395.05,2970.82
1569185230646907392,2020-03,1232.85,3848.76,1615.97,368.64,-1368.58,1602.24
1569185230646907392,2020-04,0,6458.12,1215.38,1144.27,-6387.01,-4784.77
1569185230646907392,2020-05,0,1087.34,3041.22,661.95,1291.93,-3492.84
1569185230646907392,2020-06,2589.89,1462.55,3368.54,2042.07,2453.81,-1039.03
1569185230646907392,2020-07,0,3977.49,1407.76,1804.32,-4374.05,-5413.08
1569185230646907392,2020-08,3151.49,7711.17,250.82,208.46,-4517.32,-9930.4
1569185230646907392,2020-09,1588.28,1366.93,0,2710.68,-2489.33,-12419.73
1569185230646907392,2020-10,887.12,1234.1,0,587.58,-934.56,-13354.29
1569185230646907392,2020-11,2531.95,5835.68,1375.86,6480.56,-8408.43,-21762.72
1569185230646907392,2020-12,6944.41,4636.37,0,5111.51,-2803.47,-24566.19
1570241880615277056,2020-01,650.56,1179.96,0,0,-529.4,-529.4
1570241880615277056,2020-02,0,864.24,0,0,-864.24,-1393.64
1570241880615277056,2020-03,3048.22,0,2287.51,0,5335.73,3942.09
1570241880615277056,2020-04,0,265.34,0,0,-265.34,3676.75
1570241880615277056,2020-09,1298.64,0,0,0,1298.64,4975.39
1571109356411542272,2020-01,6320.62,0,4370.02,1736.64,8954,8954
1571109356411542272,2020-02,4112.95,1454.17,5888.34,1887.96,6659.16,15613.16
1571109356411542272,2020-03,526.26,0,3993.63,1854.74,2665.15,18278.31
1571109356411542272,2020-04,1562.02,0,3303.04,0,4865.06,23143.37
1571109356411542272,2020-05,0,1879.02,4846.31,3295.97,-328.68,22814.69
1571109356411542272,2020-06,1677.25,824.52,1397.01,562.64,1687.1,24501.79
1571109356411542272,2020-07,0,2569.58,1719.57,1238.11,-2088.12,22413.67
1571109356411542272,2020-08,4956.97,586.2,1310.07,1822.89,3857.95,26271.62
1571109356411542272,2020-09,904.01,0,1673.19,437.79,2139.41,28411.03
1571109356411542272,2020-10,2949.32,2993.98,3109.56,2336.06,728.84,29139.87
1571109356411542272,2020-11,2056.93,3119.92,3554.09,2056.67,434.43,29574.3
1571109356411542272,2020-12,170.59,1412.48,2917.23,0,1675.34,31249.64
1572217149479844352,2020-01,9321.83,5344.49,3735.98,7916.15,-202.83,-202.83
1572217149479844352,2020-02,2406.41,6679.85,3762.83,6396.94,-6907.55,-7110.38
1572217149479844352,2020-03,1765.21,266.06,6814.4,3979.58,4333.97,-2776.41
1572217149479844352,2020-04,3230.6,5815.97,5724.88,5873.55,-2734.04,-5510.45
1572217149479844352,2020-05,6261.35,4289.55,4072.53,7477.51,-1433.18,-6943.63
1572217149479844352,2020-06,3741.03,13503.67,9136.25,2240.91,-2867.3,-9810.93
1572217149479844352,2020-07,3384.35,4362.85,7255.07,4548.72,1727.85,-8083.08
1572217149479844352,2020-08,9731.8,5365.3,3507.31,3744.07,4129.74,-3953.34
1572217149479844352,2020-09,4958.61,6385.45,3952.31,5274.7,-2749.23,-6702.57
1572217149479844352,2020-10,4792.65,4610.75,2075.01,5363.95,-3107.04,-9809.61
1572217149479844352,2020-11,65.62,3385.77,4911.1,967.6,623.35,-9186.26
1572217149479844352,2020-12,904.75,2787.16,1796.17,2737.84,-2824.08,-12010.34
1573316326693758976,2020-01,2977.34,2255.28,4087.92,6380.07,-1570.09,-1570.09
1573316326693758976,2020-02,0,1605.57,3065.55,83.53,1376.45,-193.64
1573316326693758976,2020-03,0,2211,999.46,1590.22,-2801.76,-2995.4
1573316326693758976,2020-04,956.09,3471.25,3224.47,1689.52,-980.21,-3975.61
1573316326693758976,2020-05,3948.6,3216.26,739.24,4588.38,-3116.8,-7092.41
1573316326693758976,2020-06,1577.36,2260.89,5859.6,5213.78,-37.71,-7130.12
1573316326693758976,2020-07,3925.75,1252.68,1789.57,0,4462.64,-2667.48
1573316326693758976,2020-08,4202.6,4597.4,0,1430.83,-1825.63,-4493.11
1573316326693758976,2020-09,926.36,3048.6,1840.21,1896.43,-2178.46,-6671.57
1573316326693758976,2020-10,5244.93,2805.95,748.13,3058.92,128.19,-6543.38
1573316326693758976,2020-11,2023.8,1478.12,1912.01,5614.82,-3157.13,-9700.51
1573316326693758976,2020-12,1134.08,3062.4,1671.6,0,-256.72,-9957.23
1574367364918659328,2020-01,3536.54,3141.94,5646.84,3772.07,2269.37,2269.37
1574367364918659328,2020-02,2121.2,1423.24,2806.38,5466.78,-1962.44,306.93
1574367364918659328,2020-03,2244.19,613.76,2684.5,6242.19,-1927.26,-1620.33
1574367364918659328,2020-04,2049.44,3686.7,4760.85,8038.21,-4914.62,-6534.95
1574367364918659328,2020-05,2299.82,6869.07,2752.95,5453.31,-7269.61,-13804.56
1574367364918659328,2020-06,4470.08,5799.78,3995.05,1378.66,1286.69,-12517.87
1574367364918659328,2020-07,2814.8,7396.22,3649.41,5845.68,-6777.69,-19295.56
1574367364918659328,2020-08,4964.75,4274.78,7389.86,6953.33,1126.5,-18169.06
1574367364918659328,2020-09,0,7920.99,7081.48,7126.7,-7966.21,-26135.27
1574367364918659328,2020-10,6491.32,5283.72,2768.14,1813.15,2162.59,-23972.68
1574367364918659328,2020-11,5160.31,5403.65,4927.98,2912.95,1771.69,-22200.99
1574367364918659328,2020-12,6259.42,4498.78,6229.67,3697.35,4292.96,-17908.03
1574433334215995648,2020-01,3195.36,3165.16,1055.11,1809.17,-723.86,-723.86
1574433334215995648,2020-02,1153.94,5423.2,751.6,2558.86,-6076.52,-6800.38
1574433334215995648,2020-03,343.95,1748.8,0,1107.29,-2512.14,-9312.52
1574433334215995648,2020-04,855.52,4471.77,748.54,0,-2867.71,-12180.23
1574433334215995648,2020-05,2144.48,0,0,1629.86,514.62,-11665.61
1574433334215995648,2020-06,124.81,0,289.37,3541.74,-3127.56,-14793.17
1574433334215995648,2020-07,2480.27,1470.15,0,3428.19,-2418.07,-17211.24
1574433334215995648,2020-08,2847.23,131.26,1639.1,2172.96,2182.11,-15029.13
1574433334215995648,2020-09,0,1318.39,0,0,-1318.39,-16347.52
1574433334215995648,2020-10,5090.64,4004.09,730.04,87.49,1729.1,-14618.42
1574433334215995648,2020-12,2399.93,1912.1,0,1601.29,-1113.46,-15731.88
1574617342106158592,2020-01,237.97,5764.42,2854.99,3129.78,-5801.24,-5801.24
1574617342106158592,2020-02,1871.93,3552.88,7400.14,3095.58,2623.61,-3177.63
1574617342106158592,2020-03,699.47,3497.17,7919.3,1299.67,3821.93,644.3
1574617342106158592,2020-04,1918.71,7930.19,2343.58,1329.8,-4997.7,-4353.4
1574617342106158592,2020-05,0,5477.52,1214.45,2081.84,-6344.91,-10698.31
1574617342106158592,2020-06,3047.23,3572.83,6927.57,3657.04,2744.93,-7953.38
1574617342106158592,2020-07,8826.81,4019.7,282.83,3369.67,1720.27,-6233.11
1574617342106158592,2020-08,1692.23,2990.27,1711.14,0,413.1,-5820.01
1574617342106158592,2020-09,3336.01,4538.47,3228.96,3870.69,-1844.19,-7664.2
1574617342106158592,2020-10,0,8249.07,4014.26,3277.21,-7512.02,-15176.22
1574617342106158592,2020-11,3314.25,2975.92,2379.92,8031.49,-5313.24,-20489.46
1574617342106158592,2020-12,4707.49,1874.44,3094.96,0,5928.01,-14561.45
1575214116717263872,2020-01,2806.22,2380.04,981.76,1288.34,119.6,119.6
1575214116717263872,2020-02,1853.35,1658.79,1241.38,3628.51,-2192.57,-2072.97
1575214116717263872,2020-03,5175.22,2464.87,3491.65,1513.48,4688.52,2615.55
1575214116717263872,2020-04,974.09,5550.17,3198.95,2083.59,-3460.72,-845.17
1575214116717263872,2020-05,3164.84,8273.11,0,5091.48,-10199.75,-11044.92
1575214116717263872,2020-06,4867.85,5018.09,4844.62,3681.99,1012.39,-10032.53
1575214116717263872,2020-07,6434.17,2162.81,7575.89,1566.43,10280.82,248.29
1575214116717263872,2020-08,3506.81,3596.89,3628.64,2317.34,1221.22,1469.51
1575214116717263872,2020-09,1565.43,750.34,2554.12,4069.35,-700.14,769.37
1575214116717263872,2020-10,197.31,3301.1,5756.99,519.12,2134.08,2903.45
1575214116717263872,2020-11,3859.22,5160.64,2469.22,4977.59,-3809.79,-906.34
1575214116717263872,2020-12,1866.42,3048.42,5515.52,3632.05,701.47,-204.87
1576024251463812096,2020-01,3183.44,1439.39,4658.16,6510,-107.79,-107.79
1576024251463812096,2020-02,2088.22,4166.14,1755.06,2254.09,-2576.95,-2684.74
1576024251463812096,2020-03,1250.37,2110.8,0,0,-860.43,-3545.17
1576024251463812096,2020-04,1119.46,3818.63,0,473.05,-3172.22,-6717.39
1576024251463812096,2020-05,5197.46,7099.73,212.6,4373.69,-6063.36,-12780.75
1576024251463812096,2020-06,0,480.55,5692.75,3288.23,1923.97,-10856.78
1576024251463812096,2020-07,967.85,2429.37,634.42,1070.53,-1897.63,-12754.41
1576024251463812096,2020-08,1263.19,5550.41,4224.43,1946.19,-2008.98,-14763.39
1576024251463812096,2020-09,2281.11,1613.8,1026.1,126.68,1566.73,-13196.66
1576024251463812096,2020-10,3271.15,1412.65,3839.34,1454.16,4243.68,-8952.98
1576024251463812096,2020-11,2001.26,2062.88,1217.75,5122.21,-3966.08,-12919.06
1576024251463812096,2020-12,198.46,606.21,0,4404.95,-4812.7,-17731.76
1577127247759014912,2020-01,4169.74,6127.24,3042.65,8372.94,-7287.79,-7287.79
1577127247759014912,2020-02,439.83,2058.03,3717.31,2803.22,-704.11,-7991.9
1577127247759014912,2020-03,3927.22,6281.01,3856.49,5749.56,-4246.86,-12238.76
1577127247759014912,2020-04,7109.12,6186.25,5814.59,5092.37,1645.09,-10593.67
1577127247759014912,2020-05,5280.04,2969.7,6358.4,1266.35,7402.39,-3191.28
1577127247759014912,2020-06,3393.66,4239.6,1390.66,5726.4,-5181.68,-8372.96
1577127247759014912,2020-07,7074.06,3833.71,4195.35,5924.13,1511.57,-6861.39
1577127247759014912,2020-08,3264.48,2443.79,4733.04,8140.7,-2586.97,-9448.36
1577127247759014912,2020-09,10830.68,846.22,1610.58,5118.29,6476.75,-2971.61
1577127247759014912,2020-10,4197.36,2950.55,842.91,3920.03,-1830.31,-4801.92
1577127247759014912,2020-11,4150.63,3961.06,856.21,739.45,306.33,-4495.59
1577127247759014912,2020-12,3996.24,872.53,4478.14,805.22,6796.63,2301.04
1577194139540000256,2020-01,1877.09,2821.21,1759.18,0,815.06,815.06
1577194139540000256,2020-02,406.95,1167.11,0,1101.47,-1861.63,-1046.57
1577194139540000256,2020-03,1231.32,1927.93,0,1751.57,-2448.18,-3494.75
1577194139540000256,2020-04,3348.8,0,359.15,708.61,2999.34,-495.41
1577194139540000256,2020-05,2251.05,215.95,4487.44,0,6522.54,6027.13
1577194139540000256,2020-06,1638.61,669.26,0,0,969.35,6996.48
1577194139540000256,2020-07,0,669.82,0,0,-669.82,6326.66
1577194139540000256,2020-08,0,2245.85,0,1448.74,-3694.59,2632.07
1577194139540000256,2020-09,0,1348.2,1388.16,0,39.96,2672.03
1577194139540000256,2020-10,1851.96,1264.88,423.29,1248.3,-237.93,2434.1
1577194139540000256,2020-11,1890.07,1002.24,710.22,0,1598.05,4032.15
1577194139540000256,2020-12,1678.36,0,3477.41,1839.31,3316.46,7348.61
1577838236462189568,2020-01,2971.66,2426.12,3035.55,5529.18,-1948.09,-1948.09
1577838236462189568,2020-02,529.44,968.23,3361.86,1686.66,1236.41,-711.68
1577838236462189568,2020-03,579.91,3128.52,2398.59,4230.41,-4380.43,-5092.11
1577838236462189568,2020-04,3171.42,2307.6,3019.92,3082.84,800.9,-4291.21
1577838236462189568,2020-05,3223.09,4802.89,3205.7,6101.66,-4475.76,-8766.97
1577838236462189568,2020-06,3628.8,2283.04,2188.14,3726.48,-192.58,-8959.55
1577838236462189568,2020-07,2579.73,6383.12,2226.65,5796.69,-7373.43,-16332.98
1577838236462189568,2020-08,4320.03,5188.98,4770.26,2127.13,1774.18,-14558.8
1577838236462189568,2020-09,2619.33,6037.9,2263.04,3430.03,-4585.56,-19144.36
1577838236462189568,2020-10,1855.01,6072.3,5580.8,3369.27,-2005.76,-21150.12
1577838236462189568,2020-11,5280.43,4097.58,3812.28,2041.83,2953.3,-18196.82
1577838236462189568,2020-12,383.89,3365.44,7262.32,11682.53,-7401.76,-25598.58
1578059628244964608,2020-01,135.43,509.16,796.67,8060.75,-7637.81,-7637.81
1578059628244964608,2020-02,5141.17,5221.57,521.04,1853.32,-1412.68,-9050.49
1578059628244964608,2020-03,4661.9,2458.58,1648.21,2898.77,952.76,-8097.73
1578059628244964608,2020-04,1122.26,3955.67,1820.22,2425.44,-3438.63,-11536.36
1578059628244964608,2020-05,3556.19,1241.6,3022.23,5128.85,207.97,-11328.39
1578059628244964608,2020-06,4160.73,682.71,0,3958.65,-480.63,-11809.02
1578059628244964608,2020-07,4406.8,765.56,6278.4,4059.2,5860.44,-5948.58
1578059628244964608,2020-08,1072.4,1678.54,5689.1,3259.56,1823.4,-4125.18
1578059628244964608,2020-09,2579.16,1668.3,4314.11,1183.79,4041.18,-84
1578059628244964608,2020-10,3468.46,3811.72,1161.14,1811.32,-993.44,-1077.44
1578059628244964608,2020-11,198.08,10420.48,1811.32,5963.39,-14374.47,-15451.91
1578059628244964608,2020-12,3856.7,1226.51,2549.9,2479.16,2700.93,-12750.98
1579296909314452992,2020-01,9597.96,12604.48,2961.71,5586.69,-5631.5,-5631.5
1579296909314452992,2020-02,5595.28,5170.99,982.54,3034,-1627.17,-7258.67
1579296909314452992,2020-03,5155.88,1101.51,7127.62,4105.27,7076.72,-181.95
1579296909314452992,2020-04,3531.93,6827.3,7937.76,3413.52,1228.87,1046.92
1579296909314452992,2020-05,3773.75,297.34,4315.71,9317.04,-1524.92,-478
1579296909314452992,2020-06,4014.4,2330.74,2899.42,4542.76,40.32,-437.68
1579296909314452992,2020-07,2328.38,2921.36,7813.62,1662.22,5558.42,5120.74
1579296909314452992,2020-08,3870.47,6556.18,4812.07,3689.45,-1563.09,3557.65
1579296909314452992,2020-09,5349.87,5331.14,605.27,4386.37,-3762.37,-204.72
1579296909314452992,2020-10,11708.97,6572.85,1214.8,5401.35,949.57,744.85
1579296909314452992,2020-11,9235.28,0,3726.77,3145.47,9816.58,10561.43
1579296909314452992,2020-12,3964.85,3179.45,4492.64,4015.73,1262.31,11823.74
1579410122647017984,2020-01,4824.63,2747.9,3809.78,2464.23,3422.28,3422.28
1579410122647017984,2020-02,574.16,2473.93,1958.13,1202,-1143.64,2278.64
1579410122647017984,2020-03,1553.63,3306.31,4550.9,874.05,1924.17,4202.81
1579410122647017984,2020-04,10.81,3361.64,3539.64,1046.49,-857.68,3345.13
1579410122647017984,2020-05,715.53,2099.66,1457.23,309.05,-235.95,3109.18
1579410122647017984,2020-06,0,651.46,689.07,283.87,-246.26,2862.92
1579410122647017984,2020-07,3113.88,578.2,180.41,1404.12,1311.97,4174.89
1579410122647017984,2020-08,3594.94,824.86,2532.91,2189.2,3113.79,7288.68
1579410122647017984,2020-09,116.93,0,3879.9,1046.22,2950.61,10239.29
1579410122647017984,2020-11,364.08,2546.29,0,2218.74,-4400.95,5838.34
1579410122647017984,2020-12,655.96,0,480.98,1199.55,-62.61,5775.73
1580038882701275648,2020-01,1009.75,1399.94,5800.69,5490.31,-79.81,-79.81
1580038882701275648,2020-02,3896.56,1823.88,2716.44,4388.81,400.31,320.5
1580038882701275648,2020-03,2757.47,4807.91,2386.1,4208.85,-3873.19,-3552.69
1580038882701275648,2020-04,5819.59,3024.56,1356,9440.6,-5289.57,-8842.26
1580038882701275648,2020-05,2370.71,1172.17,2345.69,3290.5,253.73,-8588.53
1580038882701275648,2020-06,4795.12,5361.77,6948.43,3857.27,2524.51,-6064.02
1580038882701275648,2020-07,7251.31,3494.82,1367.66,8149.57,-3025.42,-9089.44
1580038882701275648,2020-08,7130.78,4077.63,10398.16,1011.13,12440.18,3350.74
1580038882701275648,2020-09,3588.59,2633.17,4633.08,4174.5,1414,4764.74
1580038882701275648,2020-10,9131.06,5304.86,2559.93,0.03,6386.1,11150.84
1580038882701275648,2020-11,3279.91,4471.55,2340.56,3280.32,-2131.4,9019.44
1580038882701275648,2020-12,4062.69,8085.5,1250.44,149.39,-2921.76,6097.68
1580633206010489856,2020-01,2192.31,731.38,6349.3,6717.95,1092.28,1092.28
1580633206010489856,2020-02,2325.51,4169.77,4935.09,334.15,2756.68,3848.96
1580633206010489856,2020-03,1783.37,2986.65,4776.12,2347.55,1225.29,5074.25
1580633206010489856,2020-04,322.93,1968.05,3545.15,1973.8,-73.77,5000.48
1580633206010489856,2020-05,4108.43,2499.66,5829.1,4124.16,3313.71,8314.19
1580633206010489856,2020-06,4454.84,3420.85,0,4648.4,-3614.41,4699.78
1580633206010489856,2020-07,2435.75,1477.76,4794.92,3299.77,2453.14,7152.92
1580633206010489856,2020-08,0,1804.96,3573.85,1288.07,480.82,7633.74
1580633206010489856,2020-09,1283.26,4524.67,6037.03,6415.22,-3619.6,4014.14
1580633206010489856,2020-10,4833.93,3382.91,4831.78,5190.5,1092.3,5106.44
1580633206010489856,2020-11,4958.79,2483.03,3367.38,3604.58,2238.56,7345
1580633206010489856,2020-12,4973.72,818.29,3103.76,1125.07,6134.12,13479.12
1580794644002378752,2020-01,1976.47,2612.81,3262.64,1810.01,816.29,816.29
1580794644002378752,2020-02,0,3573,802.17,319.18,-3090.01,-2273.72
1580794644002378752,2020-03,214.56,1888.68,1954.53,0,280.41,-1993.31
1580794644002378752,2020-04,1691.85,1226.7,0,0,465.15,-1528.16
1580794644002378752,2020-05,737.19,179.94,788.18,0,1345.43,-182.73
1580794644002378752,2020-06,0,2772.34,2733.85,0,-38.49,-221.22
1580794644002378752,2020-07,0,333.18,3406.9,0,3073.72,2852.5
1580794644002378752,2020-08,1108.15,0,3898.13,2877.29,2128.99,4981.49
1580794644002378752,2020-09,2777.32,3273.35,1070.87,0,574.84,5556.33
1580794644002378752,2020-10,467.84,2536.41,0,449.74,-2518.31,3038.02
1580794644002378752,2020-11,1459.9,0,3530.6,0,4990.5,8028.52
1580794644002378752,2020-12,0,2200.93,0,0,-2200.93,5827.59
1581645411501447424,2020-01,1990.45,0,188.35,0,2178.8,2178.8
1581645411501447424,2020-03,266.32,0,0,0,266.32,2445.12
1581645411501447424,2020-05,141.01,0,1935.73,402.11,1674.63,4119.75
1581645411501447424,2020-06,539.1,0,0,757.04,-217.94,3901.81
1581645411501447424,2020-11,1045.23,0,1867.76,1289.61,1623.38,5525.19
1581645411501447424,2020-12,0,2016.9,0,80.11,-2097.01,3428.18
1582600490773362944,2020-01,2841.22,1641.42,12.3,1705.13,-493.03,-493.03
1582600490773362944,2020-02,2477.94,4266.89,2044.99,5000.76,-4744.72,-5237.75
1582600490773362944,2020-03,0,3215.57,1925.46,2420.85,-3710.96,-8948.71
1582600490773362944,2020-04,6032.03,1273.48,1847.1,719.69,5885.96,-3062.75
1582600490773362944,2020-05,0,495.14,947.61,2135.55,-1683.08,-4745.83
1582600490773362944,2020-06,1819.87,3734.52,3086.3,0,1171.65,-3574.18
1582600490773362944,2020-07,505.15,3406.28,2484.68,0,-416.45,-3990.63
1582600490773362944,2020-08,2734.52,6358.72,6175.14,1333.23,1217.71,-2772.92
1582600490773362944,2020-09,379.52,1819.22,2741.82,7182.99,-5880.87,-8653.79
1582600490773362944,2020-10,1261.54,918.54,1412.07,1512.11,242.96,-8410.83
1582600490773362944,2020-11,4790.89,5391.12,2106.91,795.85,710.83,-7700
1582600490773362944,2020-12,1773.57,5123.62,6640.65,2973.9,316.7,-7383.3
1582765586152785408,2020-01,5646.78,3802.24,6568.17,3723.05,4689.66,4689.66
1582765586152785408,2020-02,5281.12,6298.65,1725.34,8437.9,-7730.09,-3040.43
1582765586152785408,2020-03,9162.3,5638.46,3869.44,3873.69,3519.59,479.16
1582765586152785408,2020-04,2977.45,542.24,2820.96,2462.97,2793.2,3272.36
1582765586152785408,2020-05,9223.28,2562.63,6129.07,4107.23,8682.49,11954.85
1582765586152785408,2020-06,6849.05,5679.95,2774.53,7872.72,-3929.09,8025.76
1582765586152785408,2020-07,995.2,1879,4376.26,1568.85,1923.61,9949.37
1582765586152785408,2020-08,6329.72,9955.06,3743.76,3618.82,-3500.4,6448.97
1582765586152785408,2020-09,4447.76,4224.09,1090.17,4990.23,-3676.39,2772.58
1582765586152785408,2020-10,5201.04,549.48,2995.09,1608.19,6038.46,8811.04
1582765586152785408,2020-11,5200.67,0,1552.83,3282.12,3471.38,12282.42
1582765586152785408,2020-12,2265.62,2563.94,5970.34,3459.27,2212.75,14495.17
1582952554916079104,2020-01,1106.79,1399.4,3073.52,2620.68,160.23,160.23
1582952554916079104,2020-02,3467.2,5840.36,1489.69,1871.21,-2754.68,-2594.45
1582952554916079104,2020-03,1768.53,1956.61,604.77,3658.04,-3241.35,-5835.8
1582952554916079104,2020-04,6502.51,2239.07,688.84,0,4952.28,-883.52
1582952554916079104,2020-05,1383.2,2299.52,0,1962.19,-2878.51,-3762.03
1582952554916079104,2020-06,0,5612.21,2488.54,1153.82,-4277.49,-8039.52
1582952554916079104,2020-07,2022.38,5026.78,0,4283.62,-7288.02,-15327.54
1582952554916079104,2020-08,3321.12,4072.64,566.12,3812.27,-3997.67,-19325.21
1582952554916079104,2020-09,2063.8,3000.26,3979.79,0,3043.33,-16281.88
1582952554916079104,2020-10,1462.4,2004.15,4624.22,1820.75,2261.72,-14020.16
1582952554916079104,2020-11,433.45,229.23,0,0,204.22,-13815.94
1582952554916079104,2020-12,1615.03,1342.04,2067.48,4951.62,-2611.15,-16427.09
1583632735116064256,2020-01,4975.36,5041.57,217.47,1591.77,-1440.51,-1440.51
1583632735116064256,2020-02,3482.87,2496.8,1399.44,4617.82,-2232.31,-3672.82
1583632735116064256,2020-03,437.62,0,5180.67,1935.76,3682.53,9.71
1583632735116064256,2020-04,4018.7,2488.3,2932.83,3918.75,544.48,554.19
1583632735116064256,2020-05,1145.18,4360.65,8914.77,1823.58,3875.72,4429.91
1583632735116064256,2020-06,61.6,3922.56,1317.59,1064.78,-3608.15,821.76
1583632735116064256,2020-07,9448.93,3879.65,3711.24,4837.5,4443.02,5264.78
1583632735116064256,2020-08,3713.2,2557.39,3507.24,3405.63,1257.42,6522.2
1583632735116064256,2020-09,1708.7,2670.89,6504.48,5069.6,472.69,6994.89
1583632735116064256,2020-10,4101.59,4475.99,1707.18,1489.33,-156.55,6838.34
1583632735116064256,2020-11,7956.01,4183.71,45.16,1636.86,2180.6,9018.94
1583632735116064256,2020-12,2213.91,1920.28,1941.66,4524.96,-2289.67,6729.27
1587472372264482816,2020-01,2369.2,2824.37,1197.74,1997.43,-1254.86,-1254.86
1587472372264482816,2020-02,1244.26,1731.71,3322.43,609.93,2225.05,970.19
1587472372264482816,2020-03,1438.83,0,4469.29,459.94,5448.18,6418.37
1587472372264482816,2020-04,1895.56,2882.1,0,0,-986.54,5431.83
1587472372264482816,2020-05,0,2399.84,3599.97,2456.98,-1256.85,4174.98
1587472372264482816,2020-06,1337.76,756.64,773.58,3318.31,-1963.61,2211.37
1587472372264482816,2020-07,1841.16,3129.85,537.11,1317.18,-2068.76,142.61
1587472372264482816,2020-08,3363.24,5159.91,1370.66,8421.43,-8847.44,-8704.83
1587472372264482816,2020-09,3619.1,3873.82,396.77,1515.07,-1373.02,-10077.85
1587472372264482816,2020-10,2043.76,623.85,2881.42,1567.18,2734.15,-7343.7
1587472372264482816,2020-11,996.98,5280.37,3443.1,525.09,-1365.38,-8709.08
1587472372264482816,2020-12,514.22,3230.58,2593.89,2346.55,-2469.02,-11178.1
1587632235553229312,2020-01,1108.14,83.43,1275.18,1012.62,1287.27,1287.27
1587632235553229312,2020-02,786.08,4018.58,690.52,2871.21,-5413.19,-4125.92
1587632235553229312,2020-03,3232.73,1019.54,5071.51,2037.92,5246.78,1120.86
1587632235553229312,2020-04,0,3532.49,785.42,1948.07,-4695.14,-3574.28
1587632235553229312,2020-05,8316.13,3843.5,1789.33,729.06,5532.9,1958.62
1587632235553229312,2020-06,2390.05,2670.08,2660.76,2540.95,-160.22,1798.4
1587632235553229312,2020-07,3079.61,5239.26,6403.93,5526.2,-1281.92,516.48
1587632235553229312,2020-08,6235.33,1330.79,594.8,6554.42,-1055.08,-538.6
1587632235553229312,2020-09,8843.33,868.48,3232.28,2594.78,8612.35,8073.75
1587632235553229312,2020-10,2397.28,1813.24,1969.04,3660.65,-1107.57,6966.18
1587632235553229312,2020-11,6698.09,1662.43,3931.2,5119.33,3847.53,10813.71
1587632235553229312,2020-12,571.38,3546.6,1796.87,2168.52,-3346.87,7466.84
1587840003691253248,2020-01,5617.89,3372.33,5580.22,2068.02,5757.76,5757.76
1587840003691253248,2020-02,1691.77,4611.34,3989.79,2549.41,-1479.19,4278.57
1587840003691253248,2020-03,2782.95,8749.26,141.2,2937.96,-8763.07,-4484.5
1587840003691253248,2020-04,3044.96,3936.55,8100.87,5251.2,1958.08,-2526.42
1587840003691253248,2020-05,1030.05,5804.14,4352.12,3097.47,-3519.44,-6045.86
1587840003691253248,2020-06,5247.88,2635.02,5178.47,6361.63,1429.7,-4616.16
1587840003691253248,2020-07,2480.84,7724.94,3941.92,468.34,-1770.52,-6386.68
1587840003691253248,2020-08,3539.78,3228.35,6469.92,7853,-1071.65,-7458.33
1587840003691253248,2020-09,4397.58,11071.74,4843.29,5620.11,-7450.98,-14909.31
1587840003691253248,2020-10,4828.1,2009.91,3205.44,3080.86,2942.77,-11966.54
1587840003691253248,2020-11,3016.92,3334.8,4573.33,5877.28,-1621.83,-13588.37
1587840003691253248,2020-12,4250.28,1660.06,3796.64,8042.12,-1655.26,-15243.63
1588432889662089472,2020-01,12324.26,2270.05,5317.5,8869.31,6502.4,6502.4
1588432889662089472,2020-02,10972.87,2842.6,4236.45,2597,9769.72,16272.12
1588432889662089472,2020-03,4141.57,5354.6,2365.82,3221.57,-2068.78,14203.34
1588432889662089472,2020-04,809.78,4747.38,3870.29,6429.07,-6496.38,7706.96
1588432889662089472,2020-05,3866.97,10701.18,749.61,5918.42,-12003.02,-4296.06
1588432889662089472,2020-06,4104.21,1677.25,5695.33,895.54,7226.75,2930.69
1588432889662089472,2020-07,5042.63,5139.16,4774.6,5445.64,-767.57,2163.12
1588432889662089472,2020-08,4256.03,10223.98,5034.24,3002.54,-3936.25,-1773.13
1588432889662089472,2020-09,6201.29,5379.54,3281.92,6988.34,-2884.67,-4657.8
1588432889662089472,2020-10,7462.44,44.48,4739.73,2830.77,9326.92,4669.12
1588432889662089472,2020-11,1804.56,2880.17,5797.01,4225.37,496.03,5165.15
1588432889662089472,2020-12,5956.18,4240.78,2976.53,1957.45,2734.48,7899.63
1588737007283431680,2020-01,234.86,719.11,1604.21,0,1119.96,1119.96
1588737007283431680,2020-02,0,516.95,0,0,-516.95,603.01
1588737007283431680,2020-03,697.65,0,0,694.34,3.31,606.32
1588737007283431680,2020-04,1152.21,0,0,0,1152.21,1758.53
1588737007283431680,2020-05,1995.94,1500,0,176.93,319.01,2077.54
1588737007283431680,2020-07,122.42,0,0,1054.18,-931.76,1145.78
1588737007283431680,2020-08,0,1081.56,2991.19,1481.67,427.96,1573.74
1588737007283431680,2020-10,1578.2,0,0,0,1578.2,3151.94
1588737007283431680,2020-11,2669.24,0,142.21,0,2811.45,5963.39
1590261147564764928,2020-01,5692.8,3736.72,2847.25,1899.95,2903.38,2903.38
1590261147564764928,2020-02,1133.68,5866.61,3097.98,1823.9,-3458.85,-555.47
1590261147564764928,2020-03,1123.55,3659.29,2994.24,1115.51,-657.01,-1212.48
1590261147564764928,2020-04,4342.75,3061.56,7604.06,3725.31,5159.94,3947.46
1590261147564764928,2020-05,8883.92,5954.63,2632.93,1833.38,3728.84,7676.3
1590261147564764928,2020-06,6726.58,3217.31,12002.3,2362.6,13148.97,20825.27
1590261147564764928,2020-07,10201.62,2262.2,2345.42,5297.77,4987.07,25812.34
1590261147564764928,2020-08,4828.12,2736.63,0,6525.62,-4434.13,21378.21
1590261147564764928,2020-09,2044.99,3320.62,1897.54,3436.65,-2814.74,18563.47
1590261147564764928,2020-10,7398.8,2727.22,4446.76,5478.18,3640.16,22203.63
1590261147564764928,2020-11,2403.38,3714.47,8066.03,4722.22,2032.72,24236.35
1590261147564764928,2020-12,2622.15,525.29,2903.8,4271.28,729.38,24965.73
1590957861809131776,2020-01,2644.79,4070.17,0,4805.49,-6230.87,-6230.87
1590957861809131776,2020-02,1224.88,2235.78,1175.34,5936.3,-5771.86,-12002.73
1590957861809131776,2020-03,2562.7,0,8411.15,945.35,10028.5,-1974.23
1590957861809131776,2020-04,4880.41,3984.18,4765.43,2186.22,3475.44,1501.21
1590957861809131776,2020-05,1941.68,3391.4,3287.97,4460.08,-2621.83,-1120.62
1590957861809131776,2020-06,0,1272.76,3007.83,1709.79,25.28,-1095.34
1590957861809131776,2020-07,2939.26,2733.64,2826.41,819.08,2212.95,1117.61
1590957861809131776,2020-08,4063.09,1041.03,1632.19,2341.28,2312.97,3430.58
1590957861809131776,2020-09,2534.51,74.7,2202.36,524.38,4137.79,7568.37
1590957861809131776,2020-10,2457.94,2633.21,6964.81,4175.03,2614.51,10182.88
1590957861809131776,2020-11,3295.4,452.98,1771.02,849.93,3763.51,13946.39
1590957861809131776,2020-12,1732.12,3169.4,2913.3,2552.57,-1076.55,12869.84
1592095518710828032,2020-01,402.12,0,0,0,402.12,402.12
1592095518710828032,2020-03,0,1875.75,0,0,-1875.75,-1473.63
1592095518710828032,2020-04,0,2935.23,0,177.81,-3113.04,-4586.67
1592095518710828032,2020-05,1625.68,0,0,0,1625.68,-2960.99
1592095518710828032,2020-06,0,2834.98,1653.56,825.34,-2006.76,-4967.75
1592095518710828032,2020-08,1834.28,1623.56,0,0,210.72,-4757.03
1592095518710828032,2020-09,1717.99,0,0,0,1717.99,-3039.04
1592095518710828032,2020-10,2045.36,0,0,0,2045.36,-993.68
1592095518710828032,2020-11,1641.13,0,0,0,1641.13,647.45
1592788141998928384,2020-01,1270.25,4417.04,3395.58,714.68,-465.89,-465.89
1592788141998928384,2020-02,3499.34,195.92,4809.38,1686.93,6425.87,5959.98
1592788141998928384,2020-03,3721.54,657.16,1972.99,2368.82,2668.55,8628.53
1592788141998928384,2020-04,1260.75,91.29,346.04,2223.52,-708.02,7920.51
1592788141998928384,2020-05,0,2779.39,0,1214.4,-3993.79,3926.72
1592788141998928384,2020-06,3140.11,3327.97,3117.54,1147.58,1782.1,5708.82
1592788141998928384,2020-07,5080.07,553.25,148.38,0,4675.2,10384.02
1592788141998928384,2020-08,3218.25,0,0,2213.73,1004.52,11388.54
1592788141998928384,2020-09,1528.87,2231.47,1222.55,1499.77,-979.82,10408.72
1592788141998928384,2020-10,3944.15,390.02,3075.63,785.23,5844.53,16253.25
1592788141998928384,2020-11,0,924.09,1922.01,0,997.92,17251.17
1592788141998928384,2020-12,531.12,0,5631.77,1631.03,4531.86,21783.03
1593227984108449280,2020-01,8072.02,3331.53,3324.51,1946.45,6118.55,6118.55
1593227984108449280,2020-02,1643.63,7060.83,6842.98,4603.37,-3177.59,2940.96
1593227984108449280,2020-03,2530.99,6057.91,3391.26,6303.24,-6438.9,-3497.94
1593227984108449280,2020-04,0,5341.57,6254.76,2931.95,-2018.76,-5516.7
1593227984108449280,2020-05,6872.79,3645.73,3490.37,3572.2,3145.23,-2371.47
1593227984108449280,2020-06,1310.59,7881.74,1766.89,4596.46,-9400.72,-11772.19
1593227984108449280,2020-07,9404.24,6307.12,4179.54,6544.64,732.02,-11040.17
1593227984108449280,2020-08,4928.09,10117.84,4149.95,3038.98,-4078.78,-15118.95
1593227984108449280,2020-09,5612.65,4474.73,810.74,7513.44,-5564.78,-20683.73
1593227984108449280,2020-10,10363.48,4200.59,3276.36,4566.14,4873.11,-15810.62
1593227984108449280,2020-11,3265.14,4323.67,5190.09,3595.61,535.95,-15274.67
1593227984108449280,2020-12,2247.15,5643.48,1959.21,2812.46,-4249.58,-19524.25
1594046871995956480,2020-01,7394.6,3741.92,2718.89,1870.49,4501.08,4501.08
1594046871995956480,2020-02,3051.48,1759.67,1006.74,759.05,1539.5,6040.58
1594046871995956480,2020-03,2655.33,2127.39,1956.42,3216.95,-732.59,5307.99
1594046871995956480,2020-04,2953.83,1089.68,1424.5,2568.37,720.28,6028.27
1594046871995956480,2020-05,564.12,1466.72,0,1391.51,-2294.11,3734.16
1594046871995956480,2020-06,0,2989.26,1824.93,4224.48,-5388.81,-1654.65
1594046871995956480,2020-07,1251.91,1318.55,2071.71,867.68,1137.39,-517.26
1594046871995956480,2020-08,1260.85,3011.55,0,1481.31,-3232.01,-3749.27
1594046871995956480,2020-09,5506.27,0,174.91,3103.52,2577.66,-1171.61
1594046871995956480,2020-10,3645.04,2133.13,2662.29,1427.14,2747.06,1575.45
1594046871995956480,2020-11,0,4895.75,3673.68,0,-1222.07,353.38
1594046871995956480,2020-12,1560.86,2921.63,0,1111.18,-2471.95,-2118.57
1594941700622676224,2020-01,0,1815.33,1744.73,620.86,-691.46,-691.46
1594941700622676224,2020-04,0,1608.91,1806.55,0,197.64,-493.82
1594941700622676224,2020-06,1311.67,0,0,0,1311.67,817.85
1594941700622676224,2020-07,1953.69,0,0,647.76,1305.93,2123.78
1594941700622676224,2020-10,0,1666.43,833.24,0,-833.19,1290.59
1594941700622676224,2020-12,0,360,0,1666.42,-2026.42,-735.83
1596390988488103424,2020-01,2698.93,6156.87,10534.48,4637.15,2439.39,2439.39
1596390988488103424,2020-02,3678.09,3547.26,4155.86,6661.73,-2375.04,64.35
1596390988488103424,2020-03,6033.73,1071.14,1614.19,2106.76,4470.02,4534.37
1596390988488103424,2020-04,2500.15,1172.64,5823.59,4446.53,2704.57,7238.94
1596390988488103424,2020-05,4784.6,4121.63,2083.34,0,2746.31,9985.25
1596390988488103424,2020-06,2949.13,1279.77,2445.71,978.9,3136.17,13121.42
1596390988488103424,2020-07,3706.38,1206,5050.94,2580.07,4971.25,18092.67
1596390988488103424,2020-08,6449.88,34.92,3896.58,10896.19,-584.65,17508.02
1596390988488103424,2020-09,1885.52,4193.01,4947.84,904.91,1735.44,19243.46
1596390988488103424,2020-10,3177.85,2595.78,4533.68,1356.11,3759.64,23003.1
1596390988488103424,2020-11,1769.35,3465.97,1238.19,4333.38,-4791.81,18211.29
1596390988488103424,2020-12,5733.31,2433.91,5640.22,1530.14,7409.48,25620.77
1597260396957785088,2020-01,2466.6,4940.37,293.36,5298.42,-7478.83,-7478.83
1597260396957785088,2020-02,2185.84,2208.02,3553.56,5557.38,-2026,-9504.83
1597260396957785088,2020-03,2475.97,7177.95,1095.43,4876.73,-8483.28,-17988.11
1597260396957785088,2020-04,6093.14,4920.12,8203.31,6963.04,2413.29,-15574.82
1597260396957785088,2020-05,1819.6,3994.83,8711.86,7370.49,-833.86,-16408.68
1597260396957785088,2020-06,5214.73,12404.18,3898.55,2312.53,-5603.43,-22012.11
1597260396957785088,2020-07,759.67,2968.39,7487.82,5728.63,-449.53,-22461.64
1597260396957785088,2020-08,776.46,3323.68,2089.03,2717.33,-3175.52,-25637.16
1597260396957785088,2020-09,2508.84,994.86,511.45,3141.6,-1116.17,-26753.33
1597260396957785088,2020-10,5014.39,8392.11,4688.4,3818.37,-2507.69,-29261.02
1597260396957785088,2020-11,4396.04,4007.52,4016.18,4523.99,-119.29,-29380.31
1597260396957785088,2020-12,2758.12,8005.98,2364.93,2874.57,-5757.5,-35137.81
1597332995188690176,2020-01,4051.68,1743.75,1912.74,1778.57,2442.1,2442.1
1597332995188690176,2020-02,0,1345.62,939.34,0,-406.28,2035.82
1597332995188690176,2020-03,3427.56,2901.56,1468.78,4587.67,-2592.89,-557.07
1597332995188690176,2020-04,4261.86,2718.84,827.74,3815.88,-1445.12,-2002.19
1597332995188690176,2020-05,0,266.36,5049.96,1817.83,2965.77,963.58
1597332995188690176,2020-06,6672.51,2342.31,5573.94,1190.8,8713.34,9676.92
1597332995188690176,2020-07,0,2359.39,1972.7,4316.44,-4703.13,4973.79
1597332995188690176,2020-08,731.35,3180.22,2956.61,1475.89,-968.15,4005.64
1597332995188690176,2020-09,3568.82,5794.66,1681.4,1788.71,-2333.15,1672.49
1597332995188690176,2020-10,5436.5,4489.32,3523.4,3140.86,1329.72,3002.21
1597332995188690176,2020-11,0,685.71,3226.66,1951.96,588.99,3591.2
1597332995188690176,2020-12,3428.7,0,1771.92,3173.41,2027.21,5618.41
1598292961600159232,2020-01,0,1567.6,1699.16,0,131.56,131.56
1598292961600159232,2020-02,2444.9,1468.82,3254.69,1716.2,2514.57,2646.13
1598292961600159232,2020-03,892.88,0,2053.69,1498.99,1447.58,4093.71
1598292961600159232,2020-04,615.17,2167.13,0,0,-1551.96,2541.75
1598292961600159232,2020-06,79.97,0,1585.14,2359.45,-694.34,1847.41
1598292961600159232,2020-07,1969.93,0,0,982.17,987.76,2835.17
1598292961600159232,2020-08,0,431.59,553.03,2286.42,-2164.98,670.19
1598292961600159232,2020-09,2916.66,0,1855.25,0,4771.91,5442.1
1598292961600159232,2020-10,363.38,0,2372.81,1492.54,1243.65,6685.75
1598292961600159232,2020-11,608.98,0,703.6,276.75,1035.83,7721.58
1598292961600159232,2020-12,129.6,1196.79,1323.49,0,256.3,7977.88
1599426422163561984,2020-01,3743.12,3324.12,5372.34,9242.21,-3450.87,-3450.87
1599426422163561984,2020-02,792.79,3013.45,4917.48,5446.15,-2749.33,-6200.2
1599426422163561984,2020-03,7872.86,2004.15,5995.56,3936.69,7927.58,1727.38
1599426422163561984,2020-04,2680.07,5056.3,6370.5,6508.91,-2514.64,-787.26
1599426422163561984,2020-05,5146.25,4264.55,1800.76,6502.86,-3820.4,-4607.66
1599426422163561984,2020-06,6296.7,5440.39,4604.81,4224.02,1237.1,-3370.56
1599426422163561984,2020-07,2659.77,4428.38,2687.41,3444.87,-2526.07,-5896.63
1599426422163561984,2020-08,7435.52,4185.57,8238.71,3394.09,8094.57,2197.94
1599426422163561984,2020-09,2969.37,1670.53,6437.69,5077.7,2658.83,4856.77
1599426422163561984,2020-10,4947.55,7374.71,10104.42,3907.57,3769.69,8626.46
1599426422163561984,2020-11,3972.12,2834.69,7300.66,5719.75,2718.34,11344.8
1599426422163561984,2020-12,9651.09,2424.14,1846.22,4226.96,4846.21,16191.01
1599684542009929216,2020-01,2440.69,5221.19,2147.31,2171.41,-2804.6,-2804.6
1599684542009929216,2020-02,5315.33,3596.11,1664.86,667.48,2716.6,-88
1599684542009929216,2020-03,2846.84,3755.84,4440.49,1545.75,1985.74,1897.74
1599684542009929216,2020-04,1570.88,211.26,3433.15,188.51,4604.26,6502
1599684542009929216,2020-05,1519.33,0,1665.35,3461.77,-277.09,6224.91
1599684542009929216,2020-06,0,1891.28,1544.18,0,-347.1,5877.81
1599684542009929216,2020-07,1097.64,0,5030.39,4467.89,1660.14,7537.95
1599684542009929216,2020-08,1626.23,6032.04,3008.17,266.72,-1664.36,5873.59
1599684542009929216,2020-09,2747.59,591.79,1624.07,1585.69,2194.18,8067.77
1599684542009929216,2020-10,3940.08,1321.87,4625.41,4238,3005.62,11073.39
1599684542009929216,2020-11,8281.26,766.27,2056.35,2834.52,6736.82,17810.21
1599684542009929216,2020-12,4532.89,0,1084.25,2068.69,3548.45,21358.66
1600478822880115456,2020-01,4730.09,0,4698.85,1618.77,7810.17,7810.17
1600478822880115456,2020-02,2911.85,4297.65,1115.19,6415.94,-6686.55,1123.62
1600478822880115456,2020-03,2006.36,4217.59,7103.64,5183.64,-291.23,832.39
1600478822880115456,2020-04,5477.1,767.01,4015.51,2331.28,6394.32,7226.71
1600478822880115456,2020-05,2771.75,2614.44,726.68,2578.15,-1694.16,5532.55
1600478822880115456,2020-06,7481.32,4889.84,8086.72,8158.95,2519.25,8051.8
1600478822880115456,2020-07,0,1200.84,9028.51,6279,1548.67,9600.47
1600478822880115456,2020-08,5081.77,2427.21,1892.6,3410.96,1136.2,10736.67
1600478822880115456,2020-09,11673.41,2028.39,348.9,905.08,9088.84,19825.51
1600478822880115456,2020-10,1751.48,2737.07,0,2226.04,-3211.63,16613.88
1600478822880115456,2020-11,5826.03,3522.8,4822.53,3597.74,3528.02,20141.9
1600478822880115456,2020-12,2483.87,1064.18,3010.36,613,3817.05,23958.95
1600541709925121792,2020-01,4280.99,1924.2,3998.73,2315.6,4039.92,4039.92
1600541709925121792,2020-02,2453.64,3103.53,2268.59,3871.51,-2252.81,1787.11
1600541709925121792,2020-03,3466.27,1135.19,3882.79,2060.02,4153.85,5940.96
1600541709925121792,2020-04,4054.58,2181.21,3341.95,3501.28,1714.04,7655
1600541709925121792,2020-05,2911.82,5926.49,5522.71,1364.63,1143.41,8798.41
1600541709925121792,2020-06,556.45,0,4414.09,4876.96,93.58,8891.99
1600541709925121792,2020-07,4711.18,718.72,4716.12,3529.63,5178.95,14070.94
1600541709925121792,2020-08,906.1,1752.44,4813.64,1520.3,2447,16517.94
1600541709925121792,2020-09,3170.86,444.86,3998.7,3844.66,2880.04,19397.98
1600541709925121792,2020-10,604.81,1737.17,3204.61,2960.48,-888.23,18509.75
1600541709925121792,2020-11,0,1274.82,0,2636.47,-3911.29,14598.46
1600541709925121792,2020-12,633.61,1246.35,2493.96,6817.76,-4936.54,9661.92
1600937766401807360,2020-01,1358.15,2635.58,1878.4,4251.21,-3650.24,-3650.24
1600937766401807360,2020-02,3517.75,0,1504.8,0,5022.55,1372.31
1600937766401807360,2020-03,97.51,5090.36,8573.59,2653.31,927.43,2299.74
1600937766401807360,2020-04,4108.08,1786.73,37.48,1428.18,930.65,3230.39
1600937766401807360,2020-06,1940.67,862.1,456.74,3603.01,-2067.7,1162.69
1600937766401807360,2020-07,606.69,3278.77,2882.05,2438.47,-2228.5,-1065.81
1600937766401807360,2020-08,3666.9,3807.26,2555.98,1398.32,1017.3,-48.51
1600937766401807360,2020-09,592.77,392.24,1663.2,2407.29,-543.56,-592.07
1600937766401807360,2020-10,5499.03,676.23,1736.15,0,6558.95,5966.88
1600937766401807360,2020-11,945.73,0,3157.56,2401.89,1701.4,7668.28
1600937766401807360,2020-12,2577.52,0,1141.74,2158.88,1560.38,9228.66
1601319978481409024,2020-01,1740.92,3510.71,0,1969.9,-3739.69,-3739.69
1601319978481409024,2020-02,0,1945.88,542.79,0,-1403.09,-5142.78
1601319978481409024,2020-03,1859.35,3976.69,731.72,4450.71,-5836.33,-10979.11
1601319978481409024,2020-04,783.67,1307.45,2462.93,896.08,1043.07,-9936.04
1601319978481409024,2020-05,3063.23,3221.31,1539.39,8329.55,-6948.24,-16884.28
1601319978481409024,2020-06,3945.35,1250.88,1593.17,4910.56,-622.92,-17507.2
1601319978481409024,2020-07,2377.74,3136.01,1214.87,5472.53,-5015.93,-22523.13
1601319978481409024,2020-08,9678.72,5774.49,0,3079.81,824.42,-21698.71
1601319978481409024,2020-09,191.34,3414.64,1890.69,332.5,-1665.11,-23363.82
1601319978481409024,2020-10,4764.33,6010.05,1735.36,4374.14,-3884.5,-27248.32
1601319978481409024,2020-11,2470.73,5389.88,1457.47,4650.93,-6112.61,-33360.93
1601319978481409024,2020-12,5171.38,4466.03,2711.64,419.38,2997.61,-30363.32
1601977080331490304,2020-01,3407.14,6733.41,3484,3169.72,-3011.99,-3011.99
1601977080331490304,2020-02,4813.13,3086.79,3853.57,7613.16,-2033.25,-5045.24
1601977080331490304,2020-03,2564.71,4397.83,2053.27,1143.9,-923.75,-5968.99
1601977080331490304,2020-04,0,4286.78,2870.56,2349.17,-3765.39,-9734.38
1601977080331490304,2020-05,2399.34,4784.36,1872.06,939.05,-1452.01,-11186.39
1601977080331490304,2020-06,4798.98,2885.07,4521.22,5559.79,875.34,-10311.05
1601977080331490304,2020-07,3322.61,3237.06,6442.5,4392.79,2135.26,-8175.79
1601977080331490304,2020-08,3539.57,0,6471.12,2722.46,7288.23,-887.56
1601977080331490304,2020-09,2388.96,1812.54,4637.24,2916.32,2297.34,1409.78
1601977080331490304,2020-10,1329.77,2745.82,4388.45,2079.86,892.54,2302.32
1601977080331490304,2020-11,1632.86,7689.23,2961.85,3839.97,-6934.49,-4632.17
1601977080331490304,2020-12,1898.49,4991.98,5043,1833.28,116.23,-4515.94
1602036008879004928,2020-01,649.64,6172.32,1851.4,5270.43,-8941.71,-8941.71
1602036008879004928,2020-02,615.65,6661.63,5611.58,2953.48,-3387.88,-12329.59
1602036008879004928,2020-03,3748.22,6950.57,5155.83,5755.46,-3801.98,-16131.57
1602036008879004928,2020-04,4332.95,2134.18,7443.33,2792.85,6849.25,-9282.32
1602036008879004928,2020-05,3360.76,474.98,8799.77,6121.93,5563.62,-3718.7
1602036008879004928,2020-06,2724.1,4007.89,5594.31,4247.82,62.7,-3656
1602036008879004928,2020-07,3455.28,5460.72,5693.68,1123.82,2564.42,-1091.58
1602036008879004928,2020-08,2482.53,1088.37,3848.92,5790.23,-547.15,-1638.73
1602036008879004928,2020-09,4772.03,1488.92,3385.48,2648.22,4020.37,2381.64
1602036008879004928,2020-10,1597.66,4028.35,1927.72,3990.57,-4493.54,-2111.9
1602036008879004928,2020-11,6564.66,961.34,2693.93,5603.16,2694.09,582.19
1602036008879004928,2020-12,3133.68,5563.53,677.64,2827.12,-4579.33,-3997.14
1602354449810963968,2020-01,5053.52,1749.63,7624.61,3465.1,7463.4,7463.4
1602354449810963968,2020-02,1139.11,1113.72,3551.81,3596.99,-19.79,7443.61
1602354449810963968,2020-03,2686.45,5466.42,5723.2,2582.96,360.27,7803.88
1602354449810963968,2020-04,4980.4,2255.78,4135.08,4499.29,2360.41,10164.29
1602354449810963968,2020-05,5104.97,3587.63,5547.46,3698.38,3366.42,13530.71
1602354449810963968,2020-06,3825.74,7736.01,4674.36,0,764.09,14294.8
1602354449810963968,2020-07,3293.13,6627.82,5252.71,4340.19,-2422.17,11872.63
1602354449810963968,2020-08,4001.1,7912.45,5322.7,3072.11,-1660.76,10211.87
1602354449810963968,2020-09,7246.26,7788.15,5048.45,638.7,3867.86,14079.73
1602354449810963968,2020-10,6303.42,8729.05,6515.42,3258.27,831.52,14911.25
1602354449810963968,2020-11,3400.25,9674.23,5761.52,3217.37,-3729.83,11181.42
1602354449810963968,2020-12,6912.82,4643.98,4714.8,3693.58,3290.06,14471.48
1602644147320315136,2020-01,1875.19,7003.4,9471.08,4044.9,297.97,297.97
1602644147320315136,2020-02,0,4611.27,3530.92,11680,-12760.35,-12462.38
1602644147320315136,2020-03,6597.76,3262.87,5330.58,5529.69,3135.78,-9326.6
1602644147320315136,2020-04,2137.26,0,4212.47,3529.53,2820.2,-6506.4
1602644147320315136,2020-05,2559.72,3448.87,5440.31,1000.62,3550.54,-2955.86
1602644147320315136,2020-06,5293.79,2594.92,5485.51,3117.5,5066.88,2111.02
1602644147320315136,2020-07,2868.05,4694.94,1652.53,10086.93,-10261.29,-8150.27
1602644147320315136,2020-08,6091.36,9083.84,363.23,7655.95,-10285.2,-18435.47
1602644147320315136,2020-09,3702.37,3649.58,2875.42,6968.22,-4040.01,-22475.48
1602644147320315136,2020-10,5970.46,11434.44,1212.08,6756.82,-11008.72,-33484.2
1602644147320315136,2020-11,4906.34,3064.42,3562.07,4637.64,766.35,-32717.85
1602644147320315136,2020-12,2202.7,4789.55,4858.97,3343.52,-1071.4,-33789.25
1602694693133013248,2020-01,2938.13,5362.11,0,1149.37,-3573.35,-3573.35
1602694693133013248,2020-03,0,3004.53,4939.53,1665.49,269.51,-3303.84
1602694693133013248,2020-04,0,1728.45,1032.62,0,-695.83,-3999.67
1602694693133013248,2020-05,0,2949.72,232.23,2012.98,-4730.47,-8730.14
1602694693133013248,2020-06,1485.34,1140.31,620.02,644.98,320.07,-8410.07
1602694693133013248,2020-07,1431.33,0,1535.42,1979.27,987.48,-7422.59
1602694693133013248,2020-08,440.8,2495.93,388.12,2995.83,-4662.84,-12085.43
1602694693133013248,2020-09,1512.55,865.89,526.62,620.3,552.98,-11532.45
1602694693133013248,2020-10,797.92,701.73,1510.8,1906.06,-299.07,-11831.52
1602694693133013248,2020-11,4739.35,705.97,296.14,772.05,3557.47,-8274.05
1602694693133013248,2020-12,1905.69,0,1282.38,1296.16,1891.91,-6382.14
1602930111355037696,2020-01,3056.26,484.19,4945.86,3770.77,3747.16,3747.16
1602930111355037696,2020-02,1302.44,3853.75,5267.76,6159.22,-3442.77,304.39
1602930111355037696,2020-03,4339.75,5429.59,4494.93,1859.44,1545.65,1850.04
1602930111355037696,2020-04,3769.28,729.97,1595.62,5247.31,-612.38,1237.66
1602930111355037696,2020-05,4775.51,9435.81,4432.54,1846.2,-2073.96,-836.3
1602930111355037696,2020-06,5316.88,11717.56,11465.67,7493.16,-2428.17,-3264.47
1602930111355037696,2020-07,438.5,9026.56,6384.31,2390.66,-4594.41,-7858.88
1602930111355037696,2020-08,1531.81,12756.94,2967.08,5135.88,-13393.93,-21252.81
1602930111355037696,2020-09,10740.58,3148.2,2836.7,8965.32,1463.76,-19789.05
1602930111355037696,2020-10,3975.78,1816.83,7885.28,3446.87,6597.36,-13191.69
1602930111355037696,2020-11,1019.91,3409.31,0,3788.23,-6177.63,-19369.32
1602930111355037696,2020-12,5333.34,5176.31,4253.14,2310.02,2100.15,-17269.17
1603939871861019904,2020-02,3800.72,2469.82,5422.26,4249.42,2503.74,2503.74
1603939871861019904,2020-03,3735.34,5862.83,1407.83,1814.42,-2534.08,-30.34
1603939871861019904,2020-04,2365.34,4122.12,2811.74,3321.71,-2266.75,-2297.09
1603939871861019904,2020-05,3153.03,8373.97,1614.43,636.64,-4243.15,-6540.24
1603939871861019904,2020-06,2982.22,1052.66,4089.78,2667.06,3352.28,-3187.96
1603939871861019904,2020-07,3019.39,5511.92,0,3737.96,-6230.49,-9418.45
1603939871861019904,2020-08,1950.1,4934.9,3599.38,4486.47,-3871.89,-13290.34
1603939871861019904,2020-09,2321.8,1511.91,2882.75,3841.2,-148.56,-13438.9
1603939871861019904,2020-10,1953.08,6461.96,290.8,7352.53,-11570.61,-25009.51
1603939871861019904,2020-11,2206.37,3654.89,6702.8,5763.82,-509.54,-25519.05
1603939871861019904,2020-12,4480.74,5794.54,4295.8,4560.01,-1578.01,-27097.06
1605820021126945792,2020-01,0,1066.87,0,2770.54,-3837.41,-3837.41
1605820021126945792,2020-02,0,1770.21,908.91,0,-861.3,-4698.71
1605820021126945792,2020-03,0,1447.67,2321.44,0,873.77,-3824.94
1605820021126945792,2020-05,0,1442.59,589.53,795.62,-1648.68,-5473.62
1605820021126945792,2020-06,442.83,0,0,1779.74,-1336.91,-6810.53
1605820021126945792,2020-07,231.16,143.53,0,0,87.63,-6722.9
1605820021126945792,2020-08,0,1458.84,1519.81,0,60.97,-6661.93
1605820021126945792,2020-09,0,1546.11,1708.12,1872.82,-1710.81,-8372.74
1605820021126945792,2020-10,1458.05,4299.14,0,0,-2841.09,-11213.83
1605820021126945792,2020-11,5000.43,0,422.66,0,5423.09,-5790.74
1605820021126945792,2020-12,442.25,1898.73,0,1424.63,-2881.11,-8671.85
1606103564181051136,2020-01,2902.24,2530.57,3983.47,5610.56,-1255.42,-1255.42
1606103564181051136,2020-02,1916.34,6957.28,3488.54,5828.58,-7380.98,-8636.4
1606103564181051136,2020-03,0,2447.4,8087.69,7547.05,-1906.76,-10543.16
1606103564181051136,2020-04,3393.21,1657.2,2925.49,1356.99,3304.51,-7238.65
1606103564181051136,2020-05,3200.53,2674.45,3025.3,2839.07,712.31,-6526.34
1606103564181051136,2020-06,8932.63,1211.9,3017.76,6418.04,4320.45,-2205.89
1606103564181051136,2020-07,5537,3298.72,3106.21,7079.09,-1734.6,-3940.49
1606103564181051136,2020-08,1525.89,2957.69,4885.5,6736.87,-3283.17,-7223.66
1606103564181051136,2020-09,1265.22,5574.94,2226.05,871.85,-2955.52,-10179.18
1606103564181051136,2020-10,6051.51,6971.75,3919.55,1999.9,999.41,-9179.77
1606103564181051136,2020-11,10135.09,5239.06,4505.11,5034.03,4367.11,-4812.66
1606103564181051136,2020-12,0,4078.71,1233.76,4819.48,-7664.43,-12477.09
1608704200920143360,2020-01,7085.55,2053.35,4983.84,1487.07,8528.97,8528.97
1608704200920143360,2020-02,2487.79,4380.53,349.13,325.81,-1869.42,6659.55
1608704200920143360,2020-03,4537.11,577.14,7523.84,3250.05,8233.76,14893.31
1608704200920143360,2020-04,0,1027.13,2963.72,4294.61,-2358.02,12535.29
1608704200920143360,2020-05,2881.34,3381.87,2420.33,5799.42,-3879.62,8655.67
1608704200920143360,2020-06,2685.52,2901.68,3601.52,5004.27,-1618.91,7036.76
1608704200920143360,2020-07,2075.8,1702.75,1093.74,2250.13,-783.34,6253.42
1608704200920143360,2020-08,2837.52,4873.08,2411.37,1184.07,-808.26,5445.16
1608704200920143360,2020-09,4094.66,3321.28,0,2300.22,-1526.84,3918.32
1608704200920143360,2020-10,3742.22,4003.85,4096.96,3169.66,665.67,4583.99
1608704200920143360,2020-11,697.95,3558.83,2468.96,0,-391.92,4192.07
1608704200920143360,2020-12,1801.55,5340.96,3835.48,5501.19,-5205.12,-1013.05
1609867818460790272,2020-02,3362.53,1045.3,828.96,461.37,2684.82,2684.82
1609867818460790272,2020-03,4884.92,3681.06,3207.59,1400.13,3011.32,5696.14
1609867818460790272,2020-04,0,2436.18,0,0,-2436.18,3259.96
1609867818460790272,2020-05,604.19,3794.22,0,451.98,-3642.01,-382.05
1609867818460790272,2020-06,687.04,3029.27,2681.05,860.48,-521.66,-903.71
1609867818460790272,2020-07,1184.38,1076.68,513.31,2436.11,-1815.1,-2718.81
1609867818460790272,2020-08,722.17,0,0,0,722.17,-1996.64
1609867818460790272,2020-09,1951.97,537.2,1200.18,283.25,2331.7,335.06
1609867818460790272,2020-10,231.46,0,977.89,356.64,852.71,1187.77
1609867818460790272,2020-11,1943.38,1301.14,0,0,642.24,1830.01
1609867818460790272,2020-12,4472.71,3624.2,1394.33,3641.76,-1398.92,431.09
1611167232810097152,2020-01,4352.14,5180.98,3595.02,5781.26,-3015.08,-3015.08
1611167232810097152,2020-02,3637.13,6365.01,9124.52,4168.52,2228.12,-786.96
1611167232810097152,2020-03,3511.18,4652.17,4706.34,5996.25,-2430.9,-3217.86
1611167232810097152,2020-04,0,595.72,5077.51,2126.78,2355.01,-862.85
1611167232810097152,2020-05,2359.26,3392.02,6684.38,2327.26,3324.36,2461.51
1611167232810097152,2020-06,5831.25,2641.55,5966.02,604.1,8551.62,11013.13
1611167232810097152,2020-07,1267.86,6823.35,1795.48,2538.23,-6298.24,4714.89
1611167232810097152,2020-08,5879.32,7607.4,3722.42,5712.31,-3717.97,996.92
1611167232810097152,2020-09,1877.79,1904.05,1834.42,6359.84,-4551.68,-3554.76
1611167232810097152,2020-10,4916.73,7168.05,7371.14,5205.32,-85.5,-3640.26
1611167232810097152,2020-11,6265.76,3027.04,5428.33,4562.79,4104.26,464
1611167232810097152,2020-12,4698.77,1182.57,12346.96,8157.51,7705.65,8169.65
1611385764549220352,2020-01,1666.59,947.93,735.95,1655.42,-200.81,-200.81
1611385764549220352,2020-02,1178.64,3884.97,235.06,1128.52,-3599.79,-3800.6
1611385764549220352,2020-03,5853.17,2761.09,2567.98,4135.73,1524.33,-2276.27
1611385764549220352,2020-04,6206.1,2023.26,917.66,676.63,4423.87,2147.6
1611385764549220352,2020-05,2121.29,4168.59,4416.29,3599.63,-1230.64,916.96
1611385764549220352,2020-06,2405.17,4515.4,2460.92,5366.81,-5016.12,-4099.16
1611385764549220352,2020-07,4548.74,6169.17,2546.5,5012.29,-4086.22,-8185.38
1611385764549220352,2020-08,3509.92,1935.53,5779.23,2546.49,4807.13,-3378.25
1611385764549220352,2020-09,5533.62,4340.5,2268.91,307.13,3154.9,-223.35
1611385764549220352,2020-10,3365.18,1436.12,2746.19,1612.25,3063,2839.65
1611385764549220352,2020-11,3172.35,632.88,2738.48,3259.93,2018.02,4857.67
1611385764549220352,2020-12,2438.82,3988.91,4125.48,1451.92,1123.47,5981.14
1611494785713040640,2020-01,0,553.61,0,988.26,-1541.87,-1541.87
1611494785713040640,2020-02,1582.81,2090.86,601.97,398,-304.08,-1845.95
1611494785713040640,2020-04,3280.55,0,0,255.76,3024.79,1178.84
1611494785713040640,2020-05,0,1201.14,0,1698.17,-2899.31,-1720.47
1611494785713040640,2020-06,3088.23,0,0,0,3088.23,1367.76
1611494785713040640,2020-07,497.43,1537.41,2383.13,1376.25,-33.1,1334.66
1611494785713040640,2020-09,2378.03,1009.84,1545.38,3563.68,-650.11,684.55
1611494785713040640,2020-10,1982.87,1423.67,0,1573.63,-1014.43,-329.88
1611494785713040640,2020-11,2676.62,0,1749.86,417.97,4008.51,3678.63
1611494785713040640,2020-12,1074.58,0,1224.4,869.59,1429.39,5108.02
1612741386737594368,2020-01,1842.25,755.07,896.06,3339.26,-1356.02,-1356.02
1612741386737594368,2020-02,2465.23,4234.8,4176.62,2088.24,318.81,-1037.21
1612741386737594368,2020-03,526.42,4535.21,1263.95,0,-2744.84,-3782.05
1612741386737594368,2020-05,1751.04,0,1319.8,1214.47,1856.37,-1925.68
1612741386737594368,2020-06,2102.91,1635.18,1381.06,101.23,1747.56,-178.12
1612741386737594368,2020-07,0,3367.71,1879.97,1634.74,-3122.48,-3300.6
1612741386737594368,2020-08,1504.95,288.39,1487.82,581.11,2123.27,-1177.33
1612741386737594368,2020-10,1096.61,1621.75,2250.36,0,1725.22,547.89
1612741386737594368,2020-11,2546.99,0,0,0,2546.99,3094.88
1612741386737594368,2020-12,2458.07,0,208.94,2422.5,244.51,3339.39
1613518719512217600,2020-01,1483.36,1320.65,0,0,162.71,162.71
1613518719512217600,2020-02,0,3450.64,1754.83,1248.31,-2944.12,-2781.41
1613518719512217600,2020-03,2866.16,1869.13,3502.22,5980.21,-1480.96,-4262.37
1613518719512217600,2020-04,1136.34,936.1,5251.77,62.29,5389.72,1127.35
1613518719512217600,2020-05,0,3016.12,2095.34,2426.73,-3347.51,-2220.16
1613518719512217600,2020-06,0,3465.74,0,1973.56,-5439.3,-7659.46
1613518719512217600,2020-07,7472.72,1412.45,610.02,2365.32,4304.97,-3354.49
1613518719512217600,2020-08,901.49,3731.98,1504.59,3141.28,-4467.18,-7821.67
1613518719512217600,2020-09,2206.84,1831.11,342.69,711.67,6.75,-7814.92
1613518719512217600,2020-10,233.95,0,710.64,4482.92,-3538.33,-11353.25
1613518719512217600,2020-11,1741.46,2581.51,0,1221.9,-2061.95,-13415.2
1613518719512217600,2020-12,0,1985.29,2576.83,0,591.54,-12823.66
1613547804422991360,2020-04,0,1193.34,0,0,-1193.34,-1193.34
1613547804422991360,2020-10,189.03,0,267.2,503.61,-47.38,-1240.72
1613912828476647680,2020-01,2180.73,1058.25,2008.31,0,3130.79,3130.79
1613912828476647680,2020-02,1008.87,81.23,1487.82,0,2415.46,5546.25
1613912828476647680,2020-03,2150.69,642.47,1168.61,1136.36,1540.47,7086.72
1613912828476647680,2020-04,0,2125.6,3793.03,1766.07,-98.64,6988.08
1613912828476647680,2020-05,3409.85,2700.8,1102.2,1072.85,738.4,7726.48
1613912828476647680,2020-06,4892.69,0,1354.66,4123.68,2123.67,9850.15
1613912828476647680,2020-07,554.85,2357.2,290.06,1186.34,-2698.63,7151.52
1613912828476647680,2020-08,0,2087.56,2495.38,4331.66,-3923.84,3227.68
1613912828476647680,2020-09,0,2111.75,0,263.99,-2375.74,851.94
1613912828476647680,2020-10,0,768.84,1540.95,1732.84,-960.73,-108.79
1613912828476647680,2020-11,3826.1,5340.16,2323.21,2910.05,-2100.9,-2209.69
1613912828476647680,2020-12,830.13,1014.84,5744.31,1339.1,4220.5,2010.81
1614234752539722752,2020-01,1886.44,39.76,0,580.68,1266,1266
1614234752539722752,2020-02,0,551.42,4248.29,2961.99,734.88,2000.88
1614234752539722752,2020-03,1350.41,1291.09,211.3,0,270.62,2271.5
1614234752539722752,2020-04,2327.91,2993.86,3150.67,757.31,1727.41,3998.91
1614234752539722752,2020-05,3404.28,3642.96,2458.03,2736.7,-517.35,3481.56
1614234752539722752,2020-06,0,2973.43,1627.48,2957.97,-4303.92,-822.36
1614234752539722752,2020-07,2100.93,2150.28,848.8,3455.39,-2655.94,-3478.3
1614234752539722752,2020-08,0,1391.3,1579.84,0,188.54,-3289.76
1614234752539722752,2020-09,3155.18,1052.05,0,671.4,1431.73,-1858.03
1614234752539722752,2020-10,1044.01,3003.59,2969.82,154.99,855.25,-1002.78
1614234752539722752,2020-11,4069.95,6440.49,0,0,-2370.54,-3373.32
1614234752539722752,2020-12,607.56,583.06,493,807.06,-289.56,-3662.88
1614333565146521344,2020-01,3417.52,5839.03,2022.2,1261.33,-1660.64,-1660.64
1614333565146521344,2020-02,2950.63,127.02,9352.09,4151.43,8024.27,6363.63
1614333565146521344,2020-03,1561.96,4366.89,4154.61,2439.86,-1090.18,5273.45
1614333565146521344,2020-04,7122.78,1593.73,6338.7,769.71,11098.04,16371.49
1614333565146521344,2020-05,4030.99,1924.61,3972.72,1986.4,4092.7,20464.19
1614333565146521344,2020-06,6829.99,506.25,1139.55,2560.73,4902.56,25366.75
1614333565146521344,2020-07,4639.04,6105.57,2297.33,1374.79,-543.99,24822.76
1614333565146521344,2020-08,4521.33,0,2273.76,2510.97,4284.12,29106.88
1614333565146521344,2020-09,8198.45,4016.14,4445.55,1947.24,6680.62,35787.5
1614333565146521344,2020-10,1811.29,5591.73,445.21,2847.68,-6182.91,29604.59
1614333565146521344,2020-11,2576.85,1931.04,1676.76,759.86,1562.71,31167.3
1614333565146521344,2020-12,3561.48,1507.83,818.73,2960.28,-87.9,31079.4
1617006744959942656,2020-01,3258.25,3181.94,4643.35,0,4719.66,4719.66
1617006744959942656,2020-02,478.15,1905.12,23.5,6512.56,-7916.03,-3196.37
1617006744959942656,2020-03,1664.98,0,349.52,1021.51,992.99,-2203.38
1617006744959942656,2020-04,1356.61,1983.4,2036.51,728.16,681.56,-1521.82
1617006744959942656,2020-05,2334.83,3388.53,4882.75,3046.96,782.09,-739.73
1617006744959942656,2020-06,536.37,1384.64,851.08,6247.99,-6245.18,-6984.91
1617006744959942656,2020-07,2002.23,961.59,462.87,4783.94,-3280.43,-10265.34
1617006744959942656,2020-08,761.05,1015.87,0,2127.28,-2382.1,-12647.44
1617006744959942656,2020-09,1215.2,2908.59,1939.87,1648.04,-1401.56,-14049
1617006744959942656,2020-10,1237.77,2915.01,2043.12,6557.07,-6191.19,-20240.19
1617006744959942656,2020-11,5247.75,2893.41,1872.47,702.27,3524.54,-16715.65
1617006744959942656,2020-12,1558.88,1660.77,2645.85,4592.47,-2048.51,-18764.16
1617296696654530304,2020-01,6985.31,6280.06,3859.53,5638.61,-1073.83,-1073.83
1617296696654530304,2020-02,3349.85,1098.71,692.76,4675.05,-1731.15,-2804.98
1617296696654530304,2020-03,0,2986.98,838.48,0,-2148.5,-4953.48
1617296696654530304,2020-04,4639.17,4053.19,3834.07,2993.33,1426.72,-3526.76
1617296696654530304,2020-05,385.78,3255.95,5462.48,2442.49,149.82,-3376.94
1617296696654530304,2020-06,876.19,1903.51,1905.99,1715.32,-836.65,-4213.59
1617296696654530304,2020-07,4318.88,4164.23,7076.46,0,7231.11,3017.52
1617296696654530304,2020-08,3663.36,1014.52,1222.95,5775.32,-1903.53,1113.99
1617296696654530304,2020-09,1451.05,3468.93,1917.21,5373.68,-5474.35,-4360.36
1617296696654530304,2020-10,1592.95,2231.02,7778.56,3200.06,3940.43,-419.93
1617296696654530304,2020-11,1823.9,1306.02,3091.08,7542,-3933.04,-4352.97
1617296696654530304,2020-12,2706.61,0,1808.33,1867.53,2647.41,-1705.56
1617764697078422272,2020-01,8384.6,7009.93,2479.97,3995.06,-140.42,-140.42
1617764697078422272,2020-02,2008.72,3564.63,3336.57,4921.55,-3140.89,-3281.31
1617764697078422272,2020-03,10462.03,3424.83,2044.29,5586.4,3495.09,213.78
1617764697078422272,2020-04,2440.26,3106.6,4557.98,4750.88,-859.24,-645.46
1617764697078422272,2020-05,7766.54,4720.4,7175.13,821.34,9399.93,8754.47
1617764697078422272,2020-06,2201.82,7776.15,2393.31,4200.18,-7381.2,1373.27
1617764697078422272,2020-07,2338.32,0,2333.96,4252.75,419.53,1792.8
1617764697078422272,2020-08,4740.64,4309.13,10445.99,6000.68,4876.82,6669.62
1617764697078422272,2020-09,4722.95,3538.49,1059.16,3380.31,-1136.69,5532.93
1617764697078422272,2020-10,6305.83,3189.48,4776.41,1522.35,6370.41,11903.34
1617764697078422272,2020-11,7316.57,1874.14,3691.61,4706.45,4427.59,16330.93
1617764697078422272,2020-12,2189.75,8204.86,9241.99,1285.11,1941.77,18272.7
1618940975958251008,2020-02,0,2137.34,0,3017.39,-5154.73,-5154.73
1618940975958251008,2020-03,1854.56,165.77,0,0,1688.79,-3465.94
1618940975958251008,2020-04,92.52,668.64,0,134.1,-710.22,-4176.16
1618940975958251008,2020-07,758.65,0,583.32,0,1341.97,-2834.19
1618940975958251008,2020-09,1206,1848.99,0,0,-642.99,-3477.18
1618940975958251008,2020-10,0,1238.52,0,60.9,-1299.42,-4776.6
1618940975958251008,2020-11,0,551.25,48.38,0,-502.87,-5279.47
1618940975958251008,2020-12,607.37,0,0,292.07,315.3,-4964.17
1619709713421097984,2020-01,5813.88,1612.87,5674.47,5163.46,4712.02,4712.02
1619709713421097984,2020-02,5294.06,1932.11,271.52,1675.99,1957.48,6669.5
1619709713421097984,2020-03,2613.44,6598.1,1910.53,2400.74,-4474.87,2194.63
1619709713421097984,2020-04,1981.45,4895.74,4861.99,3242.31,-1294.61,900.02
1619709713421097984,2020-05,2118.86,5913.66,0,0,-3794.8,-2894.78
1619709713421097984,2020-06,2480.39,728.4,3350.88,1502.62,3600.25,705.47
1619709713421097984,2020-07,1428.09,4469.75,1824.33,2337.66,-3554.99,-2849.52
1619709713421097984,2020-08,201.59,5591.77,708.34,2261.59,-6943.43,-9792.95
1619709713421097984,2020-09,430.21,2683.07,2280.86,4432.23,-4404.23,-14197.18
1619709713421097984,2020-10,2988.55,1149.97,552.94,4665.27,-2273.75,-16470.93
1619709713421097984,2020-11,0,2841.42,4488.29,1341.51,305.36,-16165.57
1619709713421097984,2020-12,3091.17,2370.7,3467.55,4214.53,-26.51,-16192.08
1621376252295982080,2020-01,2440.95,2449.67,9982.79,5630.49,4343.58,4343.58
1621376252295982080,2020-02,2392.93,3677.11,809.73,4098.53,-4572.98,-229.4
1621376252295982080,2020-03,2222.74,1970.42,8415.18,3330.63,5336.87,5107.47
1621376252295982080,2020-04,1529.12,2027.62,4706.53,3019.26,1188.77,6296.24
1621376252295982080,2020-05,1712.44,304.23,4079.55,1732.49,3755.27,10051.51
1621376252295982080,2020-06,0,4150,4286.88,3328.38,-3191.5,6860.01
1621376252295982080,2020-07,3649.59,3321.54,3857.87,3675.35,510.57,7370.58
1621376252295982080,2020-08,3550.98,0,2100.54,1557.97,4093.55,11464.13
1621376252295982080,2020-09,6820.37,872.99,3473,1242.57,8177.81,19641.94
1621376252295982080,2020-10,74.61,4018.64,820.16,2255.62,-5379.49,14262.45
1621376252295982080,2020-11,5855.42,0,3441.05,1076.66,8219.81,22482.26
1621376252295982080,2020-12,2952.84,5974.76,1440.12,322.69,-1904.49,20577.77
1623246221256661760,2020-01,2811.65,0,1593.16,5712.24,-1307.43,-1307.43
1623246221256661760,2020-02,1995.34,945.99,6092.64,6186.6,955.39,-352.04
1623246221256661760,2020-03,614.55,1144.43,2473.27,1681.43,261.96,-90.08
1623246221256661760,2020-04,1990.04,1896.53,1253,1869.63,-523.12,-613.2
1623246221256661760,2020-05,0,3434.38,959.04,2398.04,-4873.38,-5486.58
1623246221256661760,2020-06,2157.71,1156.78,2104.09,1583.41,1521.61,-3964.97
1623246221256661760,2020-07,3819.48,1508.9,3458.09,2730.5,3038.17,-926.8
1623246221256661760,2020-08,1307.55,2025.63,5064.21,5014.13,-668,-1594.8
1623246221256661760,2020-09,3288.21,1697.02,2422.07,3057.33,955.93,-638.87
1623246221256661760,2020-10,7687.66,5175.54,3862.19,2361.48,4012.83,3373.96
1623246221256661760,2020-11,1339.74,4156.53,275.91,5527.32,-8068.2,-4694.24
1623246221256661760,2020-12,1792.13,5588.49,3402.6,5228.6,-5622.36,-10316.6
1623503533391037184,2020-01,2113.12,892.89,1337.77,1934.28,623.72,623.72
1623503533391037184,2020-02,0,3788.49,44.34,947.34,-4691.49,-4067.77
1623503533391037184,2020-03,511.58,2279.35,166.17,0,-1601.6,-5669.37
1623503533391037184,2020-04,1176.99,219.97,1952.23,1595.75,1313.5,-4355.87
1623503533391037184,2020-05,5175.23,1287.82,3515.75,4451.7,2951.46,-1404.41
1623503533391037184,2020-06,380.68,1675.45,2362.15,2617.38,-1550,-2954.41
1623503533391037184,2020-07,4500.79,1752.2,2594.02,898.23,4444.38,1489.97
1623503533391037184,2020-08,2981.15,1662.66,2864.45,1573.87,2609.07,4099.04
1623503533391037184,2020-09,0,1650.31,1821.96,0,171.65,4270.69
1623503533391037184,2020-10,0,2686.6,871.94,2704.41,-4519.07,-248.38
1623503533391037184,2020-11,252.08,4139.41,4409.97,0,522.64,274.26
1623503533391037184,2020-12,585.04,1931.88,3186.3,2870.29,-1030.83,-756.57
1623969816265341184,2020-01,2494.89,2653.3,3699.32,2907.77,633.14,633.14
1623969816265341184,2020-02,3207.67,0,625.18,1326.75,2506.1,3139.24
1623969816265341184,2020-03,1123.79,6149.84,1950.66,3270.24,-6345.63,-3206.39
1623969816265341184,2020-04,3834.84,3824.29,4031.45,874.31,3167.69,-38.7
1623969816265341184,2020-05,3732.21,1200.16,0,1105.71,1426.34,1387.64
1623969816265341184,2020-06,2184.53,3742.07,3399.98,0,1842.44,3230.08
1623969816265341184,2020-07,116.54,1566.05,2170.47,1429.9,-708.94,2521.14
1623969816265341184,2020-08,809.72,2268.23,1141.36,0,-317.15,2203.99
1623969816265341184,2020-09,0,1177.77,0,202.26,-1380.03,823.96
1623969816265341184,2020-10,7987.18,4887.62,2459.66,1910.12,3649.1,4473.06
1623969816265341184,2020-11,1989.54,0,0,1175.72,813.82,5286.88
1623969816265341184,2020-12,0,2475.2,959.15,1461.22,-2977.27,2309.61
1624269278915868416,2020-01,1106.4,660.36,0,0,446.04,446.04
1624269278915868416,2020-02,688.77,0,0,0,688.77,1134.81
1624269278915868416,2020-03,130.26,3638.06,2905.58,552.33,-1154.55,-19.74
1624269278915868416,2020-04,888.38,1903.31,0,0,-1014.93,-1034.67
1624269278915868416,2020-05,0,417.09,528.69,0,111.6,-923.07
1624269278915868416,2020-06,0,1983.32,0,0,-1983.32,-2906.39
1624269278915868416,2020-07,0,912.47,0,3425.45,-4337.92,-7244.31
1624269278915868416,2020-08,1063.67,0,791.74,92.02,1763.39,-5480.92
1624269278915868416,2020-09,1326.48,0,0,2032.19,-705.71,-6186.63
1624269278915868416,2020-10,0,1000.49,1325.38,1918.45,-1593.56,-7780.19
1624269278915868416,2020-11,69.2,262.1,2.96,1272.63,-1462.57,-9242.76
1624269278915868416,2020-12,639.51,0,2019.52,741.49,1917.54,-7325.22
1624650626798849536,2020-01,2710.56,0,3865.89,314.96,6261.49,6261.49
1624650626798849536,2020-02,2624.47,3093.02,4398.13,0,3929.58,10191.07
1624650626798849536,2020-03,42.48,3871.24,4337.48,3355.32,-2846.6,7344.47
1624650626798849536,2020-04,5012.54,4113.7,2545.03,10138.44,-6694.57,649.9
1624650626798849536,2020-05,3010.48,1771.59,6967.52,1521.62,6684.79,7334.69
1624650626798849536,2020-06,1577.8,3912.61,1697.8,1163.81,-1800.82,5533.87
1624650626798849536,2020-07,322.8,3917.44,836.03,1868.31,-4626.92,906.95
1624650626798849536,2020-08,4386.69,449.4,5633.95,273.58,9297.66,10204.61
1624650626798849536,2020-10,5639.19,1974.83,2177.61,1290.3,4551.67,14756.28
1624650626798849536,2020-11,2764.55,2651.7,4474.21,1739.62,2847.44,17603.72
1624650626798849536,2020-12,3221.04,1945.85,276.95,5328.37,-3776.23,13827.49
1626325833591865600,2020-01,3606.42,2375.95,1687.26,1843.48,1074.25,1074.25
1626325833591865600,2020-02,4709.07,2513.38,6302.97,1325.86,7172.8,8247.05
1626325833591865600,2020-03,9591.09,6597.4,6559.15,7808.28,1744.56,9991.61
1626325833591865600,2020-04,2681.79,2441.2,2438.1,4136.68,-1457.99,8533.62
1626325833591865600,2020-05,2556.2,1611.48,3444.08,3135.96,1252.84,9786.46
1626325833591865600,2020-06,5961.45,5284.45,4225.23,3560.6,1341.63,11128.09
1626325833591865600,2020-07,4372.47,7068.81,5697.28,7736.65,-4735.71,6392.38
1626325833591865600,2020-08,2628.96,2765.55,6492.93,4976.74,1379.6,7771.98
1626325833591865600,2020-09,6772.33,5791.99,5850.66,10376.98,-3545.98,4226
1626325833591865600,2020-10,3122.26,2873.76,6829.48,6434.98,643,4869
1626325833591865600,2020-11,5863.69,2819.81,6854.88,3510.89,6387.87,11256.87
1626325833591865600,2020-12,4362.41,10918.91,2004.1,4760.79,-9313.19,1943.68
1626849174829862144,2020-01,2421.77,10126.49,2570.44,3343.84,-8478.12,-8478.12
1626849174829862144,2020-02,4782.78,5347.49,2379.38,4952.57,-3137.9,-11616.02
1626849174829862144,2020-03,122.66,2403.57,4532.54,4290.35,-2038.72,-13654.74
1626849174829862144,2020-04,8022.75,2870.77,7582.63,4665.2,8069.41,-5585.33
1626849174829862144,2020-05,10961.8,7781.27,8806.33,6414.2,5572.66,-12.67
1626849174829862144,2020-06,2768.61,3224.83,6256.28,4158.26,1641.8,1629.13
1626849174829862144,2020-07,6792.25,9739.96,3704.11,3252.2,-2495.8,-866.67
1626849174829862144,2020-08,5301.39,7282.99,2365.22,2777.02,-2393.4,-3260.07
1626849174829862144,2020-09,3720.92,2993.08,1382.03,6000.73,-3890.86,-7150.93
1626849174829862144,2020-10,4766.51,4727.36,2209.93,2837.03,-587.95,-7738.88
1626849174829862144,2020-11,9467.25,3086.26,5933.72,6384.83,5929.88,-1809
1626849174829862144,2020-12,5232.42,6997.73,4203.46,6034.34,-3596.19,-5405.19
1626896285740826624,2020-01,3387.46,3706.57,2524.39,2334.18,-128.9,-128.9
1626896285740826624,2020-02,1386.07,1401.21,4049.67,3412.75,621.78,492.88
1626896285740826624,2020-03,2290.58,5751.59,3596.05,1072.84,-937.8,-444.92
1626896285740826624,2020-04,1224.12,850.73,2020.53,1972.55,421.37,-23.55
1626896285740826624,2020-05,2554.84,2095.91,0,0,458.93,435.38
1626896285740826624,2020-06,2236.45,809.07,636.67,3146.47,-1082.42,-647.04
1626896285740826624,2020-07,1772.9,2701,813.21,1756.28,-1871.17,-2518.21
1626896285740826624,2020-08,2238.72,5012.92,978.06,0,-1796.14,-4314.35
1626896285740826624,2020-09,3933.15,2262.6,2212.97,1724.31,2159.21,-2155.14
1626896285740826624,2020-10,1034.58,957.42,129.21,1345.12,-1138.75,-3293.89
1626896285740826624,2020-11,2638.33,637.21,6603.91,1769.14,6835.89,3542
1626896285740826624,2020-12,2972.33,0,0,939.5,2032.83,5574.83
1627899401346944768,2020-01,3665.76,4713.75,2636.19,2998.29,-1410.09,-1410.09
1627899401346944768,2020-02,1469.35,6080.98,5209.69,6295.73,-5697.67,-7107.76
1627899401346944768,2020-03,6299.07,4676.41,690.26,884.14,1428.78,-5678.98
1627899401346944768,2020-04,4.79,3810.8,4327.24,7037.73,-6516.5,-12195.48
1627899401346944768,2020-05,5541.68,6424.44,2618.04,1398.48,336.8,-11858.68
1627899401346944768,2020-06,5021.57,1710.4,2556.42,2998.84,2868.75,-8989.93
1627899401346944768,2020-07,4306.78,6867.31,11537.37,2234.55,6742.29,-2247.64
1627899401346944768,2020-08,4722.33,5427.95,4733.67,4162.89,-134.84,-2382.48
1627899401346944768,2020-09,4260.31,4439.11,3839.84,1790.89,1870.15,-512.33
1627899401346944768,2020-10,4788,10221.6,9740.77,639.42,3667.75,3155.42
1627899401346944768,2020-11,3675.61,4338.58,503.48,5852.92,-6012.41,-2856.99
1627899401346944768,2020-12,250.4,1748.57,3103.46,4604.57,-2999.28,-5856.27
1628506633971594752,2020-01,3089.05,4550.97,9974.08,3758.74,4753.42,4753.42
1628506633971594752,2020-02,4629.09,1874.31,7589.94,5169.65,5175.07,9928.49
1628506633971594752,2020-03,3160.99,8213.26,5341.77,4020.99,-3731.49,6197
1628506633971594752,2020-04,6910.07,1451.11,431.7,2810.71,3079.95,9276.95
1628506633971594752,2020-05,3340.39,3307.67,3409.85,3619.74,-177.17,9099.78
1628506633971594752,2020-06,4847.36,4896.58,44.75,3283.56,-3288.03,5811.75
1628506633971594752,2020-07,9247.91,9501.5,3451.13,5643.66,-2446.12,3365.63
1628506633971594752,2020-08,1308.14,1038.12,4016.93,4695.57,-408.62,2957.01
1628506633971594752,2020-09,3302.27,1175.14,1449.25,4888.75,-1312.37,1644.64
1628506633971594752,2020-10,3568.49,2958.97,2440.15,2514.36,535.31,2179.95
1628506633971594752,2020-11,7280.04,417.96,4043.94,4502.21,6403.81,8583.76
1628506633971594752,2020-12,3750.22,2319.64,4299.57,2222.48,3507.67,12091.43
1628646924130924800,2020-01,12108.5,5788.97,1771.51,1257.07,6833.97,6833.97
1628646924130924800,2020-02,3346.54,2376.34,1698.38,3146.14,-477.56,6356.41
1628646924130924800,2020-03,6118.38,726.98,2367.73,8177.63,-418.5,5937.91
1628646924130924800,2020-04,5550.46,5920.99,4474.03,2406.42,1697.08,7634.99
1628646924130924800,2020-05,6226.79,7070.29,7928.96,4982.22,2103.24,9738.23
1628646924130924800,2020-06,2549.01,6983.01,1755.13,2790.26,-5469.13,4269.1
1628646924130924800,2020-07,6650.5,3740.25,2784.58,9975.29,-4280.46,-11.36
1628646924130924800,2020-08,7452.81,5207.33,3325.99,8021.65,-2450.18,-2461.54
1628646924130924800,2020-09,2544.51,2255.68,6205.31,6004.1,490.04,-1971.5
1628646924130924800,2020-10,1756.77,4131.79,6920.83,4850.39,-304.58,-2276.08
1628646924130924800,2020-11,5414.93,6804.71,6673.63,2556.15,2727.7,451.62
1628646924130924800,2020-12,9283.99,4076.47,9130.88,4304.93,10033.47,10485.09
1629997526381032704,2020-01,1416.56,2778.91,3526.07,541.85,1621.87,1621.87
1629997526381032704,2020-02,0,3141.27,2620.28,0,-520.99,1100.88
1629997526381032704,2020-03,0,238.31,471.49,1164.99,-931.81,169.07
1629997526381032704,2020-04,774.92,1300.62,0,1214.63,-1740.33,-1571.26
1629997526381032704,2020-05,1705.82,0,2256.56,0,3962.38,2391.12
1629997526381032704,2020-06,1474.2,0,1979.75,1713.68,1740.27,4131.39
1629997526381032704,2020-07,0,2043.24,0,1855.49,-3898.73,232.66
1629997526381032704,2020-08,957.65,474.95,0,0,482.7,715.36
1629997526381032704,2020-09,0,1900.21,0,0,-1900.21,-1184.85
1629997526381032704,2020-10,1235.33,1462.49,1648.16,4578.15,-3157.15,-4342
1629997526381032704,2020-11,1011.48,1187.19,2195.45,154.22,1865.52,-2476.48
1629997526381032704,2020-12,0,2021.65,449.53,3316.75,-4888.87,-7365.35
1630092878511708160,2020-01,3985.25,3794.69,5273.88,6767.73,-1303.29,-1303.29
1630092878511708160,2020-02,7152.21,1953.06,6865.97,2754.19,9310.93,8007.64
1630092878511708160,2020-03,4212.97,4994,2767.72,9399.17,-7412.48,595.16
1630092878511708160,2020-04,8042.4,3211.1,4251.59,1862.45,7220.44,7815.6
1630092878511708160,2020-05,5342.61,3910.47,6543.91,5154.11,2821.94,10637.54
1630092878511708160,2020-06,3879.18,6082.52,2833.81,7851.06,-7220.59,3416.95
1630092878511708160,2020-07,6335.37,3308.35,643.36,1677.06,1993.32,5410.27
1630092878511708160,2020-08,5938.91,1869.03,782.54,8880.35,-4027.93,1382.34
1630092878511708160,2020-09,2774.37,4118.92,2960.83,941.2,675.08,2057.42
1630092878511708160,2020-10,3746.5,6486.6,5603.57,1349.23,1514.24,3571.66
1630092878511708160,2020-11,3390.34,1569.14,5045.08,3360.42,3505.86,7077.52
1630092878511708160,2020-12,3525.62,8296.7,3407.87,4013.46,-5376.67,1700.85
1630169910566005760,2020-01,1450.36,0,1497.25,0,2947.61,2947.61
1630169910566005760,2020-02,0,2762.01,0,45.61,-2807.62,139.99
1630169910566005760,2020-04,0,399.93,0,0,-399.93,-259.94
1630169910566005760,2020-05,0,1424.61,1180.04,2682.85,-2927.42,-3187.36
1630169910566005760,2020-06,1202.99,0,1699.1,692.23,2209.86,-977.5
1630169910566005760,2020-08,0,1212.42,1733.63,0,521.21,-456.29
1630169910566005760,2020-09,0,524.03,194.16,1070,-1399.87,-1856.16
1630169910566005760,2020-11,1682.11,617.35,1909.45,0,2974.21,1118.05
1630169910566005760,2020-12,2962.93,0,1003.59,1461.49,2505.03,3623.08
1631962099788180736,2020-02,1320.84,0,0,0,1320.84,1320.84
1631962099788180736,2020-04,437.8,0,0,0,437.8,1758.64
1631962099788180736,2020-06,1382.94,0,1604.49,0,2987.43,4746.07
1631962099788180736,2020-08,879.15,1583.3,0,0,-704.15,4041.92
1631962099788180736,2020-09,89.45,0,0,0,89.45,4131.37
1631962099788180736,2020-10,734.42,450.9,0,0,283.52,4414.89
1631962099788180736,2020-12,56.59,1797.93,0,0,-1741.34,2673.55
1633089046569117952,2020-01,1816.35,0,535.14,1821.33,530.16,530.16
1633089046569117952,2020-02,685.76,0,1741.65,993.48,1433.93,1964.09
1633089046569117952,2020-04,708.4,1768.62,0,0,-1060.22,903.87
1633089046569117952,2020-05,998.06,0,0,0,998.06,1901.93
1633089046569117952,2020-06,2284.21,0,911.84,0,3196.05,5097.98
1633089046569117952,2020-12,0,3115.88,0,0,-3115.88,1982.1
1635713438520084992,2020-02,0,1756.83,0,997.56,-2754.39,-2754.39
1635713438520084992,2020-04,1489.15,1386.43,1992.38,540.48,1554.62,-1199.77
1635713438520084992,2020-05,231.98,496.39,0,0,-264.41,-1464.18
1635713438520084992,2020-06,0,1414.04,0,0,-1414.04,-2878.22
1635713438520084992,2020-07,1655.17,0,10.41,0,1665.58,-1212.64
1635713438520084992,2020-08,815.91,4003.51,1067.22,1044.58,-3164.96,-4377.6
1635713438520084992,2020-09,1631.18,42.38,0,1501.76,87.04,-4290.56
1635713438520084992,2020-10,0,394.75,2166.66,827.78,944.13,-3346.43
1635713438520084992,2020-12,3488.85,0,0,1617.91,1870.94,-1475.49
1636461889835848960,2020-04,997.22,364.4,0,0,632.82,632.82
1636461889835848960,2020-05,0,3251.92,0,0,-3251.92,-2619.1
1636461889835848960,2020-07,0,2144.15,0,723.52,-2867.67,-5486.77
1636461889835848960,2020-11,1391.69,0,0,0,1391.69,-4095.08
1636625324427217152,2020-01,0,2294.45,2311.25,2021.64,-2004.84,-2004.84
1636625324427217152,2020-02,3446.74,0,3065.8,420.42,6092.12,4087.28
1636625324427217152,2020-03,89.41,201.17,1585.83,2048.07,-574,3513.28
1636625324427217152,2020-04,12.77,2232.39,2008.85,1761.31,-1972.08,1541.2
1636625324427217152,2020-05,1351.83,795.05,1619.52,0,2176.3,3717.5
1636625324427217152,2020-06,1641.31,1568.13,1604.29,583.15,1094.32,4811.82
1636625324427217152,2020-07,1996.78,0,569.36,5494.69,-2928.55,1883.27
1636625324427217152,2020-08,2172.27,2079.3,1814.39,0,1907.36,3790.63
1636625324427217152,2020-09,3501.06,2741.32,808.42,391.5,1176.66,4967.29
1636625324427217152,2020-10,1287,1723.9,2967.01,522.18,2007.93,6975.22
1636625324427217152,2020-11,1597.26,779.09,1796.92,2509.61,105.48,7080.7
1636625324427217152,2020-12,1511.09,3398.02,1160.13,0,-726.8,6353.9
1636836985879253760,2020-01,584.65,0,0,386.25,198.4,198.4
1636836985879253760,2020-02,1355.37,0,628.73,1391.44,592.66,791.06
1636836985879253760,2020-03,1983.3,89.28,543.28,1737.79,699.51,1490.57
1636836985879253760,2020-04,1492.97,0,1822.93,2403.42,912.48,2403.05
1636836985879253760,2020-05,0,1307.39,1842.06,2180.17,-1645.5,757.55
1636836985879253760,2020-06,5017.04,0,1405.8,0,6422.84,7180.39
1636836985879253760,2020-07,2656.89,1445.6,0,298.29,913,8093.39
1636836985879253760,2020-08,916.39,1384.79,1443.06,0,974.66,9068.05
1636836985879253760,2020-09,0,1877.7,3185.52,0,1307.82,10375.87
1636836985879253760,2020-10,0,483.75,0,0,-483.75,9892.12
1636836985879253760,2020-12,3001.6,2632.14,2911.1,0,3280.56,13172.68
1638582747813087488,2020-01,2023.45,641.58,933.63,1704.94,610.56,610.56
1638582747813087488,2020-02,0,693.62,1506.74,0,813.12,1423.68
1638582747813087488,2020-03,0,2564.68,3924.54,770.31,589.55,2013.23
1638582747813087488,2020-04,1730.13,0,0,22.5,1707.63,3720.86
1638582747813087488,2020-05,1590.85,0,1679.92,1691.34,1579.43,5300.29
1638582747813087488,2020-06,1538.19,0,1230.45,1084.34,1684.3,6984.59
1638582747813087488,2020-07,2962.29,1970.17,0,0,992.12,7976.71
1638582747813087488,2020-08,105.59,1232.27,760.13,396.01,-762.56,7214.15
1638582747813087488,2020-09,718.85,0,2364.42,7758.02,-4674.75,2539.4
1638582747813087488,2020-10,3572.94,1089.29,2459.34,2562.48,2380.51,4919.91
1638582747813087488,2020-11,1084.65,0,1003.22,2502.93,-415.06,4504.85
1638582747813087488,2020-12,1428.95,2271.72,2994.58,625.62,1526.19,6031.04
1639062140018044928,2020-01,4047.55,441.49,0,3199.01,407.05,407.05
1639062140018044928,2020-02,1973.57,4769.42,2582.24,706.29,-919.9,-512.85
1639062140018044928,2020-03,821.6,1658.62,0,6222.44,-7059.46,-7572.31
1639062140018044928,2020-04,317.19,0,207.19,0,524.38,-7047.93
1639062140018044928,2020-05,4016.19,2977.09,5347.1,1640.44,4745.76,-2302.17
1639062140018044928,2020-06,3968.34,3505.35,0,0,462.99,-1839.18
1639062140018044928,2020-07,1567.32,2481.45,745.22,1116.73,-1285.64,-3124.82
1639062140018044928,2020-08,2984.93,791.43,23.44,1211.38,1005.56,-2119.26
1639062140018044928,2020-09,1932.93,3949.86,5177.04,982.6,2177.51,58.25
1639062140018044928,2020-10,1117.02,3250.2,1027.18,1325.08,-2431.08,-2372.83
1639062140018044928,2020-11,4428.49,3540.52,3239.65,3565.09,562.53,-1810.3
1639062140018044928,2020-12,2330.86,786.91,0,903.32,640.63,-1169.67
1641827773504012800,2020-01,0,2222.18,316.64,3854.59,-5760.13,-5760.13
1641827773504012800,2020-02,1135.67,7472.43,1591.73,2588.39,-7333.42,-13093.55
1641827773504012800,2020-03,1558.58,3899.39,1758.58,1955.46,-2537.69,-15631.24
1641827773504012800,2020-04,863.38,1207.27,4817.09,104.93,4368.27,-11262.97
1641827773504012800,2020-05,0,3445.53,2582.33,964.9,-1828.1,-13091.07
1641827773504012800,2020-06,3061.42,2788.46,4266.21,3587.63,951.54,-12139.53
1641827773504012800,2020-07,3725.43,1200.72,3703.65,0,6228.36,-5911.17
1641827773504012800,2020-08,1364.84,1422.93,5141.51,1658.75,3424.67,-2486.5
1641827773504012800,2020-09,492.32,1728.25,2543.23,4505.09,-3197.79,-5684.29
1641827773504012800,2020-10,879.55,2043.07,0,3245.71,-4409.23,-10093.52
1641827773504012800,2020-11,2728.45,3143.08,2789.91,1872.23,503.05,-9590.47
1641827773504012800,2020-12,555.13,2337.92,6441.25,1257.76,3400.7,-6189.77
1642387143382910464,2020-02,0,95.51,161.25,0,65.74,65.74
1642387143382910464,2020-04,1838.88,126.75,0,0,1712.13,1777.87
1642387143382910464,2020-06,1286.55,0,0,1094.02,192.53,1970.4
1642387143382910464,2020-09,226.17,0,0,1582.84,-1356.67,613.73
1642387143382910464,2020-10,1973.19,0,0,1341.58,631.61,1245.34
1642387143382910464,2020-11,249.21,712.38,0,0,-463.17,782.17
1643449868997907968,2020-01,882.17,1932.27,2696.36,1808.33,-162.07,-162.07
1643449868997907968,2020-03,0,1947.75,1822.03,0,-125.72,-287.79
1643449868997907968,2020-04,0,1354.4,1856.77,1666.46,-1164.09,-1451.88
1643449868997907968,2020-05,1703.93,1425.55,0,1840.1,-1561.72,-3013.6
1643449868997907968,2020-06,1299.39,1763.58,1528.45,1356.29,-292.03,-3305.63
1643449868997907968,2020-07,2286.12,1289.59,0,1996.03,-999.5,-4305.13
1643449868997907968,2020-08,530.63,0,966.82,0,1497.45,-2807.68
1643449868997907968,2020-09,167.42,1340.14,2358.11,3262.43,-2077.04,-4884.72
1643449868997907968,2020-10,580.22,1225.8,637.89,2078.44,-2086.13,-6970.85
1643449868997907968,2020-11,0,2792.95,1973.12,3648.72,-4468.55,-11439.4
1643479381885310976,2020-01,411.6,0,0,3062.65,-2651.05,-2651.05
1643479381885310976,2020-02,404.89,1870.47,1159.3,2758.01,-3064.29,-5715.34
1643479381885310976,2020-03,2349.91,898.4,1365.11,1756.63,1059.99,-4655.35
1643479381885310976,2020-04,648.54,5180.39,0,3494.24,-8026.09,-12681.44
1643479381885310976,2020-05,0,678.68,0,1843.67,-2522.35,-15203.79
1643479381885310976,2020-06,3362.68,1091.55,1411.34,0,3682.47,-11521.32
1643479381885310976,2020-07,552.24,919.95,1231.61,0,863.9,-10657.42
1643479381885310976,2020-08,1561.09,1775.12,203.34,1597.24,-1607.93,-12265.35
1643479381885310976,2020-09,0,1581.63,0,39.75,-1621.38,-13886.73
1643479381885310976,2020-10,3660.19,1179.68,1465.09,0,3945.6,-9941.13
1643479381885310976,2020-11,106.49,1761.89,0,0,-1655.4,-11596.53
1643479381885310976,2020-12,2259.55,2876.22,130.48,3125.48,-3611.67,-15208.2
1644012141860209408,2020-01,4297.94,4117.92,1832.99,2605.59,-592.58,-592.58
1644012141860209408,2020-02,20.9,3132.6,6268.16,2485.09,671.37,78.79
1644012141860209408,2020-03,3439.86,7480.1,3685.6,3120.39,-3475.03,-3396.24
1644012141860209408,2020-04,3402.1,5259.32,3950.12,3757.43,-1664.53,-5060.77
1644012141860209408,2020-05,3683.39,1471.41,1859.36,3849.47,221.87,-4838.9
1644012141860209408,2020-06,4923.4,3815.92,5854.94,4241.83,2720.59,-2118.31
1644012141860209408,2020-07,4385.71,4189.73,5944.97,3601.09,2539.86,421.55
1644012141860209408,2020-08,1044.02,1068.19,6658.9,2714.94,3919.79,4341.34
1644012141860209408,2020-09,6420.77,1817.89,4217.81,4537.66,4283.03,8624.37
1644012141860209408,2020-10,2926.25,5269.26,7501.74,2448.4,2710.33,11334.7
1644012141860209408,2020-11,4872.13,0,4332.36,3814.49,5390,16724.7
1644012141860209408,2020-12,4748.07,613.13,174.12,3436.06,873,17597.7
1644243482972157184,2020-01,3537.28,2660.54,4209.26,10034.61,-4948.61,-4948.61
1644243482972157184,2020-02,2198.85,1443.43,3292.64,4432.73,-384.67,-5333.28
1644243482972157184,2020-03,3766.86,4715.51,5708.79,0,4760.14,-573.14
1644243482972157184,2020-04,6108.98,4833.94,625.63,4938.03,-3037.36,-3610.5
1644243482972157184,2020-05,6446.89,5251.87,3237.25,6320.83,-1888.56,-5499.06
1644243482972157184,2020-06,4850.8,6564.73,3281.15,1615.98,-48.76,-5547.82
1644243482972157184,2020-07,2810,5085.09,4383.07,1072.95,1035.03,-4512.79
1644243482972157184,2020-08,7690.21,6827.98,3764.26,3720.01,906.48,-3606.31
1644243482972157184,2020-09,5454.65,3211.32,4378.29,5741.55,880.07,-2726.24
1644243482972157184,2020-10,1967.66,4871.82,5044.07,2523.97,-384.06,-3110.3
1644243482972157184,2020-11,2990.89,5328.99,4484.6,7257.14,-5110.64,-8220.94
1644243482972157184,2020-12,5465.74,3081.46,4643.08,289.2,6738.16,-1482.78
1644645675533880320,2020-01,536.51,1806.92,324.21,0,-946.2,-946.2
1644645675533880320,2020-02,1387.27,0,355.2,0,1742.47,796.27
1644645675533880320,2020-03,735.41,0,334.91,0,1070.32,1866.59
1644645675533880320,2020-04,0,489.51,0,0,-489.51,1377.08
1644645675533880320,2020-05,3440.88,1435.41,2082.86,436.13,3652.2,5029.28
1644645675533880320,2020-06,3083.88,0,924.93,158.08,3850.73,8880.01
1644645675533880320,2020-08,891.96,0,748.2,0,1640.16,10520.17
1644645675533880320,2020-09,0,1692.14,308.62,0,-1383.52,9136.65
1644645675533880320,2020-11,0,1449.73,329.99,0,-1119.74,8016.91
1645572043076990976,2020-01,718.33,2675.37,6145.37,584.55,3603.78,3603.78
1645572043076990976,2020-02,0,2701.71,1303.61,10832.02,-12230.12,-8626.34
1645572043076990976,2020-03,1995.79,5217.77,3661.61,1925.01,-1485.38,-10111.72
1645572043076990976,2020-04,4979.25,2037.96,4311.1,1246.71,6005.68,-4106.04
1645572043076990976,2020-05,3207.56,3844.04,953.53,7969.83,-7652.78,-11758.82
1645572043076990976,2020-06,9353.92,5332.19,5190.94,1892.72,7319.95,-4438.87
1645572043076990976,2020-07,2639.11,4694.47,7063.61,2726.96,2281.29,-2157.58
1645572043076990976,2020-08,4815.12,6521.81,4440.72,2283.13,450.9,-1706.68
1645572043076990976,2020-09,6687.51,5275.11,2046.63,6506.94,-3047.91,-4754.59
1645572043076990976,2020-10,807.47,6557.41,4820.09,5737.78,-6667.63,-11422.22
1645572043076990976,2020-11,2525.53,1400.08,4091.12,4741.99,474.58,-10947.64
1645572043076990976,2020-12,937.45,1985.04,314.94,4028.78,-4761.43,-15709.07
1645650370242893056,2020-01,3381.23,6122.7,2309.65,3486.45,-3918.27,-3918.27
1645650370242893056,2020-02,2210.76,5671.62,5894.02,7964.25,-5531.09,-9449.36
1645650370242893056,2020-03,6478.07,5431.12,6061.51,2541.42,4567.04,-4882.32
1645650370242893056,2020-04,1712.05,10191.67,3681.23,6944.84,-11743.23,-16625.55
1645650370242893056,2020-05,3088.78,3609.64,11903.05,8168.96,3213.23,-13412.32
1645650370242893056,2020-06,5167.42,5137.63,6283.8,6855.55,-541.96,-13954.28
1645650370242893056,2020-07,3218.09,5553.09,7431.48,7954,-2857.52,-16811.8
1645650370242893056,2020-08,1784.04,6441.5,1005.95,5069.31,-8720.82,-25532.62
1645650370242893056,2020-09,3413.58,4225.05,3204.33,6027.98,-3635.12,-29167.74
1645650370242893056,2020-10,9612.23,5758.4,1265.91,2360.16,2759.58,-26408.16
1645650370242893056,2020-11,3967.12,3694.17,1240.08,2858.34,-1345.31,-27753.47
1645650370242893056,2020-12,7437.22,911.56,4432.33,1349.22,9608.77,-18144.7
1645830177468174336,2020-06,1401.26,0,0,1372.44,28.82,28.82
1645830177468174336,2020-10,596.62,0,0,0,596.62,625.44
1646149824927976448,2020-02,0,700.98,0,0,-700.98,-700.98
1646149824927976448,2020-04,1049.05,1222.03,0,1143.42,-1316.4,-2017.38
1646149824927976448,2020-05,272.52,928.63,0,0,-656.11,-2673.49
1646149824927976448,2020-07,1480.52,0,1460.72,0,2941.24,267.75
1646149824927976448,2020-09,0,215.82,0,196.56,-412.38,-144.63
1646149824927976448,2020-10,0,1482.69,0,0,-1482.69,-1627.32
1646149824927976448,2020-11,0,1905.39,0,0,-1905.39,-3532.71
1646150358646614528,2020-01,2965.81,8075.42,0,8000.13,-13109.74,-13109.74
1646150358646614528,2020-02,2661.93,6944.6,5083.98,5179.68,-4378.37,-17488.11
1646150358646614528,2020-03,3989.27,1535.9,1573,2436.78,1589.59,-15898.52
1646150358646614528,2020-04,3351.29,2939.49,1914.26,6550.44,-4224.38,-20122.9
1646150358646614528,2020-05,2272.93,3987.82,12069.66,7754.36,2600.41,-17522.49
1646150358646614528,2020-06,5448.81,2348.96,2110.05,6350.7,-1140.8,-18663.29
1646150358646614528,2020-07,3787.65,4269,3753.9,2875.27,397.28,-18266.01
1646150358646614528,2020-08,4720.48,3611.64,5192.92,1891.78,4409.98,-13856.03
1646150358646614528,2020-09,3960.04,761.62,5451.23,3318.38,5331.27,-8524.76
1646150358646614528,2020-10,4837.82,5288.07,5117.26,3853.54,813.47,-7711.29
1646150358646614528,2020-11,1830.93,1493.34,1709.59,4768.62,-2721.44,-10432.73
1646150358646614528,2020-12,4008.65,6737.59,4070.16,4033.61,-2692.39,-13125.12
1646964640369660416,2020-07,1416.74,0,0,0,1416.74,1416.74
1646964640369660416,2020-08,183.26,0,0,0,183.26,1600
1646964640369660416,2020-11,579.26,12.63,0,0,566.63,2166.63
1647365790657982976,2020-01,561.67,1240.49,2557.25,0,1878.43,1878.43
1647365790657982976,2020-02,190.74,409.99,940.49,54.42,666.82,2545.25
1647365790657982976,2020-03,2871.43,2261.12,0,0,610.31,3155.56
1647365790657982976,2020-04,351.06,3204.85,1256.02,1671.82,-3269.59,-114.03
1647365790657982976,2020-05,2187.87,2949.4,0,0,-761.53,-875.56
1647365790657982976,2020-06,0,1679.86,0,627.68,-2307.54,-3183.1
1647365790657982976,2020-08,126.44,3116.14,265.91,1111.05,-3834.84,-7017.94
1647365790657982976,2020-09,3216.02,56.32,3877.43,2499.33,4537.8,-2480.14
1647365790657982976,2020-10,12.39,535.06,491.93,1999.17,-2029.91,-4510.05
1647365790657982976,2020-12,342.33,1464.89,0,372.64,-1495.2,-6005.25
1648027624998188288,2020-01,1254.71,0,1128.4,2671.62,-288.51,-288.51
1648027624998188288,2020-02,1276.76,47.86,0,1142.93,85.97,-202.54
1648027624998188288,2020-04,1506.01,1087.18,1121,0,1539.83,1337.29
1648027624998188288,2020-05,354.32,351.94,1730.5,1739.87,-6.99,1330.3
1648027624998188288,2020-06,0,947.44,2555.3,35.75,1572.11,2902.41
1648027624998188288,2020-07,4888.7,3919.93,0,3266.28,-2297.51,604.9
1648027624998188288,2020-08,1080.11,1080.06,1509.63,3478.64,-1968.96,-1364.06
1648027624998188288,2020-09,512.22,1767.75,911.88,335.08,-678.73,-2042.79
1648027624998188288,2020-10,0,594.68,3429.07,1426.8,1407.59,-635.2
1648027624998188288,2020-11,0,3511.67,0,5603.27,-9114.94,-9750.14
1648027624998188288,2020-12,1831.67,271.46,1225.18,771.97,2013.42,-7736.72
1648198184827443456,2020-01,0,3878.96,2467.09,4882.44,-6294.31,-6294.31
1648198184827443456,2020-02,2696.41,2874.46,2560.48,2995.08,-612.65,-6906.96
1648198184827443456,2020-03,7455.15,4174.05,6622.67,7357.93,2545.84,-4361.12
1648198184827443456,2020-04,4869.74,4908.47,4922.81,3738.22,1145.86,-3215.26
1648198184827443456,2020-05,1769.81,3253.11,5339.31,2289.01,1567,-1648.26
1648198184827443456,2020-06,4192.4,1062.48,2689.71,1550.36,4269.27,2621.01
1648198184827443456,2020-07,7359.29,3345.9,128.97,3598.25,544.11,3165.12
1648198184827443456,2020-08,1030.51,4489.4,5228,3447.38,-1678.27,1486.85
1648198184827443456,2020-09,3293.95,4389.31,8849.23,1694.13,6059.74,7546.59
1648198184827443456,2020-10,3492.71,4773.21,2253.22,2674.22,-1701.5,5845.09
1648198184827443456,2020-11,593.94,2836.68,1750.21,4146.49,-4639.02,1206.07
1648198184827443456,2020-12,4370.31,1839.19,1031.32,4989.24,-1426.8,-220.73
1649455044886447104,2020-01,326.31,1596.58,1516.66,501.53,-255.14,-255.14
1649455044886447104,2020-02,0,4525.59,2482.75,2249.98,-4292.82,-4547.96
1649455044886447104,2020-03,2935.34,0,1672.45,4362.49,245.3,-4302.66
1649455044886447104,2020-04,1514.84,45.51,2603.32,761.35,3311.3,-991.36
1649455044886447104,2020-05,3665.85,2872.15,1449.65,3190.2,-946.85,-1938.21
1649455044886447104,2020-06,0,900.87,1267.77,1072.43,-705.53,-2643.74
1649455044886447104,2020-07,1455.45,0,0,1179.03,276.42,-2367.32
1649455044886447104,2020-08,140.42,0,489.53,3553.43,-2923.48,-5290.8
1649455044886447104,2020-09,59.22,424.12,2080.18,1086.7,628.58,-4662.22
1649455044886447104,2020-10,2321.31,2199.13,2723.16,0,2845.34,-1816.88
1649455044886447104,2020-11,2662.41,5977.13,0,0,-3314.72,-5131.6
1649455044886447104,2020-12,1218.13,0,1803.17,643.67,2377.63,-2753.97
1649594900053981184,2020-01,1673.42,0,3302.31,3688.64,1287.09,1287.09
1649594900053981184,2020-02,3932.94,6668.69,1107.25,3128.87,-4757.37,-3470.28
1649594900053981184,2020-03,2369.4,1363.04,5291.87,1722.78,4575.45,1105.17
1649594900053981184,2020-04,3255.95,2117.23,1.14,5940.95,-4801.09,-3695.92
1649594900053981184,2020-05,4861.57,1573.74,2769.85,8851.53,-2793.85,-6489.77
1649594900053981184,2020-06,1607.15,3924.7,894.6,5914.91,-7337.86,-13827.63
1649594900053981184,2020-07,2520.58,2470.23,6455.49,0,6505.84,-7321.79
1649594900053981184,2020-08,880.08,1828.12,668.49,4033.5,-4313.05,-11634.84
1649594900053981184,2020-09,1856.68,2909.94,3042.88,1572.98,416.64,-11218.2
1649594900053981184,2020-10,2792.42,5875.45,12289.14,496.14,8709.97,-2508.23
1649594900053981184,2020-11,6252.64,5679.35,1688.95,4252.82,-1990.58,-4498.81
1649594900053981184,2020-12,5653.16,2817.3,1314.93,7283.72,-3132.93,-7631.74
1651318880020495360,2020-01,2035.74,5360.68,5192.58,2700.9,-833.26,-833.26
1651318880020495360,2020-02,1964.65,3997.06,1800.91,4823.74,-5055.24,-5888.5
1651318880020495360,2020-03,5614.49,5792.24,6468.85,3982.32,2308.78,-3579.72
1651318880020495360,2020-04,4836.18,3090.86,700.54,2620.22,-174.36,-3754.08
1651318880020495360,2020-05,155.43,8479.07,5059.09,3053.17,-6317.72,-10071.8
1651318880020495360,2020-06,639.92,3641.06,2272.63,1489.85,-2218.36,-12290.16
1651318880020495360,2020-07,2949.7,4441.53,2294.69,171.59,631.27,-11658.89
1651318880020495360,2020-08,591.33,2048.65,6427.9,3748.4,1222.18,-10436.71
1651318880020495360,2020-09,2139.05,1786.88,3455.1,5892.98,-2085.71,-12522.42
1651318880020495360,2020-10,2554.74,3451.07,2650.56,5493.59,-3739.36,-16261.78
1651318880020495360,2020-11,1479.71,3090.9,5843.28,7798.76,-3566.67,-19828.45
1651318880020495360,2020-12,1891.14,3642.49,5130.15,5403.61,-2024.81,-21853.26
1652256505236028672,2020-01,3637.92,4499.87,4353.92,2312.14,1179.83,1179.83
1652256505236028672,2020-02,1001.84,1860.14,7541.33,566.71,6116.32,7296.15
1652256505236028672,2020-03,860.14,5244.52,191.89,400.48,-4592.97,2703.18
1652256505236028672,2020-04,2392.64,664.45,763.36,2793.53,-301.98,2401.2
1652256505236028672,2020-05,3756.9,5503.76,4040.33,625.95,1667.52,4068.72
1652256505236028672,2020-06,3414.68,5093.47,3559.15,3400.87,-1520.51,2548.21
1652256505236028672,2020-07,1901.57,2563.47,2622.23,3928.32,-1967.99,580.22
1652256505236028672,2020-08,3122.02,4100.44,2110.71,2071.08,-938.79,-358.57
1652256505236028672,2020-09,1949.18,7324.87,1485.15,1384.46,-5275,-5633.57
1652256505236028672,2020-10,1961.28,4376.56,6056.54,652.2,2989.06,-2644.51
1652256505236028672,2020-11,3485.85,1406.26,1432.44,11785.77,-8273.74,-10918.25
1652256505236028672,2020-12,3634.93,2514.16,2394.59,3625.39,-110.03,-11028.28
1652295763155311616,2020-01,4464.87,264.53,6660.86,1732.35,9128.85,9128.85
1652295763155311616,2020-02,1322.05,3605.5,6446.66,8370.67,-4207.46,4921.39
1652295763155311616,2020-03,6485.98,6167.2,1813.66,623.81,1508.63,6430.02
1652295763155311616,2020-04,4796.02,5004.58,828.39,11273.36,-10653.53,-4223.51
1652295763155311616,2020-05,5887.18,2140.67,6483.63,1742.6,8487.54,4264.03
1652295763155311616,2020-06,545.32,2044.71,2089.63,7880.29,-7290.05,-3026.02
1652295763155311616,2020-07,729.6,3533.3,2079.68,6280.35,-7004.37,-10030.39
1652295763155311616,2020-08,4919.38,807.8,1400.96,1455.43,4057.11,-5973.28
1652295763155311616,2020-09,7247.02,1289.13,3327.8,4105.34,5180.35,-792.93
1652295763155311616,2020-10,1020.93,4532.41,3989.28,3555.99,-3078.19,-3871.12
1652295763155311616,2020-11,4618.43,3902.61,2820.95,1497.38,2039.39,-1831.73
1652295763155311616,2020-12,1760.35,1984.66,5183.6,1659.68,3299.61,1467.88
1652630273696432896,2020-01,6406.51,3957.79,5773.62,3426.15,4796.19,4796.19
1652630273696432896,2020-02,620.17,3948.53,2654.33,5192.49,-5866.52,-1070.33
1652630273696432896,2020-03,6322.59,3282.19,3079.16,7978.42,-1858.86,-2929.19
1652630273696432896,2020-04,2535.87,8412.37,3350.62,5050.94,-7576.82,-10506.01
1652630273696432896,2020-05,2612.12,6563.7,3719.88,7474.75,-7706.45,-18212.46
1652630273696432896,2020-06,5143.42,4708.57,9445.7,3307.96,6572.59,-11639.87
1652630273696432896,2020-07,1762.17,3299.54,3231.26,4015.11,-2321.22,-13961.09
1652630273696432896,2020-08,1246.67,4727.43,2986.8,4906.25,-5400.21,-19361.3
1652630273696432896,2020-09,4300.14,4465.58,3084.18,4860.39,-1941.65,-21302.95
1652630273696432896,2020-10,3050.84,4153.28,4372.23,7855.7,-4585.91,-25888.86
1652630273696432896,2020-11,2325.48,6414.87,6799.81,3098.85,-388.43,-26277.29
1652630273696432896,2020-12,6410.61,1297.42,1297.85,3238.84,3172.2,-23105.09
1653193332139766016,2020-01,2279.2,589.88,0,1511.6,177.72,177.72
1653193332139766016,2020-02,635.48,1809.39,0,1490.65,-2664.56,-2486.84
1653193332139766016,2020-03,1669.78,4828.45,1189.09,0,-1969.58,-4456.42
1653193332139766016,2020-04,1012.39,882.83,1694.73,0,1824.29,-2632.13
1653193332139766016,2020-05,0,840.26,0,5787.03,-6627.29,-9259.42
1653193332139766016,2020-06,0,3388.27,1328.67,0,-2059.6,-11319.02
1653193332139766016,2020-07,0,2281.18,0,0,-2281.18,-13600.2
1653193332139766016,2020-08,3042.47,2117.89,881.56,1169.5,636.64,-12963.56
1653193332139766016,2020-09,172.12,2644.27,1347.37,482.93,-1607.71,-14571.27
1653193332139766016,2020-10,3107.28,3589.67,2113.26,1156.32,474.55,-14096.72
1653193332139766016,2020-12,1518.56,2658.42,962.69,3282.32,-3459.49,-17556.21
1653429393735948288,2020-01,14908.3,5444.25,2719.74,1840.96,10342.83,10342.83
1653429393735948288,2020-02,2442.46,6311.02,4816.93,4822.18,-3873.81,6469.02
1653429393735948288,2020-03,3869.23,5026.13,3461.43,2880.4,-575.87,5893.15
1653429393735948288,2020-04,7557.97,3745.78,3766.26,3737.85,3840.6,9733.75
1653429393735948288,2020-05,5787.97,1568.38,1297.76,5014.74,502.61,10236.36
1653429393735948288,2020-06,4542.72,0,1673.27,1407.83,4808.16,15044.52
1653429393735948288,2020-07,5001.51,5219.02,3204.07,4582.72,-1596.16,13448.36
1653429393735948288,2020-08,1846.75,5060.76,7407.28,2003.36,2189.91,15638.27
1653429393735948288,2020-09,3009.07,2834.1,4651.78,3566.17,1260.58,16898.85
1653429393735948288,2020-10,4492.14,2872.56,4911.99,3964.94,2566.63,19465.48
1653429393735948288,2020-11,2305.06,2155.59,2818.19,6967.77,-4000.11,15465.37
1653429393735948288,2020-12,3228.61,4365.93,11172.55,2526.33,7508.9,22974.27
1655332661980111616,2020-01,2396.48,4995.21,5978.4,3078.66,301.01,301.01
1655332661980111616,2020-02,0,3543.8,7232.71,6894.3,-3205.39,-2904.38
1655332661980111616,2020-03,0,4150.82,4326.94,4451.99,-4275.87,-7180.25
1655332661980111616,2020-04,2982.92,2258.02,2126.38,4548.27,-1696.99,-8877.24
1655332661980111616,2020-05,3414.24,3378.25,5596.48,6775.95,-1143.48,-10020.72
1655332661980111616,2020-06,4706.27,2988.43,4499.87,2952.23,3265.48,-6755.24
1655332661980111616,2020-07,6728.83,3993.43,3610.22,1609.54,4736.08,-2019.16
1655332661980111616,2020-08,5844.72,1806.72,1438.5,3208.46,2268.04,248.88
1655332661980111616,2020-09,7278.47,5347.19,6281.36,3474.09,4738.55,4987.43
1655332661980111616,2020-10,10162.41,2568.82,15664.3,8235.35,15022.54,20009.97
1655332661980111616,2020-11,5473.28,4122.82,4486.07,3608.71,2227.82,22237.79
1655332661980111616,2020-12,9112.04,3262.4,6222.04,1765.9,10305.78,32543.57
1659451545208641792,2020-01,0,578.83,0,0,-578.83,-578.83
1659451545208641792,2020-06,1007.07,0,1907.84,0,2914.91,2336.08
1659451545208641792,2020-07,1569.16,0,0,749.1,820.06,3156.14
1659451545208641792,2020-09,0,1750.88,0,0,-1750.88,1405.26
1659451545208641792,2020-11,0,997.63,614.03,0,-383.6,1021.66
1659451545208641792,2020-12,322.63,0,1378.46,0,1701.09,2722.75
1659580516931517184,2020-01,9027.31,3247.32,5502.79,3918.7,7364.08,7364.08
1659580516931517184,2020-02,243.46,1314.56,638.01,4510.52,-4943.61,2420.47
1659580516931517184,2020-03,955.7,1961.89,2464.92,3142.76,-1684.03,736.44
1659580516931517184,2020-04,2224.71,2958.27,169.78,1792.36,-2356.14,-1619.7
1659580516931517184,2020-05,4504.57,1270.84,407.14,3091.6,549.27,-1070.43
1659580516931517184,2020-06,1768.89,6700.09,0,4557.77,-9488.97,-10559.4
1659580516931517184,2020-07,3791.24,235.38,3727.4,2647.4,4635.86,-5923.54
1659580516931517184,2020-08,3466.26,3991.09,2497.12,580.66,1391.63,-4531.91
1659580516931517184,2020-09,8866.39,4296.89,549.93,2710.96,2408.47,-2123.44
1659580516931517184,2020-10,4881.2,6044.01,4346.28,1727,1456.47,-666.97
1659580516931517184,2020-11,2602.5,2899.86,1733.79,5299.52,-3863.09,-4530.06
1659580516931517184,2020-12,1496.87,936.13,3316.2,3461.25,415.69,-4114.37
1661775925589676032,2020-01,4133.03,1530.09,3503.4,117.3,5989.04,5989.04
1661775925589676032,2020-02,2718.52,554,364.14,253.4,2275.26,8264.3
1661775925589676032,2020-03,1504.95,2116.5,0,1016.56,-1628.11,6636.19
1661775925589676032,2020-04,3008.64,1524.61,331.24,3671.25,-1855.98,4780.21
1661775925589676032,2020-05,2957.13,0,192.37,2641.91,507.59,5287.8
1661775925589676032,2020-06,4245.3,1570.91,1190.72,1084.23,2780.88,8068.68
1661775925589676032,2020-07,1326.08,0,1416.13,954.57,1787.64,9856.32
1661775925589676032,2020-08,0,3675.44,1919.73,0,-1755.71,8100.61
1661775925589676032,2020-09,0,3688.57,115.09,2213.58,-5787.06,2313.55
1661775925589676032,2020-10,0,212.49,2729.32,2084.86,431.97,2745.52
1661775925589676032,2020-11,1747.22,4914.95,605.02,736.3,-3299.01,-553.49
1661775925589676032,2020-12,726.28,0,1357.18,3240.04,-1156.58,-1710.07
1662339853452600832,2020-01,1693.04,3322.51,506.74,0,-1122.73,-1122.73
1662339853452600832,2020-02,1969.53,2513.02,0,397,-940.49,-2063.22
1662339853452600832,2020-03,2398.46,0,323.88,56.72,2665.62,602.4
1662339853452600832,2020-04,1936.71,0,712.79,0,2649.5,3251.9
1662339853452600832,2020-06,530.24,4084.2,586.98,0,-2966.98,284.92
1662339853452600832,2020-07,3848.5,2028.57,232.63,0,2052.56,2337.48
1662339853452600832,2020-08,549.5,652.51,1454.11,1623.8,-272.7,2064.78
1662339853452600832,2020-09,2488.31,108.55,1848.99,0,4228.75,6293.53
1662339853452600832,2020-10,2679.2,2496.15,1419.11,942.61,659.55,6953.08
1662339853452600832,2020-11,1516.9,1411.44,1968.92,1120.03,954.35,7907.43
1662339853452600832,2020-12,2352.43,0,0,949.09,1403.34,9310.77
1662347890544777984,2020-01,0,991.79,0,0,-991.79,-991.79
1662347890544777984,2020-04,0,2187.89,0,0,-2187.89,-3179.68
1662347890544777984,2020-06,1037.21,0,0,0,1037.21,-2142.47
1662347890544777984,2020-12,1339.98,0,0,0,1339.98,-802.49
1663729961998703360,2020-01,0,2902.88,0,909.35,-3812.23,-3812.23
1663729961998703360,2020-02,353.87,594.87,1795.56,1571.49,-16.93,-3829.16
1663729961998703360,2020-03,0,730.37,3029.74,0,2299.37,-1529.79
1663729961998703360,2020-04,1186.27,0,1240.65,5109.06,-2682.14,-4211.93
1663729961998703360,2020-05,1353.24,0,3775.39,433.38,4695.25,483.32
1663729961998703360,2020-06,1190.51,926.3,0,422.08,-157.87,325.45
1663729961998703360,2020-07,4101.84,1225.75,438.04,581.09,2733.04,3058.49
1663729961998703360,2020-08,0,2596.27,0,0,-2596.27,462.22
1663729961998703360,2020-09,200.14,55.21,528,2798.27,-2125.34,-1663.12
1663729961998703360,2020-10,1232.69,63.11,0,642.41,527.17,-1135.95
1663729961998703360,2020-11,1906.69,0,0,0,1906.69,770.74
1663729961998703360,2020-12,161.2,1595,0,3326.13,-4759.93,-3989.19
1663859414176190208,2020-01,1756.54,7323.26,1353.98,5075.77,-9288.51,-9288.51
1663859414176190208,2020-02,6261.84,3614.71,4625.55,5841.63,1431.05,-7857.46
1663859414176190208,2020-03,5514.07,8193.93,4620.01,5803.36,-3863.21,-11720.67
1663859414176190208,2020-04,2752.4,4295.27,5522.63,4300.4,-320.64,-12041.31
1663859414176190208,2020-05,2567.27,9198.56,1316.23,2524.21,-7839.27,-19880.58
1663859414176190208,2020-06,4171.28,4005.7,4196.61,10284.4,-5922.21,-25802.79
1663859414176190208,2020-07,5430.24,3011.4,4897.55,5949.25,1367.14,-24435.65
1663859414176190208,2020-08,5388.87,2186.8,6030.91,7774.21,1458.77,-22976.88
1663859414176190208,2020-09,4184.82,960.46,4132.09,4338.16,3018.29,-19958.59
1663859414176190208,2020-10,5965.62,3172.01,4028.17,5595.27,1226.51,-18732.08
1663859414176190208,2020-11,2676.55,6312.69,11094.83,4670.91,2787.78,-15944.3
1663859414176190208,2020-12,2129.15,5362.49,4340.84,4539.11,-3431.61,-19375.91
1665130629687666432,2020-01,1513.68,5627.88,5365.65,0,1251.45,1251.45
1665130629687666432,2020-02,5918.6,0,8422.49,3226.26,11114.83,12366.28
1665130629687666432,2020-03,4703.41,3782.23,2015.76,6291.53,-3354.59,9011.69
1665130629687666432,2020-04,2648.02,0,1286.56,1020.58,2914,11925.69
1665130629687666432,2020-05,1763.75,3388.31,3173.49,5156.57,-3607.64,8318.05
1665130629687666432,2020-06,2920.69,3961.94,1209.27,4453.01,-4284.99,4033.06
1665130629687666432,2020-07,2475.56,6280.01,7645.15,3114.26,726.44,4759.5
1665130629687666432,2020-08,601.22,4850.72,1513.6,1915.72,-4651.62,107.88
1665130629687666432,2020-09,6344.75,3226.61,3652.03,2799.2,3970.97,4078.85
1665130629687666432,2020-10,1352.54,8451.03,3614.6,2171.68,-5655.57,-1576.72
1665130629687666432,2020-11,5626.12,3394.43,3587.59,3540.74,2278.54,701.82
1665130629687666432,2020-12,3031.5,10520.1,4941.39,1387.12,-3934.33,-3232.51
1665798942371608320,2020-01,2031.37,0,0,378.52,1652.85,1652.85
1665798942371608320,2020-03,2069.66,835.7,0,1617.45,-383.49,1269.36
1665798942371608320,2020-06,0,2543.57,0,63.08,-2606.65,-1337.29
1665798942371608320,2020-07,2804.19,0,1083.29,1701.57,2185.91,848.62
1665798942371608320,2020-08,862.38,0,0,0,862.38,1711
1665798942371608320,2020-10,655.21,127.7,0,124.73,402.78,2113.78
1665798942371608320,2020-11,1456.75,1921.38,111.57,0,-353.06,1760.72
1667848954419637760,2020-01,1966.21,5203.03,4764.89,4376.11,-2848.04,-2848.04
1667848954419637760,2020-02,6890.93,2636.59,1745.85,6632,-631.81,-3479.85
1667848954419637760,2020-03,7036.19,4784.74,3255.43,5903.45,-396.57,-3876.42
1667848954419637760,2020-04,9448.05,7359.94,2990.58,9261,-4182.31,-8058.73
1667848954419637760,2020-05,2964.69,5883.12,6340.38,344.96,3076.99,-4981.74
1667848954419637760,2020-06,4842.34,3505.14,2465.65,1795.97,2006.88,-2974.86
1667848954419637760,2020-07,5323.73,3974.27,14267.34,6205.25,9411.55,6436.69
1667848954419637760,2020-08,354.24,3267.7,5283.93,2146.75,223.72,6660.41
1667848954419637760,2020-09,8046.04,2550.84,5492.79,7281.31,3706.68,10367.09
1667848954419637760,2020-10,3278.68,3210.35,1028.29,1944.08,-847.46,9519.63
1667848954419637760,2020-11,999.77,1820.19,924.71,3316.6,-3212.31,6307.32
1667848954419637760,2020-12,2544.2,1923.7,4644.95,1716.12,3549.33,9856.65
1668130814824284672,2020-01,651.54,3842.56,2030.84,1527.54,-2687.72,-2687.72
1668130814824284672,2020-02,1430.42,1996.34,1956.95,0,1391.03,-1296.69
1668130814824284672,2020-03,0,2866,186.32,1870.35,-4550.03,-5846.72
1668130814824284672,2020-04,5520.48,0,0,5823.93,-303.45,-6150.17
1668130814824284672,2020-05,0,1593.88,1685.38,420.73,-329.23,-6479.4
1668130814824284672,2020-06,0,2182.04,0,0,-2182.04,-8661.44
1668130814824284672,2020-07,3718.97,1592.47,3658.81,3609.94,2175.37,-6486.07
1668130814824284672,2020-08,1272.97,0,1578.26,3277.48,-426.25,-6912.32
1668130814824284672,2020-09,1696.75,599.63,2080.49,2971.7,205.91,-6706.41
1668130814824284672,2020-10,3208.76,0,1952.13,0,5160.89,-1545.52
1668130814824284672,2020-11,2044.88,1377.83,2060.62,2820.34,-92.67,-1638.19
1668130814824284672,2020-12,2095.16,771.04,1895.76,2155.58,1064.3,-573.89
1668232590218488320,2020-02,0,278.01,108.37,0,-169.64,-169.64
1668591491372764160,2020-01,963.78,767.49,2094.87,2215.33,75.83,75.83
1668591491372764160,2020-02,3136.3,2799.54,0,3237.28,-2900.52,-2824.69
1668591491372764160,2020-03,0,1025.92,0,2328.41,-3354.33,-6179.02
1668591491372764160,2020-05,0,1234.7,800.67,2506.21,-2940.24,-9119.26
1668591491372764160,2020-06,1580.27,3917.64,675.69,1511.39,-3173.07,-12292.33
1668591491372764160,2020-07,1845.88,1744.01,2275.92,223.86,2153.93,-10138.4
1668591491372764160,2020-08,4.18,2040.37,184.6,852.61,-2704.2,-12842.6
1668591491372764160,2020-09,0,1211.01,967.87,1882.2,-2125.34,-14967.94
1668591491372764160,2020-10,3228.38,579.85,2664.56,0,5313.09,-9654.85
1668591491372764160,2020-11,17.48,1413.25,1593.76,0,197.99,-9456.86
1668591491372764160,2020-12,0,795.02,0,3270.69,-4065.71,-13522.57
1672061519577850624,2020-01,577.26,7116.54,2038.51,5558.79,-10059.56,-10059.56
1672061519577850624,2020-02,2195.99,6589.76,9222.04,4855.16,-26.89,-10086.45
1672061519577850624,2020-03,6830.29,6360.66,1049.97,3530.93,-2011.33,-12097.78
1672061519577850624,2020-04,10160.7,3518,3562.51,3476.08,6729.13,-5368.65
1672061519577850624,2020-05,5077.34,4527.43,3195.73,5567.13,-1821.49,-7190.14
1672061519577850624,2020-06,5235.32,6467.8,6128.62,5594.04,-697.9,-7888.04
1672061519577850624,2020-07,4848.98,2849.79,4194,7156.27,-963.08,-8851.12
1672061519577850624,2020-08,7613.03,2967.76,1069.53,5242.07,472.73,-8378.39
1672061519577850624,2020-09,4626.62,4323.22,7841.15,8147.32,-2.77,-8381.16
1672061519577850624,2020-10,5061.61,968.98,8567.26,6589.64,6070.25,-2310.91
1672061519577850624,2020-11,2890.53,3650.65,8062.65,6213.19,1089.34,-1221.57
1672061519577850624,2020-12,3103.24,498.24,3706.37,5676.44,634.93,-586.64
1673394160247966976,2020-01,2565.22,228.01,776.12,0,3113.33,3113.33
1673394160247966976,2020-02,1269.33,1627.4,879.6,0,521.53,3634.86
1673394160247966976,2020-03,1251.56,0,522.74,592.07,1182.23,4817.09
1673394160247966976,2020-04,274.85,0,0,0,274.85,5091.94
1673394160247966976,2020-05,1252.65,1222.94,1982.82,5718.4,-3705.87,1386.07
1673394160247966976,2020-06,1611.31,0,3402.42,1268.61,3745.12,5131.19
1673394160247966976,2020-07,313.69,1269.13,0,390.75,-1346.19,3785
1673394160247966976,2020-08,0,614.9,0,3100.83,-3715.73,69.27
1673394160247966976,2020-09,590.6,0,1988.2,659.25,1919.55,1988.82
1673394160247966976,2020-10,3040.94,1956.47,1622.47,1536.5,1170.44,3159.26
1673394160247966976,2020-11,2552.61,1631.04,2085.94,1663,1344.51,4503.77
1673394160247966976,2020-12,600.53,0,294.53,4018.39,-3123.33,1380.44
1673423938437381120,2020-01,3265.38,7420.46,4455.75,7645.73,-7345.06,-7345.06
1673423938437381120,2020-02,4097.86,10439.45,10230.46,5590.29,-1701.42,-9046.48
1673423938437381120,2020-03,5570.24,3820.55,3159.17,5268.98,-360.12,-9406.6
1673423938437381120,2020-04,3198.48,8815.61,310.8,400.13,-5706.46,-15113.06
1673423938437381120,2020-05,8236.12,4697.03,2551.59,3518.9,2571.78,-12541.28
1673423938437381120,2020-06,3007.56,1310.34,2049.77,2447.49,1299.5,-11241.78
1673423938437381120,2020-07,2714.98,3861.23,1457.21,9502.79,-9191.83,-20433.61
1673423938437381120,2020-08,3450.16,5221.09,3447.53,2219.18,-542.58,-20976.19
1673423938437381120,2020-09,5973.04,4649.31,5124.52,12.07,6436.18,-14540.01
1673423938437381120,2020-10,2028.4,2543.87,5605.62,1641.32,3448.83,-11091.18
1673423938437381120,2020-11,5052,2993.75,6114.45,6527.82,1644.88,-9446.3
1673423938437381120,2020-12,7648.25,3688.55,5325.91,1274.68,8010.93,-1435.37
1674551238931757824,2020-01,6566.3,2665.79,6156.06,1448.57,8608,8608
1674551238931757824,2020-02,4101.13,2280.24,3707.54,2371.92,3156.51,11764.51
1674551238931757824,2020-03,2689.82,788.76,3629.93,608.55,4922.44,16686.95
1674551238931757824,2020-04,1475.22,3487.83,5750.45,4640.95,-903.11,15783.84
1674551238931757824,2020-05,4588.39,6528.8,1391.13,7115.44,-7664.72,8119.12
1674551238931757824,2020-06,438.83,5662.92,1094.4,1724.25,-5853.94,2265.18
1674551238931757824,2020-07,3521.01,1575.35,6408.88,1802.43,6552.11,8817.29
1674551238931757824,2020-08,5655.62,6362.91,3374.69,20.67,2646.73,11464.02
1674551238931757824,2020-09,316.04,182.97,4980.75,1621.97,3491.85,14955.87
1674551238931757824,2020-10,2324.92,1060.22,2426.94,887.8,2803.84,17759.71
1674551238931757824,2020-11,733.18,3148.66,4636.31,4557.26,-2336.43,15423.28
1674551238931757824,2020-12,3066.56,3849.67,2665.34,250.34,1631.89,17055.17
1674697199204711424,2020-01,5383.15,598.28,4217.86,4084.66,4918.07,4918.07
1674697199204711424,2020-02,5654.66,4885.82,4872.06,4867.26,773.64,5691.71
1674697199204711424,2020-03,1600.48,2004.4,3784.06,253.25,3126.89,8818.6
1674697199204711424,2020-04,4639.48,728.77,1708.7,4382.26,1237.15,10055.75
1674697199204711424,2020-05,2564.28,5111.91,2489.59,958.02,-1016.06,9039.69
1674697199204711424,2020-06,2396.68,2946.85,3697.4,0,3147.23,12186.92
1674697199204711424,2020-07,2759.61,625.2,2144.69,4410.83,-131.73,12055.19
1674697199204711424,2020-08,5500.21,6193.02,3830.41,4228.23,-1090.63,10964.56
1674697199204711424,2020-09,2262.05,1606.82,3779.94,2916.78,1518.39,12482.95
1674697199204711424,2020-10,0,2509.89,1016.86,3331.19,-4824.22,7658.73
1674697199204711424,2020-11,0,2266.1,5171.76,5866.45,-2960.79,4697.94
1674697199204711424,2020-12,1343.01,1999.95,8365.3,2644.94,5063.42,9761.36
1676535090213698560,2020-01,7526.96,1764.33,255.35,955.62,5062.36,5062.36
1676535090213698560,2020-02,3123.63,2273.04,1335.45,3821.95,-1635.91,3426.45
1676535090213698560,2020-03,2018.01,4543.79,1148.28,2835.35,-4212.85,-786.4
1676535090213698560,2020-04,3326.56,1867.54,1728.98,3210.71,-22.71,-809.11
1676535090213698560,2020-05,2470.41,0,965.5,1051.62,2384.29,1575.18
1676535090213698560,2020-06,5174.02,4375.26,1118.62,2589.67,-672.29,902.89
1676535090213698560,2020-07,1215.32,1545.74,4032.16,2297.73,1404.01,2306.9
1676535090213698560,2020-08,1871.53,2263.37,0,0,-391.84,1915.06
1676535090213698560,2020-09,1940.03,1833.77,2540.4,5855.48,-3208.82,-1293.76
1676535090213698560,2020-10,1033.26,2263.2,1430.04,3426.35,-3226.25,-4520.01
1676535090213698560,2020-11,2123.24,997.87,2170.47,1862.24,1433.6,-3086.41
1676535090213698560,2020-12,0,4290.69,6475.46,2190.82,-6.05,-3092.46
1677676525569752320,2020-02,1609.57,1352.45,1185.17,1237.48,204.81,204.81
1677676525569752320,2020-03,3623.09,1426.48,0,190.22,2006.39,2211.2
1677676525569752320,2020-04,1065.27,465.72,0,2584.25,-1984.7,226.5
1677676525569752320,2020-05,1917.54,750.84,3011.84,763.86,3414.68,3641.18
1677676525569752320,2020-06,0,1134.08,7719.88,1964.4,4621.4,8262.58
1677676525569752320,2020-07,0,1948.42,3101.97,597.91,555.64,8818.22
1677676525569752320,2020-08,1237.68,1862.08,1947.76,0,1323.36,10141.58
1677676525569752320,2020-09,2946.09,4602.53,0,0,-1656.44,8485.14
1677676525569752320,2020-10,1047.47,1969.55,0,698.17,-1620.25,6864.89
1677676525569752320,2020-11,1214.16,1381.43,736.75,4670.31,-4100.83,2764.06
1677676525569752320,2020-12,935.31,5052.69,1845.68,6008.73,-8280.43,-5516.37
1678718251770588160,2020-01,84.13,1140.39,1255.64,2300.12,-2100.74,-2100.74
1678718251770588160,2020-02,3190.88,1802.28,0,4708.74,-3320.14,-5420.88
1678718251770588160,2020-03,2114.82,4842.7,757.41,4022.48,-5992.95,-11413.83
1678718251770588160,2020-04,710.41,3219.01,4239.89,4285.29,-2554,-13967.83
1678718251770588160,2020-05,307.54,1247.9,366.24,2203.35,-2777.47,-16745.3
1678718251770588160,2020-06,0,1831.11,740.37,2981.52,-4072.26,-20817.56
1678718251770588160,2020-07,0,4367.01,1188.04,3389.95,-6568.92,-27386.48
1678718251770588160,2020-08,288.08,1445.9,1259.61,0,101.79,-27284.69
1678718251770588160,2020-09,874.83,5481.47,1864.68,989.56,-3731.52,-31016.21
1678718251770588160,2020-10,7747.71,1669.19,5712.35,169,11621.87,-19394.34
1678718251770588160,2020-11,74.35,1196.86,2387.52,2998.44,-1733.43,-21127.77
1678718251770588160,2020-12,1089,2191.39,1119.94,2617.84,-2600.29,-23728.06
1680503464869977088,2020-01,5056.36,3906.47,1387.16,3833.46,-1296.41,-1296.41
1680503464869977088,2020-02,4887.8,1069.76,6763.23,5151.04,5430.23,4133.82
1680503464869977088,2020-03,5303.58,6747.9,3812.2,3969.34,-1601.46,2532.36
1680503464869977088,2020-04,2811.91,4872.99,4358.95,6194.61,-3896.74,-1364.38
1680503464869977088,2020-05,3766.52,5524.26,1456.3,4115.29,-4416.73,-5781.11
1680503464869977088,2020-06,4118.88,2949.46,2161.49,3609.62,-278.71,-6059.82
1680503464869977088,2020-07,1334.31,1655.91,5313.44,6212.3,-1220.46,-7280.28
1680503464869977088,2020-08,5116.01,6607.94,3982.87,9835.8,-7344.86,-14625.14
1680503464869977088,2020-09,3969.04,2085.32,3919.92,6100.61,-296.97,-14922.11
1680503464869977088,2020-10,1931.96,1699.24,3847.98,4879.58,-798.88,-15720.99
1680503464869977088,2020-11,3510.84,11289.58,5307.58,3116.52,-5587.68,-21308.67
1680503464869977088,2020-12,4918.33,4077.03,2506.74,5883.08,-2535.04,-23843.71
1682594259319948288,2020-01,137.49,4759.52,2058.04,1033.53,-3597.52,-3597.52
1682594259319948288,2020-02,4559.34,1936.76,3028.84,2714.2,2937.22,-660.3
1682594259319948288,2020-03,3478.21,2931.25,1394.13,468.25,1472.84,812.54
1682594259319948288,2020-04,352.41,1861.82,942.24,1441.8,-2008.97,-1196.43
1682594259319948288,2020-05,1473.44,2214.35,3014.1,1863.11,410.08,-786.35
1682594259319948288,2020-06,708.99,2133.48,2046.43,1295.27,-673.33,-1459.68
1682594259319948288,2020-07,6373.89,3468.6,1811.48,2415.32,2301.45,841.77
1682594259319948288,2020-08,0,207.05,1783.78,1228.91,347.82,1189.59
1682594259319948288,2020-09,0,3650.12,1810.04,0,-1840.08,-650.49
1682594259319948288,2020-10,1382.74,3212.03,69.41,4855.46,-6615.34,-7265.83
1682594259319948288,2020-12,916.7,959.98,1742.39,2343.6,-644.49,-7910.32
1683078411254765056,2020-01,6237.76,2051.15,7842.8,3004.46,9024.95,9024.95
1683078411254765056,2020-02,227.54,618.95,1122.14,5054.6,-4323.87,4701.08
1683078411254765056,2020-03,5352.58,5674.87,1046.93,9087.83,-8363.19,-3662.11
1683078411254765056,2020-04,2939.15,5634.06,613.06,3299.26,-5381.11,-9043.22
1683078411254765056,2020-05,4714.51,2734.72,5132.46,3094.67,4017.58,-5025.64
1683078411254765056,2020-06,0,1395.29,3463.31,1236.09,831.93,-4193.71
1683078411254765056,2020-07,2456.1,3861.88,500.59,3163.07,-4068.26,-8261.97
1683078411254765056,2020-08,985.77,1682.08,2952.38,3870.99,-1614.92,-9876.89
1683078411254765056,2020-09,1328.69,7770.25,3769.76,5130.61,-7802.41,-17679.3
1683078411254765056,2020-10,4238.17,2706.92,2206.36,712.22,3025.39,-14653.91
1683078411254765056,2020-11,5547.67,2950.92,2582.28,6059.84,-880.81,-15534.72
1683078411254765056,2020-12,3494.78,3979.12,467.31,3281.34,-3298.37,-18833.09
1684808941454839808,2020-01,6922.43,3568.15,2814.87,2790.59,3378.56,3378.56
1684808941454839808,2020-02,5366.84,5075.32,2026.44,4511.73,-2193.77,1184.79
1684808941454839808,2020-03,2442.49,7592.49,3488.5,4926.07,-6587.57,-5402.78
1684808941454839808,2020-04,6726.8,2315.33,2707.98,5216.94,1902.51,-3500.27
1684808941454839808,2020-05,479.15,5549.76,2827.19,1057.28,-3300.7,-6800.97
1684808941454839808,2020-06,2527.22,2590.07,2417.68,3109.52,-754.69,-7555.66
1684808941454839808,2020-07,5562.61,11199.22,1576.31,7075.62,-11135.92,-18691.58
1684808941454839808,2020-08,2218.18,8357.1,2394.41,4468.17,-8212.68,-26904.26
1684808941454839808,2020-09,5065.84,1141.57,5603.61,3077.23,6450.65,-20453.61
1684808941454839808,2020-10,9488,3837.22,514.6,2159.41,4005.97,-16447.64
1684808941454839808,2020-11,1214.83,630.16,4216.82,3932.47,869.02,-15578.62
1684808941454839808,2020-12,869.79,3771.84,7144.59,5926.37,-1683.83,-17262.45
1687084216800524544,2020-01,5177.36,0,3854.99,3962.9,5069.45,5069.45
1687084216800524544,2020-02,6181.72,4167.23,742.05,2899.55,-143.01,4926.44
1687084216800524544,2020-03,1640.48,421.01,1238.46,1527.01,930.92,5857.36
1687084216800524544,2020-04,362.7,6792.22,3148,9944.2,-13225.72,-7368.36
1687084216800524544,2020-05,2033.68,397.88,1915.33,2419.15,1131.98,-6236.38
1687084216800524544,2020-06,1159.42,4571.71,0,2041.89,-5454.18,-11690.56
1687084216800524544,2020-07,370.65,2582.93,0,1777.75,-3990.03,-15680.59
1687084216800524544,2020-08,0,656.93,3334.93,3454,-776,-16456.59
1687084216800524544,2020-09,1411.41,513.31,3314.14,2499.24,1713,-14743.59
1687084216800524544,2020-10,2164.53,475.39,2760.15,4019.67,429.62,-14313.97
1687084216800524544,2020-11,2226.8,2027.37,3127.79,6165.58,-2838.36,-17152.33
1687084216800524544,2020-12,813.33,677.2,3277.88,5907.21,-2493.2,-19645.53
1687728830851722240,2020-01,2093.9,1045.13,1473.7,864.8,1657.67,1657.67
1687728830851722240,2020-02,1838.97,1975.96,468.43,2.22,329.22,1986.89
1687728830851722240,2020-03,1344.88,4276.37,3517.75,0,586.26,2573.15
1687728830851722240,2020-04,1032.69,2874.43,1704.92,2763.08,-2899.9,-326.75
1687728830851722240,2020-05,1760.11,5232.63,772.3,3939.06,-6639.28,-6966.03
1687728830851722240,2020-06,1926.24,2421.8,0,1877.54,-2373.1,-9339.13
1687728830851722240,2020-07,0,3905.91,5733.08,0,1827.17,-7511.96
1687728830851722240,2020-08,415.38,1302.99,3297.71,3593.75,-1183.65,-8695.61
1687728830851722240,2020-09,2301.95,3807.05,2269.36,4943.68,-4179.42,-12875.03
1687728830851722240,2020-10,2894.17,1776.83,491.53,7026.16,-5417.29,-18292.32
1687728830851722240,2020-11,1167.18,2622.36,1823.38,3756.98,-3388.78,-21681.1
1687728830851722240,2020-12,1643.35,266.77,2762.65,2582.32,1556.91,-20124.19
1688275138929452800,2020-01,3609.32,2220.3,4804.13,3411.8,2781.35,2781.35
1688275138929452800,2020-02,274,4120.26,7547.6,3244.8,456.54,3237.89
1688275138929452800,2020-03,5578.1,7238.14,7082.64,1859.75,3562.85,6800.74
1688275138929452800,2020-04,6267.81,7332.78,5182.16,2682.61,1434.58,8235.32
1688275138929452800,2020-05,1616.29,1626.89,5277.83,3378.21,1889.02,10124.34
1688275138929452800,2020-06,5988.13,8249.86,1841,5354.41,-5775.14,4349.2
1688275138929452800,2020-07,2576.55,0,5805.48,3119.38,5262.65,9611.85
1688275138929452800,2020-08,0,6330.49,1906.31,6293.03,-10717.21,-1105.36
1688275138929452800,2020-09,1693.17,1344.33,2981.66,5932.93,-2602.43,-3707.79
1688275138929452800,2020-10,6248.45,6731.67,5229.31,8851.21,-4105.12,-7812.91
1688275138929452800,2020-11,8609.61,8074.38,4832.8,2995.68,2372.35,-5440.56
1688275138929452800,2020-12,2405.32,2457.69,599.66,8024.18,-7476.89,-12917.45
1688383791351930112,2020-01,3209.42,2063.7,1000.07,11841.46,-9695.67,-9695.67
1688383791351930112,2020-02,6888.25,5652.57,4298.24,4167.15,1366.77,-8328.9
1688383791351930112,2020-03,1844.1,595.54,3219.67,4823,-354.77,-8683.67
1688383791351930112,2020-04,2701.01,4357.05,4896.37,6696.56,-3456.23,-12139.9
1688383791351930112,2020-05,3370.43,5142.1,5408.3,3640.27,-3.64,-12143.54
1688383791351930112,2020-06,6019.84,2310.53,0,7920.33,-4211.02,-16354.56
1688383791351930112,2020-07,11030.3,2496.47,6016.17,5611.14,8938.86,-7415.7
1688383791351930112,2020-08,3499.81,3679.64,2473.87,4146.5,-1852.46,-9268.16
1688383791351930112,2020-09,2171.93,6936.75,1757.5,5823.07,-8830.39,-18098.55
1688383791351930112,2020-10,3236.14,7820.67,3946.49,6826.28,-7464.32,-25562.87
1688383791351930112,2020-11,3584.59,969.16,3845.94,6179.29,282.08,-25280.79
1688383791351930112,2020-12,4449.64,2296.21,7285.68,0,9439.11,-15841.68
1688667073174682880,2020-01,4098.84,2327.55,7934.31,4253.03,5452.57,5452.57
1688667073174682880,2020-02,4762.76,4244.69,4441.35,841.6,4117.82,9570.39
1688667073174682880,2020-03,5188.83,5733.43,6919.27,5944.48,430.19,10000.58
1688667073174682880,2020-04,6919.23,4507.91,6139,7573.26,977.06,10977.64
1688667073174682880,2020-05,6105.1,12491.96,920.66,2572.15,-8038.35,2939.29
1688667073174682880,2020-06,7628.29,6910.06,4371.28,6298.48,-1208.97,1730.32
1688667073174682880,2020-07,1218.4,2368.94,8939.35,5306.45,2482.36,4212.68
1688667073174682880,2020-08,3239.67,2428.37,4372.53,5256.66,-72.83,4139.85
1688667073174682880,2020-09,2701.48,3854.86,3189.17,4566.22,-2530.43,1609.42
1688667073174682880,2020-10,5085.49,6350.56,5252.71,1987.03,2000.61,3610.03
1688667073174682880,2020-11,4845.59,3170.41,3231.15,4252.27,654.06,4264.09
1688667073174682880,2020-12,5601.36,4178.94,5157.63,3783.95,2796.1,7060.19
1688707624930443520,2020-01,1108.92,3180.59,2472.87,3931,-3529.8,-3529.8
1688707624930443520,2020-02,4125.43,2951.46,3802.05,4214.82,761.2,-2768.6
1688707624930443520,2020-03,11178.04,1240.75,3817.82,2889.61,10865.5,8096.9
1688707624930443520,2020-04,3867.6,4060.93,5133.04,5320.61,-380.9,7716
1688707624930443520,2020-05,4679.73,6345.13,3871.3,3360.07,-1154.17,6561.83
1688707624930443520,2020-06,2469.15,273.04,10041.03,3064.26,9172.88,15734.71
1688707624930443520,2020-07,3639.23,2323.97,0,4273.15,-2957.89,12776.82
1688707624930443520,2020-08,4264.51,6132.43,4666.18,7266.43,-4468.17,8308.65
1688707624930443520,2020-09,8627.7,2760.42,3603.67,854.94,8616.01,16924.66
1688707624930443520,2020-10,2808.36,2308.53,6164.85,2436.2,4228.48,21153.14
1688707624930443520,2020-11,2750.73,4182.79,6799.74,4217.62,1150.06,22303.2
1688707624930443520,2020-12,5502.11,1941.33,745.44,4610.06,-303.84,21999.36
1688857554523240960,2020-01,4784.5,3100.56,6160.01,4604.61,3239.34,3239.34
1688857554523240960,2020-02,3949.53,1069.94,2163.7,1123.35,3919.94,7159.28
1688857554523240960,2020-03,4215.5,2380.93,3940.91,4787.57,987.91,8147.19
1688857554523240960,2020-04,3473.85,4086.48,565.27,1364.48,-1411.84,6735.35
1688857554523240960,2020-05,2449.41,4007.52,1892.36,4905.88,-4571.63,2163.72
1688857554523240960,2020-06,3644.14,6184.6,0,3664.82,-6205.28,-4041.56
1688857554523240960,2020-07,4667.72,3985.94,2204.22,392.18,2493.82,-1547.74
1688857554523240960,2020-08,2158.29,3737.1,3187.61,2612.59,-1003.79,-2551.53
1688857554523240960,2020-09,1382,4325.18,3089.86,3595.48,-3448.8,-6000.33
1688857554523240960,2020-10,1074.31,2195.3,872.28,3952.11,-4200.82,-10201.15
1688857554523240960,2020-11,4355.38,0,1391.66,5782.35,-35.31,-10236.46
1688857554523240960,2020-12,1645.84,3984.27,4350.18,5146.5,-3134.75,-13371.21
1693702888147707648,2020-01,0,1457.28,4954.7,2515.39,982.03,982.03
1693702888147707648,2020-02,1430.9,0,1446.24,1923.57,953.57,1935.6
1693702888147707648,2020-03,1817.43,3410.1,3654.91,0,2062.24,3997.84
1693702888147707648,2020-04,1484.1,4089.49,6074.67,2729.26,740.02,4737.86
1693702888147707648,2020-05,4044.7,2606.44,3337.29,3886.44,889.11,5626.97
1693702888147707648,2020-06,0,2949.97,752.49,3685.85,-5883.33,-256.36
1693702888147707648,2020-07,3236.72,1903.9,216.79,283,1266.61,1010.25
1693702888147707648,2020-08,1601.87,0,2416.44,2576.22,1442.09,2452.34
1693702888147707648,2020-09,2133.37,0,2358.16,0,4491.53,6943.87
1693702888147707648,2020-10,1652.57,0,3638.71,2170.14,3121.14,10065.01
1693702888147707648,2020-11,2479.36,4062.93,2929.15,1624.57,-278.99,9786.02
1693702888147707648,2020-12,3009.15,0,3216.47,1761.8,4463.82,14249.84
1694284327487255552,2020-01,449.49,3845.46,751.9,362.8,-3006.87,-3006.87
1694284327487255552,2020-02,764.63,0,1430.63,0,2195.26,-811.61
1694284327487255552,2020-03,0,865.42,0,2478.48,-3343.9,-4155.51
1694284327487255552,2020-04,0,1841.19,1145.79,1706.29,-2401.69,-6557.2
1694284327487255552,2020-05,4512.7,1593.71,1104.17,191.45,3831.71,-2725.49
1694284327487255552,2020-06,0,1647.94,0,1516.67,-3164.61,-5890.1
1694284327487255552,2020-07,883.82,1640.6,522.68,326.55,-560.65,-6450.75
1694284327487255552,2020-09,2462.31,4463.52,0,0,-2001.21,-8451.96
1694284327487255552,2020-10,2267.41,2098.98,0,801.92,-633.49,-9085.45
1694284327487255552,2020-11,183.1,2892.48,3560.13,0,850.75,-8234.7
1694284327487255552,2020-12,704.68,86.76,0,44.02,573.9,-7660.8
1694306322387176960,2020-01,5531.23,4867.51,2993.47,2650.51,1006.68,1006.68
1694306322387176960,2020-02,4873.48,10861.58,2671.1,8663.39,-11980.39,-10973.71
1694306322387176960,2020-03,5388.04,5129.66,5473.9,2103.92,3628.36,-7345.35
1694306322387176960,2020-04,1331.37,4527.92,6358.94,3887.11,-724.72,-8070.07
1694306322387176960,2020-05,822.99,5668.47,4869.65,9568.26,-9544.09,-17614.16
1694306322387176960,2020-06,2198.81,3741.03,6967.31,0,5425.09,-12189.07
1694306322387176960,2020-07,2814.62,9459.79,1784.62,5700.05,-10560.6,-22749.67
1694306322387176960,2020-08,7421.14,7545.21,6621.74,5205.02,1292.65,-21457.02
1694306322387176960,2020-09,1376.94,7850.62,5090.12,2852.93,-4236.49,-25693.51
1694306322387176960,2020-10,5852.77,6892.16,9799.04,0,8759.65,-16933.86
1694306322387176960,2020-11,1679.83,5679.71,3356.38,6527.08,-7170.58,-24104.44
1694306322387176960,2020-12,5021,2885.33,7784.02,6936.59,2983.1,-21121.34
1694574186145318400,2020-01,4160.29,3644.37,4054.1,3908.31,661.71,661.71
1694574186145318400,2020-02,7350.24,9061.02,10095.65,2257.77,6127.1,6788.81
1694574186145318400,2020-03,5308.23,4812.17,6098.17,4986.41,1607.82,8396.63
1694574186145318400,2020-04,5674.74,3913.84,4491.39,5738.58,513.71,8910.34
1694574186145318400,2020-05,4021.1,2164.81,2817.68,8532.84,-3858.87,5051.47
1694574186145318400,2020-06,7900.62,4602.36,4149.37,4468.97,2978.66,8030.13
1694574186145318400,2020-07,1984.59,3960.08,9364.45,5695.85,1693.11,9723.24
1694574186145318400,2020-08,4005.15,5100.49,2560.82,1993.9,-528.42,9194.82
1694574186145318400,2020-09,4748.98,0,5992.54,1317.46,9424.06,18618.88
1694574186145318400,2020-10,6976.12,6623.25,6858.15,4658.99,2552.03,21170.91
1694574186145318400,2020-11,5363.16,3734.06,580.91,4097.15,-1887.14,19283.77
1694574186145318400,2020-12,5116.35,2678.77,1916.98,3862.6,491.96,19775.73
1694933149750223616,2020-01,1770.55,1183.04,1341.72,3890.24,-1961.01,-1961.01
1694933149750223616,2020-02,3203.27,3811.21,0,3287.69,-3895.63,-5856.64
1694933149750223616,2020-03,3458.19,95.87,2048.76,590.25,4820.83,-1035.81
1694933149750223616,2020-04,2894.69,2891.02,3255.4,2827.54,431.53,-604.28
1694933149750223616,2020-05,1981.56,2084.09,2528.59,2778.97,-352.91,-957.19
1694933149750223616,2020-06,3424.41,3440.2,2981.65,2902.93,62.93,-894.26
1694933149750223616,2020-07,1550.09,4286.45,86.73,0,-2649.63,-3543.89
1694933149750223616,2020-08,3350.06,85.93,0,0,3264.13,-279.76
1694933149750223616,2020-09,5607.14,1978.98,0,1808.08,1820.08,1540.32
1694933149750223616,2020-10,4070.04,1689.16,357.41,1347.52,1390.77,2931.09
1694933149750223616,2020-11,0,1134.89,1808.88,2983.55,-2309.56,621.53
1694933149750223616,2020-12,6993.45,3115.86,0,0,3877.59,4499.12
1695893009382136064,2020-03,873.84,0,0,0,873.84,873.84
1695893009382136064,2020-06,852.95,0,0,0,852.95,1726.79
1696293375755796224,2020-01,228.73,0,1759.1,1471.97,515.86,515.86
1696293375755796224,2020-02,2272.81,535.73,0,0,1737.08,2252.94
1696293375755796224,2020-04,2741.37,0,989.01,0,3730.38,5983.32
1696293375755796224,2020-05,710.13,844.14,0,0,-134.01,5849.31
1696293375755796224,2020-06,38.43,3273.78,0,4710.07,-7945.42,-2096.11
1696293375755796224,2020-07,1350.48,1026.42,3550.78,2496.89,1377.95,-718.16
1696293375755796224,2020-08,5253.74,2113.04,0,0,3140.7,2422.54
1696293375755796224,2020-09,3203.55,0,0,0,3203.55,5626.09
1696293375755796224,2020-10,2877.16,1888.9,3912.37,0,4900.63,10526.72
1696293375755796224,2020-11,0,1758.19,0,3384.83,-5143.02,5383.7
1696293375755796224,2020-12,634.49,0,501.18,4201.93,-3066.26,2317.44
1697260048546000896,2020-01,4155.01,33.22,2471.21,0,6593,6593
1697260048546000896,2020-02,6900.45,4069.12,10184.16,5977.8,7037.69,13630.69
1697260048546000896,2020-03,3748.04,5561.36,2992.6,1937.88,-758.6,12872.09
1697260048546000896,2020-04,3523.07,2141.05,5594.03,3891.25,3084.8,15956.89
1697260048546000896,2020-05,8834.27,1886.93,6747.85,6449.91,7245.28,23202.17
1697260048546000896,2020-06,5613.04,7293.48,8682.7,4378.58,2623.68,25825.85
1697260048546000896,2020-07,4798.37,129.06,5320.96,3357.85,6632.42,32458.27
1697260048546000896,2020-08,4427.73,4111.09,6489.85,8534.83,-1728.34,30729.93
1697260048546000896,2020-09,3122.35,9973.74,7227.57,7328.82,-6952.64,23777.29
1697260048546000896,2020-10,7183.36,5420.19,3795.23,6552.18,-993.78,22783.51
1697260048546000896,2020-11,3290.46,4262.62,3321.65,1023.78,1325.71,24109.22
1697260048546000896,2020-12,519.38,4153.17,1697.94,5484.63,-7420.48,16688.74
1697369693743596032,2020-01,12577.75,6444.57,3790.33,3130.68,6792.83,6792.83
1697369693743596032,2020-02,1629.02,531.4,11917.81,2214.26,10801.17,17594
1697369693743596032,2020-03,4819.97,1654.95,6729.5,3549.76,6344.76,23938.76
1697369693743596032,2020-04,1953.84,4195.9,4691.84,4589.12,-2139.34,21799.42
1697369693743596032,2020-05,4149.99,3845.71,4939.15,3039.91,2203.52,24002.94
1697369693743596032,2020-06,8148.44,1899.4,5909.27,6608.19,5550.12,29553.06
1697369693743596032,2020-07,3139.8,5039.43,4260.36,3729.78,-1369.05,28184.01
1697369693743596032,2020-08,3111.84,549.11,4250.7,1960.67,4852.76,33036.77
1697369693743596032,2020-09,2699.28,6618.87,7203.09,1040.99,2242.51,35279.28
1697369693743596032,2020-10,4882.12,5462.12,4397.51,2596.24,1221.27,36500.55
1697369693743596032,2020-11,1767.21,3526.85,4963.47,3284.45,-80.62,36419.93
1697369693743596032,2020-12,4827.19,2553.08,7485.41,3996.73,5762.79,42182.72
1698015100228622592,2020-01,4831.65,4019.67,6571.73,6315.49,1068.22,1068.22
1698015100228622592,2020-02,4082.07,8252.85,3010.4,10399.19,-11559.57,-10491.35
1698015100228622592,2020-03,5172.44,7503.42,7443.67,2418.41,2694.28,-7797.07
1698015100228622592,2020-04,5587.23,5394.2,1630.89,5814.77,-3990.85,-11787.92
1698015100228622592,2020-05,3878.74,4428.55,5915.55,5845.73,-479.99,-12267.91
1698015100228622592,2020-06,3324.81,3967.18,2264.88,7446.59,-5824.08,-18091.99
1698015100228622592,2020-07,4411.76,5879.2,2261.73,1873.54,-1079.25,-19171.24
1698015100228622592,2020-08,5985.44,5240.24,2361.26,3554.62,-448.16,-19619.4
1698015100228622592,2020-09,4692.28,6528.07,7794.03,5245.17,713.07,-18906.33
1698015100228622592,2020-10,4956.21,6042.97,3237.05,1388.63,761.66,-18144.67
1698015100228622592,2020-11,6278.04,2771.59,2381.52,4652.15,1235.82,-16908.85
1698015100228622592,2020-12,3795.31,3944.97,4292.96,5304.72,-1161.42,-18070.27
1698550080872685824,2020-01,2682.69,4908.26,4604.52,5339.53,-2960.58,-2960.58
1698550080872685824,2020-02,2003.86,3846.35,3614.67,9379.18,-7607,-10567.58
1698550080872685824,2020-03,421.71,2796.26,4250.09,966.66,908.88,-9658.7
1698550080872685824,2020-04,3220.64,2963.14,0,2604.68,-2347.18,-12005.88
1698550080872685824,2020-05,453.34,0,0,3365.47,-2912.13,-14918.01
1698550080872685824,2020-06,1755.24,2007.92,1523.29,86.24,1184.37,-13733.64
1698550080872685824,2020-07,7030.85,3711.81,2687.36,417.58,5588.82,-8144.82
1698550080872685824,2020-08,1107.36,1468.86,1551.73,1678.11,-487.88,-8632.7
1698550080872685824,2020-09,1337.13,352.86,782.76,936.31,830.72,-7801.98
1698550080872685824,2020-10,2633.08,1739.76,3053.86,4938.96,-991.78,-8793.76
1698550080872685824,2020-12,1776.56,1410.42,2979.88,2683.65,662.37,-8131.39
1699005824856815872,2020-01,1981.91,0,0,38.84,1943.07,1943.07
1699005824856815872,2020-05,521.38,0,0,0,521.38,2464.45
1699005824856815872,2020-06,1185.95,0,0,0,1185.95,3650.4
1699005824856815872,2020-07,0,1249.55,996.81,1546.66,-1799.4,1851
1699005824856815872,2020-12,0,1039.2,0,0,-1039.2,811.8
1699006311462889216,2020-01,1749.91,2827.15,715.01,602.67,-964.9,-964.9
1699006311462889216,2020-02,1621.06,1273.81,2070.76,0,2418.01,1453.11
1699006311462889216,2020-03,3147.22,1465.2,1079.86,0,2761.88,4214.99
1699006311462889216,2020-04,0,1826.35,1802.91,1082.56,-1106,3108.99
1699006311462889216,2020-05,937.24,386.13,61.2,521.43,90.88,3199.87
1699006311462889216,2020-06,2754.89,2399.87,1288.74,1213.01,430.75,3630.62
1699006311462889216,2020-07,2160.9,2784.47,1436.28,4007.82,-3195.11,435.51
1699006311462889216,2020-08,801.39,3.6,0,1160.73,-362.94,72.57
1699006311462889216,2020-10,4303.65,4999.91,3012.02,1232.2,1083.56,1156.13
1699006311462889216,2020-11,0,3183.44,0,71.24,-3254.68,-2098.55
1699006311462889216,2020-12,1731.22,0,0,2819.51,-1088.29,-3186.84
1699996191985853440,2020-01,5835.97,6825.15,262.74,8385.5,-9111.94,-9111.94
1699996191985853440,2020-02,791.87,6145.29,4285.58,1882.27,-2950.11,-12062.05
1699996191985853440,2020-03,5036.43,6224.47,4671.39,3643.26,-159.91,-12221.96
1699996191985853440,2020-04,3397.31,4277.67,2223.73,2673.27,-1329.9,-13551.86
1699996191985853440,2020-05,4331.62,5426.43,2880.33,2136.76,-351.24,-13903.1
1699996191985853440,2020-06,4502.93,1930.25,255.79,2025.12,803.35,-13099.75
1699996191985853440,2020-07,9653.26,3179.55,5287.75,3839.88,7921.58,-5178.17
1699996191985853440,2020-08,1972.11,961.47,1620.69,3165.52,-534.19,-5712.36
1699996191985853440,2020-09,5212.25,5654.28,4750.52,3492.46,816.03,-4896.33
1699996191985853440,2020-10,3897.71,8059.32,3938.41,3846.11,-4069.31,-8965.64
1699996191985853440,2020-11,2981.15,9094.13,4308.48,2586.95,-4391.45,-13357.09
1699996191985853440,2020-12,2232.59,9495.08,3198.57,1498.69,-5562.61,-18919.7
1701413267892471296,2020-01,628.7,3169.54,7811.5,1304.83,3965.83,3965.83
1701413267892471296,2020-02,492.3,6313.14,0,682.5,-6503.34,-2537.51
1701413267892471296,2020-03,277.65,2458.69,4616.27,3703.21,-1267.98,-3805.49
1701413267892471296,2020-04,1584.11,2097.81,708.55,1190.72,-995.87,-4801.36
1701413267892471296,2020-05,2635.9,4808.43,3001.53,1259.6,-430.6,-5231.96
1701413267892471296,2020-06,5057.02,2830.43,2964.13,3523.22,1667.5,-3564.46
1701413267892471296,2020-07,3872.1,2635.24,2089.11,4347.89,-1021.92,-4586.38
1701413267892471296,2020-08,2818.46,818.8,2811.66,423.71,4387.61,-198.77
1701413267892471296,2020-09,139.37,6179.54,1164.34,1671.43,-6547.26,-6746.03
1701413267892471296,2020-10,384.5,5064.4,1760.58,2799,-5718.32,-12464.35
1701413267892471296,2020-11,6716,1562.66,1008.42,2536.05,3625.71,-8838.64
1701413267892471296,2020-12,1218.22,783.23,473.24,8643.89,-7735.66,-16574.3
1702619387540332032,2020-01,2643.47,0,730.9,0,3374.37,3374.37
1702619387540332032,2020-02,566.78,2570.26,545.21,0,-1458.27,1916.1
1702619387540332032,2020-03,3162.34,0,0,0,3162.34,5078.44
1702619387540332032,2020-04,2537.21,0,137.82,1831.22,843.81,5922.25
1702619387540332032,2020-05,713.89,1701.59,0,0,-987.7,4934.55
1702619387540332032,2020-07,736.63,747.57,1520.28,441.22,1068.12,6002.67
1702619387540332032,2020-09,0,148.55,0,0,-148.55,5854.12
1702676628931560960,2020-01,4331.2,5690.11,6578.03,5140.9,78.22,78.22
1702676628931560960,2020-02,4017.63,1877.06,1261.28,4240.07,-838.22,-760
1702676628931560960,2020-03,3911.26,8342.74,4323.55,6211.14,-6319.07,-7079.07
1702676628931560960,2020-04,995.04,6110.69,4907.17,3556.18,-3764.66,-10843.73
1702676628931560960,2020-05,4076.94,2426.19,3551.3,2261.12,2940.93,-7902.8
1702676628931560960,2020-06,3284.4,5414.7,1871.41,4025.15,-4284.04,-12186.84
1702676628931560960,2020-07,2303.32,683.5,2832.62,6703.06,-2250.62,-14437.46
1702676628931560960,2020-08,289,2944.24,0,2392.9,-5048.14,-19485.6
1702676628931560960,2020-09,6784.55,6144.22,3724.66,4585.71,-220.72,-19706.32
1702676628931560960,2020-10,4631.81,2734.46,3412.37,2233.32,3076.4,-16629.92
1702676628931560960,2020-11,5916.99,3796.85,7864.26,4216.29,5768.11,-10861.81
1702676628931560960,2020-12,4367.5,2406.77,4168.06,5858.51,270.28,-10591.53
1702705513826258944,2020-01,2052.64,7502.33,5628.21,2718.93,-2540.41,-2540.41
1702705513826258944,2020-02,5501.66,1070.02,2916.98,3361.52,3987.1,1446.69
1702705513826258944,2020-03,1334.88,1990.48,3678.9,4792.39,-1769.09,-322.4
1702705513826258944,2020-04,4084.73,5142.26,3194.22,1920.73,215.96,-106.44
1702705513826258944,2020-05,8011.14,6941.5,2830.59,749.66,3150.57,3044.13
1702705513826258944,2020-06,5345.11,3504.96,832.75,2850.91,-178.01,2866.12
1702705513826258944,2020-07,6324.28,4386.54,6687.01,2772.69,5852.06,8718.18
1702705513826258944,2020-08,7518.24,6123.49,1155.96,5229.08,-2678.37,6039.81
1702705513826258944,2020-09,8402.33,8776.63,5607.25,963.56,4269.39,10309.2
1702705513826258944,2020-10,2108.11,2980.53,7352.24,3082.6,3397.22,13706.42
1702705513826258944,2020-11,2702.95,1130.73,4107.02,2681.67,2997.57,16703.99
1702705513826258944,2020-12,4582.3,7036.85,4633.28,7490.09,-5311.36,11392.63
1703659603821096448,2020-01,1367.21,3958.59,1390.94,286.95,-1487.39,-1487.39
1703659603821096448,2020-02,1032.19,1497.11,495.44,4479.88,-4449.36,-5936.75
1703659603821096448,2020-03,3139.36,5634.5,5096.23,5445.68,-2844.59,-8781.34
1703659603821096448,2020-04,1663.22,0,1954.97,0,3618.19,-5163.15
1703659603821096448,2020-05,1282.56,2931.14,4875.44,3709.14,-482.28,-5645.43
1703659603821096448,2020-06,1724.02,1825.74,2161.1,2076.47,-17.09,-5662.52
1703659603821096448,2020-07,1959.53,0,1985.1,0,3944.63,-1717.89
1703659603821096448,2020-08,4833.8,6094.32,4233.85,3004.36,-31.03,-1748.92
1703659603821096448,2020-09,2389.81,1041.04,737.91,3605.42,-1518.74,-3267.66
1703659603821096448,2020-10,0,5578.72,4276.63,2455.14,-3757.23,-7024.89
1703659603821096448,2020-11,293.62,2613.01,5089.05,3816.33,-1046.67,-8071.56
1703659603821096448,2020-12,1895.64,4502.84,3555.08,809.23,138.65,-7932.91
1705755136921454848,2020-01,6616.63,3398.91,5257.73,3388.48,5086.97,5086.97
1705755136921454848,2020-02,1434,3488.47,0,0,-2054.47,3032.5
1705755136921454848,2020-03,3267.25,1927.17,9250.2,6278.71,4311.57,7344.07
1705755136921454848,2020-04,4749.65,3893.13,7154.67,2155.99,5855.2,13199.27
1705755136921454848,2020-05,4909.68,1614.39,2654.25,2567.77,3381.77,16581.04
1705755136921454848,2020-06,7985.38,1627.09,6614.06,3080.4,9891.95,26472.99
1705755136921454848,2020-07,4073.01,3932.39,5288.12,3115.5,2313.24,28786.23
1705755136921454848,2020-08,7876.69,3534.43,8263.79,5531.58,7074.47,35860.7
1705755136921454848,2020-09,0,1877.88,1257.05,3448.29,-4069.12,31791.58
1705755136921454848,2020-10,5320.03,4685.85,800.78,6523.09,-5088.13,26703.45
1705755136921454848,2020-11,3402.54,3539.05,3220.21,4408.29,-1324.59,25378.86
1705755136921454848,2020-12,1146.07,4566.38,5009.64,1145.13,444.2,25823.06
1705910612353082112,2020-05,0,155.12,193.74,982.29,-943.67,-943.67
1705910612353082112,2020-06,0,530.74,2564.55,0,2033.81,1090.14
1705910612353082112,2020-07,190.88,0,0,1525.04,-1334.16,-244.02
1705910612353082112,2020-11,0,636.86,375.06,0,-261.8,-505.82
1706512983590207744,2020-02,1243.87,0,0,1408.08,-164.21,-164.21
1706512983590207744,2020-03,0,1795.12,994.48,0,-800.64,-964.85
1706512983590207744,2020-06,1424.44,1925.29,1974.21,2232.19,-758.83,-1723.68
1706512983590207744,2020-08,0,1728.23,0,0,-1728.23,-3451.91
1706512983590207744,2020-09,0,808.2,2799.18,0,1990.98,-1460.93
1706512983590207744,2020-10,0,1797.16,2268.33,0,471.17,-989.76
1706512983590207744,2020-11,2252.84,201.16,0,26.03,2025.65,1035.89
1706512983590207744,2020-12,1613.63,473.24,0,1192.91,-52.52,983.37
1711283765182065408,2020-01,1166.34,0,1461.74,709.17,1918.91,1918.91
1711283765182065408,2020-03,219.07,3094.4,106,1545.8,-4315.13,-2396.22
1711283765182065408,2020-04,3406.19,557.76,1238.34,1955.56,2131.21,-265.01
1711283765182065408,2020-05,3120.06,0,0,1288.34,1831.72,1566.71
1711283765182065408,2020-06,3833.89,1416.12,1041.01,3597.69,-138.91,1427.8
1711283765182065408,2020-07,5289.17,1894.84,933,1380.28,2947.05,4374.85
1711283765182065408,2020-08,1527.8,771.08,2116.51,1094.29,1778.94,6153.79
1711283765182065408,2020-09,1918.41,5.42,1473.35,0,3386.34,9540.13
1711283765182065408,2020-10,0,367.99,1375.67,0,1007.68,10547.81
1711283765182065408,2020-11,0,3767.5,1608.86,988.14,-3146.78,7401.03
1711283765182065408,2020-12,1933.55,1701.72,1972.78,0,2204.61,9605.64
1712323574034482176,2020-01,5574.15,1319.16,8490.72,4809.62,7936.09,7936.09
1712323574034482176,2020-02,4059.15,2317.74,1875.53,9580.69,-5963.75,1972.34
1712323574034482176,2020-03,4259.71,3286.06,5277.19,4668.83,1582.01,3554.35
1712323574034482176,2020-04,3029.5,6968.14,7983.07,7482.74,-3438.31,116.04
1712323574034482176,2020-05,8037.42,7016.67,8351.02,4497.27,4874.5,4990.54
1712323574034482176,2020-06,4504.02,1375.83,5486.7,9474.23,-859.34,4131.2
1712323574034482176,2020-07,6519.33,7458.44,3808.52,3311.45,-442.04,3689.16
1712323574034482176,2020-08,6102.21,8198.92,7011.02,819.56,4094.75,7783.91
1712323574034482176,2020-09,5102.07,3559.13,3044.78,3396.65,1191.07,8974.98
1712323574034482176,2020-10,7213.3,4835.78,3603.55,2707.75,3273.32,12248.3
1712323574034482176,2020-11,1556.65,6527.3,3752.01,5161.74,-6380.38,5867.92
1712323574034482176,2020-12,1336.61,5728.01,4774.67,2527.36,-2144.09,3723.83
1713985928335154432,2020-01,1650.55,5423.81,2269.58,2597.85,-4101.53,-4101.53
1713985928335154432,2020-02,0,1945.26,252.16,4556.85,-6249.95,-10351.48
1713985928335154432,2020-03,3453.2,0,3627.76,5421.79,1659.17,-8692.31
1713985928335154432,2020-04,1325.95,0,3225.23,0,4551.18,-4141.13
1713985928335154432,2020-05,2511.05,2469.45,2440.34,2736.33,-254.39,-4395.52
1713985928335154432,2020-06,0,200.4,2357.99,1312.62,844.97,-3550.55
1713985928335154432,2020-07,1532.19,0,2396.42,5446.45,-1517.84,-5068.39
1713985928335154432,2020-08,4030.68,3500.42,678.83,1925.62,-716.53,-5784.92
1713985928335154432,2020-09,1949.46,1322.47,2794.38,3812.39,-391.02,-6175.94
1713985928335154432,2020-10,1899.44,3670.85,4670.37,1959.99,938.97,-5236.97
1713985928335154432,2020-11,3434.83,5130.21,1443.56,6216.71,-6468.53,-11705.5
1713985928335154432,2020-12,2725.78,889.57,2459.58,1329.41,2966.38,-8739.12
1714145419332462848,2020-01,0,1676.87,1605.21,2924.99,-2996.65,-2996.65
1714145419332462848,2020-02,0,1583.8,2757.36,728.58,444.98,-2551.67
1714145419332462848,2020-03,2337.52,2265.82,1990.33,0,2062.03,-489.64
1714145419332462848,2020-05,1259.99,1346.32,1628.71,1824.66,-282.28,-771.92
1714145419332462848,2020-06,577.51,2900.23,2295.58,2356.13,-2383.27,-3155.19
1714145419332462848,2020-07,4114.16,0,3519.83,1758.72,5875.27,2720.08
1714145419332462848,2020-08,0,3781.82,818.48,961.43,-3924.77,-1204.69
1714145419332462848,2020-10,2111.96,2452.93,3743.49,1929.58,1472.94,268.25
1714145419332462848,2020-11,0,1594.72,1418.02,1968.67,-2145.37,-1877.12
1714145419332462848,2020-12,738.7,2871.94,908.14,2288.25,-3513.35,-5390.47
1714206643651421952,2020-01,580.93,2056.41,0,444.67,-1920.15,-1920.15
1714206643651421952,2020-02,0,130.05,0,5643.57,-5773.62,-7693.77
1714206643651421952,2020-03,1566.78,2092.38,503.45,2581.17,-2603.32,-10297.09
1714206643651421952,2020-04,0,1345.31,965.67,1293.47,-1673.11,-11970.2
1714206643651421952,2020-05,5530.13,0,3686.61,1453.94,7762.8,-4207.4
1714206643651421952,2020-06,2115.6,2790.18,3093.41,3317.7,-898.87,-5106.27
1714206643651421952,2020-07,4275.53,5318.47,0,0,-1042.94,-6149.21
1714206643651421952,2020-08,0,1501.42,1288.89,0,-212.53,-6361.74
1714206643651421952,2020-09,615.1,5.59,1774.58,3337.22,-953.13,-7314.87
1714206643651421952,2020-10,8795.16,5370.6,3127.56,1374.91,5177.21,-2137.66
1714206643651421952,2020-11,719.71,0,1578.81,1811.58,486.94,-1650.72
1714206643651421952,2020-12,2927.31,483.69,2205.82,2861.33,1788.11,137.39
1715317760068153856,2020-01,3372.52,2895.05,3723.49,4001.38,199.58,199.58
1715317760068153856,2020-02,0,2940.21,1475.99,3925.62,-5389.84,-5190.26
1715317760068153856,2020-03,3477.3,2491.34,884.69,3272.46,-1401.81,-6592.07
1715317760068153856,2020-04,5747.96,5000.03,6724.79,1625.56,5847.16,-744.91
1715317760068153856,2020-05,1087.05,5255.61,1287.36,0,-2881.2,-3626.11
1715317760068153856,2020-06,0,482.31,1712.65,1662.6,-432.26,-4058.37
1715317760068153856,2020-07,2848.58,0,4110.78,1024.17,5935.19,1876.82
1715317760068153856,2020-08,1959.01,4096.81,3227.03,0,1089.23,2966.05
1715317760068153856,2020-09,1001.11,0,2552.01,6952.95,-3399.83,-433.78
1715317760068153856,2020-10,0.7,1693.17,3315.64,4870.07,-3246.9,-3680.68
1715317760068153856,2020-11,7698.7,1646.83,2825.71,1426.96,7450.62,3769.94
1715317760068153856,2020-12,1752.91,3873.28,2105.32,5111.67,-5126.72,-1356.78
1715429908988779008,2020-01,3008.89,3513.14,2633.07,5980.7,-3851.88,-3851.88
1715429908988779008,2020-02,7534.12,3319.4,4059.84,4237.13,4037.43,185.55
1715429908988779008,2020-03,4114.95,1348.41,2358.54,3139.05,1986.03,2171.58
1715429908988779008,2020-04,13721.75,4500.19,1961.95,1422.51,9761,11932.58
1715429908988779008,2020-05,6804.94,3447.73,3286.26,1039.29,5604.18,17536.76
1715429908988779008,2020-06,4026.12,1857.64,9304.44,2996.83,8476.09,26012.85
1715429908988779008,2020-07,8087.03,2731.6,7079.31,2872.76,9561.98,35574.83
1715429908988779008,2020-08,9128.72,3709.08,5553.04,1460.38,9512.3,45087.13
1715429908988779008,2020-09,5223.07,2648.86,3643.5,4229.82,1987.89,47075.02
1715429908988779008,2020-10,1402.58,1815.08,1938.4,4679.72,-3153.82,43921.2
1715429908988779008,2020-11,12305.02,2450.74,2233.79,1221.93,10866.14,54787.34
1715429908988779008,2020-12,4858.7,3164.38,8661.12,4700,5655.44,60442.78
1719079157303561728,2020-01,1597.17,2309.15,2105.73,3586.3,-2192.55,-2192.55
1719079157303561728,2020-02,619.17,683.1,1101.11,1645.81,-608.63,-2801.18
1719079157303561728,2020-03,1538.57,2363.66,1896.18,2829.33,-1758.24,-4559.42
1719079157303561728,2020-04,3239.45,4083.56,2011.15,1892.62,-725.58,-5285
1719079157303561728,2020-05,3334.37,3275.15,1468.81,3116.25,-1588.22,-6873.22
1719079157303561728,2020-06,1388.22,2531.22,0,1153.54,-2296.54,-9169.76
1719079157303561728,2020-07,0,6502.78,1406.16,0,-5096.62,-14266.38
1719079157303561728,2020-08,1022.34,4925.58,326.12,0,-3577.12,-17843.5
1719079157303561728,2020-09,170.68,404.97,7521.39,0,7287.1,-10556.4
1719079157303561728,2020-10,1450.1,0,3912.94,384.99,4978.05,-5578.35
1719079157303561728,2020-11,1024.18,390.76,2611.28,0,3244.7,-2333.65
1719079157303561728,2020-12,0,1622.95,44.6,3816.95,-5395.3,-7728.95
1719603271067340288,2020-01,730.73,3468.98,0,3677.43,-6415.68,-6415.68
1719603271067340288,2020-02,561.07,0,0,952.29,-391.22,-6806.9
1719603271067340288,2020-03,0,418.42,92.77,4572.1,-4897.75,-11704.65
1719603271067340288,2020-04,3403.5,1732.83,3288.56,1177.44,3781.79,-7922.86
1719603271067340288,2020-05,476.13,2190.12,1683.72,824.13,-854.4,-8777.26
1719603271067340288,2020-06,780.31,2120.98,574.99,0,-765.68,-9542.94
1719603271067340288,2020-07,4170.68,5984.77,3194.73,851.48,529.16,-9013.78
1719603271067340288,2020-09,0,3454.39,1993.76,245.69,-1706.32,-10720.1
1719603271067340288,2020-10,3502.12,1826.86,0,1534.11,141.15,-10578.95
1719603271067340288,2020-11,1455.7,2738.96,3692.12,2126.98,281.88,-10297.07
1719603271067340288,2020-12,83.73,2235.61,746.7,4857.76,-6262.94,-16560.01
1719798788005232640,2020-01,5148.37,6165.49,6224.43,4648.13,559.18,559.18
1719798788005232640,2020-02,6976.22,6819.96,9999.47,4427.28,5728.45,6287.63
1719798788005232640,2020-03,6213.43,4856.58,3226.96,3166.01,1417.8,7705.43
1719798788005232640,2020-04,4520.84,2489.27,1587.08,1275.66,2342.99,10048.42
1719798788005232640,2020-05,4365.75,2429.76,7661.86,5908.85,3689,13737.42
1719798788005232640,2020-06,500.39,3593.21,6552.99,5189.11,-1728.94,12008.48
1719798788005232640,2020-07,6318.64,9718.33,3752.58,8696.54,-8343.65,3664.83
1719798788005232640,2020-08,0,3379.31,8754.36,7049.42,-1674.37,1990.46
1719798788005232640,2020-09,4536.87,2136.38,2966,7839.61,-2473.12,-482.66
1719798788005232640,2020-10,2333.57,10101.64,7807.97,3796.18,-3756.28,-4238.94
1719798788005232640,2020-11,988.01,6056.13,4775.53,2200.73,-2493.32,-6732.26
1719798788005232640,2020-12,3633.31,4195.72,4534.84,1808.03,2164.4,-4567.86
1721128903802475520,2020-01,1773.91,3589.42,7757.46,4952.69,989.26,989.26
1721128903802475520,2020-02,4310.44,3888.43,2821.56,1661.16,1582.41,2571.67
1721128903802475520,2020-03,1365.01,2124.95,3322.88,1612.04,950.9,3522.57
1721128903802475520,2020-04,5305.01,0,1137.41,1974.16,4468.26,7990.83
1721128903802475520,2020-05,4008.05,11178.58,4652.32,4830.75,-7348.96,641.87
1721128903802475520,2020-06,2293.92,7716.2,0,1886.5,-7308.78,-6666.91
1721128903802475520,2020-07,1871.75,9153.13,1140.33,2512.66,-8653.71,-15320.62
1721128903802475520,2020-08,0,6827.77,2680.69,2398.27,-6545.35,-21865.97
1721128903802475520,2020-09,5052.14,1121.46,529.73,2980,1480.41,-20385.56
1721128903802475520,2020-10,5400.58,4521.95,1341.48,1316.8,903.31,-19482.25
1721128903802475520,2020-11,3387.91,4482.62,0,3780.65,-4875.36,-24357.61
1721128903802475520,2020-12,4001.76,3108.45,4536.29,2003.89,3425.71,-20931.9
1722717217522698240,2020-01,7171.97,1671.98,1775.34,0,7275.33,7275.33
1722717217522698240,2020-02,1727.41,4465.31,1663.28,5328.01,-6402.63,872.7
1722717217522698240,2020-03,2126.92,730.87,7437.57,1871.03,6962.59,7835.29
1722717217522698240,2020-04,4348.24,1327.11,3215.46,2594.78,3641.81,11477.1
1722717217522698240,2020-05,1565.34,4956.66,1714.15,4383.78,-6060.95,5416.15
1722717217522698240,2020-06,1693.3,0,0,6947.42,-5254.12,162.03
1722717217522698240,2020-07,893.89,463.17,587.63,4401.22,-3382.87,-3220.84
1722717217522698240,2020-08,2391.97,579.82,3748.49,1528.75,4031.89,811.05
1722717217522698240,2020-09,1621.03,5053.54,530.06,748.82,-3651.27,-2840.22
1722717217522698240,2020-10,4925.53,3387.52,1699.65,1173.48,2064.18,-776.04
1722717217522698240,2020-11,2381.15,2175.74,1319.56,964.91,560.06,-215.98
1722717217522698240,2020-12,4802.04,705.94,1140.37,4333,903.47,687.49
1723454967256092416,2020-01,1822.39,0,788.13,1384.66,1225.86,1225.86
1723454967256092416,2020-02,0,146.7,557.44,3809.22,-3398.48,-2172.62
1723454967256092416,2020-03,1733.16,1016.14,1053,1485.61,284.41,-1888.21
1723454967256092416,2020-04,35.38,1797.45,2591.63,0,829.56,-1058.65
1723454967256092416,2020-05,1767.81,3449.09,1330.1,1455.46,-1806.64,-2865.29
1723454967256092416,2020-06,2552.45,0,0,0,2552.45,-312.84
1723454967256092416,2020-07,0,1813.27,0,758.67,-2571.94,-2884.78
1723454967256092416,2020-09,563.83,1769.84,2606.11,82.86,1317.24,-1567.54
1723454967256092416,2020-10,838.43,1245.26,0,94.75,-501.58,-2069.12
1723454967256092416,2020-11,1315.47,1389.34,632.61,1525.46,-966.72,-3035.84
1723454967256092416,2020-12,0,3253.6,2565.24,0,-688.36,-3724.2
1725261128054190080,2020-01,2761.36,2338.89,1274.89,1908.17,-210.81,-210.81
1725261128054190080,2020-02,2581.03,2207.27,3986.28,4762.93,-402.89,-613.7
1725261128054190080,2020-03,1331.86,1195.86,6526.66,875.94,5786.72,5173.02
1725261128054190080,2020-04,5056.17,5031.98,1162.28,2251.88,-1065.41,4107.61
1725261128054190080,2020-05,1212.03,4400.71,3722.28,4436.54,-3902.94,204.67
1725261128054190080,2020-06,2904.43,5615.36,4074.52,3705.05,-2341.46,-2136.79
1725261128054190080,2020-07,4858.66,6282.42,2336.79,6092.38,-5179.35,-7316.14
1725261128054190080,2020-08,5201.4,5253.91,2388.71,630.71,1705.49,-5610.65
1725261128054190080,2020-09,3905.74,0,4262.67,0,8168.41,2557.76
1725261128054190080,2020-10,1112.04,5114.43,1002.32,7757.4,-10757.47,-8199.71
1725261128054190080,2020-11,1898.25,5499.5,3714.77,730.46,-616.94,-8816.65
1725261128054190080,2020-12,0,2222.62,1229.43,2122.41,-3115.6,-11932.25
1725434218133016576,2020-01,3414.52,1892.18,2424.65,823.7,3123.29,3123.29
1725434218133016576,2020-02,5917.64,2983.88,2498.08,0,5431.84,8555.13
1725434218133016576,2020-03,5479.16,4875.2,4934.78,766.44,4772.3,13327.43
1725434218133016576,2020-04,1586.37,1652.71,4765.84,2209.76,2489.74,15817.17
1725434218133016576,2020-05,1225.55,5976.53,4814.54,3321.96,-3258.4,12558.77
1725434218133016576,2020-06,3882.87,0,5214.49,745.88,8351.48,20910.25
1725434218133016576,2020-07,872.67,3292.48,4512.46,2104.29,-11.64,20898.61
1725434218133016576,2020-08,5852.68,6221.79,1564.03,2162.54,-967.62,19930.99
1725434218133016576,2020-09,5059.4,6253.21,2962.96,5242.93,-3473.78,16457.21
1725434218133016576,2020-10,960.5,5780.68,0,3704.92,-8525.1,7932.11
1725434218133016576,2020-11,3155.57,3935.93,3686.61,1437.73,1468.52,9400.63
1725434218133016576,2020-12,7346.34,3713.92,8694.18,3742,8584.6,17985.23
1726581146544178944,2020-01,2211.17,5758.91,6035.75,6708.83,-4220.82,-4220.82
1726581146544178944,2020-02,1959.02,3222.22,1604.81,5467.26,-5125.65,-9346.47
1726581146544178944,2020-03,5283.66,475.33,1731.38,7979.93,-1440.22,-10786.69
1726581146544178944,2020-04,7002.41,2585.62,4536.66,3406.5,5546.95,-5239.74
1726581146544178944,2020-05,6078.31,3327.66,6583.72,3524.37,5810,570.26
1726581146544178944,2020-06,4487.27,6118.41,6844.81,6216.11,-1002.44,-432.18
1726581146544178944,2020-07,8627.97,3369.63,3985.74,7328.66,1915.42,1483.24
1726581146544178944,2020-08,1994.62,1088.79,8053.14,5781.16,3177.81,4661.05
1726581146544178944,2020-09,2868.61,4135.3,3039.02,4600.6,-2828.27,1832.78
1726581146544178944,2020-10,2926.95,4351.09,6457.53,5476.01,-442.62,1390.16
1726581146544178944,2020-11,4624.48,6370.64,4025.57,3555.01,-1275.6,114.56
1726581146544178944,2020-12,1532.39,3809.18,6206.21,7460.11,-3530.69,-3416.13
1726648449963402240,2020-01,2031.02,5750.36,1869.53,5095.61,-6945.42,-6945.42
1726648449963402240,2020-02,9114.82,1799.66,0,4337.5,2977.66,-3967.76
1726648449963402240,2020-03,5446.85,1721.89,4009.36,2831.48,4902.84,935.08
1726648449963402240,2020-04,1333.38,7873.32,9345.03,2852.52,-47.43,887.65
1726648449963402240,2020-05,6458.68,9366.06,4347.11,2234.05,-794.32,93.33
1726648449963402240,2020-06,8250.64,2143.02,1321.75,2746.77,4682.6,4775.93
1726648449963402240,2020-07,6806.42,3181.53,7645.54,7765.92,3504.51,8280.44
1726648449963402240,2020-08,2613.08,9509.79,6079.74,6396.74,-7213.71,1066.73
1726648449963402240,2020-09,5189.88,3620.76,3022.86,4587.48,4.5,1071.23
1726648449963402240,2020-10,1294.28,1452.11,0,6932.8,-7090.63,-6019.4
1726648449963402240,2020-11,2643.26,4383.29,6282.31,5400.6,-858.32,-6877.72
1726648449963402240,2020-12,4715.12,5803.87,8156.95,6184.9,883.3,-5994.42
1727220587562685952,2020-01,38.19,1564.67,140.63,0,-1385.85,-1385.85
1727220587562685952,2020-03,1352.7,0,0,0,1352.7,-33.15
1727220587562685952,2020-04,452.65,0,0,0,452.65,419.5
1727220587562685952,2020-05,2053.2,0,867.38,0,2920.58,3340.08
1727220587562685952,2020-07,787.54,0,0,0,787.54,4127.62
1727220587562685952,2020-10,268.62,0,257.02,0,525.64,4653.26
1727220587562685952,2020-11,0,13.76,0,2989.18,-3002.94,1650.32
1727220587562685952,2020-12,1434.07,776.62,0,0,657.45,2307.77
1727587378618140928,2020-01,6904.57,1551.69,6881.29,10326.96,1907.21,1907.21
1727587378618140928,2020-02,5027.68,3301.9,4277.26,7042.59,-1039.55,867.66
1727587378618140928,2020-03,6988.94,3928.61,2953.64,5082.78,931.19,1798.85
1727587378618140928,2020-04,2585.37,1292.91,5552.67,3726.95,3118.18,4917.03
1727587378618140928,2020-05,4316.96,4294.04,5000.07,4074.17,948.82,5865.85
1727587378618140928,2020-06,5403.7,1743.9,3407.74,3429.1,3638.44,9504.29
1727587378618140928,2020-07,2283.61,3817.01,2223.82,3609.87,-2919.45,6584.84
1727587378618140928,2020-08,2255.03,3876.01,2430.25,169.7,639.57,7224.41
1727587378618140928,2020-09,4415.21,8185.24,770.62,4414.47,-7413.88,-189.47
1727587378618140928,2020-10,12417.93,4550.41,6118.92,1901.93,12084.51,11895.04
1727587378618140928,2020-11,7982.87,5710.12,3566.41,2844.41,2994.75,14889.79
1727587378618140928,2020-12,906.97,7649.21,4677.37,5610.4,-7675.27,7214.52
1728490371596197376,2020-01,1279.84,3259.62,832.54,0,-1147.24,-1147.24
1728490371596197376,2020-02,931,3263.7,0,0,-2332.7,-3479.94
1728490371596197376,2020-03,485.31,0,0,0,485.31,-2994.63
1728490371596197376,2020-05,1801.64,2516.18,1807.71,0,1093.17,-1901.46
1728490371596197376,2020-06,0,153.59,0,0,-153.59,-2055.05
1728490371596197376,2020-07,3262.71,0,1015.35,2206.99,2071.07,16.02
1728490371596197376,2020-08,1858.02,1962.07,0,0,-104.05,-88.03
1728490371596197376,2020-09,1248.48,1265.18,0,0,-16.7,-104.73
1728490371596197376,2020-11,0,1900.55,0,0,-1900.55,-2005.28
1728490371596197376,2020-12,0,211.42,0,1484.04,-1695.46,-3700.74
1728527708877803264,2020-01,0,1766.77,3549.3,9698.39,-7915.86,-7915.86
1728527708877803264,2020-02,1088.56,8580.18,4878.45,3802.47,-6415.64,-14331.5
1728527708877803264,2020-03,4233.23,7513.96,7016.25,2765.75,969.77,-13361.73
1728527708877803264,2020-04,6295.72,3697.47,7745.09,3082.33,7261.01,-6100.72
1728527708877803264,2020-05,4373.5,6796.67,5540.14,6937.14,-3820.17,-9920.89
1728527708877803264,2020-06,5463.79,2641.46,9850.04,4573.04,8099.33,-1821.56
1728527708877803264,2020-07,3984.04,3241.14,2617.44,3472.25,-111.91,-1933.47
1728527708877803264,2020-08,2446.22,1257.26,3229.44,7874.66,-3456.26,-5389.73
1728527708877803264,2020-09,290.22,9651.56,3667.11,3168.1,-8862.33,-14252.06
1728527708877803264,2020-10,2285.8,4976.87,4904.23,2893.18,-680.02,-14932.08
1728527708877803264,2020-11,7016.16,4468.61,2698.27,2710.77,2535.05,-12397.03
1728527708877803264,2020-12,8359.62,2155.11,6385.33,3049.43,9540.41,-2856.62
1729692831303878656,2020-01,1001.39,4269.71,270.52,5056.85,-8054.65,-8054.65
1729692831303878656,2020-02,2257.64,5184.82,1298.31,2603.72,-4232.59,-12287.24
1729692831303878656,2020-03,3464.96,3599.81,4048.53,8033.57,-4119.89,-16407.13
1729692831303878656,2020-04,4374.07,2057.63,3515.41,10155.29,-4323.44,-20730.57
1729692831303878656,2020-05,4116.23,2759.91,523.42,3637.43,-1757.69,-22488.26
1729692831303878656,2020-06,1687.94,3093.68,314.57,7231.23,-8322.4,-30810.66
1729692831303878656,2020-07,5954.18,2680.5,1620.53,2187.52,2706.69,-28103.97
1729692831303878656,2020-08,1998.56,4563.58,2722.01,5297.82,-5140.83,-33244.8
1729692831303878656,2020-09,5874.02,5971.09,5657.5,4228.52,1331.91,-31912.89
1729692831303878656,2020-10,6063,4463.13,5299.1,3619.15,3279.82,-28633.07
1729692831303878656,2020-11,8315.16,5178.76,5056.53,3823.06,4369.87,-24263.2
1729692831303878656,2020-12,7176.47,11255.88,2650.18,4193.51,-5622.74,-29885.94
1730624708894917632,2020-01,5728.28,9236.02,9045.65,4176.74,1361.17,1361.17
1730624708894917632,2020-02,2836.69,1906.52,2456.64,3427.91,-41.1,1320.07
1730624708894917632,2020-03,7620.32,5352.29,5093.52,5349.3,2012.25,3332.32
1730624708894917632,2020-04,3521.75,3855.2,5041.45,10405.97,-5697.97,-2365.65
1730624708894917632,2020-05,2045.36,4052.75,2817.74,5343.59,-4533.24,-6898.89
1730624708894917632,2020-06,6329.22,1718.57,6262.94,4559.34,6314.25,-584.64
1730624708894917632,2020-07,4794.18,5643.23,8726.36,5104.93,2772.38,2187.74
1730624708894917632,2020-08,4762.42,5065.12,6033.95,7454.13,-1722.88,464.86
1730624708894917632,2020-09,2884.5,6778.02,1896.19,10111.76,-12109.09,-11644.23
1730624708894917632,2020-10,3176.72,1294.67,4225.04,2112.3,3994.79,-7649.44
1730624708894917632,2020-11,1993.72,2923.11,614.15,6032.42,-6347.66,-13997.1
1730624708894917632,2020-12,6089.72,7704.47,4950.43,6538.55,-3202.87,-17199.97
1731106574841157888,2020-01,1294.2,5358.23,1097.4,2437.38,-5404.01,-5404.01
1731106574841157888,2020-02,4892.93,2555.18,4962.3,2183.13,5116.92,-287.09
1731106574841157888,2020-03,1638.3,280.26,29.87,3934.74,-2546.83,-2833.92
1731106574841157888,2020-05,4148.63,5492.97,322.64,832.05,-1853.75,-4687.67
1731106574841157888,2020-06,3254.85,1735.93,0,6537.93,-5019.01,-9706.68
1731106574841157888,2020-07,997.91,261.37,990.96,1962.52,-235.02,-9941.7
1731106574841157888,2020-08,2476.03,1870.34,5300.86,334.23,5572.32,-4369.38
1731106574841157888,2020-09,4574.61,567.49,689.69,2805.1,1891.71,-2477.67
1731106574841157888,2020-10,4427.83,2655.94,1593.65,3941.06,-575.52,-3053.19
1731106574841157888,2020-11,5919.61,1379.41,730.98,2224.89,3046.29,-6.9
1731106574841157888,2020-12,2356.55,0,8042.79,4006.4,6392.94,6386.04
1732836497342416128,2020-01,583.99,1290.99,1709.24,1822.15,-819.91,-819.91
1732836497342416128,2020-02,1425.98,1592.83,1267.12,1972.86,-872.59,-1692.5
1732836497342416128,2020-03,1824.04,1209.24,5217.55,3381.94,2450.41,757.91
1732836497342416128,2020-04,3312.33,3699.07,5188.38,1070.37,3731.27,4489.18
1732836497342416128,2020-05,863.44,3267.71,2593.54,2961.47,-2772.2,1716.98
1732836497342416128,2020-06,433.49,1836.8,6253.99,5217.69,-367.01,1349.97
1732836497342416128,2020-07,4120.06,1742.66,3728.29,9501.64,-3395.95,-2045.98
1732836497342416128,2020-08,5306.38,1278.58,4033.45,2362.96,5698.29,3652.31
1732836497342416128,2020-09,2787.28,1275.12,2212.69,2924.13,800.72,4453.03
1732836497342416128,2020-10,1301.45,7421.79,690.2,2100.83,-7530.97,-3077.94
1732836497342416128,2020-11,3647.25,4876.23,2427.74,2609.68,-1410.92,-4488.86
1732836497342416128,2020-12,1364.84,4354.5,1222.51,1892.34,-3659.49,-8148.35
1734830383520477696,2020-01,3074.77,3710.75,7350.45,3356.73,3357.74,3357.74
1734830383520477696,2020-02,3968.34,2703.67,2502.3,5116.93,-1349.96,2007.78
1734830383520477696,2020-03,6048.51,3252.19,5401.84,2339.4,5858.76,7866.54
1734830383520477696,2020-04,1403.27,771.24,5832.72,2794.64,3670.11,11536.65
1734830383520477696,2020-05,2594.47,835.88,1448.61,3197.37,9.83,11546.48
1734830383520477696,2020-06,2794.47,4637.29,4205.18,5414.67,-3052.31,8494.17
1734830383520477696,2020-07,3744.96,6500.55,3475.95,3711.36,-2991,5503.17
1734830383520477696,2020-08,3537.96,1838.13,6361.98,3125.5,4936.31,10439.48
1734830383520477696,2020-09,4631.18,7209.47,1644.93,5542.04,-6475.4,3964.08
1734830383520477696,2020-10,2327.4,3410.81,5618.4,4054.59,480.4,4444.48
1734830383520477696,2020-11,2454.85,4392.21,5181.51,5469.07,-2224.92,2219.56
1734830383520477696,2020-12,6876.62,4313.18,4538.76,3538.87,3563.33,5782.89
1735340422276908032,2020-01,3203.37,6617.52,4455.54,7718.16,-6676.77,-6676.77
1735340422276908032,2020-02,5563.66,2690.64,5955.32,5146.31,3682.03,-2994.74
1735340422276908032,2020-03,9158.43,3166.47,7625.43,2102.69,11514.7,8519.96
1735340422276908032,2020-04,2165.96,3601,5590.46,4450.23,-294.81,8225.15
1735340422276908032,2020-05,6025.43,3903.46,10807.61,5614.12,7315.46,15540.61
1735340422276908032,2020-06,1058.52,5763.88,3107.92,10720.87,-12318.31,3222.3
1735340422276908032,2020-07,1937.6,5663.44,3521.6,3988.59,-4192.83,-970.53
1735340422276908032,2020-08,8767.49,7873.2,5279.66,2944.97,3228.98,2258.45
1735340422276908032,2020-09,7022.07,3174.83,4816.38,1253,7410.62,9669.07
1735340422276908032,2020-10,8455.21,2276.77,5324.82,162.72,11340.54,21009.61
1735340422276908032,2020-11,3632.78,3163.21,568.26,6422.4,-5384.57,15625.04
1735340422276908032,2020-12,2636.96,5591.48,9761.16,8867.98,-2061.34,13563.7
1736353193281809664,2020-01,6451.14,14374.77,9348.3,8087.62,-6662.95,-6662.95
1736353193281809664,2020-02,4168.3,5631.32,2170.64,3722.63,-3015.01,-9677.96
1736353193281809664,2020-03,5438.61,6011.62,4203.26,4459.48,-829.23,-10507.19
1736353193281809664,2020-04,2408.57,6739.01,4745.53,390.68,24.41,-10482.78
1736353193281809664,2020-05,4776.11,5520.52,5730.33,8346.06,-3360.14,-13842.92
1736353193281809664,2020-06,8193.51,1060.93,737.14,4810.16,3059.56,-10783.36
1736353193281809664,2020-07,2584.92,9970.53,6477.2,2470.41,-3378.82,-14162.18
1736353193281809664,2020-08,5322.11,2916.68,5933.9,1823.91,6515.42,-7646.76
1736353193281809664,2020-09,2432.42,2677.41,2695.97,1941.11,509.87,-7136.89
1736353193281809664,2020-10,7579.33,2738.85,4105.79,2861.58,6084.69,-1052.2
1736353193281809664,2020-11,0,6083.46,2327.41,216.1,-3972.15,-5024.35
1736353193281809664,2020-12,8150.62,2981.64,10796.8,2140.42,13825.36,8801.01
1738488980807918336,2020-01,7026.94,2868.6,5409.91,5274.91,4293.34,4293.34
1738488980807918336,2020-02,4525.81,8460.13,3474.78,4363.22,-4822.76,-529.42
1738488980807918336,2020-03,4518,8215.41,1449.34,7436.31,-9684.38,-10213.8
1738488980807918336,2020-04,80.83,1841.11,3676.66,4881.93,-2965.55,-13179.35
1738488980807918336,2020-05,11192.31,4277.19,7402.96,11874.12,2443.96,-10735.39
1738488980807918336,2020-06,8492.7,12066.05,5234.09,8245.72,-6584.98,-17320.37
1738488980807918336,2020-07,7955.52,511.98,5165.29,2824.82,9784.01,-7536.36
1738488980807918336,2020-08,6741.15,5656.77,5014.19,3991.68,2106.89,-5429.47
1738488980807918336,2020-09,2478.95,1741.18,2323.27,2652.09,408.95,-5020.52
1738488980807918336,2020-10,6344.24,3415.47,122.45,648.19,2403.03,-2617.49
1738488980807918336,2020-11,2136.88,4850.8,6249.65,9705.35,-6169.62,-8787.11
1738488980807918336,2020-12,2626.32,6416.07,4092.84,3260.34,-2957.25,-11744.36
1738495347381216256,2020-01,1171.56,3241.27,602.71,2717.16,-4184.16,-4184.16
1738495347381216256,2020-02,4485.32,2591.28,3002.88,2414.64,2482.28,-1701.88
1738495347381216256,2020-03,5130.21,1714.3,3517.52,1713.34,5220.09,3518.21
1738495347381216256,2020-04,4117.95,1168.96,2859.23,1333.42,4474.8,7993.01
1738495347381216256,2020-05,2993.95,0,0,3715.97,-722.02,7270.99
1738495347381216256,2020-06,1686.63,2802.18,1578.15,5057.27,-4594.67,2676.32
1738495347381216256,2020-07,1724.24,2677.74,1154.89,1782.62,-1581.23,1095.09
1738495347381216256,2020-08,6903.52,3152.18,1975.13,1452.64,4273.83,5368.92
1738495347381216256,2020-09,376.86,0,4194.16,0,4571.02,9939.94
1738495347381216256,2020-10,2107.02,1201.57,5261.53,3757.71,2409.27,12349.21
1738495347381216256,2020-11,1174.43,2558.37,5406.92,1290.98,2732,15081.21
1738495347381216256,2020-12,0,3940.01,3750.73,3772.3,-3961.58,11119.63
1739325909551416320,2020-01,0,828.1,3401.12,5480.55,-2907.53,-2907.53
1739325909551416320,2020-02,1296.34,376.76,5819.47,1187.48,5551.57,2644.04
1739325909551416320,2020-03,1776.94,800.51,1917.59,1223.38,1670.64,4314.68
1739325909551416320,2020-04,2044.68,2885.41,129.97,1399.23,-2109.99,2204.69
1739325909551416320,2020-05,3102.55,0,1617.42,0,4719.97,6924.66
1739325909551416320,2020-06,0,2648.94,1263.24,1186.42,-2572.12,4352.54
1739325909551416320,2020-07,5674.71,3306,2298.49,4132.74,534.46,4887
1739325909551416320,2020-08,3286.85,0,6795.48,0,10082.33,14969.33
1739325909551416320,2020-09,2593.77,0,688.11,3322.39,-40.51,14928.82
1739325909551416320,2020-10,0,2887.99,1852.06,4525.56,-5561.49,9367.33
1739325909551416320,2020-11,1269.45,4391.91,2736.73,2272.49,-2658.22,6709.11
1739325909551416320,2020-12,889,2114.81,440.88,0,-784.93,5924.18
1740610698981719808,2020-06,1656.19,0,0,0,1656.19,1656.19
1741337473134555392,2020-01,2976.46,3143.08,469.15,7920.25,-7617.72,-7617.72
1741337473134555392,2020-02,2956.07,2464.86,6313.7,2737.44,4067.47,-3550.25
1741337473134555392,2020-03,2811.96,1166.56,2568.47,611.87,3602,51.75
1741337473134555392,2020-04,4235.51,5977.48,1059.82,3511.1,-4193.25,-4141.5
1741337473134555392,2020-05,302.51,3694.72,3285.09,2797.36,-2904.48,-7045.98
1741337473134555392,2020-06,2154.68,107.56,3188.24,2887.33,2348.03,-4697.95
1741337473134555392,2020-07,0,3317.39,0,4839.61,-8157,-12854.95
1741337473134555392,2020-08,4243.99,2515.03,0,182.81,1546.15,-11308.8
1741337473134555392,2020-09,2774.93,2164.23,2386.56,3117.89,-120.63,-11429.43
1741337473134555392,2020-10,223.62,3520.17,1179.62,1631.37,-3748.3,-15177.73
1741337473134555392,2020-11,3122.13,0,107.82,277.95,2952,-12225.73
1741337473134555392,2020-12,617.38,0,1649.17,5009.15,-2742.6,-14968.33
1742057619137907200,2020-01,296.89,5888.97,4195.79,1579.86,-2976.15,-2976.15
1742057619137907200,2020-02,4890.72,3759.78,2338.43,2465.08,1004.29,-1971.86
1742057619137907200,2020-03,1735.5,4122.87,1762.73,117.73,-742.37,-2714.23
1742057619137907200,2020-04,747.26,2623.43,2306.39,2978.49,-2548.27,-5262.5
1742057619137907200,2020-05,0,3083.72,0,849.35,-3933.07,-9195.57
1742057619137907200,2020-06,6113.38,3861.95,1909.84,8316.62,-4155.35,-13350.92
1742057619137907200,2020-07,3980.46,3425.44,0,116.31,438.71,-12912.21
1742057619137907200,2020-08,289.55,2507.9,3267.02,1740.97,-692.3,-13604.51
1742057619137907200,2020-09,4087.85,557.15,2404.88,15.11,5920.47,-7684.04
1742057619137907200,2020-10,0,1228.53,592.09,3551.91,-4188.35,-11872.39
1742057619137907200,2020-11,5802.75,3940.8,133.59,3908.42,-1912.88,-13785.27
1742057619137907200,2020-12,799.09,4101.43,3742.89,1192.03,-751.48,-14536.75
1742619984864158720,2020-02,0,760.58,1850.28,0,1089.7,1089.7
1742619984864158720,2020-03,0,1255.12,0,0,-1255.12,-165.42
1742619984864158720,2020-04,1402.88,0,0,0,1402.88,1237.46
1742619984864158720,2020-06,1914.6,2465.79,902.17,0,350.98,1588.44
1742619984864158720,2020-07,587.33,801.13,0,2883.05,-3096.85,-1508.41
1742619984864158720,2020-08,1194.97,2311.64,418.83,0,-697.84,-2206.25
1742619984864158720,2020-09,0,1365.26,0,160.34,-1525.6,-3731.85
1742619984864158720,2020-11,1184.03,0,1201.69,1790.8,594.92,-3136.93
1743107719318469632,2020-01,4162.67,6319.51,4971.21,1775.48,1038.89,1038.89
1743107719318469632,2020-02,1750.19,4470.8,315.99,1864.1,-4268.72,-3229.83
1743107719318469632,2020-03,2722.04,1590.11,2760.14,4527.25,-635.18,-3865.01
1743107719318469632,2020-04,2079.54,6999.1,5055.64,4953.18,-4817.1,-8682.11
1743107719318469632,2020-05,134.32,1832.58,3816.37,1959.82,158.29,-8523.82
1743107719318469632,2020-06,2778.13,2098.63,2320.21,3083.08,-83.37,-8607.19
1743107719318469632,2020-07,2858.21,1811.55,1155.57,880,1322.23,-7284.96
1743107719318469632,2020-08,4185.76,298.08,2738.23,6187.8,438.11,-6846.85
1743107719318469632,2020-09,1019.35,1037.4,1156.96,3901.11,-2762.2,-9609.05
1743107719318469632,2020-10,3942.49,2700.17,3270.94,1087.58,3425.68,-6183.37
1743107719318469632,2020-11,9243.16,1694.75,308.76,3542.98,4314.19,-1869.18
1743681941292367360,2020-01,1371.66,4003.9,1830.21,4608.22,-5410.25,-5410.25
1743681941292367360,2020-02,2277.37,3170.55,3160,2593.53,-326.71,-5736.96
1743681941292367360,2020-03,5834.25,4844.79,7368.6,3642.88,4715.18,-1021.78
1743681941292367360,2020-04,5577.91,6975.64,2941.89,3049.53,-1505.37,-2527.15
1743681941292367360,2020-05,1729.77,1530.73,1676.62,4053.4,-2177.74,-4704.89
1743681941292367360,2020-06,6004.93,4630.41,2803.97,2072.49,2106,-2598.89
1743681941292367360,2020-07,2354.27,3582.97,8805.72,4179.8,3397.22,798.33
1743681941292367360,2020-08,6206.31,2004.87,4103.71,0,8305.15,9103.48
1743681941292367360,2020-09,2597.86,1761.06,2151.19,3599.71,-611.72,8491.76
1743681941292367360,2020-10,761.97,942.56,6480.47,3823.05,2476.83,10968.59
1743681941292367360,2020-11,803.61,5093.54,8511.29,3573.99,647.37,11615.96
1743681941292367360,2020-12,5876.5,3256.12,1793.42,4886.71,-472.91,11143.05
1743959794442165504,2020-01,8584.7,2920.95,7176.71,1709.65,11130.81,11130.81
1743959794442165504,2020-02,3897.56,5005.59,5960.4,2409.75,2442.62,13573.43
1743959794442165504,2020-03,3560.5,5929.42,2702.22,3284.2,-2950.9,10622.53
1743959794442165504,2020-04,5090.2,6931.53,3952.17,5382.74,-3271.9,7350.63
1743959794442165504,2020-05,3606.03,5949.72,1083.09,5966.9,-7227.5,123.13
1743959794442165504,2020-06,3222.68,7994.47,5280.26,3237.33,-2728.86,-2605.73
1743959794442165504,2020-07,11946.11,2247.84,836.5,2858.36,7676.41,5070.68
1743959794442165504,2020-08,3459.07,3806.65,9753.64,9748.01,-341.95,4728.73
1743959794442165504,2020-09,3389.44,5897.37,7843.54,3377.52,1958.09,6686.82
1743959794442165504,2020-10,1891.49,5744.21,3630.18,4871.25,-5093.79,1593.03
1743959794442165504,2020-11,2864.63,6727.82,5216.44,6014.16,-4660.91,-3067.88
1743959794442165504,2020-12,4119.88,1369.72,4787.14,8731.56,-1194.26,-4262.14
1744647349297827072,2020-01,4529.83,3740.56,1790.59,8021.2,-5441.34,-5441.34
1744647349297827072,2020-02,0,6616.74,3700.64,3834.62,-6750.72,-12192.06
1744647349297827072,2020-03,2779.11,548.49,1328.95,1855.06,1704.51,-10487.55
1744647349297827072,2020-04,5715.94,2508.22,4056.48,2406.38,4857.82,-5629.73
1744647349297827072,2020-05,3653.63,1568.68,10707.43,2482.96,10309.42,4679.69
1744647349297827072,2020-06,1403.28,4696.26,2776.39,7237.16,-7753.75,-3074.06
1744647349297827072,2020-07,4770.39,5281.68,4151.89,649.85,2990.75,-83.31
1744647349297827072,2020-08,11034.29,3085.31,4530.68,4288.75,8190.91,8107.6
1744647349297827072,2020-09,213.5,5937.08,717.63,5986.34,-10992.29,-2884.69
1744647349297827072,2020-10,521.67,2718.43,5238.1,4583.86,-1542.52,-4427.21
1744647349297827072,2020-11,0,4714.3,4231.09,2318.33,-2801.54,-7228.75
1744647349297827072,2020-12,3002.59,1280.14,625.15,1250.13,1097.47,-6131.28
1746680681193081600,2020-01,830.99,1382.33,1271.76,3317.66,-2597.24,-2597.24
1746680681193081600,2020-02,2732.71,321.01,5215.16,1428.91,6197.95,3600.71
1746680681193081600,2020-03,9800.25,3462.29,3942.87,6292.66,3988.17,7588.88
1746680681193081600,2020-04,1055.26,2275.57,4019.25,3278.63,-479.69,7109.19
1746680681193081600,2020-05,1300.21,4235.97,1579.45,7171.81,-8528.12,-1418.93
1746680681193081600,2020-06,4346.12,1102.52,4988.14,2860.07,5371.67,3952.74
1746680681193081600,2020-07,5649.52,1761.98,3098.5,672.58,6313.46,10266.2
1746680681193081600,2020-08,1933.25,2698.15,2144.44,2486.45,-1106.91,9159.29
1746680681193081600,2020-09,3176.21,5593.95,2501.31,1779.73,-1696.16,7463.13
1746680681193081600,2020-10,1888.07,2667.09,3917.94,4301.65,-1162.73,6300.4
1746680681193081600,2020-11,3784.59,1803.71,2832.92,1959.25,2854.55,9154.95
1746680681193081600,2020-12,3078.26,1884.06,3503.26,1314.05,3383.41,12538.36
1747520315229481472,2020-01,237.48,1571.89,2250.98,3275.64,-2359.07,-2359.07
1747520315229481472,2020-02,4055.98,2896.69,337.63,962.52,534.4,-1824.67
1747520315229481472,2020-03,1762.12,0,1316.89,1954.06,1124.95,-699.72
1747520315229481472,2020-04,1997.19,2227.95,0,1705.39,-1936.15,-2635.87
1747520315229481472,2020-05,7384.26,166.59,152.36,396.71,6973.32,4337.45
1747520315229481472,2020-06,6245.87,2936,451.13,1652.27,2108.73,6446.18
1747520315229481472,2020-07,0,1316.3,0,2445.72,-3762.02,2684.16
1747520315229481472,2020-08,6050.92,930.28,3819.73,2138.11,6802.26,9486.42
1747520315229481472,2020-09,1777.59,4476.52,0,387,-3085.93,6400.49
1747520315229481472,2020-10,1312.69,1426.16,806.14,547.41,145.26,6545.75
1747520315229481472,2020-11,0,1646.27,3690.38,2698.69,-654.58,5891.17
1748031407578715392,2020-01,1385.9,0,0,0,1385.9,1385.9
1748031407578715392,2020-02,0,158.38,0,1794.14,-1952.52,-566.62
1748031407578715392,2020-03,0,5189.92,0,412.4,-5602.32,-6168.94
1748031407578715392,2020-04,3238.76,0,1074.9,0,4313.66,-1855.28
1748031407578715392,2020-05,880.53,0,1591.31,1815.05,656.79,-1198.49
1748031407578715392,2020-06,2401.9,0,2009.03,135.58,4275.35,3076.86
1748031407578715392,2020-07,897.84,0,1546,562.92,1880.92,4957.78
1748031407578715392,2020-08,1884.61,212.67,220.74,0,1892.68,6850.46
1748031407578715392,2020-09,1496.82,0,3455.58,3602.39,1350.01,8200.47
1748031407578715392,2020-10,1250.51,1721.01,0,1776.6,-2247.1,5953.37
1748031407578715392,2020-11,1706.11,574.66,1160.55,0,2292,8245.37
1748031407578715392,2020-12,272.17,1286.8,0,2839.2,-3853.83,4391.54
1748247234062195200,2020-01,3645.64,6698.99,3151.19,3311.47,-3213.63,-3213.63
1748247234062195200,2020-02,1318.92,4093.78,2315.47,8511.39,-8970.78,-12184.41
1748247234062195200,2020-03,6499.77,1625.6,6178.56,6949.13,4103.6,-8080.81
1748247234062195200,2020-04,550.57,3914.56,6625.44,1948.32,1313.13,-6767.68
1748247234062195200,2020-05,0,2578.54,5416.32,5087.1,-2249.32,-9017
1748247234062195200,2020-06,3012.24,1720.34,3668.55,2296.4,2664.05,-6352.95
1748247234062195200,2020-07,6271.87,12264.83,5127.57,3694.4,-4559.79,-10912.74
1748247234062195200,2020-08,5293.56,1890.34,10354.23,4176.94,9580.51,-1332.23
1748247234062195200,2020-09,8288.74,5780.44,5896.22,7033.71,1370.81,38.58
1748247234062195200,2020-10,1207.99,3362.72,538.03,7836.59,-9453.29,-9414.71
1748247234062195200,2020-11,0,6269.15,1863.72,5700.7,-10106.13,-19520.84
1748247234062195200,2020-12,4634.5,3154.68,1642.54,4095.83,-973.47,-20494.31
1748716242679602944,2020-01,2890.85,1449.18,4059.99,4231.75,1269.91,1269.91
1748716242679602944,2020-02,477.56,3235.78,294.98,2507.22,-4970.46,-3700.55
1748716242679602944,2020-03,2767.54,1082.12,3424.98,5296.24,-185.84,-3886.39
1748716242679602944,2020-04,1646.08,188.21,3389.82,4513.48,334.21,-3552.18
1748716242679602944,2020-05,3332.58,258.04,3460.34,4707.74,1827.14,-1725.04
1748716242679602944,2020-06,1661.69,3374.6,106.18,1934.84,-3541.57,-5266.61
1748716242679602944,2020-07,1011.41,1259.21,1013.53,3297.95,-2532.22,-7798.83
1748716242679602944,2020-08,3777.87,1932.81,26.06,0,1871.12,-5927.71
1748716242679602944,2020-09,5963.9,3043.56,739.32,1706.62,1953.04,-3974.67
1748716242679602944,2020-10,5796.94,100.7,4742.73,626.3,9812.67,5838
1748716242679602944,2020-11,392.32,0,0,2368.91,-1976.59,3861.41
1748716242679602944,2020-12,2177.58,3576.19,6406.57,241.25,4766.71,8628.12
1750848909052664064,2020-01,1711.32,370.15,244.39,2945.12,-1359.56,-1359.56
1750848909052664064,2020-02,950.69,787.92,0,2039.34,-1876.57,-3236.13
1750848909052664064,2020-03,1958.04,3588.89,0,2266.29,-3897.14,-7133.27
1750848909052664064,2020-04,793.71,3199.3,1395.47,0,-1010.12,-8143.39
1750848909052664064,2020-05,3518.85,1319.08,2001.68,3049.32,1152.13,-6991.26
1750848909052664064,2020-06,379.19,1725.02,0,2202.62,-3548.45,-10539.71
1750848909052664064,2020-07,3119.96,2463.7,6105.88,1200.69,5561.45,-4978.26
1750848909052664064,2020-08,509.54,948.78,505.34,2406,-2339.9,-7318.16
1750848909052664064,2020-09,3423.9,2890.24,0,1383.53,-849.87,-8168.03
1750848909052664064,2020-10,2260.69,1855.58,1678.26,2200.37,-117,-8285.03
1750848909052664064,2020-11,3840.64,0,0,0,3840.64,-4444.39
1750848909052664064,2020-12,2627.51,0,2738.99,4723.97,642.53,-3801.86
1753655591116456960,2020-01,2033.19,3657.13,3717.77,3304.24,-1210.41,-1210.41
1753655591116456960,2020-02,1458.64,1012.89,1675.78,2800.64,-679.11,-1889.52
1753655591116456960,2020-03,1703.94,3047.17,0,1929.96,-3273.19,-5162.71
1753655591116456960,2020-04,1789.42,2340.48,893.99,0,342.93,-4819.78
1753655591116456960,2020-05,737.94,5063.43,2187.82,3198.39,-5336.06,-10155.84
1753655591116456960,2020-06,544.31,3781.64,2806.87,2543.04,-2973.5,-13129.34
1753655591116456960,2020-07,468.94,2098.9,5260.9,2577.34,1053.6,-12075.74
1753655591116456960,2020-08,5495.09,4787.21,1772.86,7062.48,-4581.74,-16657.48
1753655591116456960,2020-09,3479.9,5335.68,2783.98,3597.92,-2669.72,-19327.2
1753655591116456960,2020-10,4597.32,538.02,0,6349.65,-2290.35,-21617.55
1753655591116456960,2020-11,2569.44,5124.41,3412.08,209.34,647.77,-20969.78
1753655591116456960,2020-12,169.24,4643.05,1519.26,3378.06,-6332.61,-27302.39
1754115951623668224,2020-01,5239.41,4650.34,4723.81,2989.1,2323.78,2323.78
1754115951623668224,2020-02,4904.04,6022.87,5060.67,4256.06,-314.22,2009.56
1754115951623668224,2020-03,7592.31,3908.78,9359.19,11338.77,1703.95,3713.51
1754115951623668224,2020-04,11821.19,135.36,1704.67,4677.76,8712.74,12426.25
1754115951623668224,2020-05,373.02,4100.02,12578.58,6443.86,2407.72,14833.97
1754115951623668224,2020-06,8619.67,7052.82,4126.23,11112.78,-5419.7,9414.27
1754115951623668224,2020-07,3781.86,9413.26,635.13,5239.38,-10235.65,-821.38
1754115951623668224,2020-08,5986.05,2081.36,3156.55,4746.91,2314.33,1492.95
1754115951623668224,2020-09,6917,5122.03,5011.59,5958.88,847.68,2340.63
1754115951623668224,2020-10,5219.8,4653.78,2835.43,171.3,3230.15,5570.78
1754115951623668224,2020-11,2457.46,6024.44,6481.81,5810.6,-2895.77,2675.01
1754115951623668224,2020-12,3801.35,2705.44,4800.32,4249.06,1647.17,4322.18
1754131277713505792,2020-01,3293.48,8225.7,5434.06,7698.99,-7197.15,-7197.15
1754131277713505792,2020-02,5565.54,3135.36,3277.8,472.83,5235.15,-1962
1754131277713505792,2020-03,6643.55,10747.15,4632.61,4320.78,-3791.77,-5753.77
1754131277713505792,2020-04,2649.3,5706.8,744.41,3739.4,-6052.49,-11806.26
1754131277713505792,2020-05,144.37,2145.79,1409.76,4646.18,-5237.84,-17044.1
1754131277713505792,2020-06,7154.6,4577.55,0,1607.46,969.59,-16074.51
1754131277713505792,2020-07,1144.58,4509.7,9513.77,758.13,5390.52,-10683.99
1754131277713505792,2020-08,5339.41,5633.3,6357.17,2492.06,3571.22,-7112.77
1754131277713505792,2020-09,4224.31,5631.34,4174.28,5167.16,-2399.91,-9512.68
1754131277713505792,2020-10,6766.99,5734.28,7460.68,7494.84,998.55,-8514.13
1754131277713505792,2020-11,1879.37,10995.57,3020.9,8915.85,-15011.15,-23525.28
1754131277713505792,2020-12,7997.09,3345.74,7077.78,2177.73,9551.4,-13973.88
1755049896116571136,2020-01,586.37,0,1832.99,0,2419.36,2419.36
1755049896116571136,2020-03,237.7,0,1720.37,1228.83,729.24,3148.6
1755049896116571136,2020-04,1462.95,0,22.87,0,1485.82,4634.42
1755049896116571136,2020-05,1874.68,0,0,0,1874.68,6509.1
1755049896116571136,2020-06,0,457.93,0,0,-457.93,6051.17
1755049896116571136,2020-07,210.02,0,0,0,210.02,6261.19
1755049896116571136,2020-09,737.91,0,0,0,737.91,6999.1
1755049896116571136,2020-11,0,460.18,0,0,-460.18,6538.92
1755209879373216256,2020-01,5358.19,6102.34,4884.28,372.04,3768.09,3768.09
1755209879373216256,2020-02,6460.12,2578.35,2086.35,4417.05,1551.07,5319.16
1755209879373216256,2020-03,1955.26,1863.04,3576.08,2127.93,1540.37,6859.53
1755209879373216256,2020-04,2738.02,4095.21,3208.8,2844.38,-992.77,5866.76
1755209879373216256,2020-05,2337.05,3969.19,1762.05,3472.53,-3342.62,2524.14
1755209879373216256,2020-06,5863.44,5344.41,828.66,2543.07,-1195.38,1328.76
1755209879373216256,2020-07,1660.98,3200.55,4201.05,1727.11,934.37,2263.13
1755209879373216256,2020-08,2477.8,3646.95,8503.48,6016.32,1318.01,3581.14
1755209879373216256,2020-09,1206.67,0,6403.73,3013.69,4596.71,8177.85
1755209879373216256,2020-10,1941.35,2413.79,3643.57,2318.61,852.52,9030.37
1755209879373216256,2020-11,3351.97,8491.99,3919.32,4047.01,-5267.71,3762.66
1755209879373216256,2020-12,3720.85,1644.44,6219.22,2321.71,5973.92,9736.58
1755294718441232640,2020-01,4181.66,1225.77,10104.28,2056.06,11004.11,11004.11
1755294718441232640,2020-02,3760.99,5809.74,2654.5,631.63,-25.88,10978.23
1755294718441232640,2020-03,3209.04,3320.71,2348.67,5786.83,-3549.83,7428.4
1755294718441232640,2020-04,5165.8,2725.81,5411.72,5202.15,2649.56,10077.96
1755294718441232640,2020-05,984.31,2031.82,4080.12,5403.25,-2370.64,7707.32
1755294718441232640,2020-06,613.62,3469.43,1296.46,1474.73,-3034.08,4673.24
1755294718441232640,2020-07,6013.51,4334.79,8712.34,4161.3,6229.76,10903
1755294718441232640,2020-08,2687.4,834.95,3208.47,3806.99,1253.93,12156.93
1755294718441232640,2020-09,706.63,4605.57,3937.38,2192.8,-2154.36,10002.57
1755294718441232640,2020-10,2168.49,1919.83,5515.86,438.48,5326.04,15328.61
1755294718441232640,2020-11,0,1791.83,3394.34,2889.4,-1286.89,14041.72
1755294718441232640,2020-12,2130,3072.67,3038.03,4873.56,-2778.2,11263.52
1755527718336775168,2020-01,4104.18,3147.7,0,659.28,297.2,297.2
1755527718336775168,2020-02,7260.47,10947.47,854.59,4904.56,-7736.97,-7439.77
1755527718336775168,2020-03,430.08,6240.31,1912.66,5917.51,-9815.08,-17254.85
1755527718336775168,2020-04,2890.33,712.36,395.9,2785.48,-211.61,-17466.46
1755527718336775168,2020-05,5118.49,4128.72,3232.15,2819.56,1402.36,-16064.1
1755527718336775168,2020-06,1528.03,2474.36,1834.16,7694.36,-6806.53,-22870.63
1755527718336775168,2020-07,1127.1,5406.47,2606.94,3385.95,-5058.38,-27929.01
1755527718336775168,2020-08,2594.25,4378.78,1392.87,783.65,-1175.31,-29104.32
1755527718336775168,2020-09,2716.83,3720.68,3818.77,2371.92,443,-28661.32
1755527718336775168,2020-10,2180.56,4373.45,0,3632.94,-5825.83,-34487.15
1755527718336775168,2020-11,5108.8,1719.7,4676.35,2695.35,5370.1,-29117.05
1755527718336775168,2020-12,4770.46,626.53,753.56,6111.89,-1214.4,-30331.45
1755719736031012096,2020-01,993.21,4029.19,4536.68,3262.06,-1761.36,-1761.36
1755719736031012096,2020-02,1671.81,2628.73,3889.04,3051.48,-119.36,-1880.72
1755719736031012096,2020-03,2999.22,3216.96,4525.9,1357.14,2951.02,1070.3
1755719736031012096,2020-04,602.76,1259.02,7118.09,4275.66,2186.17,3256.47
1755719736031012096,2020-05,5425.06,1931.03,2820.3,116.98,6197.35,9453.82
1755719736031012096,2020-06,2340.92,2585.28,1989.32,2019.74,-274.78,9179.04
1755719736031012096,2020-07,4074.5,1934.82,3667.4,4584.73,1222.35,10401.39
1755719736031012096,2020-08,8459.1,4791.47,5573.19,3628.18,5612.64,16014.03
1755719736031012096,2020-09,2997.03,1946.41,3290.56,5134.26,-793.08,15220.95
1755719736031012096,2020-10,2376.04,6220.37,6579.2,4753.72,-2018.85,13202.1
1755719736031012096,2020-11,5209.54,6596.26,2104.36,336.11,381.53,13583.63
1755719736031012096,2020-12,2862.78,0,5760.01,208.65,8414.14,21997.77
1758283568065946368,2020-01,482.54,1717.55,710.57,2911.76,-3436.2,-3436.2
1758283568065946368,2020-02,991.61,0,1579.21,581.94,1988.88,-1447.32
1758283568065946368,2020-03,835.09,101.62,0,0,733.47,-713.85
1758283568065946368,2020-04,1644.37,376.59,125.27,1935.12,-542.07,-1255.92
1758283568065946368,2020-05,352.36,1267.95,1653.58,1651.32,-913.33,-2169.25
1758283568065946368,2020-06,3710.25,2300.77,478.6,0,1888.08,-281.17
1758283568065946368,2020-07,591.75,475.28,1776.39,0,1892.86,1611.69
1758283568065946368,2020-08,2244.46,1134.95,0,269.79,839.72,2451.41
1758283568065946368,2020-09,0,489.71,414.47,0,-75.24,2376.17
1758283568065946368,2020-10,0,339.03,1578.89,1764,-524.14,1852.03
1758283568065946368,2020-11,1083.05,3526.78,0,1330.78,-3774.51,-1922.48
1758397808882312448,2020-01,6454.2,1526.22,5811.39,11207.03,-467.66,-467.66
1758397808882312448,2020-02,8766.91,3318.94,0,2030.92,3417.05,2949.39
1758397808882312448,2020-03,6487.77,2761.93,2492.58,2917.84,3300.58,6249.97
1758397808882312448,2020-04,3655.46,966.4,2979,4633.12,1034.94,7284.91
1758397808882312448,2020-05,1563.86,7294.96,834.96,4019.29,-8915.43,-1630.52
1758397808882312448,2020-06,3439.39,1665.11,7966.76,8720.2,1020.84,-609.68
1758397808882312448,2020-07,4383.27,6088.34,5673.66,0,3968.59,3358.91
1758397808882312448,2020-08,1745.91,7920.08,1034.94,2428.03,-7567.26,-4208.35
1758397808882312448,2020-09,0,2997.41,1956.58,6885.97,-7926.8,-12135.15
1758397808882312448,2020-10,3358.89,2965.59,4620.21,4429.34,584.17,-11550.98
1758397808882312448,2020-11,1745.02,3821.36,3661.25,3480.23,-1895.32,-13446.3
1758397808882312448,2020-12,370.1,1867.53,2991.13,6280.85,-4787.15,-18233.45
1758807994521277696,2020-01,929.95,1334.08,0,0,-404.13,-404.13
1758807994521277696,2020-02,0,1162.59,1537.9,469.95,-94.64,-498.77
1758807994521277696,2020-03,267.71,3117.24,859.11,3047.72,-5038.14,-5536.91
1758807994521277696,2020-04,1754.68,2751.67,81.53,1608.98,-2524.44,-8061.35
1758807994521277696,2020-05,1994.06,1751.17,1624,989.65,877.24,-7184.11
1758807994521277696,2020-06,3268.15,0,1486.46,0,4754.61,-2429.5
1758807994521277696,2020-07,3917.95,2865.21,954.45,1940.25,66.94,-2362.56
1758807994521277696,2020-08,413.9,2444.59,0,3470.42,-5501.11,-7863.67
1758807994521277696,2020-09,2966.15,0,0,1402.52,1563.63,-6300.04
1758807994521277696,2020-10,2022.81,1994.83,3388.61,1891.7,1524.89,-4775.15
1758807994521277696,2020-11,2016.65,0,1448.52,1690.87,1774.3,-3000.85
1758807994521277696,2020-12,630.64,1435.08,0,1461.01,-2265.45,-5266.3
1759171070698684160,2020-01,2074.86,2739.71,0,0,-664.85,-664.85
1759171070698684160,2020-02,6274.51,5641.55,797.57,845.47,585.06,-79.79
1759171070698684160,2020-03,838.99,1630.72,1211.11,1952.06,-1532.68,-1612.47
1759171070698684160,2020-04,0,169.97,1258.25,0,1088.28,-524.19
1759171070698684160,2020-05,0,508.38,941.36,632.07,-199.09,-723.28
1759171070698684160,2020-06,1266.74,2891.66,0,700.62,-2325.54,-3048.82
1759171070698684160,2020-07,0,4350.15,1467.41,0,-2882.74,-5931.56
1759171070698684160,2020-08,597.75,682.49,1888.31,1861.91,-58.34,-5989.9
1759171070698684160,2020-09,1639.48,1684.49,2183.65,0,2138.64,-3851.26
1759171070698684160,2020-10,334.78,2687.51,218.63,237.55,-2371.65,-6222.91
1759171070698684160,2020-11,593.74,4589.12,2463.13,3652.55,-5184.8,-11407.71
1759171070698684160,2020-12,3816.6,1992.68,845.82,1070.46,1599.28,-9808.43
1759728273319568640,2020-01,2423.56,2921.37,1433.13,6843.46,-5908.14,-5908.14
1759728273319568640,2020-02,3692.21,4822.69,6701.49,2265.38,3305.63,-2602.51
1759728273319568640,2020-03,7771.81,4492.89,3394.78,2693.9,3979.8,1377.29
1759728273319568640,2020-04,2939.93,2224.12,6252.88,2312.38,4656.31,6033.6
1759728273319568640,2020-05,5704.09,5745.25,3154.16,5921.4,-2808.4,3225.2
1759728273319568640,2020-06,4378.6,3787.1,7678.95,8440.21,-169.76,3055.44
1759728273319568640,2020-07,3502.11,4176.53,4117.62,5392.02,-1948.82,1106.62
1759728273319568640,2020-08,6488.55,3885.62,6984.52,5845.22,3742.23,4848.85
1759728273319568640,2020-09,6408.48,7122.26,4914.39,5598.57,-1397.96,3450.89
1759728273319568640,2020-10,5042.46,7116.12,5745.09,5692.92,-2021.49,1429.4
1759728273319568640,2020-11,4231.15,3192.48,10199.63,4213.51,7024.79,8454.19
1759728273319568640,2020-12,3087.16,3866.23,5207.37,3770.49,657.81,9112
1760535883202685440,2020-01,2056.58,675.72,4352.57,5414.72,318.71,318.71
1760535883202685440,2020-02,6533.49,3387.83,3230.99,1674.93,4701.72,5020.43
1760535883202685440,2020-03,3933.37,2349.76,1815.38,3557.95,-158.96,4861.47
1760535883202685440,2020-04,1579.51,2372.47,4588.06,3949.06,-153.96,4707.51
1760535883202685440,2020-05,3415.84,775.16,0,4120.67,-1479.99,3227.52
1760535883202685440,2020-06,4354.15,1054.25,1047.28,884.27,3462.91,6690.43
1760535883202685440,2020-07,1121.1,4842.41,2113.69,0,-1607.62,5082.81
1760535883202685440,2020-08,2234.78,1556,3676.43,2156.51,2198.7,7281.51
1760535883202685440,2020-09,3566.27,447.47,3520.1,1810.31,4828.59,12110.1
1760535883202685440,2020-10,5374.34,307.19,886.53,3675.13,2278.55,14388.65
1760535883202685440,2020-11,4750.61,2683.18,3718.98,2486.51,3299.9,17688.55
1760535883202685440,2020-12,2987.58,853.79,1710.38,3169.85,674.32,18362.87
1760937913741533696,2020-01,1160.96,0,154.13,0,1315.09,1315.09
1760937913741533696,2020-03,1529.39,0,468.56,0,1997.95,3313.04
1760937913741533696,2020-05,1363.13,0,0,0,1363.13,4676.17
1760937913741533696,2020-09,705.09,327.05,0,0,378.04,5054.21
1760937913741533696,2020-12,1023.26,2347.82,0,0,-1324.56,3729.65
1762419973560762880,2020-01,678.26,1944.25,5175.22,160.55,3748.68,3748.68
1762419973560762880,2020-02,131.06,4131.41,3138.47,3728.12,-4590,-841.32
1762419973560762880,2020-03,0,2607.12,4724.7,1843.92,273.66,-567.66
1762419973560762880,2020-04,1353.51,3951.34,2294.63,5331.06,-5634.26,-6201.92
1762419973560762880,2020-05,3038.57,2606.89,1423.68,2947.05,-1091.69,-7293.61
1762419973560762880,2020-06,0,5048.85,0,1803.84,-6852.69,-14146.3
1762419973560762880,2020-07,5046.79,5141.57,1012.01,6212.32,-5295.09,-19441.39
1762419973560762880,2020-08,1859.44,3554,2271.61,4764.07,-4187.02,-23628.41
1762419973560762880,2020-09,4765.58,1643.06,2917.62,0,6040.14,-17588.27
1762419973560762880,2020-10,6218.77,1160.21,5601.26,5023.19,5636.63,-11951.64
1762419973560762880,2020-11,3279.27,1935.12,3046.27,2103.54,2286.88,-9664.76
1762419973560762880,2020-12,1573.28,2488.61,3276.03,1294.4,1066.3,-8598.46
1762747164268334080,2020-01,2321.18,67.93,1405.85,0,3659.1,3659.1
1762747164268334080,2020-02,2077.15,804.76,234.33,0,1506.72,5165.82
1762747164268334080,2020-03,1283.63,1938.89,0,0,-655.26,4510.56
1762747164268334080,2020-04,1563.98,0,2177.68,822.5,2919.16,7429.72
1762747164268334080,2020-05,1100.24,847.93,0,2159.15,-1906.84,5522.88
1762747164268334080,2020-06,0,1848.21,0,1424.69,-3272.9,2249.98
1762747164268334080,2020-07,1409.25,0,0,1635.57,-226.32,2023.66
1762747164268334080,2020-08,271.95,0,0,0,271.95,2295.61
1762747164268334080,2020-09,1233.33,0,257.16,0,1490.49,3786.1
1762747164268334080,2020-10,0,1525.45,2694.52,1825.01,-655.94,3130.16
1762747164268334080,2020-11,0,726.59,0,0,-726.59,2403.57
1763424800134423296,2020-01,0,2531.38,0,1901.12,-4432.5,-4432.5
1763424800134423296,2020-02,0,214.35,0,0,-214.35,-4646.85
1763424800134423296,2020-03,1769.61,854.58,0,0,915.03,-3731.82
1763424800134423296,2020-04,2590.71,0,4879.84,1076.95,6393.6,2661.78
1763424800134423296,2020-05,2762.3,3225.7,1860.86,1677.33,-279.87,2381.91
1763424800134423296,2020-06,1832.8,1330.26,0,2975.08,-2472.54,-90.63
1763424800134423296,2020-07,0,617.93,826.12,1084.07,-875.88,-966.51
1763424800134423296,2020-08,0,1061.55,2948.66,1682.19,204.92,-761.59
1763424800134423296,2020-10,0,818.14,1325.45,0,507.31,-254.28
1763424800134423296,2020-12,601.84,2310.31,0,1891.25,-3599.72,-3854
1763918304063438336,2020-05,1411.1,0,0,0,1411.1,1411.1
1765647532023913984,2020-01,521.8,1012.5,2835.03,1869.37,474.96,474.96
1765647532023913984,2020-02,1387.63,0,528.84,0,1916.47,2391.43
1765647532023913984,2020-03,2445.51,3038.14,1137.16,731.28,-186.75,2204.68
1765647532023913984,2020-04,955.14,4327.08,31.21,0,-3340.73,-1136.05
1765647532023913984,2020-05,3641.63,591.09,1871.64,2486.67,2435.51,1299.46
1765647532023913984,2020-06,2930.02,2851.07,1694.84,264.12,1509.67,2809.13
1765647532023913984,2020-07,3526.91,1354.7,2702.59,1778.38,3096.42,5905.55
1765647532023913984,2020-08,2704.26,537.64,2193.31,1855.57,2504.36,8409.91
1765647532023913984,2020-09,2455.68,3047.05,0,0,-591.37,7818.54
1765647532023913984,2020-10,0,1040.75,2153.37,1844.09,-731.47,7087.07
1765647532023913984,2020-11,2562.53,704.29,1730.53,1105.48,2483.29,9570.36
1765647532023913984,2020-12,770.81,0,1264.3,1977.54,57.57,9627.93
1765886428558445056,2020-01,5165.55,6848.2,3314.98,3058.59,-1426.26,-1426.26
1765886428558445056,2020-02,2732.76,7967.9,7612.36,4020.62,-1643.4,-3069.66
1765886428558445056,2020-03,6328.62,3760.57,2392.76,4724.05,236.76,-2832.9
1765886428558445056,2020-04,4321.62,2109.95,8897.3,4197.3,6911.67,4078.77
1765886428558445056,2020-05,8062.01,8596.11,2325.16,9329.51,-7538.45,-3459.68
1765886428558445056,2020-06,2191.63,4565.64,7694.04,4869.79,450.24,-3009.44
1765886428558445056,2020-07,2662.42,7887.85,7835.62,7255.13,-4644.94,-7654.38
1765886428558445056,2020-08,3158.85,11345.03,5508.23,4020.16,-6698.11,-14352.49
1765886428558445056,2020-09,7357.64,6159.93,2725.65,5045.92,-1122.56,-15475.05
1765886428558445056,2020-10,4397.47,4270.09,6313.59,844.4,5596.57,-9878.48
1765886428558445056,2020-11,10903.02,4302.84,272.63,6793.8,79.01,-9799.47
1765886428558445056,2020-12,0,1546.45,3653.07,2517.3,-410.68,-10210.15
1766735553364081152,2020-01,5150.4,2099.61,0,3682.51,-631.72,-631.72
1766735553364081152,2020-02,1528.97,180.31,1732.03,0,3080.69,2448.97
1766735553364081152,2020-03,832.66,3737.3,1117.77,2593.39,-4380.26,-1931.29
1766735553364081152,2020-05,4291.86,1674.19,6389.53,1153.6,7853.6,5922.31
1766735553364081152,2020-06,1356.91,1378.79,163.49,1518.24,-1376.63,4545.68
1766735553364081152,2020-07,2228.02,3705.31,1774.65,2927.9,-2630.54,1915.14
1766735553364081152,2020-08,1371.55,6664.09,1649.62,0,-3642.92,-1727.78
1766735553364081152,2020-10,1848.28,5423.22,1361.43,3222.9,-5436.41,-7164.19
1766735553364081152,2020-11,1314.28,0,5875.78,0,7190.06,25.87
1766735553364081152,2020-12,1212.09,0,3023.66,1170.69,3065.06,3090.93
1768655622738419712,2020-01,4861.19,5385.24,891.9,4456.27,-4088.42,-4088.42
1768655622738419712,2020-02,1795.96,2671.46,2029.04,0,1153.54,-2934.88
1768655622738419712,2020-03,841.08,4749.47,9146.74,3812.27,1426.08,-1508.8
1768655622738419712,2020-04,7025.58,8955.17,3469.28,4208.29,-2668.6,-4177.4
1768655622738419712,2020-05,3901.16,3336.92,5609.64,7044.12,-870.24,-5047.64
1768655622738419712,2020-06,4428.36,7940.82,3739.95,11194.74,-10967.25,-16014.89
1768655622738419712,2020-07,3357.46,6879.14,3780.81,7248.05,-6988.92,-23003.81
1768655622738419712,2020-08,7372.48,5824.72,9459.97,6957.33,4050.4,-18953.41
1768655622738419712,2020-09,4551.3,4708.98,5520.46,3270.79,2091.99,-16861.42
1768655622738419712,2020-10,7677.61,4567.11,2331.39,4171.33,1270.56,-15590.86
1768655622738419712,2020-11,1627.57,4408.2,1164.23,4654.79,-6271.19,-21862.05
1768655622738419712,2020-12,4387.24,5852.97,4854.79,3457.32,-68.26,-21930.31
1768815828991949824,2020-01,314.2,5812.4,0,1220.6,-6718.8,-6718.8
1768815828991949824,2020-02,115.71,793.72,262.49,63.52,-479.04,-7197.84
1768815828991949824,2020-03,128.25,457.96,1440.56,2628.96,-1518.11,-8715.95
1768815828991949824,2020-04,1742.44,1482.6,0,956.15,-696.31,-9412.26
1768815828991949824,2020-05,2075.33,4797.63,645,2683.39,-4760.69,-14172.95
1768815828991949824,2020-06,1124.34,975.2,1478.67,0,1627.81,-12545.14
1768815828991949824,2020-07,1620.05,1622.54,0,412.34,-414.83,-12959.97
1768815828991949824,2020-08,499.31,3558.82,0,0,-3059.51,-16019.48
1768815828991949824,2020-09,1178.42,1953.74,0,2977.29,-3752.61,-19772.09
1768815828991949824,2020-10,1244.97,962.45,0,1027.8,-745.28,-20517.37
1768815828991949824,2020-11,1206.44,0,1025.2,0,2231.64,-18285.73
1768815828991949824,2020-12,628.56,1583.97,1340.58,0,385.17,-17900.56
1769190276088097536,2020-01,651.48,1307.86,1684.16,3382.38,-2354.6,-2354.6
1769190276088097536,2020-02,4934.92,5793.97,2394.8,3549.25,-2013.5,-4368.1
1769190276088097536,2020-03,3700.45,5600.14,650.49,4092.9,-5342.1,-9710.2
1769190276088097536,2020-04,2365.84,3471.22,2501.71,1552.67,-156.34,-9866.54
1769190276088097536,2020-05,4185.46,2354.79,1430.68,1391.91,1869.44,-7997.1
1769190276088097536,2020-06,2389.71,1706.26,1957.92,2316.62,324.75,-7672.35
1769190276088097536,2020-07,3004.85,128.47,3439.5,1905.91,4409.97,-3262.38
1769190276088097536,2020-08,2199.17,2968.52,175.46,4861.77,-5455.66,-8718.04
1769190276088097536,2020-09,2693.93,0,1536.71,159.63,4071.01,-4647.03
1769190276088097536,2020-10,1345.1,4376.18,4993.36,1192.7,769.58,-3877.45
1769190276088097536,2020-11,5854.62,4524.07,1743.64,3113.46,-39.27,-3916.72
1769190276088097536,2020-12,2784.43,0,1097.89,2678.85,1203.47,-2713.25
1769368735038235136,2020-01,816.03,0,2310.57,2396.04,730.56,730.56
1769368735038235136,2020-02,2900.24,3600.12,1933.84,0,1233.96,1964.52
1769368735038235136,2020-03,2074.02,95.22,0,836.02,1142.78,3107.3
1769368735038235136,2020-04,1774.13,0,1488.75,1477.59,1785.29,4892.59
1769368735038235136,2020-05,0,682.15,0,400.9,-1083.05,3809.54
1769368735038235136,2020-06,847.76,3004.86,0,0,-2157.1,1652.44
1769368735038235136,2020-07,1416.67,1007.39,1998.72,1349.35,1058.65,2711.09
1769368735038235136,2020-09,0,4219.23,2613.53,0,-1605.7,1105.39
1769368735038235136,2020-10,1382.93,0,1215.27,584.75,2013.45,3118.84
1769368735038235136,2020-11,2309.52,0,3463.92,0,5773.44,8892.28
1769368735038235136,2020-12,0,1082.37,1093.16,3573.01,-3562.22,5330.06
1771575913546463232,2020-01,2247.92,1978.14,0,1696.06,-1426.28,-1426.28
1771575913546463232,2020-02,1768.34,521.3,0,253.69,993.35,-432.93
1771575913546463232,2020-03,1909.98,1662.44,0,2767.18,-2519.64,-2952.57
1771575913546463232,2020-04,1800.83,3407.11,2272.86,3459.82,-2793.24,-5745.81
1771575913546463232,2020-05,4208.96,1825.83,1987.29,10099.69,-5729.27,-11475.08
1771575913546463232,2020-06,98.54,2606.18,997.9,3230.61,-4740.35,-16215.43
1771575913546463232,2020-07,3198.55,2515.77,1060.13,7152.08,-5409.17,-21624.6
1771575913546463232,2020-08,8245.04,0,2726.38,1311.89,9659.53,-11965.07
1771575913546463232,2020-09,1586.1,0,3972.08,5836.88,-278.7,-12243.77
1771575913546463232,2020-10,5546.88,76.09,2669.85,669.43,7471.21,-4772.56
1771575913546463232,2020-11,0,515.26,2583,4299.6,-2231.86,-7004.42
1771575913546463232,2020-12,1805.92,3560.46,1155.37,4108.25,-4707.42,-11711.84
1772826018266408192,2020-01,3724.37,0,3172.44,0,6896.81,6896.81
1772826018266408192,2020-02,1456.24,4596.53,1973.16,2365.7,-3532.83,3363.98
1772826018266408192,2020-03,2210.48,1014.69,330.08,2038.33,-512.46,2851.52
1772826018266408192,2020-04,1486.07,5244.07,3462.19,4624.1,-4919.91,-2068.39
1772826018266408192,2020-05,861.64,8948.41,5405.56,741.69,-3422.9,-5491.29
1772826018266408192,2020-06,3291.83,3867.46,4023.57,599.62,2848.32,-2642.97
1772826018266408192,2020-07,4286.79,1377.07,3686.41,1623,4973.13,2330.16
1772826018266408192,2020-08,2044.54,4723.62,6563.75,3696.93,187.74,2517.9
1772826018266408192,2020-09,3755.74,2865.92,3473.29,3089.75,1273.36,3791.26
1772826018266408192,2020-10,3400.83,2806.57,3694.67,2174.73,2114.2,5905.46
1772826018266408192,2020-11,932.64,3175.78,4055.32,1781.66,30.52,5935.98
1772826018266408192,2020-12,2424.51,1335.05,2577.69,4215.71,-548.56,5387.42
1773172367794700288,2020-01,1359.96,653.36,5136.11,1038.59,4804.12,4804.12
1773172367794700288,2020-02,1551.73,0,1582.24,1849.18,1284.79,6088.91
1773172367794700288,2020-04,45.49,1855.1,868.86,2548.67,-3489.42,2599.49
1773172367794700288,2020-05,2826.27,481.47,3396.61,3064.27,2677.14,5276.63
1773172367794700288,2020-06,0,1523.15,3441.2,1082.94,835.11,6111.74
1773172367794700288,2020-07,524.1,1354.22,2270.56,1030.97,409.47,6521.21
1773172367794700288,2020-08,1843.26,2703.12,109.21,0,-750.65,5770.56
1773172367794700288,2020-09,2246.89,635.27,2859.85,430.54,4040.93,9811.49
1773172367794700288,2020-10,0,1282.45,0,0,-1282.45,8529.04
1773172367794700288,2020-11,1849.73,1952.8,1784.05,2999.35,-1318.37,7210.67
1773172367794700288,2020-12,1457.08,1486.33,1252.17,1054.81,168.11,7378.78
1773340765386551808,2020-01,655.8,6323.04,5620.87,6588.81,-6635.18,-6635.18
1773340765386551808,2020-02,3122.3,391.66,1986.83,7681.77,-2964.3,-9599.48
1773340765386551808,2020-03,5015.59,7377.73,3490.17,3011.91,-1883.88,-11483.36
1773340765386551808,2020-04,2844.87,5478.39,3789.15,1101.07,54.56,-11428.8
1773340765386551808,2020-05,3080.74,6632.58,5794.22,3934.93,-1692.55,-13121.35
1773340765386551808,2020-06,3654.76,6201.87,3501.05,3402.81,-2448.87,-15570.22
1773340765386551808,2020-07,2937.19,8689.02,2698.54,2900.88,-5954.17,-21524.39
1773340765386551808,2020-08,2172.87,6502.34,8026.11,3262.66,433.98,-21090.41
1773340765386551808,2020-09,3323.98,1875.74,4627.52,3090.09,2985.67,-18104.74
1773340765386551808,2020-10,7395.15,751.77,3542.9,4031.08,6155.2,-11949.54
1773340765386551808,2020-11,967.67,2629.62,612.02,3234.09,-4284.02,-16233.56
1773340765386551808,2020-12,5387.11,3079.98,3105.46,7114.45,-1701.86,-17935.42
1774901771851541760,2020-01,407.56,955.56,0,0,-548,-548
1774901771851541760,2020-02,0,2094.19,0,0,-2094.19,-2642.19
1774901771851541760,2020-09,1995.45,0,0,1196.59,798.86,-1843.33
1775336270397537280,2020-02,520.31,2880.57,89,1570.58,-3841.84,-3841.84
1775336270397537280,2020-03,2358.53,178.62,1607.95,392.41,3395.45,-446.39
1775336270397537280,2020-05,0,2386.51,7048.25,3102.14,1559.6,1113.21
1775336270397537280,2020-06,1321.67,0,3287.58,1935.87,2673.38,3786.59
1775336270397537280,2020-07,7550.64,3747.94,3585.82,0,7388.52,11175.11
1775336270397537280,2020-08,1791.81,3719.33,0,1420.58,-3348.1,7827.01
1775336270397537280,2020-09,457.86,2664.78,456.18,488.65,-2239.39,5587.62
1775336270397537280,2020-10,72.18,0,0,6780.03,-6707.85,-1120.23
1775336270397537280,2020-11,600.35,1527.31,186.27,3480.59,-4221.28,-5341.51
1775336270397537280,2020-12,2835.73,0,1365.77,4276.84,-75.34,-5416.85
1777340188857756672,2020-01,226.97,6988.65,11424.48,4533.18,129.62,129.62
1777340188857756672,2020-02,10493.55,2492.75,4382.14,7416.73,4966.21,5095.83
1777340188857756672,2020-03,1380.88,3542.92,2362.91,7031.7,-6830.83,-1735
1777340188857756672,2020-04,1993.29,5726.53,3961.21,2946.17,-2718.2,-4453.2
1777340188857756672,2020-05,13174.78,2402.52,1537.62,3628.43,8681.45,4228.25
1777340188857756672,2020-06,6177.18,4364.53,3630.79,4428.59,1014.85,5243.1
1777340188857756672,2020-07,1316.04,3253.93,2573.3,11683.69,-11048.28,-5805.18
1777340188857756672,2020-08,5675.33,6692.46,3878.53,1991.39,870.01,-4935.17
1777340188857756672,2020-09,6632.22,7717.28,4464.12,4675.55,-1296.49,-6231.66
1777340188857756672,2020-10,3486.82,1981.85,4938.34,233.48,6209.83,-21.83
1777340188857756672,2020-11,3594.11,1635.85,3844.52,3389.55,2413.23,2391.4
1777340188857756672,2020-12,2805.87,7010.21,3069.31,7729.26,-8864.29,-6472.89
1779605608609878784,2020-01,2885.61,3105.66,5177.51,10396.36,-5438.9,-5438.9
1779605608609878784,2020-02,1072.51,5496.02,1011.61,7756.07,-11167.97,-16606.87
1779605608609878784,2020-03,4084.02,4417.4,5658.59,6279.37,-954.16,-17561.03
1779605608609878784,2020-04,1133.11,3463.46,1441.71,4718.03,-5606.67,-23167.7
1779605608609878784,2020-05,1222.79,6905.74,4988.84,1185.94,-1880.05,-25047.75
1779605608609878784,2020-06,3061.14,2752.35,3538.12,3443.39,403.52,-24644.23
1779605608609878784,2020-07,5974.36,1833.01,3141.05,2056.42,5225.98,-19418.25
1779605608609878784,2020-08,6726.58,1803.58,8476.07,3194.75,10204.32,-9213.93
1779605608609878784,2020-09,5224.2,4372.01,10427.2,4467.52,6811.87,-2402.06
1779605608609878784,2020-10,5132.29,2510.49,4306.25,4705.86,2222.19,-179.87
1779605608609878784,2020-11,1903.22,1686.5,3485.99,4766.15,-1063.44,-1243.31
1779605608609878784,2020-12,6006.39,5011.94,3430.63,3243.66,1181.42,-61.89
1779939391076306944,2020-01,756.82,3012.76,1268.24,5104.08,-6091.78,-6091.78
1779939391076306944,2020-02,2899.46,419.78,1258.88,0,3738.56,-2353.22
1779939391076306944,2020-03,0,2589.72,432.29,1853.22,-4010.65,-6363.87
1779939391076306944,2020-04,1827.47,689.76,2742.29,1037.05,2842.95,-3520.92
1779939391076306944,2020-05,3365.67,1666.32,0,1136.98,562.37,-2958.55
1779939391076306944,2020-06,493.48,1611.22,2217.94,3601.16,-2500.96,-5459.51
1779939391076306944,2020-07,713,0,788.24,2718.3,-1217.06,-6676.57
1779939391076306944,2020-08,1843.43,0,137.2,0,1980.63,-4695.94
1779939391076306944,2020-09,480.55,925.84,1424.52,1364.55,-385.32,-5081.26
1779939391076306944,2020-10,230.23,4764.3,162,1103.93,-5476,-10557.26
1779939391076306944,2020-11,1879.2,877.23,0,853.05,148.92,-10408.34
1779939391076306944,2020-12,1266.29,689.35,1249.78,0,1826.72,-8581.62
1780566198283901184,2020-02,0,55.92,0,0,-55.92,-55.92
1780566198283901184,2020-05,0,1540.89,0,0,-1540.89,-1596.81
1780566198283901184,2020-10,0,217.15,0,0,-217.15,-1813.96
1783548250908075520,2020-01,1830.35,2321.99,4915.51,2713.52,1710.35,1710.35
1783548250908075520,2020-02,3433.12,659.55,1398.32,1982.01,2189.88,3900.23
1783548250908075520,2020-03,5962.42,11929.39,422.13,7324.23,-12869.07,-8968.84
1783548250908075520,2020-04,3483.11,2115.04,3547.32,5038.07,-122.68,-9091.52
1783548250908075520,2020-05,969.74,3201.39,4772.87,6290.96,-3749.74,-12841.26
1783548250908075520,2020-06,1577.05,2406.97,579.98,4927.55,-5177.49,-18018.75
1783548250908075520,2020-07,2564.31,4143.78,10474.57,1631.93,7263.17,-10755.58
1783548250908075520,2020-08,4079.9,10986.02,1379.6,2066.62,-7593.14,-18348.72
1783548250908075520,2020-09,2038.49,1781.12,4387.55,4612.96,31.96,-18316.76
1783548250908075520,2020-10,4261.06,2871.8,5449.54,2154.42,4684.38,-13632.38
1783548250908075520,2020-11,3136.4,8409.42,2388.24,4760.48,-7645.26,-21277.64
1783548250908075520,2020-12,1061.36,4817.69,4916.44,1857.06,-696.95,-21974.59
1783842966906637824,2020-01,1391.27,5128.68,1668.3,763.31,-2832.42,-2832.42
1783842966906637824,2020-02,1204.31,3404.25,1407.07,429.11,-1221.98,-4054.4
1783842966906637824,2020-03,3170.65,0,3123.31,1920.31,4373.65,319.25
1783842966906637824,2020-04,4321.6,1333.89,1887.91,0,4875.62,5194.87
1783842966906637824,2020-05,3371.11,3820.55,4572.94,127.1,3996.4,9191.27
1783842966906637824,2020-06,680.82,1429.39,3966.86,5561.66,-2343.37,6847.9
1783842966906637824,2020-07,2651.06,3083.12,6466.63,3761.11,2273.46,9121.36
1783842966906637824,2020-08,4245.08,1567.63,920.39,2132.08,1465.76,10587.12
1783842966906637824,2020-09,570.06,3104.73,12091.68,2930.86,6626.15,17213.27
1783842966906637824,2020-10,6049.22,3059.35,2656.6,1538.27,4108.2,21321.47
1783842966906637824,2020-11,2585.08,3186.06,324.17,29.42,-306.23,21015.24
1783842966906637824,2020-12,867.31,1512.77,2420.28,2997.2,-1222.38,19792.86
1784100577381891072,2020-08,1201.79,0,0,0,1201.79,1201.79
1784983368547723520,2020-05,0,704.64,0,0,-704.64,-704.64
1784983368547723520,2020-08,1895.29,0,0,0,1895.29,1190.65
1784983368547723520,2020-11,1038.42,0,0,0,1038.42,2229.07
1785774536660404736,2020-01,3152.86,398.08,3247.74,10296.42,-4293.9,-4293.9
1785774536660404736,2020-02,2574.23,1861.82,2494.57,1722.21,1484.77,-2809.13
1785774536660404736,2020-03,6884.35,1476.61,619.29,4562.38,1464.65,-1344.48
1785774536660404736,2020-04,6736.79,6235.56,3641.91,6881.61,-2738.47,-4082.95
1785774536660404736,2020-05,4449.96,1916.47,3663.33,538.46,5658.36,1575.41
1785774536660404736,2020-06,539.63,4076.83,6345.65,4306.84,-1498.39,77.02
1785774536660404736,2020-07,1905.77,5564.44,1793.81,525.85,-2390.71,-2313.69
1785774536660404736,2020-08,0,3143.58,3800.73,6432.97,-5775.82,-8089.51
1785774536660404736,2020-09,8312.46,5855.92,2595.27,5695.73,-643.92,-8733.43
1785774536660404736,2020-10,744.17,3165.95,915.4,5917.07,-7423.45,-16156.88
1785774536660404736,2020-11,3609.25,1982.27,4311.72,6715.39,-776.69,-16933.57
1785774536660404736,2020-12,1226.26,2247.84,3172.05,0,2150.47,-14783.1
1786082704493791488,2020-01,4219.42,5756.96,2136.2,3030.38,-2431.72,-2431.72
1786082704493791488,2020-02,842.77,0,2535.05,0,3377.82,946.1
1786082704493791488,2020-03,1299.94,938.42,0,2365.82,-2004.3,-1058.2
1786082704493791488,2020-04,3420.47,1198.13,7799.8,1052.56,8969.58,7911.38
1786082704493791488,2020-05,2617.98,68.92,1022.82,2886.92,684.96,8596.34
1786082704493791488,2020-06,1337.8,1009,2229.4,3111.32,-553.12,8043.22
1786082704493791488,2020-07,0,1716.78,5381.76,1378.8,2286.18,10329.4
1786082704493791488,2020-08,989.03,4935.02,0,1909.65,-5855.64,4473.76
1786082704493791488,2020-09,32.24,3887.34,1729.46,0,-2125.64,2348.12
1786082704493791488,2020-10,2937.62,95.08,507.01,243.74,3105.81,5453.93
1786082704493791488,2020-11,3521.71,3097.86,1047.07,3922.99,-2452.07,3001.86
1786082704493791488,2020-12,1713.52,1162.81,4290.18,0,4840.89,7842.75
1786945289768811008,2020-01,332.56,1644.69,2610.29,0,1298.16,1298.16
1786945289768811008,2020-02,1550.23,774.8,432.78,0,1208.21,2506.37
1786945289768811008,2020-03,2390.37,4065.55,5135.45,7126.41,-3666.14,-1159.77
1786945289768811008,2020-04,2677.99,2623.02,4753.74,3610.38,1198.33,38.56
1786945289768811008,2020-05,3158.36,2716.73,3460.26,2960.27,941.62,980.18
1786945289768811008,2020-06,2382.48,3694.61,838.79,0,-473.34,506.84
1786945289768811008,2020-07,1242.45,1176.58,533.37,915.06,-315.82,191.02
1786945289768811008,2020-08,1875.66,5184.57,827.31,1971.5,-4453.1,-4262.08
1786945289768811008,2020-09,3628.01,3328.45,2425.73,303.1,2422.19,-1839.89
1786945289768811008,2020-10,1754.32,0,0,918.6,835.72,-1004.17
1786945289768811008,2020-11,806.39,403.24,89.51,3437.66,-2945,-3949.17
1786945289768811008,2020-12,758.74,4266.26,5008.7,6537.36,-5036.18,-8985.35
1787807256815366656,2020-01,2756.6,2935.13,3766.45,2075.87,1512.05,1512.05
1787807256815366656,2020-02,512.91,5545.08,4763.58,770.79,-1039.38,472.67
1787807256815366656,2020-03,1593.68,795.83,523.39,431.3,889.94,1362.61
1787807256815366656,2020-04,555.27,0,3940.95,1567,2929.22,4291.83
1787807256815366656,2020-05,1215.81,2166.12,718.11,156.8,-389,3902.83
1787807256815366656,2020-06,2853.62,3440.19,5672.09,0,5085.52,8988.35
1787807256815366656,2020-07,3856.04,2951.99,1868.3,915.09,1857.26,10845.61
1787807256815366656,2020-08,2710.21,3544.34,1680.9,2764.45,-1917.68,8927.93
1787807256815366656,2020-09,1986.85,208.65,2847.59,501.08,4124.71,13052.64
1787807256815366656,2020-10,532.14,2863,626.34,3015.83,-4720.35,8332.29
1787807256815366656,2020-11,4600.92,1477.12,5664.07,0,8787.87,17120.16
1787807256815366656,2020-12,1011.04,4390.89,1308.44,3563.69,-5635.1,11485.06
1788427387434526720,2020-01,95.31,6184.52,4293.49,3078.62,-4874.34,-4874.34
1788427387434526720,2020-02,2036.14,5295.09,283.52,6036.63,-9012.06,-13886.4
1788427387434526720,2020-03,2177.41,4036.09,6132.61,1102.78,3171.15,-10715.25
1788427387434526720,2020-04,2402.11,3605.54,4708.36,3528.23,-23.3,-10738.55
1788427387434526720,2020-05,2087.64,3750.9,543.89,5291.41,-6410.78,-17149.33
1788427387434526720,2020-06,1260.76,169.27,730.51,2524.93,-702.93,-17852.26
1788427387434526720,2020-07,1711.76,2393.44,5082.76,2431.42,1969.66,-15882.6
1788427387434526720,2020-08,1314.78,3251.79,917.49,0,-1019.52,-16902.12
1788427387434526720,2020-09,1732,369.01,682.27,3437.88,-1392.62,-18294.74
1788427387434526720,2020-10,4537.14,3317.39,1260.05,6611.95,-4132.15,-22426.89
1788427387434526720,2020-11,2016.69,3434.02,1499.79,1592.84,-1510.38,-23937.27
1788427387434526720,2020-12,1680.84,3063.92,4556.72,2050.25,1123.39,-22813.88
1789505082597483776,2020-02,197.88,0,2020.69,0,2218.57,2218.57
1789505082597483776,2020-03,1971.42,590.05,2.82,1328.38,55.81,2274.38
1789505082597483776,2020-05,904.34,0,0,0,904.34,3178.72
1789505082597483776,2020-06,0,3158.54,1728.86,2484.56,-3914.24,-735.52
1789505082597483776,2020-07,808.01,1814.05,0,328.18,-1334.22,-2069.74
1789505082597483776,2020-10,4040.35,417.3,0,1833.78,1789.27,-280.47
1789505082597483776,2020-11,0,1318.65,0,0,-1318.65,-1599.12
1789505082597483776,2020-12,0,2345.51,0,627.21,-2972.72,-4571.84
1791632433330074880,2020-02,1864.28,0,0,3094.55,-1230.27,-1230.27
1791632433330074880,2020-03,949.77,0,1846.85,1560.31,1236.31,6.04
1791632433330074880,2020-04,0,115.51,0,0,-115.51,-109.47
1791632433330074880,2020-05,0,988.49,0,1981.03,-2969.52,-3078.99
1791632433330074880,2020-06,1188.06,0,718.19,0,1906.25,-1172.74
1791632433330074880,2020-07,55.22,0,0,0,55.22,-1117.52
1791632433330074880,2020-09,1541.21,0,1837.46,0,3378.67,2261.15
1791632433330074880,2020-11,403.22,0,0,0,403.22,2664.37
1791632433330074880,2020-12,0,393.21,328.83,0,-64.38,2599.99
1791903824555115008,2020-01,1913.67,1730.11,754.71,1638.78,-700.51,-700.51
1791903824555115008,2020-02,1663.58,339.03,0,1902.99,-578.44,-1278.95
1791903824555115008,2020-03,3154.91,1646.73,0,1151.52,356.66,-922.29
1791903824555115008,2020-04,0,2125.38,1426.38,0,-699,-1621.29
1791903824555115008,2020-05,0,1219.67,0,293.24,-1512.91,-3134.2
1791903824555115008,2020-06,1461,953.94,567.54,3937.96,-2863.36,-5997.56
1791903824555115008,2020-07,0,846.35,714.71,1899.29,-2030.93,-8028.49
1791903824555115008,2020-08,0,2147.4,1236.09,1224.05,-2135.36,-10163.85
1791903824555115008,2020-09,758.01,4973.77,0,3072.4,-7288.16,-17452.01
1791903824555115008,2020-10,2237.21,2572.51,5208.82,254.47,4619.05,-12832.96
1791903824555115008,2020-12,0,324.06,0,77.47,-401.53,-13234.49
1792756270225829632,2020-01,6026.99,6772.79,2603.9,4343.12,-2485.02,-2485.02
1792756270225829632,2020-02,5985.24,0,0,3376.74,2608.5,123.48
1792756270225829632,2020-03,2349.27,2039.62,2797.89,4691.77,-1584.23,-1460.75
1792756270225829632,2020-04,2725.6,1346.83,1712.44,443.25,2647.96,1187.21
1792756270225829632,2020-05,1993.03,3444.17,2337.18,2607.14,-1721.1,-533.89
1792756270225829632,2020-06,1203.02,1289.51,73.25,580.24,-593.48,-1127.37
1792756270225829632,2020-07,2477.06,1084.19,1653.49,3589.64,-543.28,-1670.65
1792756270225829632,2020-08,1487.66,2388.54,5671.29,2745.52,2024.89,354.24
1792756270225829632,2020-09,2364.73,147.91,2956.97,2661.81,2511.98,2866.22
1792756270225829632,2020-10,1102.51,6862.64,2959.59,8192.22,-10992.76,-8126.54
1792756270225829632,2020-11,148.24,31.29,602.59,0,719.54,-7407
1792756270225829632,2020-12,2077.83,1962.94,6472.55,345.94,6241.5,-1165.5
1792873767236052736,2020-01,225.1,4742.04,2959.8,4566.7,-6123.84,-6123.84
1792873767236052736,2020-02,2819.15,2668.45,5758.43,3953.96,1955.17,-4168.67
1792873767236052736,2020-03,2151.89,7909.14,2350.74,2320.7,-5727.21,-9895.88
1792873767236052736,2020-04,3995.43,7497.89,7785.6,1622.97,2660.17,-7235.71
1792873767236052736,2020-05,2378.14,7401.39,10687.09,5526.8,137.04,-7098.67
1792873767236052736,2020-06,4170.06,6738.05,4154.59,2669.18,-1082.58,-8181.25
1792873767236052736,2020-07,1725.62,7482.75,5396.12,5076.23,-5437.24,-13618.49
1792873767236052736,2020-08,8738.37,7056.66,5265.14,3307.7,3639.15,-9979.34
1792873767236052736,2020-09,2287.11,2958.8,6570.46,7851.36,-1952.59,-11931.93
1792873767236052736,2020-10,6429.51,1309,8030.88,8902.9,4248.49,-7683.44
1792873767236052736,2020-11,1726.95,3086.55,14749.99,3366.65,10023.74,2340.3
1792873767236052736,2020-12,6241.03,4807.02,7161.28,3297.2,5298.09,7638.39
1793862467001471744,2020-01,10236.42,9519.97,4439.86,6161.94,-1005.63,-1005.63
1793862467001471744,2020-02,6185.36,2766.42,5357.27,2246.81,6529.4,5523.77
1793862467001471744,2020-03,4159.36,0,4753.68,4486.35,4426.69,9950.46
1793862467001471744,2020-04,3368.77,3463.56,3418.54,3629.45,-305.7,9644.76
1793862467001471744,2020-05,3611.91,4386.6,3731.38,3793.88,-837.19,8807.57
1793862467001471744,2020-06,8585.69,4161.39,3989.2,8561.51,-148.01,8659.56
1793862467001471744,2020-07,5049.04,3241.99,9780.13,160.32,11426.86,20086.42
1793862467001471744,2020-08,4387.46,3474.63,4725.4,1044.91,4593.32,24679.74
1793862467001471744,2020-09,9938.76,3506.99,2460.42,4918.44,3973.75,28653.49
1793862467001471744,2020-10,9121.96,3088.48,1906.46,4849.4,3090.54,31744.03
1793862467001471744,2020-11,6549.17,6552.49,4056.2,5775.01,-1722.13,30021.9
1793862467001471744,2020-12,5027.52,3122.49,7517.43,3598.85,5823.61,35845.51
1794034668082080512,2020-01,1951.77,5120.9,1776.11,3080.35,-4473.37,-4473.37
1794034668082080512,2020-02,1893.67,1752,2905.07,6313.25,-3266.51,-7739.88
1794034668082080512,2020-03,10891.97,3390.36,2991.34,5008.3,5484.65,-2255.23
1794034668082080512,2020-04,4630.89,2727.88,5107.14,2967.86,4042.29,1787.06
1794034668082080512,2020-05,10567.36,7823.45,3731.89,7205.25,-729.45,1057.61
1794034668082080512,2020-06,2942.85,6762.8,4776.67,6031.11,-5074.39,-4016.78
1794034668082080512,2020-07,4637.59,1382.49,7042.95,4958.91,5339.14,1322.36
1794034668082080512,2020-08,6383.52,3738.89,6478.72,8223.45,899.9,2222.26
1794034668082080512,2020-09,4510.08,969.51,5968.53,7045.45,2463.65,4685.91
1794034668082080512,2020-10,3186.02,6659.93,4884.67,5081.1,-3670.34,1015.57
1794034668082080512,2020-11,756.51,4438.88,6071.74,1162.84,1226.53,2242.1
1794034668082080512,2020-12,6021.22,2674.59,2997.03,5095.84,1247.82,3489.92
1794210806834341632,2020-01,2269.69,1797.97,0,1998.08,-1526.36,-1526.36
1794210806834341632,2020-02,1763.68,1567.72,0,0,195.96,-1330.4
1794210806834341632,2020-03,0,913.05,6481.17,2135.08,3433.04,2102.64
1794210806834341632,2020-04,0,1965.53,1007.75,3738.6,-4696.38,-2593.74
1794210806834341632,2020-05,1022.29,775.69,1345.18,2333.7,-741.92,-3335.66
1794210806834341632,2020-06,3048.99,2764.49,2127.86,2548.96,-136.6,-3472.26
1794210806834341632,2020-07,0,4769.91,817.42,944.84,-4897.33,-8369.59
1794210806834341632,2020-08,2226.91,0,2138.22,1894.56,2470.57,-5899.02
1794210806834341632,2020-09,1315.7,0,1568.49,5313.9,-2429.71,-8328.73
1794210806834341632,2020-10,4544.5,271.99,0,2975.94,1296.57,-7032.16
1794210806834341632,2020-11,1276.68,1057.43,1620.96,1179.48,660.73,-6371.43
1794210806834341632,2020-12,3708.35,168.93,3520.63,3694.53,3365.52,-3005.91
1795222829867819264,2020-01,999.07,0,250.76,1808.98,-559.15,-559.15
1795222829867819264,2020-02,419.96,1932.88,2184.52,7144.19,-6472.59,-7031.74
1795222829867819264,2020-03,297.46,1784.72,1417.81,0,-69.45,-7101.19
1795222829867819264,2020-04,1374.81,1514.96,4251.94,2803.28,1308.51,-5792.68
1795222829867819264,2020-05,0,1466.25,1578.99,2712.95,-2600.21,-8392.89
1795222829867819264,2020-06,2326.06,1814.69,4496.24,3452.87,1554.74,-6838.15
1795222829867819264,2020-07,0,2609.06,3800.02,3702.55,-2511.59,-9349.74
1795222829867819264,2020-08,5143.82,1793.42,4729.61,3269.95,4810.06,-4539.68
1795222829867819264,2020-09,1851.52,3368.76,0,2342.61,-3859.85,-8399.53
1795222829867819264,2020-10,155.34,2472.9,1732.51,1688.16,-2273.21,-10672.74
1795222829867819264,2020-11,280.14,777.29,586.01,688.25,-599.39,-11272.13
1795222829867819264,2020-12,2315.3,2010,1079.04,930.15,454.19,-10817.94
1795390899105154048,2020-01,1020.17,0,0,1474.06,-453.89,-453.89
1795390899105154048,2020-02,330.86,0,0,260.53,70.33,-383.56
1795390899105154048,2020-03,1581.35,1154.88,1650.94,0,2077.41,1693.85
1795390899105154048,2020-04,0,144.01,1334.34,3940.49,-2750.16,-1056.31
1795390899105154048,2020-05,1657.07,0,0,0,1657.07,600.76
1795390899105154048,2020-06,0,371,1252.61,1470.99,-589.38,11.38
1795390899105154048,2020-08,1528.49,0,406.49,70.78,1864.2,1875.58
1795390899105154048,2020-09,2408.42,0,2194.31,0,4602.73,6478.31
1795390899105154048,2020-11,0,1877.46,544.11,435.6,-1768.95,4709.36
1796047019695740928,2020-01,2341.14,957.04,3796.19,4267.6,912.69,912.69
1796047019695740928,2020-02,1697.04,2507.22,2112.86,6790.36,-5487.68,-4574.99
1796047019695740928,2020-03,2615.34,3134.12,919.22,2642.07,-2241.63,-6816.62
1796047019695740928,2020-04,979.99,5179.63,1818.75,2489.05,-4869.94,-11686.56
1796047019695740928,2020-05,2390.68,612.71,2058.97,3242.13,594.81,-11091.75
1796047019695740928,2020-06,7952.99,3092.36,4385.35,3853.26,5392.72,-5699.03
1796047019695740928,2020-07,3986.89,1600.83,1766,5138,-985.94,-6684.97
1796047019695740928,2020-08,0,509.33,6382.98,3717.09,2156.56,-4528.41
1796047019695740928,2020-09,611.13,4209.95,6905.43,1215.47,2091.14,-2437.27
1796047019695740928,2020-10,776.4,2958.6,2944.87,4624.92,-3862.25,-6299.52
1796047019695740928,2020-11,5177.98,5157.08,1710.82,2120.15,-388.43,-6687.95
1796047019695740928,2020-12,5964.19,0,3604.84,6489.08,3079.95,-3608
1797522174506398464,2020-03,474.13,0,0,0,474.13,474.13
1797522174506398464,2020-05,0,383.69,0,0,-383.69,90.44
1797522174506398464,2020-06,0,1745.88,0,0,-1745.88,-1655.44
1797522174506398464,2020-08,0,916.57,0,0,-916.57,-2572.01
1798382214737520128,2020-01,2074.49,3392.78,3422.25,3529.72,-1425.76,-1425.76
1798382214737520128,2020-02,918.58,2465.58,1827.57,5344.98,-5064.41,-6490.17
1798382214737520128,2020-03,645.35,1158.04,1829.31,3304.9,-1988.28,-8478.45
1798382214737520128,2020-04,1265.84,2587.69,2304.01,2155.1,-1172.94,-9651.39
1798382214737520128,2020-05,2561.23,4363.11,2675.76,3668.24,-2794.36,-12445.75
1798382214737520128,2020-06,2400.6,2396.54,3349.08,1813,1540.14,-10905.61
1798382214737520128,2020-07,287.34,3631.57,2955.82,4544.71,-4933.12,-15838.73
1798382214737520128,2020-08,1912.34,1670.66,1752.74,1933.22,61.2,-15777.53
1798382214737520128,2020-09,1916.51,965.38,1412.75,1780.41,583.47,-15194.06
1798382214737520128,2020-11,0,5914.02,2659.41,0,-3254.61,-18448.67
1798382214737520128,2020-12,3103.74,0,2285.97,2374.38,3015.33,-15433.34
1799533662009272064,2020-05,1909.9,0,0,0,1909.9,1909.9
1799533662009272064,2020-06,797.74,0,0,0,797.74,2707.64
1799533662009272064,2020-07,0,1050.48,750.4,0,-300.08,2407.56
1799533662009272064,2020-08,0,1359.03,0,0,-1359.03,1048.53
1799533662009272064,2020-12,0,1794.3,0,0,-1794.3,-745.77
1802187590441074176,2020-02,417.69,1882.54,0,0,-1464.85,-1464.85
1802187590441074176,2020-04,0,1060.72,0,451.84,-1512.56,-2977.41
1802187590441074176,2020-05,3681.89,1664.52,1809.94,439.42,3387.89,410.48
1802187590441074176,2020-06,0,613.71,375.67,145.86,-383.9,26.58
1802187590441074176,2020-08,1629.12,0,0,0,1629.12,1655.7
1802187590441074176,2020-09,904.7,0,0,0,904.7,2560.4
1802187590441074176,2020-10,0,1993.74,0,0,-1993.74,566.66
1802187590441074176,2020-11,1250.29,1942.6,2362.22,0,1669.91,2236.57
1802402867300889088,2020-01,1438.47,2117.47,3083.18,5874.79,-3470.61,-3470.61
1802402867300889088,2020-02,2544.61,0,1850.28,5429.69,-1034.8,-4505.41
1802402867300889088,2020-03,1429.7,4284.48,6722.03,48.68,3818.57,-686.84
1802402867300889088,2020-04,2770,4423.58,2201.84,3893.22,-3344.96,-4031.8
1802402867300889088,2020-05,1349.86,6588.08,349.64,3660.51,-8549.09,-12580.89
1802402867300889088,2020-06,143.19,4700.64,4239.89,595.78,-913.34,-13494.23
1802402867300889088,2020-07,3491.58,2765.3,5152.03,4532.14,1346.17,-12148.06
1802402867300889088,2020-08,2407.78,5141.57,6469.65,3038.14,697.72,-11450.34
1802402867300889088,2020-09,6101.75,1188.31,2048.03,1796.54,5164.93,-6285.41
1802402867300889088,2020-10,2524.25,6462.84,4548.58,4048.25,-3438.26,-9723.67
1802402867300889088,2020-11,3929.51,6222.34,1963.95,1971.41,-2300.29,-12023.96
1802402867300889088,2020-12,2753.82,3409.16,3402.93,1518.32,1229.27,-10794.69
1802861372603037440,2020-03,260.94,0,0,10.68,250.26,250.26
1802861372603037440,2020-04,0,3442.27,0,693.16,-4135.43,-3885.17
1802861372603037440,2020-07,0,399.41,0,0,-399.41,-4284.58
1802861372603037440,2020-09,159.37,0,1430.82,0,1590.19,-2694.39
1802861372603037440,2020-10,80.98,0,0,0,80.98,-2613.41
1802861372603037440,2020-12,483.46,1141.87,1630.6,28.05,944.14,-1669.27
1803032889565436160,2020-01,2491.52,2785.5,4477.52,2072.84,2110.7,2110.7
1803032889565436160,2020-02,5616.86,3806.71,1783.23,4230.2,-636.82,1473.88
1803032889565436160,2020-03,4838.26,823.64,2154.22,5667.9,500.94,1974.82
1803032889565436160,2020-04,2494.18,3362.02,1595.58,4766.45,-4038.71,-2063.89
1803032889565436160,2020-05,3405.93,1627.02,4412.24,4274.49,1916.66,-147.23
1803032889565436160,2020-06,3947.12,2417.42,2277.32,3530.24,276.78,129.55
1803032889565436160,2020-07,6507.51,5262.94,3864.39,3195.07,1913.89,2043.44
1803032889565436160,2020-08,5903.24,5536.91,1787.8,3334.07,-1179.94,863.5
1803032889565436160,2020-09,4645.75,3933.29,3692.8,2739.9,1665.36,2528.86
1803032889565436160,2020-10,5062.12,3665.91,3833.78,9360.77,-4130.78,-1601.92
1803032889565436160,2020-11,3258.47,7853.52,7259.81,2515.94,148.82,-1453.1
1803032889565436160,2020-12,3248.99,3305.89,4882.79,2206.51,2619.38,1166.28
1803199239862204928,2020-01,192.86,5549.25,6435.79,7535.91,-6456.51,-6456.51
1803199239862204928,2020-02,5722.4,1839.75,6836.03,2076.79,8641.89,2185.38
1803199239862204928,2020-03,2471.13,3453.81,2824.32,4634.39,-2792.75,-607.37
1803199239862204928,2020-04,10438.36,2698.37,2645.08,3667.01,6718.06,6110.69
1803199239862204928,2020-05,1063.36,2559.22,7974.73,5044.65,1434.22,7544.91
1803199239862204928,2020-06,6057.19,3407.8,4890.13,5210.68,2328.84,9873.75
1803199239862204928,2020-07,1604.12,6758.26,8367.17,1896.95,1316.08,11189.83
1803199239862204928,2020-08,6100.09,2966.45,6436.88,3880.99,5689.53,16879.36
1803199239862204928,2020-09,6413.24,4362.31,2515.84,9215.85,-4649.08,12230.28
1803199239862204928,2020-10,1499.31,4299.6,3817.87,1867.14,-849.56,11380.72
1803199239862204928,2020-11,1815.9,1426.32,5306.99,1974.21,3722.36,15103.08
1803199239862204928,2020-12,4795.09,4653.93,2730.97,1431.46,1440.67,16543.75
1803505742421939712,2020-01,0,1690.46,0,1636.38,-3326.84,-3326.84
1803505742421939712,2020-02,765.79,399.29,0,0,366.5,-2960.34
1803505742421939712,2020-04,0,2408.18,0,0,-2408.18,-5368.52
1803505742421939712,2020-05,2098.47,1800.92,0,0,297.55,-5070.97
1803505742421939712,2020-06,637.12,1874.34,0,0,-1237.22,-6308.19
1803505742421939712,2020-07,0,647.96,252.89,1586.12,-1981.19,-8289.38
1803505742421939712,2020-08,0,1592,0,1743.81,-3335.81,-11625.19
1803505742421939712,2020-09,0,852.4,1666.21,0,813.81,-10811.38
1803505742421939712,2020-10,2047.53,425.29,0,0,1622.24,-9189.14
1803505742421939712,2020-11,0,1771.11,0,1228.91,-3000.02,-12189.16
1804519959182424832,2020-01,3207.4,1502.88,2692.35,5953.1,-1556.23,-1556.23
1804519959182424832,2020-02,3462.62,1859.74,3928.09,2063.39,3467.58,1911.35
1804519959182424832,2020-03,7186.61,1764.45,4035.48,1640.16,7817.48,9728.83
1804519959182424832,2020-04,2981,1361.82,3191.13,279.92,4530.39,14259.22
1804519959182424832,2020-05,3396.75,2458.77,799.34,5490,-3752.68,10506.54
1804519959182424832,2020-06,3170.87,1661.18,1984.56,6790.9,-3296.65,7209.89
1804519959182424832,2020-07,11071.82,2082.69,2026.3,3368.57,7646.86,14856.75
1804519959182424832,2020-08,3507.18,68.11,1938.54,4310.06,1067.55,15924.3
1804519959182424832,2020-09,9744.08,5241.49,1588.41,4944.67,1146.33,17070.63
1804519959182424832,2020-10,2974.47,4486.16,3362.24,973.2,877.35,17947.98
1804519959182424832,2020-11,2848.91,2611.09,1947.61,0,2185.43,20133.41
1804519959182424832,2020-12,2472.38,5009.74,1107.81,5811.08,-7240.63,12892.78
1807237531968230144,2020-01,5018.89,6544.74,2316.97,5235.24,-4444.12,-4444.12
1807237531968230144,2020-02,6483.96,2207.79,10787.72,1648.95,13414.94,8970.82
1807237531968230144,2020-03,6022.98,1473.58,2198.78,6690.26,57.92,9028.74
1807237531968230144,2020-04,8712.95,1371.29,5674.36,4909.94,8106.08,17134.82
1807237531968230144,2020-05,4362.94,5538.76,3701.64,2555.36,-29.54,17105.28
1807237531968230144,2020-06,8191.23,1598.97,2592.81,7144.9,2040.17,19145.45
1807237531968230144,2020-07,3545.57,3147.79,8442.44,2791.52,6048.7,25194.15
1807237531968230144,2020-08,6279.42,2069.53,6811.35,5232.79,5788.45,30982.6
1807237531968230144,2020-09,3248.43,4781.02,3681.54,4005.72,-1856.77,29125.83
1807237531968230144,2020-10,10655.04,1829.7,4109.3,0,12934.64,42060.47
1807237531968230144,2020-11,670.37,443.04,2904.3,4441.22,-1309.59,40750.88
1807237531968230144,2020-12,2332.91,5236.34,4812.7,2287.08,-377.81,40373.07
1807344973993044992,2020-01,2910.55,4728.9,811.99,2243.99,-3250.35,-3250.35
1807344973993044992,2020-02,2736.92,1567.59,2189.49,3207.37,151.45,-3098.9
1807344973993044992,2020-03,4899.56,3361.96,3195.59,2065.81,2667.38,-431.52
1807344973993044992,2020-04,1909.88,5144.81,2308.78,43.31,-969.46,-1400.98
1807344973993044992,2020-05,3077.14,4958.41,5493.63,3336.96,275.4,-1125.58
1807344973993044992,2020-06,47.82,908.91,0,376.39,-1237.48,-2363.06
1807344973993044992,2020-07,8563.67,2436.44,2639.98,3908.81,4858.4,2495.34
1807344973993044992,2020-08,5760.48,3761.54,3082.33,5330.3,-249.03,2246.31
1807344973993044992,2020-09,809.03,4769.43,6489.24,2440.1,88.74,2335.05
1807344973993044992,2020-10,6559.69,2469.35,2370.37,292.2,6168.51,8503.56
1807344973993044992,2020-11,2038.12,1836.05,35.72,5265.11,-5027.32,3476.24
1807344973993044992,2020-12,3102.73,3973.94,1513.47,4920.92,-4278.66,-802.42
1807449705873187328,2020-01,0,564.3,3221.2,0,2656.9,2656.9
1807449705873187328,2020-02,0,603.12,1860.32,3266.61,-2009.41,647.49
1807449705873187328,2020-03,0,573.15,1896.74,1764.15,-440.56,206.93
1807449705873187328,2020-05,1025.66,688.19,565.99,0,903.46,1110.39
1807449705873187328,2020-06,0,1359.18,2690.56,1378.54,-47.16,1063.23
1807449705873187328,2020-07,2363.02,3093.63,0,3195.15,-3925.76,-2862.53
1807449705873187328,2020-08,1014.82,986.45,0,3163.63,-3135.26,-5997.79
1807449705873187328,2020-09,2894.67,878.52,1326.8,326.53,3016.42,-2981.37
1807449705873187328,2020-10,0,2568.76,0,2160.87,-4729.63,-7711
1807449705873187328,2020-11,4333.06,4102.78,1144.18,514.48,859.98,-6851.02
1807449705873187328,2020-12,1211.22,959.51,2908.72,3873.11,-712.68,-7563.7
1810429809580685568,2020-01,3455.87,6521.29,6840.02,7452.72,-3678.12,-3678.12
1810429809580685568,2020-02,5454.16,7731.3,1779.42,4769.57,-5267.29,-8945.41
1810429809580685568,2020-03,1813.06,3521.06,1705.21,3581.02,-3583.81,-12529.22
1810429809580685568,2020-04,3499.77,4640.72,4136.05,5419.87,-2424.77,-14953.99
1810429809580685568,2020-05,6765.39,2697.34,2936.76,2936.97,4067.84,-10886.15
1810429809580685568,2020-06,1526.15,7265.99,7372.55,3760.18,-2127.47,-13013.62
1810429809580685568,2020-07,5097.45,4593.89,6289.63,3151.08,3642.11,-9371.51
1810429809580685568,2020-08,8005.1,6861.74,4776.41,6916.4,-996.63,-10368.14
1810429809580685568,2020-09,3685.07,3060.93,2803.54,6811.39,-3383.71,-13751.85
1810429809580685568,2020-10,3678.09,1909.3,6136.28,8245.54,-340.47,-14092.32
1810429809580685568,2020-11,8644.55,6340.12,5206.06,2593.3,4917.19,-9175.13
1810429809580685568,2020-12,2155.56,6560.54,3780.76,2365.13,-2989.35,-12164.48
1811045589643177472,2020-01,4145.9,5998.73,5116.53,1778.42,1485.28,1485.28
1811045589643177472,2020-02,1892.78,1432.47,1443.5,3438.91,-1535.1,-49.82
1811045589643177472,2020-03,2582.89,11759.21,5044.24,2190.1,-6322.18,-6372
1811045589643177472,2020-04,2236.38,1161.64,6597.21,4987.73,2684.22,-3687.78
1811045589643177472,2020-05,3817.04,3427.46,2144.08,5297.22,-2763.56,-6451.34
1811045589643177472,2020-06,955.42,2684.74,3576.51,3740.34,-1893.15,-8344.49
1811045589643177472,2020-07,1369.42,3485.29,3761.01,4525.52,-2880.38,-11224.87
1811045589643177472,2020-08,3369.06,5613.8,3039.79,7911.4,-7116.35,-18341.22
1811045589643177472,2020-09,4045.1,5494.61,9261.26,3007.44,4804.31,-13536.91
1811045589643177472,2020-10,7157.04,1922.3,4982.36,319.54,9897.56,-3639.35
1811045589643177472,2020-11,6503.35,1229.63,4107.55,3799.81,5581.46,1942.11
1811045589643177472,2020-12,3189.65,3492.33,486.55,5815.55,-5631.68,-3689.57
1812102629991344384,2020-01,2615.35,5186.8,8140.47,3752.51,1816.51,1816.51
1812102629991344384,2020-02,4968.38,3156.54,2141.62,5225.67,-1272.21,544.3
1812102629991344384,2020-03,9289.9,3773.99,4112.11,11289.64,-1661.62,-1117.32
1812102629991344384,2020-04,4031.85,3829.19,5662.29,7279.17,-1414.22,-2531.54
1812102629991344384,2020-05,6877.79,4469.41,3223.08,2460.09,3171.37,639.83
1812102629991344384,2020-06,3969.56,2062.95,6978.01,7537.88,1346.74,1986.57
1812102629991344384,2020-07,6469.5,4465.24,2964.37,6313.67,-1345.04,641.53
1812102629991344384,2020-08,4366.07,1917.02,5531.9,1955.67,6025.28,6666.81
1812102629991344384,2020-09,1792.38,4655.42,1290.56,4799.07,-6371.55,295.26
1812102629991344384,2020-10,4518.35,5502.52,4435.2,6011.94,-2560.91,-2265.65
1812102629991344384,2020-11,3374.82,7132.29,5856.58,2744.7,-645.59,-2911.24
1812102629991344384,2020-12,578.07,4039.53,2762.11,215.37,-914.72,-3825.96
1813457605860895488,2020-01,2270.76,1326.19,1526.57,3620.64,-1149.5,-1149.5
1813457605860895488,2020-02,4593.09,2961.44,3249.31,3810.65,1070.31,-79.19
1813457605860895488,2020-03,1817.22,1669.66,1626.48,0,1774.04,1694.85
1813457605860895488,2020-04,6302.43,3838.74,3729.63,3895.58,2297.74,3992.59
1813457605860895488,2020-05,7414.89,696.34,4347.93,3604.14,7462.34,11454.93
1813457605860895488,2020-06,2237.71,3073.03,3374.34,2471.14,67.88,11522.81
1813457605860895488,2020-07,1889.94,5583.84,5786.56,1541.74,550.92,12073.73
1813457605860895488,2020-08,3706.56,0,0,3894.48,-187.92,11885.81
1813457605860895488,2020-09,1778.04,6313.22,6404.29,2642.75,-773.64,11112.17
1813457605860895488,2020-10,4117.73,4950.7,3303.84,1671.91,798.96,11911.13
1813457605860895488,2020-11,3894.02,4105.9,1503.6,2314.8,-1023.08,10888.05
1813457605860895488,2020-12,0,5126.75,4451.57,0,-675.18,10212.87
1814360241823186688,2020-01,0,7441.01,4852.93,3097.07,-5685.15,-5685.15
1814360241823186688,2020-02,3118.7,7126.91,2911.35,2837.09,-3933.95,-9619.1
1814360241823186688,2020-03,8225.51,2138.29,2228,5674.6,2640.62,-6978.48
1814360241823186688,2020-04,6989.93,2444.81,1290.82,757.78,5078.16,-1900.32
1814360241823186688,2020-05,2444.55,309.27,5083.43,6064.99,1153.72,-746.6
1814360241823186688,2020-06,9322.14,8146.38,5419.04,5195.76,1399.04,652.44
1814360241823186688,2020-07,1784.91,4256.26,5660.01,5294.47,-2105.81,-1453.37
1814360241823186688,2020-08,1216.58,6273.9,7480.05,3976.96,-1554.23,-3007.6
1814360241823186688,2020-09,5314.32,1286.51,4492.61,2096.13,6424.29,3416.69
1814360241823186688,2020-10,1518.88,7561.74,3496.8,584.28,-3130.34,286.35
1814360241823186688,2020-11,25.94,0,2615.92,1689,952.86,1239.21
1814360241823186688,2020-12,1895.54,860.85,712.34,0,1747.03,2986.24
1814715577253248256,2020-01,13.76,0,0,394.14,-380.38,-380.38
1814715577253248256,2020-02,0,1580.98,1175.9,1668.18,-2073.26,-2453.64
1814715577253248256,2020-03,1485.13,0,1863.58,0,3348.71,895.07
1814715577253248256,2020-04,49.3,1072.78,1049.98,1700.42,-1673.92,-778.85
1814715577253248256,2020-05,0,418.29,1631.06,504.9,707.87,-70.98
1814715577253248256,2020-06,2391.63,0,2374.95,0,4766.58,4695.6
1814715577253248256,2020-07,580.1,1961.35,1575.88,0,194.63,4890.23
1814715577253248256,2020-09,465.02,4186.19,231.55,3452.48,-6942.1,-2051.87
1814715577253248256,2020-10,0,1865.83,0,1880.48,-3746.31,-5798.18
1814715577253248256,2020-11,156.72,816.23,960.59,2291.42,-1990.34,-7788.52
1814715577253248256,2020-12,0,700,0,837.17,-1537.17,-9325.69
1815265566417423104,2020-01,4019.12,0,1238.62,0,5257.74,5257.74
1815265566417423104,2020-02,1548.76,1356.14,989.21,2811.53,-1629.7,3628.04
1815265566417423104,2020-03,3635.86,5174.39,1913.31,5571.11,-5196.33,-1568.29
1815265566417423104,2020-04,622.2,5641.34,1634.38,2859.71,-6244.47,-7812.76
1815265566417423104,2020-05,3570.1,0,3293.4,6904.88,-41.38,-7854.14
1815265566417423104,2020-06,0,2657.14,3417.71,284.76,475.81,-7378.33
1815265566417423104,2020-07,4972.42,7203.5,5644.11,1552.53,1860.5,-5517.83
1815265566417423104,2020-09,4685.4,3679.46,2948.87,0,3954.81,-1563.02
1815265566417423104,2020-10,2670.66,369.37,2352.07,2920.59,1732.77,169.75
1815265566417423104,2020-11,3137.35,0,1352.17,2569.83,1919.69,2089.44
1815265566417423104,2020-12,2145,3545.67,2734.49,3917.85,-2584.03,-494.59
1815449859622905344,2020-01,2857.35,2814.41,3319.76,5250.94,-1888.24,-1888.24
1815449859622905344,2020-02,1847.83,4091.48,3008.42,1927.62,-1162.85,-3051.09
1815449859622905344,2020-03,2707.08,1483.05,2954.06,3301.8,876.29,-2174.8
1815449859622905344,2020-04,6284.83,4257.74,1794.96,2816.46,1005.59,-1169.21
1815449859622905344,2020-05,8060.68,3669.52,1810.54,3394.94,2806.76,1637.55
1815449859622905344,2020-06,5367.97,5407.48,3376.09,2319.57,1017.01,2654.56
1815449859622905344,2020-07,1841.5,4434.54,2096.66,10578.72,-11075.1,-8420.54
1815449859622905344,2020-08,2413.65,3070.41,5202.86,0,4546.1,-3874.44
1815449859622905344,2020-09,1266.08,597.99,0,2146.99,-1478.9,-5353.34
1815449859622905344,2020-10,4059.73,1794.67,3820.77,2688.64,3397.19,-1956.15
1815449859622905344,2020-11,5696.91,2663.87,5318.48,6160.85,2190.67,234.52
1815449859622905344,2020-12,1757.82,2104.21,2603.74,2795.46,-538.11,-303.59
1818351675824643328,2020-01,2080.26,5556.43,2386.06,8563.63,-9653.74,-9653.74
1818351675824643328,2020-02,4587.56,845.18,2968.68,1709.86,5001.2,-4652.54
1818351675824643328,2020-03,3693.83,3050.5,2703.02,1405.52,1940.83,-2711.71
1818351675824643328,2020-04,2721.99,0,1781.32,3198.42,1304.89,-1406.82
1818351675824643328,2020-05,2814.69,2186.41,1604.73,2200.39,32.62,-1374.2
1818351675824643328,2020-06,7683.18,5432.88,2822.89,1310.95,3762.24,2388.04
1818351675824643328,2020-07,0,3786.55,3903.16,2981.32,-2864.71,-476.67
1818351675824643328,2020-08,2633.41,2632.74,2812.54,0,2813.21,2336.54
1818351675824643328,2020-09,2588.74,3336.76,0,4457.93,-5205.95,-2869.41
1818351675824643328,2020-10,3118.06,1030.59,3228.64,2430.12,2885.99,16.58
1818351675824643328,2020-11,4581.15,5229.93,1631.4,3547.11,-2564.49,-2547.91
1818351675824643328,2020-12,7138.12,2877.4,797.91,2568.41,2490.22,-57.69
1818604086560825088,2020-01,1710.47,826.73,2396.71,1288.37,1992.08,1992.08
1818604086560825088,2020-02,1504.14,2164.51,1157.37,0,497,2489.08
1818604086560825088,2020-03,1322.92,2023.9,1691.1,0,990.12,3479.2
1818604086560825088,2020-04,250.72,0,1730.11,0,1980.83,5460.03
1818604086560825088,2020-05,641.56,3501.64,0,0,-2860.08,2599.95
1818604086560825088,2020-06,0,1858.77,1482.23,195.03,-571.57,2028.38
1818604086560825088,2020-07,0,1266.97,0,513.87,-1780.84,247.54
1818604086560825088,2020-08,174.08,0,2533.34,535.45,2171.97,2419.51
1818604086560825088,2020-09,949.29,830.46,1181.18,0,1300.01,3719.52
1818604086560825088,2020-10,2073.36,0,0,0,2073.36,5792.88
1818604086560825088,2020-11,1190.49,1471.62,5790.82,1468.71,4040.98,9833.86
1818604086560825088,2020-12,0,1052.48,140.73,402.61,-1314.36,8519.5
1818868432293790208,2020-01,4995.41,7357.82,1513.81,3477.25,-4325.85,-4325.85
1818868432293790208,2020-02,2645.39,2308.06,2167.45,1740,764.78,-3561.07
1818868432293790208,2020-03,6853.2,3362.66,2890.37,2191.88,4189.03,627.96
1818868432293790208,2020-04,2990.14,4745.01,5928.34,2350.72,1822.75,2450.71
1818868432293790208,2020-05,3175.06,5045.55,5658.46,8604.37,-4816.4,-2365.69
1818868432293790208,2020-06,3118.77,3582.89,1646.83,4964.31,-3781.6,-6147.29
1818868432293790208,2020-07,4683.1,5317.94,2907.13,5672.94,-3400.65,-9547.94
1818868432293790208,2020-08,2927.65,4535.29,7080.28,4482.81,989.83,-8558.11
1818868432293790208,2020-09,2421.67,4573.34,4727.86,2836.31,-260.12,-8818.23
1818868432293790208,2020-10,2883.5,3690.79,131.04,3306.82,-3983.07,-12801.3
1818868432293790208,2020-11,3570.95,4690.84,2524.39,0,1404.5,-11396.8
1818868432293790208,2020-12,9566.86,8327.54,4244.43,5213.22,270.53,-11126.27
1822512540386443264,2020-01,6865.7,1707.26,4250.94,5416.29,3993.09,3993.09
1822512540386443264,2020-02,8243.95,1377.34,6503.35,2187.31,11182.65,15175.74
1822512540386443264,2020-03,2356.9,4854.37,4393.86,1195.66,700.73,15876.47
1822512540386443264,2020-04,5286.11,5860.37,7869.85,2471.88,4823.71,20700.18
1822512540386443264,2020-05,5286.13,2590.73,9983.47,4801.31,7877.56,28577.74
1822512540386443264,2020-06,3952.89,6446.22,5539.69,1165.4,1880.96,30458.7
1822512540386443264,2020-07,4540.07,3900.91,5950.38,12504.89,-5915.35,24543.35
1822512540386443264,2020-08,3016.85,8186.8,7399.16,3907.62,-1678.41,22864.94
1822512540386443264,2020-09,3665.75,8127.54,6289.51,3979.46,-2151.74,20713.2
1822512540386443264,2020-10,5609.66,3004.11,3209.99,8512.51,-2696.97,18016.23
1822512540386443264,2020-11,4022.93,2954.32,6931.19,1972.56,6027.24,24043.47
1822512540386443264,2020-12,2783.7,2887.22,3953.91,4221.54,-371.15,23672.32
1822541511988021760,2020-01,3343.09,1897.39,6142.13,908.91,6678.92,6678.92
1822541511988021760,2020-02,1434.36,1534.18,1291.77,0,1191.95,7870.87
1822541511988021760,2020-03,2860.18,1745.13,1185.83,0,2300.88,10171.75
1822541511988021760,2020-04,1088.06,567.51,0,1864.74,-1344.19,8827.56
1822541511988021760,2020-05,0,2820.6,1038,126.57,-1909.17,6918.39
1822541511988021760,2020-06,0,1634.19,1883.95,4403.01,-4153.25,2765.14
1822541511988021760,2020-07,1739.37,0,274.26,3112.58,-1098.95,1666.19
1822541511988021760,2020-08,985.82,2686.03,0,477.77,-2177.98,-511.79
1822541511988021760,2020-09,1006.8,1627.7,1910.71,296.17,993.64,481.85
1822541511988021760,2020-10,1196.44,946.81,2147.86,608.32,1789.17,2271.02
1822541511988021760,2020-11,3713.52,1433.18,1520.53,395.43,3405.44,5676.46
1822541511988021760,2020-12,1199.25,177.72,3494.93,1146.77,3369.69,9046.15
1823813064563019520,2020-01,3725.29,940.56,7224.22,4440.22,5568.73,5568.73
1823813064563019520,2020-02,5439.57,3906.76,3350.45,5815.8,-932.54,4636.19
1823813064563019520,2020-03,8086.41,2968.84,5508.39,150.58,10475.38,15111.57
1823813064563019520,2020-04,2525.96,4602,5813.36,8200.53,-4463.21,10648.36
1823813064563019520,2020-05,4439.27,4158.71,1332.89,2492.78,-879.33,9769.03
1823813064563019520,2020-06,1976.83,2840.52,1798.66,2921.48,-1986.51,7782.52
1823813064563019520,2020-07,4148.42,1951.35,6305.28,5336.38,3165.97,10948.49
1823813064563019520,2020-08,3243.24,2811.47,1570.03,1004.3,997.5,11945.99
1823813064563019520,2020-09,4699.57,5802.79,1907.98,1849.65,-1044.89,10901.1
1823813064563019520,2020-10,6040.09,10337.07,5103.55,2279.56,-1472.99,9428.11
1823813064563019520,2020-11,9603.74,3647.18,5014.18,3211,7759.74,17187.85
1823813064563019520,2020-12,3661.68,2891.88,3919,4348.98,339.82,17527.67
1824516475887801088,2020-01,677.75,3010.5,3423.03,2266.24,-1175.96,-1175.96
1824516475887801088,2020-02,735.07,0,4166.34,0,4901.41,3725.45
1824516475887801088,2020-03,430.62,0,1094.45,0,1525.07,5250.52
1824516475887801088,2020-04,0,1100.9,1218.36,2264.87,-2147.41,3103.11
1824516475887801088,2020-05,1631.24,0,1327.03,0,2958.27,6061.38
1824516475887801088,2020-07,1723.07,635.08,0,3340.51,-2252.52,3808.86
1824516475887801088,2020-08,1190.2,2379.88,3617.41,0,2427.73,6236.59
1824516475887801088,2020-09,0,1435.08,1180,0,-255.08,5981.51
1824516475887801088,2020-10,2596.55,0,2834.23,0,5430.78,11412.29
1824516475887801088,2020-11,3449.88,4262.51,2774.38,2702.03,-740.28,10672.01
1824516475887801088,2020-12,3010.65,1838.36,0,2456.73,-1284.44,9387.57
1825006092083845376,2020-01,776.08,0,2346.05,0,3122.13,3122.13
1825006092083845376,2020-02,0,518.76,0,0,-518.76,2603.37
1825006092083845376,2020-03,1163.44,0,0,562.63,600.81,3204.18
1825006092083845376,2020-04,1950.14,243.69,396.48,0,2102.93,5307.11
1825006092083845376,2020-05,1212.08,2813.36,4567.79,2345.2,621.31,5928.42
1825006092083845376,2020-06,1152.57,0,0,928.91,223.66,6152.08
1825006092083845376,2020-07,1784.89,1769.45,1748.79,0,1764.23,7916.31
1825006092083845376,2020-08,0,1039.64,515.13,1208.52,-1733.03,6183.28
1825006092083845376,2020-09,1196.98,1878.25,1773.37,0,1092.1,7275.38
1825006092083845376,2020-10,0,3901.02,0,1072.7,-4973.72,2301.66
1825006092083845376,2020-11,1700.72,685.64,1415.07,446.2,1983.95,4285.61
1825006092083845376,2020-12,2199.23,443.44,4747.44,0,6503.23,10788.84
1825823009356839168,2020-01,9937.55,4116.28,3568.94,1457.62,7932.59,7932.59
1825823009356839168,2020-02,1336.98,6605.44,8040.85,0,2772.39,10704.98
1825823009356839168,2020-03,9183.37,2265.97,5998.97,3306.14,9610.23,20315.21
1825823009356839168,2020-04,10409.62,3214.33,5337.49,8862.81,3669.97,23985.18
1825823009356839168,2020-05,1279.29,7738.64,4877.02,2721.46,-4303.79,19681.39
1825823009356839168,2020-06,8437.18,1955.86,2808.74,4785.3,4504.76,24186.15
1825823009356839168,2020-07,6489.77,10729.04,681.55,2508.92,-6066.64,18119.51
1825823009356839168,2020-08,6114.55,1623.66,102.71,9443.92,-4850.32,13269.19
1825823009356839168,2020-09,6703.66,6466.1,2018.98,4063.96,-1807.42,11461.77
1825823009356839168,2020-10,8707.03,4155.12,3482.78,2169.49,5865.2,17326.97
1825823009356839168,2020-11,3900.05,3100.85,7596.32,2478.75,5916.77,23243.74
1825823009356839168,2020-12,5882.07,8415.07,938.36,7962.44,-9557.08,13686.66
1826611629850780416,2020-01,4011.38,5573.66,1921.66,4668.53,-4309.15,-4309.15
1826611629850780416,2020-02,2633.98,4460.5,1888.1,1238.18,-1176.6,-5485.75
1826611629850780416,2020-03,3331.08,3387.92,2943.96,3471.46,-584.34,-6070.09
1826611629850780416,2020-04,3709.23,1557.27,0,2615.12,-463.16,-6533.25
1826611629850780416,2020-05,3097.95,0,6999.59,2602.57,7494.97,961.72
1826611629850780416,2020-06,3903.16,3481.48,5500.74,5586.9,335.52,1297.24
1826611629850780416,2020-07,5457.55,1107.8,1244.49,5473.56,120.68,1417.92
1826611629850780416,2020-08,4001.72,5580.74,1910.12,2142.88,-1811.78,-393.86
1826611629850780416,2020-09,1658.39,869.51,3619.68,6206.62,-1798.06,-2191.92
1826611629850780416,2020-10,1469.53,3565.59,3454.93,8965.02,-7606.15,-9798.07
1826611629850780416,2020-11,6058.56,6584.74,3988.17,7579.72,-4117.73,-13915.8
1826611629850780416,2020-12,4567.33,0,3006.37,4200.52,3373.18,-10542.62
1828107135564716544,2020-01,6532.74,0,1328.84,2152.49,5709.09,5709.09
1828107135564716544,2020-02,1915.03,1582.7,1383.25,0,1715.58,7424.67
1828107135564716544,2020-03,1607.37,1427.07,1692.81,2701.32,-828.21,6596.46
1828107135564716544,2020-04,2573.25,0,1599.1,1040.17,3132.18,9728.64
1828107135564716544,2020-05,2474.97,2941.12,641.84,0,175.69,9904.33
1828107135564716544,2020-06,2963.24,4962.42,1762.99,2785.97,-3022.16,6882.17
1828107135564716544,2020-07,1757.92,1519.36,1377.48,1258.39,357.65,7239.82
1828107135564716544,2020-08,0,619.27,1552.89,37.92,895.7,8135.52
1828107135564716544,2020-09,3739.48,952.75,3308.11,1268.93,4825.91,12961.43
1828107135564716544,2020-10,3380.76,2954.05,3305.48,1464.15,2268.04,15229.47
1828107135564716544,2020-11,1931.81,2121.53,4640.07,1535.92,2914.43,18143.9
1828107135564716544,2020-12,1121.45,1611.8,991.93,2187.26,-1685.68,16458.22
1828193496422461184,2020-01,0,3340.13,2397.61,3754.11,-4696.63,-4696.63
1828193496422461184,2020-02,0,1551.35,5153.74,1463.08,2139.31,-2557.32
1828193496422461184,2020-03,1801.62,0,1616.97,2868.86,549.73,-2007.59
1828193496422461184,2020-04,4531.24,1356.88,1877.92,637.78,4414.5,2406.91
1828193496422461184,2020-05,5126.3,2424.76,0,736.53,1965.01,4371.92
1828193496422461184,2020-06,1059.33,762.29,2629.02,852.43,2073.63,6445.55
1828193496422461184,2020-08,1756.12,2164.41,212.1,1386.81,-1583,4862.55
1828193496422461184,2020-09,2127.21,1617.97,2479.16,0,2988.4,7850.95
1828193496422461184,2020-10,0,2952.08,2860.59,682.29,-773.78,7077.17
1828193496422461184,2020-11,0,2911.42,3262.4,5355.61,-5004.63,2072.54
1828193496422461184,2020-12,3496.85,685.34,2884.94,4517.32,1179.13,3251.67
1828203642474668800,2020-01,1455.97,6214.67,1671.42,1528.1,-4615.38,-4615.38
1828203642474668800,2020-02,709.6,3175.72,1406.91,6056.62,-7115.83,-11731.21
1828203642474668800,2020-03,6591.07,2580.7,95.01,1727.52,2377.86,-9353.35
1828203642474668800,2020-04,2828.68,947.4,2939.22,3288.34,1532.16,-7821.19
1828203642474668800,2020-05,3703.45,6612.71,986.95,7388.95,-9311.26,-17132.45
1828203642474668800,2020-06,5450.94,3891.78,3475.9,6042.49,-1007.43,-18139.88
1828203642474668800,2020-07,4017.88,0,4590.32,1504.39,7103.81,-11036.07
1828203642474668800,2020-08,2445.2,603.65,3169.75,7164.83,-2153.53,-13189.6
1828203642474668800,2020-09,4089.35,3880.69,1735.27,3920.14,-1976.21,-15165.81
1828203642474668800,2020-10,0,565.07,0,8949.09,-9514.16,-24679.97
1828203642474668800,2020-11,1246.16,2632.08,3893.62,1758.21,749.49,-23930.48
1828203642474668800,2020-12,3252.73,9317.47,5629.05,4705.15,-5140.84,-29071.32
1828741334767150080,2020-01,10353.07,3291.53,483.83,4163.84,3381.53,3381.53
1828741334767150080,2020-02,2885.54,7597.92,4553.78,3643.24,-3801.84,-420.31
1828741334767150080,2020-03,492.7,1241.02,4000.1,7405.11,-4153.33,-4573.64
1828741334767150080,2020-04,2614.54,2588.17,4428.28,652.92,3801.73,-771.91
1828741334767150080,2020-05,1116.47,6173.96,5121.17,8335.35,-8271.67,-9043.58
1828741334767150080,2020-06,2283.09,0,2707.23,10619.72,-5629.4,-14672.98
1828741334767150080,2020-07,5137.47,6969.74,4633.52,5755.51,-2954.26,-17627.24
1828741334767150080,2020-08,4661.84,3109.37,7151.85,1287.74,7416.58,-10210.66
1828741334767150080,2020-09,5321.94,2813.31,5737.52,3306.08,4940.07,-5270.59
1828741334767150080,2020-10,8013.52,1367.39,9065.54,2595.89,13115.78,7845.19
1828741334767150080,2020-11,2990.96,8465.77,4927.64,6248.11,-6795.28,1049.91
1828741334767150080,2020-12,2088.78,3949.02,7272.81,9381.48,-3968.91,-2919
1828753986840000256,2020-01,0,2243.87,3014.86,1095.86,-324.87,-324.87
1828753986840000256,2020-02,2555.38,848.52,3170.61,4250.63,626.84,301.97
1828753986840000256,2020-03,2063.24,3977.02,0,1549.31,-3463.09,-3161.12
1828753986840000256,2020-04,1782.46,1841.6,4061.7,3775.27,227.29,-2933.83
1828753986840000256,2020-05,2322.11,2747.07,0,4115.12,-4540.08,-7473.91
1828753986840000256,2020-06,2503.62,2926.32,3073.24,1353.58,1296.96,-6176.95
1828753986840000256,2020-07,0,1725.92,0,0,-1725.92,-7902.87
1828753986840000256,2020-08,3492.97,4233.43,2385.29,2822.67,-1177.84,-9080.71
1828753986840000256,2020-09,834.72,5532.79,3626.02,394.06,-1466.11,-10546.82
1828753986840000256,2020-10,0,1595.21,2438.02,5084.47,-4241.66,-14788.48
1828753986840000256,2020-11,295,0,737.75,1462.76,-430.01,-15218.49
1828753986840000256,2020-12,1331.93,2521.82,0,1076.66,-2266.55,-17485.04
1830126086486154496,2020-01,6782.72,72.66,1989.65,2310.79,6388.92,6388.92
1830126086486154496,2020-02,5128.08,3452.5,3464.02,7875.82,-2736.22,3652.7
1830126086486154496,2020-03,3249.7,1845.9,3065.55,3715.48,753.87,4406.57
1830126086486154496,2020-04,1439.69,5292.14,5416.49,3258.39,-1694.35,2712.22
1830126086486154496,2020-05,6233.43,3632.22,2362.87,2517.42,2446.66,5158.88
1830126086486154496,2020-06,4693.61,4108.1,2888.23,1428.03,2045.71,7204.59
1830126086486154496,2020-07,1828.68,1333.65,3679.85,4676.26,-501.38,6703.21
1830126086486154496,2020-08,8158.95,8782.97,3445.01,5027.13,-2206.14,4497.07
1830126086486154496,2020-09,4096.29,1713.44,1090.52,4444.09,-970.72,3526.35
1830126086486154496,2020-10,5135.75,1641.01,3584.4,4297.68,2781.46,6307.81
1830126086486154496,2020-11,2320.75,5018.58,3559.87,2900.73,-2038.69,4269.12
1830126086486154496,2020-12,933.26,230.27,5857.8,10091.15,-3530.36,738.76
1830590364538761472,2020-01,76.95,0,0,1310.59,-1233.64,-1233.64
1830590364538761472,2020-02,1670.22,1728.71,268.25,0,209.76,-1023.88
1830590364538761472,2020-03,0,3111.99,0,298.87,-3410.86,-4434.74
1830590364538761472,2020-04,1896.51,2526.44,388.8,1773.48,-2014.61,-6449.35
1830590364538761472,2020-05,740.98,2627.2,464.76,1706.91,-3128.37,-9577.72
1830590364538761472,2020-07,0,2534.9,3077.86,486.6,56.36,-9521.36
1830590364538761472,2020-08,2284.97,0,3833.32,185.78,5932.51,-3588.85
1830590364538761472,2020-11,705.92,2583.63,852.64,0,-1025.07,-4613.92
1830872020874408704,2020-01,2691.28,4426.81,3266.68,2483.11,-951.96,-951.96
1830872020874408704,2020-02,10239.81,3125.88,8704.57,1337.16,14481.34,13529.38
1830872020874408704,2020-03,2322.83,3220.46,3791.02,5550.49,-2657.1,10872.28
1830872020874408704,2020-04,2828.62,908.69,889.43,2172.67,636.69,11508.97
1830872020874408704,2020-05,1863.31,6104.17,3580.92,604.86,-1264.8,10244.17
1830872020874408704,2020-06,6476.49,2290.13,5324.73,5211.24,4299.85,14544.02
1830872020874408704,2020-07,5000.67,4641.64,1877.29,9911.14,-7674.82,6869.2
1830872020874408704,2020-08,7157.67,4999.46,5195.76,5641.81,1712.16,8581.36
1830872020874408704,2020-09,4927.21,6493.2,3022.12,5998.35,-4542.22,4039.14
1830872020874408704,2020-10,4065.26,5691.67,6825.21,2206.4,2992.4,7031.54
1830872020874408704,2020-11,1844.5,7728.15,4552.66,3962.18,-5293.17,1738.37
1830872020874408704,2020-12,8575.92,2087.03,4630.04,11121.17,-2.24,1736.13
1830950928577913088,2020-01,3682.74,1436.2,3807.99,5551.25,503.28,503.28
1830950928577913088,2020-02,3410.51,3347.61,6935.28,1824.47,5173.71,5676.99
1830950928577913088,2020-03,3202.16,3383.78,2778.48,1877.34,719.52,6396.51
1830950928577913088,2020-04,2144.3,5182.03,6024.14,7021.86,-4035.45,2361.06
1830950928577913088,2020-05,2254.64,4274.18,693,2178.32,-3504.86,-1143.8
1830950928577913088,2020-06,4888.76,2501.69,1143.08,0,3530.15,2386.35
1830950928577913088,2020-07,4494.44,6995.95,2262.47,2088.79,-2327.83,58.52
1830950928577913088,2020-08,3756.73,2644.78,6084.6,1676,5520.55,5579.07
1830950928577913088,2020-09,2044.87,158.92,4595.5,837.65,5643.8,11222.87
1830950928577913088,2020-10,2290.77,4412.44,1352.94,8537.52,-9306.25,1916.62
1830950928577913088,2020-11,2954.54,3547.55,9211.54,4809.6,3808.93,5725.55
1830950928577913088,2020-12,1894.93,1140.28,7354.54,2449.57,5659.62,11385.17
1831024304979425280,2020-01,2041.01,4195.12,3610.17,3731.22,-2275.16,-2275.16
1831024304979425280,2020-02,2798.09,7934.87,2523.79,8918,-11530.99,-13806.15
1831024304979425280,2020-03,6022.63,5588.17,4432.07,3164.07,1702.46,-12103.69
1831024304979425280,2020-04,5452.92,3062.46,5352.35,3580.83,4161.98,-7941.71
1831024304979425280,2020-05,8351.6,11440.24,4145.15,3275.12,-2218.61,-10160.32
1831024304979425280,2020-06,8870.13,1881.73,4388.35,5772.46,5604.29,-4556.03
1831024304979425280,2020-07,1234.77,511.83,1777.02,7911.79,-5411.83,-9967.86
1831024304979425280,2020-08,5611.23,7170.33,10492.31,1692.37,7240.84,-2727.02
1831024304979425280,2020-09,4335.45,3331.24,9439.34,5204.21,5239.34,2512.32
1831024304979425280,2020-10,5151.79,6788.21,2422.99,2518.61,-1732.04,780.28
1831024304979425280,2020-11,5473.89,10862.23,3576.31,6688.02,-8500.05,-7719.77
1831024304979425280,2020-12,2789.47,7561.35,4732.68,3674.69,-3713.89,-11433.66
1832603120905500928,2020-01,55.35,2701.21,3831.12,4158.44,-2973.18,-2973.18
1832603120905500928,2020-02,6180.71,3826.01,2684,3356.78,1681.92,-1291.26
1832603120905500928,2020-03,3737.37,3853.37,12106.64,5049.56,6941.08,5649.82
1832603120905500928,2020-04,2778.58,3899.91,3353.64,4344.58,-2112.27,3537.55
1832603120905500928,2020-05,7087.77,2394.31,3726.84,5731.56,2688.74,6226.29
1832603120905500928,2020-06,6209.67,1809.83,726.86,5744.03,-617.33,5608.96
1832603120905500928,2020-07,5574.3,7242.38,3589.86,3732.27,-1810.49,3798.47
1832603120905500928,2020-08,3890.41,3037.46,9429.36,2922.25,7360.06,11158.53
1832603120905500928,2020-09,3968.27,3786.34,4159.68,6930.25,-2588.64,8569.89
1832603120905500928,2020-10,534.01,3232.38,3938.37,5582.25,-4342.25,4227.64
1832603120905500928,2020-11,2090.34,3555.7,3155.59,5926.74,-4236.51,-8.87
1832603120905500928,2020-12,6241.85,7015.08,5736.77,2740.62,2222.92,2214.05
1832819695800392960,2020-01,5651.81,6141.04,825.07,1274.98,-939.14,-939.14
1832819695800392960,2020-02,6212.23,4541.74,4788.27,8781.33,-2322.57,-3261.71
1832819695800392960,2020-03,4611.3,2094.9,5964.03,3020.12,5460.31,2198.6
1832819695800392960,2020-04,3870.87,8017.1,3498.07,2291.4,-2939.56,-740.96
1832819695800392960,2020-05,4113.61,8692.13,7627.67,1465.19,1583.96,843
1832819695800392960,2020-06,3300.66,8115.56,9483.24,1121.97,3546.37,4389.37
1832819695800392960,2020-07,6156.13,7802.16,3556.5,5425.1,-3514.63,874.74
1832819695800392960,2020-08,8107.93,5552.8,1647.5,5075.63,-873,1.74
1832819695800392960,2020-09,4477.06,4804.73,6164.59,2364.66,3472.26,3474
1832819695800392960,2020-10,7917.83,2837.83,3781.98,2180.13,6681.85,10155.85
1832819695800392960,2020-11,6345.8,8040.18,3680.37,1911.2,74.79,10230.64
1832819695800392960,2020-12,3675.58,6611.26,2139.97,3558.06,-4353.77,5876.87
1833176628314924288,2020-01,868.89,0,1185.7,0,2054.59,2054.59
1833176628314924288,2020-02,1155.24,0,2177.71,0,3332.95,5387.54
1833176628314924288,2020-06,0,1529.22,0,1402.13,-2931.35,2456.19
1833176628314924288,2020-10,2186.01,0,0,178.21,2007.8,4463.99
1833176628314924288,2020-12,0,458.43,0,0,-458.43,4005.56
1834399596203566592,2020-01,8220.72,3950.26,5391.14,2484.01,7177.59,7177.59
1834399596203566592,2020-02,473.28,5088.08,5423.67,5006.8,-4197.93,2979.66
1834399596203566592,2020-03,3666.03,3284.11,10085.65,1997.12,8470.45,11450.11
1834399596203566592,2020-04,3421.95,2145.27,9034.45,3106.6,7204.53,18654.64
1834399596203566592,2020-05,6933.95,3820.26,6966.27,2651.71,7428.25,26082.89
1834399596203566592,2020-06,3406.79,5853.95,2621.66,6275.75,-6101.25,19981.64
1834399596203566592,2020-07,7119.42,5769.79,8441.17,3306.98,6483.82,26465.46
1834399596203566592,2020-08,4053.19,4393.67,1365.41,4395.84,-3370.91,23094.55
1834399596203566592,2020-09,1713.52,5676.96,902.98,5504.4,-8564.86,14529.69
1834399596203566592,2020-10,1463.77,3555.38,3470.77,3657,-2277.84,12251.85
1834399596203566592,2020-11,3992.53,3577.92,3446.25,137.87,3722.99,15974.84
1834399596203566592,2020-12,5558.49,2217.5,787.64,3580.63,548,16522.84
1835001190203399680,2020-01,3551.95,0,5330.3,2366.73,6515.52,6515.52
1835001190203399680,2020-02,4599.75,3233.48,3159.36,1159.86,3365.77,9881.29
1835001190203399680,2020-03,1104.19,570.69,2262.09,322.72,2472.87,12354.16
1835001190203399680,2020-04,5628.84,767.72,660.9,3141.08,2380.94,14735.1
1835001190203399680,2020-05,8554.97,488.5,285.46,1452.39,6899.54,21634.64
1835001190203399680,2020-06,1987.94,721.93,0,46.65,1219.36,22854
1835001190203399680,2020-07,1442.72,783.46,2939.2,2793.88,804.58,23658.58
1835001190203399680,2020-08,3149.08,3371.41,1009.11,8830.65,-8043.87,15614.71
1835001190203399680,2020-09,3591.43,1393.98,1734.45,1745.24,2186.66,17801.37
1835001190203399680,2020-10,1845.33,2925.34,2316.22,1535.2,-298.99,17502.38
1835001190203399680,2020-11,1619.15,1980.14,688.42,3619.47,-3292.04,14210.34
1835001190203399680,2020-12,2101.08,3245.23,2127.58,2286.09,-1302.66,12907.68
1835186615617719552,2020-01,3199.06,4251.03,1297.49,1196.08,-950.56,-950.56
1835186615617719552,2020-02,700.8,1755.63,2312.14,1332.76,-75.45,-1026.01
1835186615617719552,2020-03,5417.3,2751.19,5447.36,8266.08,-152.61,-1178.62
1835186615617719552,2020-04,1591.88,2645.35,1660.84,3832.17,-3224.8,-4403.42
1835186615617719552,2020-05,2082.67,4291.96,1021.73,3147.74,-4335.3,-8738.72
1835186615617719552,2020-06,0,3804.26,5139.57,4185.27,-2849.96,-11588.68
1835186615617719552,2020-07,6787.92,3047.16,5499.32,3787.43,5452.65,-6136.03
1835186615617719552,2020-08,1278.22,5257.16,1739.56,2436.84,-4676.22,-10812.25
1835186615617719552,2020-09,2322.06,4767.63,3406.69,4863.52,-3902.4,-14714.65
1835186615617719552,2020-10,3937.77,1283.17,3689.28,8679.37,-2335.49,-17050.14
1835186615617719552,2020-11,1384.82,2184.19,659.88,926.37,-1065.86,-18116
1835186615617719552,2020-12,7331.4,3608.11,3189.4,1449.55,5463.14,-12652.86
1837392275080117504,2020-01,6347.21,4834.19,4696,4713.46,1495.56,1495.56
1837392275080117504,2020-02,706.84,5187.7,4472.52,5334.84,-5343.18,-3847.62
1837392275080117504,2020-03,5212.7,5952.32,5588.75,4387.87,461.26,-3386.36
1837392275080117504,2020-04,5213.27,1127.83,3228.97,2533.56,4780.85,1394.49
1837392275080117504,2020-05,1840.51,8148.84,4784.78,2180.86,-3704.41,-2309.92
1837392275080117504,2020-06,11920.73,1738.85,0,6864.57,3317.31,1007.39
1837392275080117504,2020-07,6232.8,1808.64,5157.45,6366.51,3215.1,4222.49
1837392275080117504,2020-08,2183.47,3497.54,5846.38,12353.02,-7820.71,-3598.22
1837392275080117504,2020-09,4077.18,5587.51,6245.47,3661.6,1073.54,-2524.68
1837392275080117504,2020-10,4483.49,2932.23,1284.36,5469.4,-2633.78,-5158.46
1837392275080117504,2020-11,4521.31,8281.32,2017.77,5412.33,-7154.57,-12313.03
1837392275080117504,2020-12,1713.56,1468.41,3781.96,6903.87,-2876.76,-15189.79
1838753309021235968,2020-01,2845.74,3826.69,6581.83,6286.71,-685.83,-685.83
1838753309021235968,2020-02,6467.03,2552.6,3702.65,3438.8,4178.28,3492.45
1838753309021235968,2020-03,2591.84,4173.25,1361.94,3580.44,-3799.91,-307.46
1838753309021235968,2020-04,6126.2,2312.64,5330.13,5437.03,3706.66,3399.2
1838753309021235968,2020-05,2408.34,4257.41,3081.11,6422.12,-5190.08,-1790.88
1838753309021235968,2020-06,804.87,8578.7,4855.66,6630.82,-9548.99,-11339.87
1838753309021235968,2020-07,1247.13,7528,4209.91,520.05,-2591.01,-13930.88
1838753309021235968,2020-08,10236.05,4072.53,4045.46,4436.1,5772.88,-8158
1838753309021235968,2020-09,5150.58,1499.91,9268.01,6545.29,6373.39,-1784.61
1838753309021235968,2020-10,9873.23,1036.98,7618.92,5571.02,10884.15,9099.54
1838753309021235968,2020-11,1494.93,3215.64,3169.93,3967.18,-2517.96,6581.58
1838753309021235968,2020-12,2180.01,3524.46,5763.59,2936.22,1482.92,8064.5
1840303494665242880,2020-01,2937.71,6783.33,3971.47,7960.86,-7835.01,-7835.01
1840303494665242880,2020-02,4162.03,2403.54,3802.08,1430.06,4130.51,-3704.5
1840303494665242880,2020-03,1563.19,2043.26,2177.26,0,1697.19,-2007.31
1840303494665242880,2020-04,1178.7,1066.05,306.99,948.26,-528.62,-2535.93
1840303494665242880,2020-05,4396.83,3373.16,5166.62,2109.3,4080.99,1545.06
1840303494665242880,2020-06,3498.54,4125.68,2086.51,1786.25,-326.88,1218.18
1840303494665242880,2020-07,4396.22,1358.29,5750.83,3529.86,5258.9,6477.08
1840303494665242880,2020-08,3779.86,3036.14,5690.31,1758.67,4675.36,11152.44
1840303494665242880,2020-09,548.69,4575.75,5333.18,2898.15,-1592.03,9560.41
1840303494665242880,2020-10,1493.49,2600.67,6522.59,4471.33,944.08,10504.49
1840303494665242880,2020-11,9434.1,2083.75,1225.79,945.52,7630.62,18135.11
1840303494665242880,2020-12,5499.91,1267.74,5819.34,8424.29,1627.22,19762.33
1840733965817317376,2020-01,4644.11,3350.57,0,334.4,959.14,959.14
1840733965817317376,2020-02,4565.03,1493.86,1077.36,1540.66,2607.87,3567.01
1840733965817317376,2020-04,5114.29,0,0,3704.88,1409.41,4976.42
1840733965817317376,2020-05,1114.43,2085.01,3913.07,2861.3,81.19,5057.61
1840733965817317376,2020-06,0,2390.82,1234.3,1489.82,-2646.34,2411.27
1840733965817317376,2020-07,235.01,1711.45,488.77,7072.36,-8060.03,-5648.76
1840733965817317376,2020-08,1991.49,1395.29,2345.93,4712.36,-1770.23,-7418.99
1840733965817317376,2020-09,3109.64,4090.45,3436.94,1614,842.13,-6576.86
1840733965817317376,2020-10,4927.25,3013.78,2509.26,2059.74,2362.99,-4213.87
1840733965817317376,2020-11,5482.8,3404.33,1238.73,4512.51,-1195.31,-5409.18
1840733965817317376,2020-12,1.61,0,4206.77,2207.16,2001.22,-3407.96
1841330645574374400,2020-01,2923.35,3509.75,5328.81,5051.6,-309.19,-309.19
1841330645574374400,2020-02,4002.06,9240.14,14301.73,4961.51,4102.14,3792.95
1841330645574374400,2020-03,4025.07,1573.19,5750.26,6014.44,2187.7,5980.65
1841330645574374400,2020-04,566.35,6633.08,8232.64,6587.65,-4421.74,1558.91
1841330645574374400,2020-05,4904.89,5928.16,3232.8,2808.25,-598.72,960.19
1841330645574374400,2020-06,6785.57,1075.47,1748.09,4639.18,2819.01,3779.2
1841330645574374400,2020-07,7270.96,5813.85,4063.5,4431.22,1089.39,4868.59
1841330645574374400,2020-08,0,7797.91,6880.86,1196.75,-2113.8,2754.79
1841330645574374400,2020-09,4061.69,5241.16,1998.1,7503.13,-6684.5,-3929.71
1841330645574374400,2020-10,925.35,3523.38,2150.92,5692.27,-6139.38,-10069.09
1841330645574374400,2020-11,2846.45,4169.56,7882.42,4365.91,2193.4,-7875.69
1841330645574374400,2020-12,4697.85,5662.16,3965.67,7262.77,-4261.41,-12137.1
1841588266574487296,2020-01,386.87,1491.23,2205.92,844.73,256.83,256.83
1841588266574487296,2020-02,4688.31,3834.5,1828.05,723,1958.86,2215.69
1841588266574487296,2020-03,891.43,4983.27,2151.34,2753.53,-4694.03,-2478.34
1841588266574487296,2020-04,6504.03,5895.77,1836.89,5365.11,-2919.96,-5398.3
1841588266574487296,2020-05,1738.88,3548.37,7304.57,5837.45,-342.37,-5740.67
1841588266574487296,2020-06,2417.06,2050.15,1385.55,1773.82,-21.36,-5762.03
1841588266574487296,2020-07,1808.81,2814.25,2436.74,0,1431.3,-4330.73
1841588266574487296,2020-08,716.14,2839.46,3700.9,5202.71,-3625.13,-7955.86
1841588266574487296,2020-09,625.63,1815.87,343.65,3326.22,-4172.81,-12128.67
1841588266574487296,2020-10,1644.49,3400.37,3598.02,2605.25,-763.11,-12891.78
1841588266574487296,2020-11,3845.41,2421.61,1123.1,2017.28,529.62,-12362.16
1841588266574487296,2020-12,0,3254.86,4483.54,3520.91,-2292.23,-14654.39
1841904585328310784,2020-01,2945.22,624.29,1598.26,0,3919.19,3919.19
1841904585328310784,2020-02,1662.64,696.42,3335.25,775.94,3525.53,7444.72
1841904585328310784,2020-03,593.01,2041.79,0,0,-1448.78,5995.94
1841904585328310784,2020-04,463.35,3046.56,1714.76,0,-868.45,5127.49
1841904585328310784,2020-05,1048.67,0,0,0,1048.67,6176.16
1841904585328310784,2020-06,0,6261.6,922.17,0,-5339.43,836.73
1841904585328310784,2020-07,247.49,2859.59,0,1447.3,-4059.4,-3222.67
1841904585328310784,2020-08,1017.17,310.21,2148.5,1502.17,1353.29,-1869.38
1841904585328310784,2020-09,826.25,434.39,2848.26,0,3240.12,1370.74
1841904585328310784,2020-10,1585.48,1719.73,0,2880.81,-3015.06,-1644.32
1841904585328310784,2020-12,1473.05,0,0,0,1473.05,-171.27
1843831895966926848,2020-01,1828.9,3732.66,3326.63,3374.44,-1951.57,-1951.57
1843831895966926848,2020-02,4753.57,2172.99,1567.94,4046.25,102.27,-1849.3
1843831895966926848,2020-03,4317.82,7542.63,1235.71,3839.47,-5828.57,-7677.87
1843831895966926848,2020-04,1051.82,2262.51,2317.68,796.16,310.83,-7367.04
1843831895966926848,2020-05,6478.39,2488.51,1945.6,1253.94,4681.54,-2685.5
1843831895966926848,2020-06,4717.53,7687.33,6.08,2506.81,-5470.53,-8156.03
1843831895966926848,2020-07,4677.74,4781.39,2449.76,6459.4,-4113.29,-12269.32
1843831895966926848,2020-08,1274.49,4428.85,1870.6,592.71,-1876.47,-14145.79
1843831895966926848,2020-09,2682.56,5946.73,2457.73,0,-806.44,-14952.23
1843831895966926848,2020-10,1380.42,1479.07,3819.14,2513.61,1206.88,-13745.35
1843831895966926848,2020-11,2041.87,5930.8,6979.58,1502.12,1588.53,-12156.82
1843831895966926848,2020-12,3828.01,2625.51,4983.28,200.06,5985.72,-6171.1
1843937473028967168,2020-01,4234.66,5109.76,5551.02,701.56,3974.36,3974.36
1843937473028967168,2020-02,3880,4758.18,5603.43,3643.46,1081.79,5056.15
1843937473028967168,2020-03,7444.53,0,4992.74,3208.64,9228.63,14284.78
1843937473028967168,2020-04,7179.04,2508.78,1407.3,3375.16,2702.4,16987.18
1843937473028967168,2020-05,2733.68,7266.22,2609.94,2583.56,-4506.16,12481.02
1843937473028967168,2020-06,493.61,3947.32,3385.28,1737.35,-1805.78,10675.24
1843937473028967168,2020-07,7361.5,2107.92,4295.94,4056.49,5493.03,16168.27
1843937473028967168,2020-08,7424.39,7946.3,7517.01,3689.39,3305.71,19473.98
1843937473028967168,2020-09,4127.51,2585.68,5220.65,5814.53,947.95,20421.93
1843937473028967168,2020-10,2611.69,3643.03,6424.92,4386.57,1007.01,21428.94
1843937473028967168,2020-11,6129.34,6808.49,5888.35,212.51,4996.69,26425.63
1843937473028967168,2020-12,8120.4,4407.21,5144.75,2041.98,6815.96,33241.59
1846090640579972608,2020-01,495.26,2396.63,4070.89,2303.52,-134,-134
1846090640579972608,2020-02,1437.87,1437.96,3105.22,3694.24,-589.11,-723.11
1846090640579972608,2020-03,3977.55,368.34,3461.7,6178.89,892.02,168.91
1846090640579972608,2020-04,3000.89,4703.3,5561.4,2628.85,1230.14,1399.05
1846090640579972608,2020-05,0,3112.47,5253.09,3896.89,-1756.27,-357.22
1846090640579972608,2020-06,2560.49,2034.61,4163.33,2017.53,2671.68,2314.46
1846090640579972608,2020-07,3221.14,0,2656.35,0,5877.49,8191.95
1846090640579972608,2020-08,1562.26,1983.32,498.39,4767.75,-4690.42,3501.53
1846090640579972608,2020-09,133.22,4671.17,1154.52,2796.2,-6179.63,-2678.1
1846090640579972608,2020-10,4783.1,6367.02,4319,3720.79,-985.71,-3663.81
1846090640579972608,2020-11,4755.67,4550.27,0,5443.75,-5238.35,-8902.16
1846090640579972608,2020-12,4964.68,293.19,5565.9,3609.05,6628.34,-2273.82
1846377350311209984,2020-01,1412.38,0,0,0,1412.38,1412.38
1846377350311209984,2020-03,1156.2,0,0,0,1156.2,2568.58
1846377350311209984,2020-04,387.57,413.05,664.93,2309.53,-1670.08,898.5
1846377350311209984,2020-08,666.7,0,0,3014.87,-2348.17,-1449.67
1846377350311209984,2020-12,230.55,0,1273.72,0,1504.27,54.6
1847199301860788992,2020-01,805.33,5601.3,3610.26,3692.82,-4878.53,-4878.53
1847199301860788992,2020-02,876.96,4574.21,1958.07,1787.65,-3526.83,-8405.36
1847199301860788992,2020-03,0,3479.63,5450.84,1010.28,960.93,-7444.43
1847199301860788992,2020-04,3474.91,3941.31,3622.52,0,3156.12,-4288.31
1847199301860788992,2020-05,4665.2,461.18,2762.77,6322.55,644.24,-3644.07
1847199301860788992,2020-06,2288.31,5015.7,0,4296.01,-7023.4,-10667.47
1847199301860788992,2020-07,1839.03,1533.79,2732.46,4290.78,-1253.08,-11920.55
1847199301860788992,2020-08,2649.13,4107.95,2371.16,4152.45,-3240.11,-15160.66
1847199301860788992,2020-09,722.04,1549.33,6505.64,5240.41,437.94,-14722.72
1847199301860788992,2020-10,3114.11,1806.73,5789.15,5790.91,1305.62,-13417.1
1847199301860788992,2020-11,3881.51,0,2402.88,4845.5,1438.89,-11978.21
1847199301860788992,2020-12,4852.79,2783.81,4354.89,2318.12,4105.75,-7872.46
1847271750210884608,2020-01,2112.94,5508.15,2424.14,12369.82,-13340.89,-13340.89
1847271750210884608,2020-02,9416.9,5429.01,5784.21,3160.37,6611.73,-6729.16
1847271750210884608,2020-03,1629.88,2210.87,182.71,2015.19,-2413.47,-9142.63
1847271750210884608,2020-04,1965.55,3403.07,0,6077.55,-7515.07,-16657.7
1847271750210884608,2020-05,3120.68,1939.92,1817.8,6461.38,-3462.82,-20120.52
1847271750210884608,2020-06,795.07,3850.66,2959.35,4878.77,-4975.01,-25095.53
1847271750210884608,2020-07,7038.57,4508.31,140.99,2569.63,101.62,-24993.91
1847271750210884608,2020-08,5897.47,1493.57,1243.63,896.55,4750.98,-20242.93
1847271750210884608,2020-09,1881.18,2570.02,986.92,3712.82,-3414.74,-23657.67
1847271750210884608,2020-10,4711.85,2227.36,9973.98,1361.2,11097.27,-12560.4
1847271750210884608,2020-11,4404.96,517.76,5402.19,4290,4999.39,-7561.01
1847271750210884608,2020-12,2894.4,7068.2,4404.61,4178.54,-3947.73,-11508.74
1847745078605213696,2020-01,4762.49,2756.56,3965.51,1937.09,4034.35,4034.35
1847745078605213696,2020-02,271.09,1362.23,1093.37,4350.06,-4347.83,-313.48
1847745078605213696,2020-03,3958.53,610.04,0,2378.98,969.51,656.03
1847745078605213696,2020-04,5229.7,1639.22,270.81,3835.48,25.81,681.84
1847745078605213696,2020-05,2379.65,3950.36,1969.23,3344.45,-2945.93,-2264.09
1847745078605213696,2020-06,1326.08,1290.52,0,1085.07,-1049.51,-3313.6
1847745078605213696,2020-07,2453.82,3207.12,2696.64,2119.79,-176.45,-3490.05
1847745078605213696,2020-08,1889.3,1455.88,3856.46,0,4289.88,799.83
1847745078605213696,2020-09,79.24,2152.85,0,1329.48,-3403.09,-2603.26
1847745078605213696,2020-10,3414.38,6232,712.58,1930.65,-4035.69,-6638.95
1847745078605213696,2020-11,4281.62,1962.54,1491.11,0,3810.19,-2828.76
1847745078605213696,2020-12,2659.84,5812.37,3921.36,3543.47,-2774.64,-5603.4
1848052712008400128,2020-01,6081.38,329.78,258.75,1474.66,4535.69,4535.69
1848052712008400128,2020-02,4128.06,3220.32,1751.83,143.98,2515.59,7051.28
1848052712008400128,2020-03,1315.05,1909.4,0,2595.43,-3189.78,3861.5
1848052712008400128,2020-04,6203.77,3438.28,0,141.36,2624.13,6485.63
1848052712008400128,2020-05,1935.02,1946.65,1587.66,2273.8,-697.77,5787.86
1848052712008400128,2020-06,0,2244.33,2298.85,146.94,-92.42,5695.44
1848052712008400128,2020-07,2823.17,1530.21,3444.83,1074.08,3663.71,9359.15
1848052712008400128,2020-08,0,800.95,4370.32,0,3569.37,12928.52
1848052712008400128,2020-09,1106.23,0,0,4856.61,-3750.38,9178.14
1848052712008400128,2020-10,3143.01,2709.84,772.58,2064.35,-858.6,8319.54
1848052712008400128,2020-11,1902.18,0,2286.05,4680.53,-492.3,7827.24
1848052712008400128,2020-12,2143.55,2941.17,116.49,4979.73,-5660.86,2166.38
1849248919381547776,2020-01,4449.36,5312.83,0,5704.85,-6568.32,-6568.32
1849248919381547776,2020-02,2201.33,2587.44,2256.6,4268.06,-2397.57,-8965.89
1849248919381547776,2020-03,2437.44,1325.73,0,6041.25,-4929.54,-13895.43
1849248919381547776,2020-04,5390.22,1271.49,825.86,6374.21,-1429.62,-15325.05
1849248919381547776,2020-05,3937.77,0,5836.37,2737.84,7036.3,-8288.75
1849248919381547776,2020-06,5215.43,2716.33,1022.76,3178.38,343.48,-7945.27
1849248919381547776,2020-07,1817.04,1232.79,0,701.81,-117.56,-8062.83
1849248919381547776,2020-08,2694.59,1883.89,5297.58,5004.63,1103.65,-6959.18
1849248919381547776,2020-09,3977.55,3492.66,3694.15,1883.95,2295.09,-4664.09
1849248919381547776,2020-10,3512.12,95.63,2114.32,4376.56,1154.25,-3509.84
1849248919381547776,2020-11,2894.95,538.47,2161.57,4236.02,282.03,-3227.81
1849248919381547776,2020-12,3250.35,4336.07,2952.02,2381.99,-515.69,-3743.5
1849686075603117568,2020-01,1240.7,3150.11,1975.7,5716.29,-5650,-5650
1849686075603117568,2020-02,1690.72,1984.57,6294.86,5401.23,599.78,-5050.22
1849686075603117568,2020-03,969.24,0,5205.38,2951.24,3223.38,-1826.84
1849686075603117568,2020-04,2986.8,2222.76,1842.1,1065.05,1541.09,-285.75
1849686075603117568,2020-05,4361.85,2246.93,7747.82,6533.49,3329.25,3043.5
1849686075603117568,2020-06,5303.33,2073.03,3471.09,817.42,5883.97,8927.47
1849686075603117568,2020-07,3623.39,1136.26,1005.2,1227.73,2264.6,11192.07
1849686075603117568,2020-08,4146.39,0,6707.86,4283.92,6570.33,17762.4
1849686075603117568,2020-09,2964.23,3037.62,1707.73,0,1634.34,19396.74
1849686075603117568,2020-10,2560.82,5381.07,1791.42,3655.26,-4684.09,14712.65
1849686075603117568,2020-11,4395,2065.45,1506.79,3698.33,138.01,14850.66
1849686075603117568,2020-12,1568.85,6924.41,1714.72,4093.42,-7734.26,7116.4
1850041151863770880,2020-01,5171.8,4745.56,6977.69,6669.44,734.49,734.49
1850041151863770880,2020-02,3887.02,5593.93,4596.09,1802.84,1086.34,1820.83
1850041151863770880,2020-03,519.01,3909.45,6996.54,3939.14,-333.04,1487.79
1850041151863770880,2020-04,6469.88,2543.26,0,2252.14,1674.48,3162.27
1850041151863770880,2020-05,12258.46,4010.22,3627.13,5981.09,5894.28,9056.55
1850041151863770880,2020-06,8078.33,8723.4,8086.74,2930.29,4511.38,13567.93
1850041151863770880,2020-07,1636.63,3718.4,862.55,3008.33,-4227.55,9340.38
1850041151863770880,2020-08,1768.16,5198.07,4336.79,781.24,125.64,9466.02
1850041151863770880,2020-09,2115.61,2480.23,8321.81,10765.5,-2808.31,6657.71
1850041151863770880,2020-10,5875.05,6732,2284.57,2560.07,-1132.45,5525.26
1850041151863770880,2020-11,5957.96,6086.69,5753.08,7604.43,-1980.08,3545.18
1850041151863770880,2020-12,3469.75,601.24,6262.42,3716.12,5414.81,8959.99
1850741418856069376,2020-01,1761.71,11488.76,8520.04,808.67,-2015.68,-2015.68
1850741418856069376,2020-02,3493.66,7081.83,1425.65,4485.62,-6648.14,-8663.82
1850741418856069376,2020-03,1189.25,5312.85,2326.75,7820.62,-9617.47,-18281.29
1850741418856069376,2020-04,1730.93,8201.07,1249.75,1585.79,-6806.18,-25087.47
1850741418856069376,2020-05,4372.5,0,4396.62,5430.01,3339.11,-21748.36
1850741418856069376,2020-06,3564.88,3111.16,2276.69,7670.85,-4940.44,-26688.8
1850741418856069376,2020-07,3061.83,3883.32,2133.8,6255.54,-4943.23,-31632.03
1850741418856069376,2020-08,5332.22,11554.41,1608.07,3331.68,-7945.8,-39577.83
1850741418856069376,2020-09,4984.43,6281.9,1481.84,845.07,-660.7,-40238.53
1850741418856069376,2020-10,5218.33,2971.72,3944.8,2045.54,4145.87,-36092.66
1850741418856069376,2020-11,7002.9,3271.19,3508.49,1496.68,5743.52,-30349.14
1850741418856069376,2020-12,2066.17,3082.57,8476.12,3851.58,3608.14,-26741
1851937866162789376,2020-01,2580.4,3443.77,5582.28,3190.23,1528.68,1528.68
1851937866162789376,2020-02,9596.62,3692.64,1451.27,1198.18,6157.07,7685.75
1851937866162789376,2020-03,5681.86,5003.75,2146.66,0,2824.77,10510.52
1851937866162789376,2020-04,4006.67,1621,1519.34,1676.05,2228.96,12739.48
1851937866162789376,2020-05,1171.91,2807.19,6054.58,2585.78,1833.52,14573
1851937866162789376,2020-06,0,1046.25,1177.62,2744.09,-2612.72,11960.28
1851937866162789376,2020-07,4799.47,3833.47,3855.84,4518.97,302.87,12263.15
1851937866162789376,2020-08,999.74,4316.15,3602.34,2380.22,-2094.29,10168.86
1851937866162789376,2020-09,6876.74,1745.09,5076.22,1487.66,8720.21,18889.07
1851937866162789376,2020-10,1865.57,0,2427.32,3759.39,533.5,19422.57
1851937866162789376,2020-11,5454.27,2789.56,0,1074.12,1590.59,21013.16
1851937866162789376,2020-12,3508.12,2038.58,0,1249.57,219.97,21233.13
1853664499592411648,2020-01,6567.11,2258.53,4974.76,4072.81,5210.53,5210.53
1853664499592411648,2020-02,0,1635.35,720.65,1021.43,-1936.13,3274.4
1853664499592411648,2020-03,6880.5,0,1572.29,6223.71,2229.08,5503.48
1853664499592411648,2020-04,1197.71,5885.71,3730.7,1939.44,-2896.74,2606.74
1853664499592411648,2020-05,7801.24,2522.13,1856.17,5664.58,1470.7,4077.44
1853664499592411648,2020-06,2506.43,4191.38,2867.92,1635.48,-452.51,3624.93
1853664499592411648,2020-07,2920.68,2057.34,3332.23,2366.1,1829.47,5454.4
1853664499592411648,2020-08,950.82,3323.08,130.78,4720.13,-6961.61,-1507.21
1853664499592411648,2020-09,4708.9,4815.72,1299.24,5875.52,-4683.1,-6190.31
1853664499592411648,2020-10,0,7187.07,1601.52,2163.66,-7749.21,-13939.52
1853664499592411648,2020-11,3384.33,3532.22,3036.94,9734.67,-6845.62,-20785.14
1853664499592411648,2020-12,2605.19,3360.02,11096.43,0,10341.6,-10443.54
1854197243746714624,2020-01,854.73,717.28,3626.95,0,3764.4,3764.4
1854197243746714624,2020-02,1714.81,0,287.76,0,2002.57,5766.97
1854197243746714624,2020-04,201.92,2522.1,916.1,0,-1404.08,4362.89
1854197243746714624,2020-05,382.08,1157.06,0,1184.57,-1959.55,2403.34
1854197243746714624,2020-06,1331.85,2453.44,0,0,-1121.59,1281.75
1854197243746714624,2020-07,2996.24,0,0,973.37,2022.87,3304.62
1854197243746714624,2020-08,2087.01,0,71.14,0,2158.15,5462.77
1854197243746714624,2020-09,2619.39,2719.98,1759.12,101.4,1557.13,7019.9
1854197243746714624,2020-10,759.11,0,0,0,759.11,7779.01
1854197243746714624,2020-11,0,881.35,430.1,1867.63,-2318.88,5460.13
1854197243746714624,2020-12,867.33,1777.57,1480.84,0,570.6,6030.73
1855196587162173184,2020-01,3809.49,2947.14,1675.44,3876.31,-1338.52,-1338.52
1855196587162173184,2020-02,1429.23,3772.58,4887.85,3469.91,-925.41,-2263.93
1855196587162173184,2020-03,6530.83,3769.62,1824.72,1602.65,2983.28,719.35
1855196587162173184,2020-04,3437.02,5041.59,4686.54,1903.86,1178.11,1897.46
1855196587162173184,2020-05,394.2,3461.08,539.97,2103.32,-4630.23,-2732.77
1855196587162173184,2020-06,365.45,5628.85,3078.25,0,-2185.15,-4917.92
1855196587162173184,2020-07,2628.24,1263.6,2676.93,2428.29,1613.28,-3304.64
1855196587162173184,2020-08,969.53,3232.82,7147.76,5081.19,-196.72,-3501.36
1855196587162173184,2020-09,0,8646.21,2938.75,1920.14,-7627.6,-11128.96
1855196587162173184,2020-10,5285.12,1807.39,3804.69,3630.22,3652.2,-7476.76
1855196587162173184,2020-11,7228.7,7427.75,8354.71,3903.14,4252.52,-3224.24
1855196587162173184,2020-12,3314.17,6565.58,3376.4,262.54,-137.55,-3361.79
1855380598121641728,2020-01,792.09,1684.56,0,2849.86,-3742.33,-3742.33
1855380598121641728,2020-02,5596.1,3570.75,2143.81,0,4169.16,426.83
1855380598121641728,2020-03,0,872.68,461.92,2034.9,-2445.66,-2018.83
1855380598121641728,2020-04,0,7917.93,0,0,-7917.93,-9936.76
1855380598121641728,2020-05,1407.8,0,0,0,1407.8,-8528.96
1855380598121641728,2020-06,1764.64,220.52,0,755.97,788.15,-7740.81
1855380598121641728,2020-07,1445.66,858.72,0,0,586.94,-7153.87
1855380598121641728,2020-08,1982.06,1203.72,0,0,778.34,-6375.53
1855380598121641728,2020-09,1380.69,660.75,862.45,0,1582.39,-4793.14
1856021470130287872,2020-01,8488.79,3420.74,4618.79,2949.18,6737.66,6737.66
1856021470130287872,2020-02,8020.84,3023.82,2985.19,3117.66,4864.55,11602.21
1856021470130287872,2020-03,1162.12,7981.31,3416.71,3204.11,-6606.59,4995.62
1856021470130287872,2020-04,3944.62,595.03,11583.68,4263.25,10670.02,15665.64
1856021470130287872,2020-05,5737.68,3615.68,5267.52,0,7389.52,23055.16
1856021470130287872,2020-06,1805.17,2648.56,6116.81,1161.64,4111.78,27166.94
1856021470130287872,2020-07,1768.48,6561.33,749.07,1409.23,-5453.01,21713.93
1856021470130287872,2020-08,4965.46,10828.97,4100.35,3527.09,-5290.25,16423.68
1856021470130287872,2020-09,1728.57,2808.84,1382.18,1836.47,-1534.56,14889.12
1856021470130287872,2020-10,0,7141.95,2479.08,5764.24,-10427.11,4462.01
1856021470130287872,2020-11,2546.59,2468.36,1604.57,5869.39,-4186.59,275.42
1856021470130287872,2020-12,4136.4,8718.21,2291.6,0,-2290.21,-2014.79
1856397199848639232,2020-01,0,5420.83,3166.97,3280.97,-5534.83,-5534.83
1856397199848639232,2020-02,4243.89,6188.52,4591.79,4340.8,-1693.64,-7228.47
1856397199848639232,2020-03,4432.83,6382.41,1746.21,4778.95,-4982.32,-12210.79
1856397199848639232,2020-04,3976.97,6316.86,1505.83,1851.82,-2685.88,-14896.67
1856397199848639232,2020-05,2548,2905.43,6282.93,1898.54,4026.96,-10869.71
1856397199848639232,2020-06,2044.18,4899.39,4254.74,8179.82,-6780.29,-17650
1856397199848639232,2020-07,3542.98,5715.08,2482.56,6285.61,-5975.15,-23625.15
1856397199848639232,2020-08,3806.31,6771.24,2926.6,1552.25,-1590.58,-25215.73
1856397199848639232,2020-09,2848.34,3712.2,5189,3473.19,851.95,-24363.78
1856397199848639232,2020-10,2270.79,4045.2,4246.78,4596.81,-2124.44,-26488.22
1856397199848639232,2020-11,4227.66,3562.19,1183.62,69.12,1779.97,-24708.25
1856397199848639232,2020-12,5080.92,3288.31,5527.41,3602.35,3717.67,-20990.58
1858226580720611072,2020-01,5172.26,5043.39,2674.74,1784.31,1019.3,1019.3
1858226580720611072,2020-02,5715.87,2887.46,1526.21,5327.42,-972.8,46.5
1858226580720611072,2020-03,177.86,3252.11,4533.59,3823.27,-2363.93,-2317.43
1858226580720611072,2020-04,3352.2,2688.61,3160.75,5051.08,-1226.74,-3544.17
1858226580720611072,2020-05,2869.24,7771.44,1367.91,613.12,-4147.41,-7691.58
1858226580720611072,2020-06,4292.9,923.45,130.75,827.16,2673.04,-5018.54
1858226580720611072,2020-07,1604.54,5998.9,4225.52,1675.42,-1844.26,-6862.8
1858226580720611072,2020-08,2714.92,4556.86,3040.78,963.25,235.59,-6627.21
1858226580720611072,2020-09,1380.14,521.02,605.15,4598.02,-3133.75,-9760.96
1858226580720611072,2020-10,0,2385.58,0,2346.57,-4732.15,-14493.11
1858226580720611072,2020-11,5129.84,3036.12,4035.69,990.9,5138.51,-9354.6
1858226580720611072,2020-12,1865.52,1320.37,6207.26,0,6752.41,-2602.19
1859413263335656960,2020-01,2601.58,2170.56,1807.27,2435.55,-197.26,-197.26
1859413263335656960,2020-02,2482.7,2958.5,1621.28,3183.71,-2038.23,-2235.49
1859413263335656960,2020-03,377.8,5890.07,1231.21,4191.68,-8472.74,-10708.23
1859413263335656960,2020-04,9635.13,0,3205.08,6877.31,5962.9,-4745.33
1859413263335656960,2020-05,6125.58,3852.11,4876.52,242.32,6907.67,2162.34
1859413263335656960,2020-06,5936.35,0,2546.89,61.25,8421.99,10584.33
1859413263335656960,2020-07,4095.65,3720.49,1000.61,2063.84,-688.07,9896.26
1859413263335656960,2020-08,4435.63,2543.06,0,4229.36,-2336.79,7559.47
1859413263335656960,2020-09,563.21,3367.17,3397.03,1927.3,-1334.23,6225.24
1859413263335656960,2020-10,4547.01,1738.83,8436.73,0,11244.91,17470.15
1859413263335656960,2020-11,1305.69,4940.09,0,3673.37,-7307.77,10162.38
1859413263335656960,2020-12,2742.22,2340.95,256.49,990.97,-333.21,9829.17
1860240220899784192,2020-01,4251.72,3986.23,3356.3,2948.56,673.23,673.23
1860240220899784192,2020-02,5763.85,3443.9,6117.71,2663.72,5773.94,6447.17
1860240220899784192,2020-03,1076.17,2962.75,9246.36,1068.11,6291.67,12738.84
1860240220899784192,2020-04,5077.81,4779.47,3544.77,5715.55,-1872.44,10866.4
1860240220899784192,2020-05,1086.8,4802.82,4565.17,3320.26,-2471.11,8395.29
1860240220899784192,2020-06,1810.32,2136.29,3560.1,3680.16,-446.03,7949.26
1860240220899784192,2020-07,2921.28,6968.49,2228.35,2165.62,-3984.48,3964.78
1860240220899784192,2020-08,7379.74,3004.36,482.35,3690.45,1167.28,5132.06
1860240220899784192,2020-09,6222.08,7965.96,2596.82,2685.22,-1832.28,3299.78
1860240220899784192,2020-10,5088.07,2715.56,5627.22,2098.38,5901.35,9201.13
1860240220899784192,2020-11,1502.94,7162.33,4060.37,1657.4,-3256.42,5944.71
1860240220899784192,2020-12,2249.19,1416.97,6425.58,5628.17,1629.63,7574.34
1861228496842201088,2020-01,5467.48,2247.17,2667.2,2036.91,3850.6,3850.6
1861228496842201088,2020-02,3200.98,4058.79,1084.07,4524.21,-4297.95,-447.35
1861228496842201088,2020-03,959.59,7083.26,6858.99,1994.88,-1259.56,-1706.91
1861228496842201088,2020-04,2108.66,5189.25,1461.52,1876.08,-3495.15,-5202.06
1861228496842201088,2020-05,2945.4,3267.7,1960.17,1230.83,407.04,-4795.02
1861228496842201088,2020-06,2257.61,3933.77,3957.15,2443.04,-162.05,-4957.07
1861228496842201088,2020-07,4028.17,3896.45,657.2,5751.87,-4962.95,-9920.02
1861228496842201088,2020-08,1381.31,5130.29,3229.64,3968.8,-4488.14,-14408.16
1861228496842201088,2020-09,2305.58,2627.06,2180.33,2988.27,-1129.42,-15537.58
1861228496842201088,2020-10,3017.4,3051.02,3639.29,2451.48,1154.19,-14383.39
1861228496842201088,2020-11,1170.05,2156.45,1701.27,2430.86,-1715.99,-16099.38
1861228496842201088,2020-12,1400.82,4082.62,4749.2,5419.55,-3352.15,-19451.53
1862004168481614592,2020-01,1099.37,5506.69,877.27,0,-3530.05,-3530.05
1862004168481614592,2020-02,1455.51,5378.46,932.27,2069.13,-5059.81,-8589.86
1862004168481614592,2020-03,3591.88,1336.24,1772.51,1125.6,2902.55,-5687.31
1862004168481614592,2020-04,2338.6,1357.91,1566.58,0,2547.27,-3140.04
1862004168481614592,2020-05,0,2405.9,1745.21,3143.86,-3804.55,-6944.59
1862004168481614592,2020-06,5097.79,0,2568.26,1514.35,6151.7,-792.89
1862004168481614592,2020-07,148.19,666,3162.3,1466.49,1178,385.11
1862004168481614592,2020-08,234.47,3606.24,1786.32,1867.45,-3452.9,-3067.79
1862004168481614592,2020-09,3475.66,4104.33,0,3533.85,-4162.52,-7230.31
1862004168481614592,2020-10,1824.2,2135.64,28.4,2226.71,-2509.75,-9740.06
1862004168481614592,2020-11,1578.8,124.83,3114.41,2271.24,2297.14,-7442.92
1862004168481614592,2020-12,1257.95,0,1665.47,1252.34,1671.08,-5771.84
1862443891082592256,2020-06,2175.51,0,0,0,2175.51,2175.51
1864333380304741888,2020-01,3680.27,1977.11,3347,3596.2,1453.96,1453.96
1864333380304741888,2020-02,5433.51,0,0,1688.68,3744.83,5198.79
1864333380304741888,2020-03,1504.57,4063.76,3160.97,1094.84,-493.06,4705.73
1864333380304741888,2020-04,1972.41,5318.54,2868.43,0,-477.7,4228.03
1864333380304741888,2020-05,938.53,1788.11,3287.09,1183.49,1254.02,5482.05
1864333380304741888,2020-06,1542.42,4997.28,5415.29,0,1960.43,7442.48
1864333380304741888,2020-07,0,1557.1,7138.37,1490.78,4090.49,11532.97
1864333380304741888,2020-08,5797.58,1752.41,1300.3,1995.5,3349.97,14882.94
1864333380304741888,2020-09,0,2292.36,1520.74,3393.07,-4164.69,10718.25
1864333380304741888,2020-10,4509.84,197.03,686.96,3520.5,1479.27,12197.52
1864333380304741888,2020-11,1947.2,1795.32,939.17,56.28,1034.77,13232.29
1864333380304741888,2020-12,2500.35,2906.39,1080.34,779.92,-105.62,13126.67
1864399092352794112,2020-01,3778.79,1716.29,2582.97,1128.62,3516.85,3516.85
1864399092352794112,2020-02,1992.23,3122.58,950.48,7512.69,-7692.56,-4175.71
1864399092352794112,2020-03,3567.95,1779.54,3510.21,3175.97,2122.65,-2053.06
1864399092352794112,2020-04,4459,2041.75,3502.87,5128.69,791.43,-1261.63
1864399092352794112,2020-05,0,7817.69,1710.32,957.43,-7064.8,-8326.43
1864399092352794112,2020-06,939.23,0,1685.24,5142.93,-2518.46,-10844.89
1864399092352794112,2020-07,10044.16,3825.44,6245.96,73.7,12390.98,1546.09
1864399092352794112,2020-08,5339.35,96.58,1965.31,1298.38,5909.7,7455.79
1864399092352794112,2020-09,5869.86,7335.91,409.26,273.03,-1329.82,6125.97
1864399092352794112,2020-10,3025.4,2414.89,2872.13,1473.4,2009.24,8135.21
1864399092352794112,2020-11,0,1839.78,6240.08,2798.88,1601.42,9736.63
1864399092352794112,2020-12,2928.08,2581.98,4356.24,4032.96,669.38,10406.01
1866535335946192896,2020-01,6216.34,3105.34,5154.53,991.87,7273.66,7273.66
1866535335946192896,2020-02,644.97,3582.44,2655.53,1489.86,-1771.8,5501.86
1866535335946192896,2020-03,3910.61,3059.62,1073.47,3104.49,-1180.03,4321.83
1866535335946192896,2020-04,2458.99,666.28,5652.14,3605.71,3839.14,8160.97
1866535335946192896,2020-05,1885.95,570.16,2840.91,3576.45,580.25,8741.22
1866535335946192896,2020-06,1803.79,575.46,3379.76,6322.44,-1714.35,7026.87
1866535335946192896,2020-07,1891.41,2695.03,86.14,927.12,-1644.6,5382.27
1866535335946192896,2020-08,6112.98,2766.35,6587.9,3360.66,6573.87,11956.14
1866535335946192896,2020-09,1928.88,6844.37,2862.95,1997.41,-4049.95,7906.19
1866535335946192896,2020-10,3447.15,3263.57,2151.88,6487.37,-4151.91,3754.28
1866535335946192896,2020-11,4684.68,3207.84,3330,873.23,3933.61,7687.89
1866535335946192896,2020-12,3633.31,4765.51,3271.2,1175.73,963.27,8651.16
1867458007308683008,2020-01,391.66,2361.99,752.99,1790.02,-3007.36,-3007.36
1867458007308683008,2020-02,1762.5,1328.09,3729.37,3663.93,499.85,-2507.51
1867458007308683008,2020-03,2134.17,3237.36,646.17,0,-457.02,-2964.53
1867458007308683008,2020-04,1524.67,1049.26,1165.38,6367.44,-4726.65,-7691.18
1867458007308683008,2020-05,994.59,1603.73,2684.98,1439.42,636.42,-7054.76
1867458007308683008,2020-06,718.04,1954.81,1928.43,887.33,-195.67,-7250.43
1867458007308683008,2020-08,3983.4,2385.67,0,3507.16,-1909.43,-9159.86
1867458007308683008,2020-09,1930.86,1741.06,0,2426.42,-2236.62,-11396.48
1867458007308683008,2020-10,4663.92,0,1712.67,0,6376.59,-5019.89
1867458007308683008,2020-11,1726.89,1612.17,446.62,1259.41,-698.07,-5717.96
1867458007308683008,2020-12,1847.17,2190.73,0,2749.76,-3093.32,-8811.28
1867668695088709376,2020-02,1904.03,0,0,1414.8,489.23,489.23
1867668695088709376,2020-03,0,1614.66,0,784.42,-2399.08,-1909.85
1867668695088709376,2020-04,711.81,0,0,0,711.81,-1198.04
1867668695088709376,2020-05,0,2515.24,2967.91,0,452.67,-745.37
1867668695088709376,2020-08,1796.29,171.72,1812.49,0,3437.06,2691.69
1867668695088709376,2020-09,1836.34,0,0,0,1836.34,4528.03
1867668695088709376,2020-10,1951.04,2106.38,0,1658.29,-1813.63,2714.4
1867668695088709376,2020-11,2482.13,1331.76,770.74,1498.94,422.17,3136.57
1867668695088709376,2020-12,0,398.05,0,1870.96,-2269.01,867.56
1869618767792252928,2020-01,0,259.99,0,1974.17,-2234.16,-2234.16
1869618767792252928,2020-02,911.97,1784.83,0,0,-872.86,-3107.02
1869618767792252928,2020-04,520.06,0,1671.37,0,2191.43,-915.59
1869618767792252928,2020-08,1126.26,0,0,0,1126.26,210.67
1869618767792252928,2020-09,311.71,1623.51,925.33,0,-386.47,-175.8
1869618767792252928,2020-11,712.69,0,0,0,712.69,536.89
1870545738287395072,2020-03,0,2495.75,1104.94,1282.99,-2673.8,-2673.8
1870545738287395072,2020-06,0,2877.6,0,0,-2877.6,-5551.4
1870545738287395072,2020-08,1997.79,0,0,740.88,1256.91,-4294.49
1870545738287395072,2020-11,0,1131.32,0,0,-1131.32,-5425.81
1870819559116223232,2020-02,0,1340.9,1115.6,0,-225.3,-225.3
1870819559116223232,2020-04,1298.51,622.23,0,0,676.28,450.98
1870819559116223232,2020-05,0,698.57,0,0,-698.57,-247.59
1871428608219036928,2020-01,2554.7,3445.82,2649.31,6321.84,-4563.65,-4563.65
1871428608219036928,2020-02,8712.03,6809.48,1985.16,5757.2,-1869.49,-6433.14
1871428608219036928,2020-03,3641.93,4419.16,1843.38,4011,-2944.85,-9377.99
1871428608219036928,2020-04,6933.65,3354.24,6943.38,4835.51,5687.28,-3690.71
1871428608219036928,2020-05,1696.66,5031.44,3090.58,8849.31,-9093.51,-12784.22
1871428608219036928,2020-06,3372.45,4780.97,5184.74,5921.74,-2145.52,-14929.74
1871428608219036928,2020-07,5312.18,6702.61,1507.53,2685.12,-2568.02,-17497.76
1871428608219036928,2020-08,3356.15,6177.45,4784.86,2956.13,-992.57,-18490.33
1871428608219036928,2020-09,7173.59,3475.63,4628.59,4302.32,4024.23,-14466.1
1871428608219036928,2020-10,29.95,2767.16,4216.33,2990.41,-1511.29,-15977.39
1871428608219036928,2020-11,4387.21,4674.52,2453.31,4261.64,-2095.64,-18073.03
1871428608219036928,2020-12,2800.17,4692.37,4695.25,2239.45,563.6,-17509.43
1871781553349288960,2020-01,3383.64,8019.04,4640.6,3395.9,-3390.7,-3390.7
1871781553349288960,2020-02,1846.19,6617.71,5090.78,842.88,-523.62,-3914.32
1871781553349288960,2020-03,10393.71,7231.94,1876.4,2107.95,2930.22,-984.1
1871781553349288960,2020-04,3765.09,2759.15,3019.3,7109.02,-3083.78,-4067.88
1871781553349288960,2020-05,5087.03,4161.86,4550.53,618.36,4857.34,789.46
1871781553349288960,2020-06,6417.99,6804.96,3074.99,2521.09,166.93,956.39
1871781553349288960,2020-07,4172.3,2736.89,4220.59,2086.48,3569.52,4525.91
1871781553349288960,2020-08,1716.18,4683.6,4270.43,2093.22,-790.21,3735.7
1871781553349288960,2020-09,5228.77,4394.61,913.72,2492.41,-744.53,2991.17
1871781553349288960,2020-10,3672.08,7228.08,4149.18,8902.73,-8309.55,-5318.38
1871781553349288960,2020-11,6077.93,6317.03,8139.31,3126.46,4773.75,-544.63
1871781553349288960,2020-12,1883.28,8338.38,6745.63,2095.3,-1804.77,-2349.4
1872483166043110144,2020-01,3995.38,3179.4,1814.69,5228.82,-2598.15,-2598.15
1872483166043110144,2020-02,4397.81,6076.33,2081.52,3777.62,-3374.62,-5972.77
1872483166043110144,2020-03,2072.58,7603.99,6610.7,4327.59,-3248.3,-9221.07
1872483166043110144,2020-04,1805.21,5255,3684.5,5329.33,-5094.62,-14315.69
1872483166043110144,2020-05,2672.01,1958.8,1083.94,6577.48,-4780.33,-19096.02
1872483166043110144,2020-06,2239.05,5134.7,5483.03,1876.97,710.41,-18385.61
1872483166043110144,2020-07,11499.46,4481.78,7952.04,5575.86,9393.86,-8991.75
1872483166043110144,2020-08,6471.31,2052.55,6778.56,9352.82,1844.5,-7147.25
1872483166043110144,2020-09,3413.9,1362.55,3688.69,2542.45,3197.59,-3949.66
1872483166043110144,2020-10,7553.98,7408.83,9193.17,423.67,8914.65,4964.99
1872483166043110144,2020-11,7669.91,2458.83,1854.96,9060.29,-1994.25,2970.74
1872483166043110144,2020-12,8786.27,3646.51,4429.14,4372.53,5196.37,8167.11
1872499131252908032,2020-01,3590.34,4260.61,6626.5,3108.48,2847.75,2847.75
1872499131252908032,2020-02,3214.49,1165.03,4498,4675.97,1871.49,4719.24
1872499131252908032,2020-03,2210.12,5041.99,3032.82,5999.76,-5798.81,-1079.57
1872499131252908032,2020-04,3077.43,2719.73,2876.7,1557.26,1677.14,597.57
1872499131252908032,2020-05,4632.57,3049.83,4831.94,5559.45,855.23,1452.8
1872499131252908032,2020-06,4488.64,3176.07,532.85,9526.13,-7680.71,-6227.91
1872499131252908032,2020-07,5910.53,7873.1,2553.78,6569.92,-5978.71,-12206.62
1872499131252908032,2020-08,4853.12,3219.89,752.15,5427.05,-3041.67,-15248.29
1872499131252908032,2020-09,3775.75,2723.54,6442.32,2374.08,5120.45,-10127.84
1872499131252908032,2020-10,0,1672.4,3470.68,3921.98,-2123.7,-12251.54
1872499131252908032,2020-11,8889.09,3838.09,5880.62,1856.79,9074.83,-3176.71
1872499131252908032,2020-12,3415.75,2055.51,8612.26,4196.58,5775.92,2599.21
1872886952686863104,2020-01,2610.93,2453.98,2856.25,1969.67,1043.53,1043.53
1872886952686863104,2020-02,5684.65,3674.64,5196.85,3624.41,3582.45,4625.98
1872886952686863104,2020-03,2847.35,672.8,1500.03,1493.09,2181.49,6807.47
1872886952686863104,2020-04,0,1441.91,1105.86,1950.55,-2286.6,4520.87
1872886952686863104,2020-05,4339.12,2568.59,3250.77,3060.82,1960.48,6481.35
1872886952686863104,2020-06,3452.13,4312.91,4086.42,2679.76,545.88,7027.23
1872886952686863104,2020-07,3269.04,2380.72,3512.64,3416.28,984.68,8011.91
1872886952686863104,2020-08,2987.56,366.1,5029.76,2027.32,5623.9,13635.81
1872886952686863104,2020-09,904.23,4254.11,1830.91,1914.76,-3433.73,10202.08
1872886952686863104,2020-10,2779.48,5687.34,5113.89,3515.54,-1309.51,8892.57
1872886952686863104,2020-11,3600.43,194.81,459.46,910.35,2954.73,11847.3
1872886952686863104,2020-12,1572.41,1769.98,5189.58,3413,1579.01,13426.31
1873691140900858112,2020-01,2558.11,5453.13,4329.5,11887.08,-10452.6,-10452.6
1873691140900858112,2020-02,3452.4,4448.91,3758.71,4180.28,-1418.08,-11870.68
1873691140900858112,2020-03,3241.38,4091.21,8493.55,4978.82,2664.9,-9205.78
1873691140900858112,2020-04,149.45,5649.39,2654.47,1939,-4784.47,-13990.25
1873691140900858112,2020-05,824.38,7143.05,2083.16,3090.31,-7325.82,-21316.07
1873691140900858112,2020-06,2141.77,4570.12,3240.6,5709.07,-4896.82,-26212.89
1873691140900858112,2020-07,6952.73,5001.29,4267.08,798.91,5419.61,-20793.28
1873691140900858112,2020-08,281.39,1286.88,4250.01,2012.94,1231.58,-19561.7
1873691140900858112,2020-09,4441.49,3944.55,3420.41,6234.31,-2316.96,-21878.66
1873691140900858112,2020-10,4064.24,3553.02,2240.85,3546.49,-794.42,-22673.08
1873691140900858112,2020-11,811.8,1374.59,1177.07,3014.54,-2400.26,-25073.34
1873691140900858112,2020-12,3391.6,1166.5,5870.72,2067.1,6028.72,-19044.62
1873971226840898304,2020-01,3038.47,4688.29,4848.83,5671.17,-2472.16,-2472.16
1873971226840898304,2020-02,4500.23,1583.64,3467.59,2095,4289.18,1817.02
1873971226840898304,2020-03,2669.14,176.93,6035.58,3378.74,5149.05,6966.07
1873971226840898304,2020-04,6197.95,3258.11,4107.7,1804.17,5243.37,12209.44
1873971226840898304,2020-05,8495.87,2321.53,2744.11,2900.57,6017.88,18227.32
1873971226840898304,2020-06,5029.48,5857.7,2710.47,2666.71,-784.46,17442.86
1873971226840898304,2020-07,820.25,3409.47,1475.1,6057.83,-7171.95,10270.91
1873971226840898304,2020-08,6654.11,0,4516.73,2512.07,8658.77,18929.68
1873971226840898304,2020-09,2429.37,4588.29,1694.83,1373.38,-1837.47,17092.21
1873971226840898304,2020-10,2532.36,2109.33,2433.51,3406.69,-550.15,16542.06
1873971226840898304,2020-11,160.29,2297.1,8648.38,3142.01,3369.56,19911.62
1873971226840898304,2020-12,2533.49,1044.88,0,6431.78,-4943.17,14968.45
1874227776893666816,2020-02,539.23,37.31,2118.57,1530.23,1090.26,1090.26
1874227776893666816,2020-03,0,1068.31,0,3741.55,-4809.86,-3719.6
1874227776893666816,2020-04,361.24,1185.22,1923.11,0,1099.13,-2620.47
1874227776893666816,2020-05,2981.12,761.3,6248.06,0,8467.88,5847.41
1874227776893666816,2020-06,1395.11,0,5875.42,2323.26,4947.27,10794.68
1874227776893666816,2020-07,2333.9,2820.76,0,3922.24,-4409.1,6385.58
1874227776893666816,2020-08,709.26,456.87,0,2885.99,-2633.6,3751.98
1874227776893666816,2020-09,2177.8,1538.63,1529.83,0,2169,5920.98
1874227776893666816,2020-10,374.95,727.79,0,1932.66,-2285.5,3635.48
1874227776893666816,2020-11,1086.82,0,4416.41,0,5503.23,9138.71
1875041885910718720,2020-01,2287.95,6455.17,5635.74,2224.49,-755.97,-755.97
1875041885910718720,2020-02,4813.45,5834.08,462.65,3713.02,-4271,-5026.97
1875041885910718720,2020-03,5015.17,9064.49,5849.11,1584.84,214.95,-4812.02
1875041885910718720,2020-04,4837.04,6760.5,1629.82,1298.3,-1591.94,-6403.96
1875041885910718720,2020-05,2384.3,2785,4976.54,8715.24,-4139.4,-10543.36
1875041885910718720,2020-06,5164.03,3673.17,6091.16,4196.11,3385.91,-7157.45
1875041885910718720,2020-07,1655.61,1155.26,3297.36,3776.5,21.21,-7136.24
1875041885910718720,2020-08,3068.9,5960.71,4456.08,4254.75,-2690.48,-9826.72
1875041885910718720,2020-09,607.59,12884.82,5614.62,3045.48,-9708.09,-19534.81
1875041885910718720,2020-10,4075.67,3045,5360.86,4538.99,1852.54,-17682.27
1875041885910718720,2020-11,850.33,2511.93,6329.75,6167.64,-1499.49,-19181.76
1875041885910718720,2020-12,5338.48,5204.03,5167.22,2100.73,3200.94,-15980.82
1876494230858169088,2020-01,2851.89,4573.5,1212.8,1820.32,-2329.13,-2329.13
1876494230858169088,2020-02,4819.58,1056.45,7378.36,4314.3,6827.19,4498.06
1876494230858169088,2020-03,4767.36,8166.41,829,202.11,-2772.16,1725.9
1876494230858169088,2020-04,3345.08,8675.16,4468.29,2404.09,-3265.88,-1539.98
1876494230858169088,2020-05,3776.7,4281.15,3656.34,6655.62,-3503.73,-5043.71
1876494230858169088,2020-06,3632,4304.21,3004.17,7332.95,-5000.99,-10044.7
1876494230858169088,2020-07,2329.43,3182.83,6076.14,4900.98,321.76,-9722.94
1876494230858169088,2020-08,0,6734.94,3936.43,2425.99,-5224.5,-14947.44
1876494230858169088,2020-09,7288.54,3906.19,8084.24,1885.09,9581.5,-5365.94
1876494230858169088,2020-10,2475.53,2773.23,4607.21,4935.02,-625.51,-5991.45
1876494230858169088,2020-11,3196.86,6734.96,3900.1,3116.29,-2754.29,-8745.74
1876494230858169088,2020-12,1020.59,1670.13,3552.24,5874.74,-2972.04,-11717.78
1876610313286073088,2020-01,4161.83,5420.64,5439.14,5807.34,-1627.01,-1627.01
1876610313286073088,2020-02,2522.96,2354.36,3483.49,2330.47,1321.62,-305.39
1876610313286073088,2020-03,1642.63,5726.81,1009.51,7470.77,-10545.44,-10850.83
1876610313286073088,2020-04,2310.17,3383.01,6527.55,3189.98,2264.73,-8586.1
1876610313286073088,2020-05,2973.41,4008.05,3369.51,6295.92,-3961.05,-12547.15
1876610313286073088,2020-06,5957.73,5753.91,4160.73,4676.23,-311.68,-12858.83
1876610313286073088,2020-07,3795.96,6154.71,6370.88,8446.92,-4434.79,-17293.62
1876610313286073088,2020-08,2164.02,4439.46,3623.24,4978.03,-3630.23,-20923.85
1876610313286073088,2020-09,9647.2,4415.24,2665.22,6221.3,1675.88,-19247.97
1876610313286073088,2020-10,2843.56,4146.47,1819.22,3864.61,-3348.3,-22596.27
1876610313286073088,2020-11,3971.2,4441.15,3132.21,4394.52,-1732.26,-24328.53
1876610313286073088,2020-12,4053.35,5257.78,2780.77,0,1576.34,-22752.19
1876649798260181504,2020-01,6071.01,1503.92,2704.08,2678.89,4592.28,4592.28
1876649798260181504,2020-02,7221.5,5319.34,1070.16,1439.72,1532.6,6124.88
1876649798260181504,2020-03,4208.82,404.47,5922.48,5069.86,4656.97,10781.85
1876649798260181504,2020-04,4800.23,1316.33,6408.8,4586.77,5305.93,16087.78
1876649798260181504,2020-05,384.33,3548.68,2590.21,4830.1,-5404.24,10683.54
1876649798260181504,2020-06,3411.25,4315.45,2309.45,7592.89,-6187.64,4495.9
1876649798260181504,2020-07,1619.36,4047.88,2364.22,3723.54,-3787.84,708.06
1876649798260181504,2020-08,4528.43,4116.57,11291.5,3960.19,7743.17,8451.23
1876649798260181504,2020-09,5673.76,1775.39,7457.49,4872.25,6483.61,14934.84
1876649798260181504,2020-10,6724.18,3030.21,1831.43,2065,3460.4,18395.24
1876649798260181504,2020-11,4319.2,1664.52,4523.32,1073.86,6104.14,24499.38
1876649798260181504,2020-12,7539.21,7556.32,3227.36,5820.67,-2610.42,21888.96
1877445439615011072,2020-01,1767.93,103.7,4336.65,2476.1,3524.78,3524.78
1877445439615011072,2020-02,4162.19,211.14,2532.45,263.08,6220.42,9745.2
1877445439615011072,2020-03,648.81,3179.59,641.85,1120.04,-3008.97,6736.23
1877445439615011072,2020-04,3329.2,622.94,1765.43,2048.14,2423.55,9159.78
1877445439615011072,2020-05,0,290.98,0,136.57,-427.55,8732.23
1877445439615011072,2020-06,4636.06,1219.18,0,0,3416.88,12149.11
1877445439615011072,2020-07,2421.11,2137,1783.7,2531.96,-464.15,11684.96
1877445439615011072,2020-08,1921.4,1786.16,5896.03,1065.84,4965.43,16650.39
1877445439615011072,2020-09,162,2105.91,549.45,1806.31,-3200.77,13449.62
1877445439615011072,2020-10,0,4179.35,0,3067.29,-7246.64,6202.98
1877445439615011072,2020-11,0,4574.17,1121.03,2758.13,-6211.27,-8.29
1877445439615011072,2020-12,843.14,2331.9,4057.74,1127.55,1441.43,1433.14
1877588372665284608,2020-01,4674.72,0,0,1430.25,3244.47,3244.47
1877588372665284608,2020-02,0,3712.45,1739.27,4177.17,-6150.35,-2905.88
1877588372665284608,2020-03,1869.37,3411.64,393.84,4969.86,-6118.29,-9024.17
1877588372665284608,2020-04,1384.93,1634.13,3968.84,1531.38,2188.26,-6835.91
1877588372665284608,2020-05,472.87,809.71,91.69,1849.96,-2095.11,-8931.02
1877588372665284608,2020-06,2606.12,846.8,1237.82,2539.02,458.12,-8472.9
1877588372665284608,2020-07,1030.85,2851.6,1506.29,4523.52,-4837.98,-13310.88
1877588372665284608,2020-08,3764.73,3714.17,4731.39,0,4781.95,-8528.93
1877588372665284608,2020-09,2381.6,3084.42,0,458.11,-1160.93,-9689.86
1877588372665284608,2020-10,1166.85,670.07,2250.01,2296.14,450.65,-9239.21
1877588372665284608,2020-11,2756.38,6692.19,3140.13,4054.57,-4850.25,-14089.46
1877588372665284608,2020-12,1826.25,2673.55,3236.21,3018.54,-629.63,-14719.09
1878276191219499264,2020-01,1273.06,4438.49,1570.96,1332.17,-2926.64,-2926.64
1878276191219499264,2020-02,5198.06,4210.01,3071,3534.09,524.96,-2401.68
1878276191219499264,2020-03,5786.77,3087.07,2242.66,5823.13,-880.77,-3282.45
1878276191219499264,2020-04,1557.99,4110.75,2108.35,3127.44,-3571.85,-6854.3
1878276191219499264,2020-05,989,3114.16,1108.35,3323.58,-4340.39,-11194.69
1878276191219499264,2020-06,5390.33,2787.78,1208.93,4170.16,-358.68,-11553.37
1878276191219499264,2020-07,6142.83,2336.25,4646.47,4703.83,3749.22,-7804.15
1878276191219499264,2020-08,4881.91,2748.3,5267.89,3866.98,3534.52,-4269.63
1878276191219499264,2020-09,2976.17,4933.44,1076.85,664.91,-1545.33,-5814.96
1878276191219499264,2020-10,9943.01,4036.51,1583.79,1503.61,5986.68,171.72
1878276191219499264,2020-11,4080.99,2743.21,3004.75,4528.21,-185.68,-13.96
1878276191219499264,2020-12,5258.69,3498.63,1249.45,3693.47,-683.96,-697.92
1879164390211726592,2020-02,2247.54,0,26.35,2167.86,106.03,106.03
1879164390211726592,2020-03,948.74,0,1065.93,1985.78,28.89,134.92
1879164390211726592,2020-04,1167.61,1996.16,0,4201.13,-5029.68,-4894.76
1879164390211726592,2020-05,0,1592.7,0,1766.52,-3359.22,-8253.98
1879164390211726592,2020-06,0,3280.92,693.11,0,-2587.81,-10841.79
1879164390211726592,2020-07,1840.97,0,0,471.75,1369.22,-9472.57
1879164390211726592,2020-09,0,805.24,0,0,-805.24,-10277.81
1879164390211726592,2020-10,0,2656.06,26.18,0,-2629.88,-12907.69
1879164390211726592,2020-11,1752.6,3550.88,3211.22,0,1412.94,-11494.75
1879164390211726592,2020-12,625.56,1442.17,2745.85,1361.55,567.69,-10927.06
1881804685277733376,2020-01,5509.17,6608.94,5714.19,3602.21,1012.21,1012.21
1881804685277733376,2020-02,7870.11,2866.68,1921.47,8070.3,-1145.4,-133.19
1881804685277733376,2020-03,4720.02,2545.32,1075.15,6790.86,-3541.01,-3674.2
1881804685277733376,2020-04,6051.72,4485.29,2676.3,3681.13,561.6,-3112.6
1881804685277733376,2020-05,4135.24,1150.19,3944.2,4458.45,2470.8,-641.8
1881804685277733376,2020-06,4058.74,7123.72,3585.09,8334.92,-7814.81,-8456.61
1881804685277733376,2020-07,3245.82,7421.54,2655.22,5772.42,-7292.92,-15749.53
1881804685277733376,2020-08,3121.75,3660.55,67.32,7760.55,-8232.03,-23981.56
1881804685277733376,2020-09,2270.25,5315.91,4490.52,0,1444.86,-22536.7
1881804685277733376,2020-10,3408.59,6160.84,2415.02,1925.3,-2262.53,-24799.23
1881804685277733376,2020-11,9943.46,241.89,3074.77,4305.55,8470.79,-16328.44
1881804685277733376,2020-12,4505.17,4537.95,9838.52,4832.12,4973.62,-11354.82
1883680488066535168,2020-07,0,1835.08,0,0,-1835.08,-1835.08
1883680488066535168,2020-09,1527.11,0,0,223.24,1303.87,-531.21
1883680488066535168,2020-12,1798.14,0,0,0,1798.14,1266.93
1884860960166862080,2020-04,838.22,0,0,0,838.22,838.22
1884860960166862080,2020-06,673.83,0,0,0,673.83,1512.05
1884860960166862080,2020-11,0,1434.42,0,0,-1434.42,77.63
1885279313737253120,2020-02,6284.13,0,0,2584.81,3699.32,3699.32
1885279313737253120,2020-03,98.76,0,0,1492.67,-1393.91,2305.41
1885279313737253120,2020-04,1929.11,0,1523.44,0,3452.55,5757.96
1885279313737253120,2020-06,1532.41,2090.35,0,1277.8,-1835.74,3922.22
1885279313737253120,2020-07,3140.33,0,0,0,3140.33,7062.55
1885279313737253120,2020-08,1988.77,599.74,0,0,1389.03,8451.58
1885279313737253120,2020-09,154.73,0,921.33,0,1076.06,9527.64
1885279313737253120,2020-10,1895.29,264.21,0,1173.5,457.58,9985.22
1885279313737253120,2020-11,2259.75,0,1525.24,1033.8,2751.19,12736.41
1885279313737253120,2020-12,79.06,2179.64,800.29,1537.14,-2837.43,9898.98
1885622282272932864,2020-01,180.46,3038.47,999.69,785.75,-2644.07,-2644.07
1885622282272932864,2020-02,195.22,5301.96,3608.13,3148.48,-4647.09,-7291.16
1885622282272932864,2020-03,1321.19,10011.82,2483.24,2002.87,-8210.26,-15501.42
1885622282272932864,2020-04,5137.67,0,1687.96,5040.43,1785.2,-13716.22
1885622282272932864,2020-05,2868.5,3471.56,2300.29,3601.99,-1904.76,-15620.98
1885622282272932864,2020-06,6425.88,2271.13,3316.55,3043.49,4427.81,-11193.17
1885622282272932864,2020-07,2455.03,1372.22,121.76,2801.77,-1597.2,-12790.37
1885622282272932864,2020-08,542.7,3797.62,3838.89,3552.96,-2968.99,-15759.36
1885622282272932864,2020-09,1393.8,2998.56,0,3321.2,-4925.96,-20685.32
1885622282272932864,2020-10,3232.52,5909.95,5402.57,1892.23,832.91,-19852.41
1885622282272932864,2020-11,4945.02,5239.28,7225.38,3306.61,3624.51,-16227.9
1885622282272932864,2020-12,5426.69,658.77,5224.48,615.82,9376.58,-6851.32
1886226600050881280,2020-01,4224.47,1548.5,1675.25,3238.95,1112.27,1112.27
1886226600050881280,2020-02,6958.39,2773.67,987.99,4121.37,1051.34,2163.61
1886226600050881280,2020-03,5767.98,2014.78,0,6922.21,-3169.01,-1005.4
1886226600050881280,2020-04,250.78,1183.53,2890.83,1125.46,832.62,-172.78
1886226600050881280,2020-05,5395.52,3458.21,3060.23,4211.04,786.5,613.72
1886226600050881280,2020-06,1743.35,787.82,945.72,0,1901.25,2514.97
1886226600050881280,2020-07,1585.36,6529.01,4880.77,3102.98,-3165.86,-650.89
1886226600050881280,2020-08,2658.03,6328.92,0,3844.65,-7515.54,-8166.43
1886226600050881280,2020-09,2766.61,3097.19,3214.3,2132.44,751.28,-7415.15
1886226600050881280,2020-10,534.46,2053.23,2954.87,4023.07,-2586.97,-10002.12
1886226600050881280,2020-11,3306.39,2161.16,2161.63,4138.05,-831.19,-10833.31
1886226600050881280,2020-12,2565.42,236.86,1106.2,1312.8,2121.96,-8711.35
1886822725596943360,2020-07,1671.98,0,0,0,1671.98,1671.98
1886822725596943360,2020-08,0,958.6,0,0,-958.6,713.38
1890131345816453888,2020-01,4596.31,1010.74,1610.77,3243.3,1953.04,1953.04
1890131345816453888,2020-02,546.2,1008.71,1282.7,1358.46,-538.27,1414.77
1890131345816453888,2020-03,3488.92,2358.58,0,2501.55,-1371.21,43.56
1890131345816453888,2020-04,1660.02,0,2825.86,3523.03,962.85,1006.41
1890131345816453888,2020-05,1186.14,3568.04,3367.62,5879.61,-4893.89,-3887.48
1890131345816453888,2020-06,11119.59,3361.31,1922.91,2158.57,7522.62,3635.14
1890131345816453888,2020-07,0,3990.2,2997.24,2735.26,-3728.22,-93.08
1890131345816453888,2020-08,3718.87,1295.93,6053.37,3197.58,5278.73,5185.65
1890131345816453888,2020-09,4748.9,4374.13,0,503.65,-128.88,5056.77
1890131345816453888,2020-10,906.83,3346.74,511.52,3776.56,-5704.95,-648.18
1890131345816453888,2020-11,462.87,1151.73,2159.67,5362.4,-3891.59,-4539.77
1890131345816453888,2020-12,2430.03,1957.36,2456.74,7673.29,-4743.88,-9283.65
1890318034344927744,2020-01,6329.48,452.54,5655.04,3972.09,7559.89,7559.89
1890318034344927744,2020-02,1639.89,2043.47,395.12,6615.49,-6623.95,935.94
1890318034344927744,2020-03,1807.77,3166.6,6064.5,630.88,4074.79,5010.73
1890318034344927744,2020-04,3531.57,3897.54,1153.84,3262.26,-2474.39,2536.34
1890318034344927744,2020-05,1561.08,2524.02,2563.52,3412.39,-1811.81,724.53
1890318034344927744,2020-06,4292.08,6259.41,4079.67,3786.13,-1673.79,-949.26
1890318034344927744,2020-07,3354.47,2059.09,3220.32,1288.71,3226.99,2277.73
1890318034344927744,2020-08,2991.12,5052.72,4329.76,7019.72,-4751.56,-2473.83
1890318034344927744,2020-09,1297.39,2871.47,2751.21,8985.47,-7808.34,-10282.17
1890318034344927744,2020-10,4943.02,4263.65,3927.88,4581.99,25.26,-10256.91
1890318034344927744,2020-11,2303.52,4210.35,2470.1,1853.46,-1290.19,-11547.1
1890318034344927744,2020-12,6094.42,2329.08,1027.08,2309.27,2483.15,-9063.95
1890825910254450944,2020-01,460.4,3306.94,4622.52,3144.04,-1368.06,-1368.06
1890825910254450944,2020-02,648.76,0,790.27,1327.66,111.37,-1256.69
1890825910254450944,2020-03,6137.38,2705.33,1021.11,3179.52,1273.64,16.95
1890825910254450944,2020-04,3952.33,2851.32,888.93,0,1989.94,2006.89
1890825910254450944,2020-05,2741,0,0,1657.5,1083.5,3090.39
1890825910254450944,2020-06,3652.73,5853.26,501.91,6699.57,-8398.19,-5307.8
1890825910254450944,2020-07,3343.13,4298.9,3770.69,1215.55,1599.37,-3708.43
1890825910254450944,2020-08,3805.76,2890.83,4349.66,1774.31,3490.28,-218.15
1890825910254450944,2020-09,3564.97,0,680.52,0,4245.49,4027.34
1890825910254450944,2020-10,286.77,1338.5,534.37,1777.95,-2295.31,1732.03
1890825910254450944,2020-11,1931.05,7711.06,2659.39,1717.04,-4837.66,-3105.63
1890825910254450944,2020-12,1606.83,3215.19,1161.48,2965.05,-3411.93,-6517.56
1890918654285785600,2020-01,4651.83,5806.93,1694.7,4347.56,-3807.96,-3807.96
1890918654285785600,2020-02,7016.56,850.15,1192.98,1284.78,6074.61,2266.65
1890918654285785600,2020-03,1610.4,892.07,3994.9,6116.63,-1403.4,863.25
1890918654285785600,2020-04,2911.22,365.89,4205.48,1538.56,5212.25,6075.5
1890918654285785600,2020-05,6033.31,2529.09,2217.22,2866.22,2855.22,8930.72
1890918654285785600,2020-06,4116.65,3325.13,2058.85,3515.64,-665.27,8265.45
1890918654285785600,2020-07,4113.68,2443.65,0,2312.26,-642.23,7623.22
1890918654285785600,2020-08,1858.7,10044.44,825.57,0,-7360.17,263.05
1890918654285785600,2020-09,1808.37,5.93,1545.13,1518.97,1828.6,2091.65
1890918654285785600,2020-10,3186.14,3515.08,0,4115.73,-4444.67,-2353.02
1890918654285785600,2020-11,5785.74,4761.35,3267.42,7416.96,-3125.15,-5478.17
1890918654285785600,2020-12,0,4132.52,2522.73,2074.72,-3684.51,-9162.68
1893084371016102400,2020-01,4757.65,3320.83,298.08,8929.18,-7194.28,-7194.28
1893084371016102400,2020-02,5156.61,4626.22,1647.97,6473.12,-4294.76,-11489.04
1893084371016102400,2020-03,7272.14,4745.24,6781.73,5623.17,3685.46,-7803.58
1893084371016102400,2020-04,15112.06,5286.58,5513.19,5658.09,9680.58,1877
1893084371016102400,2020-05,11122.67,2832.1,2039.02,3590.96,6738.63,8615.63
1893084371016102400,2020-06,5855.93,3589.23,2131.26,2824.95,1573.01,10188.64
1893084371016102400,2020-07,2606.25,7524.6,419.06,3501.23,-8000.52,2188.12
1893084371016102400,2020-08,6621.46,9766.41,5309.99,8834.47,-6669.43,-4481.31
1893084371016102400,2020-09,4618.29,4860.65,6863.97,5498.31,1123.3,-3358.01
1893084371016102400,2020-10,2163.88,2664.43,9159.82,1463.02,7196.25,3838.24
1893084371016102400,2020-11,3927.18,2534.55,9644.6,3922.02,7115.21,10953.45
1893084371016102400,2020-12,3737.25,2754.41,5222.28,3983.11,2222.01,13175.46
1893093348520915200,2020-01,3354.94,86.67,4221.07,0,7489.34,7489.34
1893093348520915200,2020-02,4535.59,7278.78,3580.98,3458.55,-2620.76,4868.58
1893093348520915200,2020-03,2334.03,4485.15,1652.58,4360.04,-4858.58,10
1893093348520915200,2020-04,2976.56,1415.33,4451.6,5875.12,137.71,147.71
1893093348520915200,2020-05,3061.26,2955.99,3976.66,1434.51,2647.42,2795.13
1893093348520915200,2020-06,5940.31,8795.09,780.28,4097.79,-6172.29,-3377.16
1893093348520915200,2020-07,2993.58,1971.3,943.87,2289.31,-323.16,-3700.32
1893093348520915200,2020-08,3058.59,6736.43,3913.99,2775.79,-2539.64,-6239.96
1893093348520915200,2020-09,2756.05,1210.46,1349.61,5247.88,-2352.68,-8592.64
1893093348520915200,2020-10,4478.38,5604.24,2654.92,5533.22,-4004.16,-12596.8
1893093348520915200,2020-11,3881.18,2872.8,2099.14,7618.9,-4511.38,-17108.18
1893093348520915200,2020-12,2869.33,810.29,3847.92,5302.79,604.17,-16504.01
1893675621527886592,2020-01,1994.73,3703.33,4886.27,7568.12,-4390.45,-4390.45
1893675621527886592,2020-02,649.79,2678.18,7679.81,4931.67,719.75,-3670.7
1893675621527886592,2020-03,5219.91,7350.29,3584.42,2573.35,-1119.31,-4790.01
1893675621527886592,2020-04,8416.56,3667.88,7833.91,6138.42,6444.17,1654.16
1893675621527886592,2020-05,2763.39,2912.38,8403.81,4698.36,3556.46,5210.62
1893675621527886592,2020-06,3219.64,4662.49,5318.77,3277.75,598.17,5808.79
1893675621527886592,2020-07,870.95,3343.75,2741.09,4617.06,-4348.77,1460.02
1893675621527886592,2020-08,2215.53,2759.16,5333.09,2423.36,2366.1,3826.12
1893675621527886592,2020-09,3241.25,4758.61,4973.57,3072.35,383.86,4209.98
1893675621527886592,2020-10,2065.15,8264.57,1050.06,1793.71,-6943.07,-2733.09
1893675621527886592,2020-11,4921.67,6714.72,1637.61,3199.23,-3354.67,-6087.76
1893675621527886592,2020-12,3797.09,7330.15,4717.88,4841.72,-3656.9,-9744.66
1896067648869633536,2020-03,1143.68,1315.94,423.91,0,251.65,251.65
1896067648869633536,2020-05,0,375.75,0,0,-375.75,-124.1
1896067648869633536,2020-07,0,771.35,0,198.24,-969.59,-1093.69
1896067648869633536,2020-12,572.21,1706.03,1718.48,0,584.66,-509.03
1897396107800082432,2020-01,8554.33,3516.97,3050.74,1804.5,6283.6,6283.6
1897396107800082432,2020-02,741.83,3211.54,1760.86,488.77,-1197.62,5085.98
1897396107800082432,2020-03,16050.98,3704.17,7317.48,2781.79,16882.5,21968.48
1897396107800082432,2020-04,2238.81,4257.71,4154.22,1984.29,151.03,22119.51
1897396107800082432,2020-05,8864.64,10744.33,2321.86,7381.99,-6939.82,15179.69
1897396107800082432,2020-06,6008.77,0,6359.99,3796.32,8572.44,23752.13
1897396107800082432,2020-07,6881.14,4727.83,4292.7,6744.82,-298.81,23453.32
1897396107800082432,2020-08,5737.26,7717.12,3699.24,6453.05,-4733.67,18719.65
1897396107800082432,2020-09,4626.21,3082.98,4653.72,6063.91,133.04,18852.69
1897396107800082432,2020-10,4529.77,1952.68,5390.87,4514.59,3453.37,22306.06
1897396107800082432,2020-11,3808.48,6284.6,459.97,2703.59,-4719.74,17586.32
1897396107800082432,2020-12,7498.88,2119.5,6050.25,2576.94,8852.69,26439.01
1897723756149448192,2020-02,0,888.37,0,0,-888.37,-888.37
1897723756149448192,2020-04,0,1397.86,0,0,-1397.86,-2286.23
1897723756149448192,2020-05,750.73,0,0,0,750.73,-1535.5
1897723756149448192,2020-06,1872.11,0,0,0,1872.11,336.61
1897723756149448192,2020-07,406.81,0,2974.2,294.59,3086.42,3423.03
1897723756149448192,2020-08,1693.47,0,1028.71,0,2722.18,6145.21
1897723756149448192,2020-09,1325.59,0,0,0,1325.59,7470.8
1897723756149448192,2020-10,0,1357.01,4449.11,2492.1,600,8070.8
1897723756149448192,2020-12,975.44,0,0,1363.98,-388.54,7682.26
1898411792739272448,2020-01,2600.21,12630.97,6773.18,4524.27,-7781.85,-7781.85
1898411792739272448,2020-02,7105.17,4434.72,3012.41,7780.81,-2097.95,-9879.8
1898411792739272448,2020-03,8639.89,6380.29,1974.19,4567.74,-333.95,-10213.75
1898411792739272448,2020-04,1868.63,6469.86,5835.59,2197.56,-963.2,-11176.95
1898411792739272448,2020-05,1961.43,3897.49,7981.25,3414.9,2630.29,-8546.66
1898411792739272448,2020-06,3041.5,6266.71,2417.04,1373,-2181.17,-10727.83
1898411792739272448,2020-07,3455.8,3774.59,0,669.07,-987.86,-11715.69
1898411792739272448,2020-08,2354.73,9794.06,7372.1,3155.62,-3222.85,-14938.54
1898411792739272448,2020-09,2094.64,5276.74,5869.36,4271.31,-1584.05,-16522.59
1898411792739272448,2020-10,1835.9,5983.15,2971.23,2365.16,-3541.18,-20063.77
1898411792739272448,2020-11,964.06,1296.48,2305.78,5113.62,-3140.26,-23204.03
1898411792739272448,2020-12,2632.06,271.94,1203.39,4516.35,-952.84,-24156.87
1899508429274744576,2020-01,1241.96,0,692.37,2344.63,-410.3,-410.3
1899508429274744576,2020-03,165.31,1089.76,470.64,1945.52,-2399.33,-2809.63
1899508429274744576,2020-04,1023.91,236.31,1454.96,505.82,1736.74,-1072.89
1899508429274744576,2020-05,258.81,36.23,0,4373.87,-4151.29,-5224.18
1899508429274744576,2020-06,0,4696.24,2257.77,1830.43,-4268.9,-9493.08
1899508429274744576,2020-07,0,3545.58,3039.66,2869.88,-3375.8,-12868.88
1899508429274744576,2020-08,0,42.81,4626.52,0,4583.71,-8285.17
1899508429274744576,2020-09,3497.9,1561.96,2438.83,265.69,4109.08,-4176.09
1899508429274744576,2020-10,2028.55,0,607.32,0,2635.87,-1540.22
1899508429274744576,2020-11,3337.54,943.48,433.57,2876.41,-48.78,-1589
1899508429274744576,2020-12,4696.69,886.52,920.35,659.74,4070.78,2481.78
1901228823300455680,2020-01,3276.99,3416.72,3250.17,1694.7,1415.74,1415.74
1901228823300455680,2020-02,52.84,2922.73,2549.4,3188.11,-3508.6,-2092.86
1901228823300455680,2020-03,4073.7,7890.1,4202.42,5965.61,-5579.59,-7672.45
1901228823300455680,2020-04,5987.5,8131.74,7249.17,7254.17,-2149.24,-9821.69
1901228823300455680,2020-05,1465.18,6007.08,4289.71,3546.73,-3798.92,-13620.61
1901228823300455680,2020-06,4719.64,4078.72,5965.72,2080.22,4526.42,-9094.19
1901228823300455680,2020-07,7924.96,967.08,2835.96,1652.8,8141.04,-953.15
1901228823300455680,2020-08,1630.86,4890.49,3891.04,4487.25,-3855.84,-4808.99
1901228823300455680,2020-09,4540.93,3946.29,1602.53,2149.44,47.73,-4761.26
1901228823300455680,2020-10,4029.89,5940.5,3705.4,775.27,1019.52,-3741.74
1901228823300455680,2020-11,5811.05,1744.78,5009.75,4816.04,4259.98,518.24
1901228823300455680,2020-12,2019.67,6509.41,3497.84,5985.77,-6977.67,-6459.43
1901534349752326400,2020-01,3703.49,6123.99,2562.78,3975.2,-3832.92,-3832.92
1901534349752326400,2020-02,3227.68,3069.44,6282.95,6763.19,-322,-4154.92
1901534349752326400,2020-03,3726.23,2154.61,3337.94,1207.64,3701.92,-453
1901534349752326400,2020-04,5644.99,5007,5349.42,5570,417.41,-35.59
1901534349752326400,2020-05,1876.05,7677.32,4036.69,9269.25,-11033.83,-11069.42
1901534349752326400,2020-06,8417.32,3693.21,3443.13,2670.06,5497.18,-5572.24
1901534349752326400,2020-07,1380.38,3615.41,2790.22,3524.95,-2969.76,-8542
1901534349752326400,2020-08,3629.39,5328.5,8695.97,950.2,6046.66,-2495.34
1901534349752326400,2020-09,7872.16,419.79,2290.26,1710.43,8032.2,5536.86
1901534349752326400,2020-10,3572.57,1448.31,2814.66,778.9,4160.02,9696.88
1901534349752326400,2020-11,5235.14,3513.75,6699.89,7133.4,1287.88,10984.76
1901534349752326400,2020-12,4417.27,1768.16,5868.42,1613.18,6904.35,17889.11
1902603130831384832,2020-01,3392.99,5797.98,0,2625.46,-5030.45,-5030.45
1902603130831384832,2020-02,8161.28,10206.11,3238.62,3173.1,-1979.31,-7009.76
1902603130831384832,2020-03,3422.54,2616.08,6487.85,8212.63,-918.32,-7928.08
1902603130831384832,2020-04,2065.75,6611.92,3190,3745.87,-5102.04,-13030.12
1902603130831384832,2020-05,2351.67,1437.23,2575.84,2448.65,1041.63,-11988.49
1902603130831384832,2020-06,3357.36,2780.27,8289.95,2104.75,6762.29,-5226.2
1902603130831384832,2020-07,7316.79,3570.11,6416.46,461.66,9701.48,4475.28
1902603130831384832,2020-08,1215.61,2342.38,4863.75,1663.92,2073.06,6548.34
1902603130831384832,2020-09,1960.25,1586.06,2896.22,4180.51,-910.1,5638.24
1902603130831384832,2020-10,4433.09,8825.22,7813.69,3277.66,143.9,5782.14
1902603130831384832,2020-11,1469.02,0,4933.64,1704.56,4698.1,10480.24
1902603130831384832,2020-12,3333.27,3669.71,2688.16,8921.94,-6570.22,3910.02
1903143830159793152,2020-01,0,656.85,4756.71,4414.21,-314.35,-314.35
1903143830159793152,2020-02,8577.82,4888.28,3205.72,3694.4,3200.86,2886.51
1903143830159793152,2020-03,6028.12,2848.42,2037.33,6266.43,-1049.4,1837.11
1903143830159793152,2020-04,2608.78,943.17,4459.86,2029.91,4095.56,5932.67
1903143830159793152,2020-05,0,3703.58,5294.51,4858.71,-3267.78,2664.89
1903143830159793152,2020-06,8147.46,1787.04,6382.94,562.82,12180.54,14845.43
1903143830159793152,2020-07,3839.96,5296.15,2369.43,4745.37,-3832.13,11013.3
1903143830159793152,2020-08,6417.83,0,1213.98,2916.76,4715.05,15728.35
1903143830159793152,2020-09,5476.04,2259.73,4392.59,5085.56,2523.34,18251.69
1903143830159793152,2020-10,7470.27,250.03,9266.89,3691.47,12795.66,31047.35
1903143830159793152,2020-11,5096.39,0,3620.23,2031.91,6684.71,37732.06
1903143830159793152,2020-12,1718.37,6409.95,4364.5,4874.3,-5201.38,32530.68
1903278746700771584,2020-01,6528.19,2833.24,4966.04,4348.78,4312.21,4312.21
1903278746700771584,2020-02,4106.61,1464.43,5116.79,8301.99,-543.02,3769.19
1903278746700771584,2020-03,3541.95,4344.93,5903.74,3643.29,1457.47,5226.66
1903278746700771584,2020-04,7603.32,4665.04,2450.07,8798.56,-3410.21,1816.45
1903278746700771584,2020-05,10471.84,236.87,6591.28,4262.14,12564.11,14380.56
1903278746700771584,2020-06,3002.31,7357.97,6626.87,1945.46,325.75,14706.31
1903278746700771584,2020-07,3664.55,3776.34,2825.47,4527.75,-1814.07,12892.24
1903278746700771584,2020-08,5006.39,4556.12,9525.48,1918.42,8057.33,20949.57
1903278746700771584,2020-09,1406.1,4792.9,2813.23,1859.22,-2432.79,18516.78
1903278746700771584,2020-10,9171.37,3061.51,10554.52,3153.7,13510.68,32027.46
1903278746700771584,2020-11,4619.88,1696.22,6403.99,6533.62,2794.03,34821.49
1903278746700771584,2020-12,2183.58,6354.48,5515.62,2773.34,-1428.62,33392.87
1903594511203137792,2020-01,0,1377.5,0,757.52,-2135.02,-2135.02
1903594511203137792,2020-02,0,1140.99,1497.28,3578.89,-3222.6,-5357.62
1903594511203137792,2020-03,1782.9,0,2147.29,3053.64,876.55,-4481.07
1903594511203137792,2020-04,535.25,1703,1514.98,0,347.23,-4133.84
1903594511203137792,2020-06,2044.23,0,560.71,0,2604.94,-1528.9
1903594511203137792,2020-07,1533.73,131.89,0,1152.09,249.75,-1279.15
1903594511203137792,2020-08,0,2919.71,0,2792.76,-5712.47,-6991.62
1903594511203137792,2020-09,1096.58,1010.34,0,980.26,-894.02,-7885.64
1903594511203137792,2020-10,0,2432.72,2285.33,2560.62,-2708.01,-10593.65
1903594511203137792,2020-11,1235.76,6988.93,0,1438.57,-7191.74,-17785.39
1903594511203137792,2020-12,3448.44,2730.28,0,1059.8,-341.64,-18127.03
1906204093647408896,2020-01,407.62,5521.89,3938.89,4478.42,-5653.8,-5653.8
1906204093647408896,2020-02,3510.86,2989.37,8384.14,3438.56,5467.07,-186.73
1906204093647408896,2020-03,4530.88,3865.96,2125,1921.55,868.37,681.64
1906204093647408896,2020-04,2980.81,5233.95,5065.24,4048.86,-1236.76,-555.12
1906204093647408896,2020-05,1463.76,2055.49,6449.32,1788.56,4069.03,3513.91
1906204093647408896,2020-06,2812.12,4708.77,7652.68,4527.67,1228.36,4742.27
1906204093647408896,2020-07,878.16,2451.02,11588.22,57.6,9957.76,14700.03
1906204093647408896,2020-08,7358.4,3052.35,4874.04,3466.56,5713.53,20413.56
1906204093647408896,2020-09,3516.89,4312.57,4924.94,4903.41,-774.15,19639.41
1906204093647408896,2020-10,8080.56,3489.48,3673.73,3492.95,4771.86,24411.27
1906204093647408896,2020-11,2651.27,4309.37,489.52,6158.6,-7327.18,17084.09
1906204093647408896,2020-12,4310.49,1556.06,3174.54,2133.16,3795.81,20879.9
1908917547283226624,2020-01,3128.22,2698.16,2988.91,5845.17,-2426.2,-2426.2
1908917547283226624,2020-02,321.45,1304.01,59.85,3483.44,-4406.15,-6832.35
1908917547283226624,2020-03,1970.05,1090.39,0,1011.01,-131.35,-6963.7
1908917547283226624,2020-04,0,1990.18,826.24,1592.41,-2756.35,-9720.05
1908917547283226624,2020-05,1954.82,553.5,1850.8,3769.86,-517.74,-10237.79
1908917547283226624,2020-06,3805.34,0,1939.78,4967.38,777.74,-9460.05
1908917547283226624,2020-07,4349.84,0,0,1677.36,2672.48,-6787.57
1908917547283226624,2020-08,3471.33,0,1696.99,722.36,4445.96,-2341.61
1908917547283226624,2020-09,0,2917.5,3447.42,1541.46,-1011.54,-3353.15
1908917547283226624,2020-10,1155.15,7637.07,1799.94,1791.41,-6473.39,-9826.54
1908917547283226624,2020-11,3680.09,1126.77,58.55,3522.64,-910.77,-10737.31
1908917547283226624,2020-12,3418.89,1133.25,1417.38,1787.51,1915.51,-8821.8
1909081253591783168,2020-01,715.98,1611.39,2199.46,2005.53,-701.48,-701.48
1909081253591783168,2020-02,830.26,0,969.51,0,1799.77,1098.29
1909081253591783168,2020-03,1856.76,0,362.31,953.33,1265.74,2364.03
1909081253591783168,2020-04,1027.11,5358.36,2327.97,1974.9,-3978.18,-1614.15
1909081253591783168,2020-05,3177.9,1273.85,0,2862.83,-958.78,-2572.93
1909081253591783168,2020-06,1489.97,0,0,1716.9,-226.93,-2799.86
1909081253591783168,2020-07,1659.95,2961.05,1606.86,1899.53,-1593.77,-4393.63
1909081253591783168,2020-08,308.97,2399.91,628.56,412.42,-1874.8,-6268.43
1909081253591783168,2020-09,2341.57,0,471.85,2950.98,-137.56,-6405.99
1909081253591783168,2020-10,2702.32,1906.41,0,2401.4,-1605.49,-8011.48
1909081253591783168,2020-11,389.19,2658.58,0,1973.74,-4243.13,-12254.61
1909081253591783168,2020-12,4547.67,1557.28,3296.6,2568.58,3718.41,-8536.2
1909721810662825216,2020-01,1233.68,1430.52,0,0,-196.84,-196.84
1909721810662825216,2020-02,1603.09,0,1526.89,1431.09,1698.89,1502.05
1909721810662825216,2020-03,0,4567,4996.98,5468.95,-5038.97,-3536.92
1909721810662825216,2020-04,5725.35,1968.06,2575.22,3055.42,3277.09,-259.83
1909721810662825216,2020-05,3120.48,0,501.75,1849.15,1773.08,1513.25
1909721810662825216,2020-06,6603.52,2388.94,1705.17,2271.06,3648.69,5161.94
1909721810662825216,2020-07,2173.04,1195.51,5608.53,2656.01,3930.05,9091.99
1909721810662825216,2020-08,0,1917.07,5056.78,2089.72,1049.99,10141.98
1909721810662825216,2020-09,3469.32,1566.19,0,1764.96,138.17,10280.15
1909721810662825216,2020-10,4530.75,3104.07,989.16,0,2415.84,12695.99
1909721810662825216,2020-11,0,8523.04,5005.36,0,-3517.68,9178.31
1909721810662825216,2020-12,2191.58,244.41,0,2889.9,-942.73,8235.58
1910024634235063808,2020-05,1162.22,0,0,0,1162.22,1162.22
1910024634235063808,2020-12,2081.51,0,425.24,0,2506.75,3668.97
1910767323472731136,2020-01,2623.8,3667.05,4539.05,2066.85,1428.95,1428.95
1910767323472731136,2020-02,2199.58,4168.13,2340.72,6620.86,-6248.69,-4819.74
1910767323472731136,2020-03,3968.21,2070.67,1450.44,2960.13,387.85,-4431.89
1910767323472731136,2020-04,8016.48,3416.59,3981.29,7680.18,901,-3530.89
1910767323472731136,2020-05,2787.24,7560.32,8552.6,3726.64,52.88,-3478.01
1910767323472731136,2020-06,7775.13,1235.05,5107.85,4092.78,7555.15,4077.14
1910767323472731136,2020-07,2093.97,4600.82,3821.45,3864.96,-2550.36,1526.78
1910767323472731136,2020-08,6625.69,3137.63,6204.88,5173.66,4519.28,6046.06
1910767323472731136,2020-09,4881.86,3452.42,6671.09,4201.49,3899.04,9945.1
1910767323472731136,2020-10,3158.78,8575.56,2279.58,3531.35,-6668.55,3276.55
1910767323472731136,2020-11,6208.08,1689.64,1022.21,3111.84,2428.81,5705.36
1910767323472731136,2020-12,2429.55,7246.6,4331.88,4373.15,-4858.32,847.04
1911533223705697536,2020-01,5257.62,2062.42,1766.84,3117.08,1844.96,1844.96
1911533223705697536,2020-02,6569.9,5244.02,1060.56,1993.78,392.66,2237.62
1911533223705697536,2020-03,1566.48,2366.29,6319.01,1430.6,4088.6,6326.22
1911533223705697536,2020-04,4206.76,2481.82,748.43,5508.19,-3034.82,3291.4
1911533223705697536,2020-05,6480.13,2906.06,2960.47,1694.8,4839.74,8131.14
1911533223705697536,2020-06,2478,3754.89,2953.77,3242.21,-1565.33,6565.81
1911533223705697536,2020-07,2700.79,1898.4,5040.79,2505.4,3337.78,9903.59
1911533223705697536,2020-08,1398.51,7284.21,689.32,2569.5,-7765.88,2137.71
1911533223705697536,2020-09,5467.58,617.54,0,2677.83,2172.21,4309.92
1911533223705697536,2020-10,2748.94,1638.08,4813.28,3348.51,2575.63,6885.55
1911533223705697536,2020-11,1880.17,6269.54,4121.64,2085.42,-2353.15,4532.4
1911533223705697536,2020-12,2435.55,8030.26,5514.81,4135.37,-4215.27,317.13
1911784529103594496,2020-01,2806.71,4160.94,2606.21,9647.77,-8395.79,-8395.79
1911784529103594496,2020-02,5609.55,7701.47,3975.75,3144.01,-1260.18,-9655.97
1911784529103594496,2020-03,4031.27,3404.97,3154.22,269.56,3510.96,-6145.01
1911784529103594496,2020-04,4312.21,4878.52,6.97,779.14,-1338.48,-7483.49
1911784529103594496,2020-05,4513.11,4047.19,5439.46,3667.5,2237.88,-5245.61
1911784529103594496,2020-06,375.99,1253.97,0,1674.34,-2552.32,-7797.93
1911784529103594496,2020-07,3654.75,9381.36,3415.15,4644.36,-6955.82,-14753.75
1911784529103594496,2020-08,1444.34,7527.94,2851.61,2677.93,-5909.92,-20663.67
1911784529103594496,2020-09,3745.49,837.36,6320.31,212.51,9015.93,-11647.74
1911784529103594496,2020-10,4861.86,8124.6,3193.13,5211.31,-5280.92,-16928.66
1911784529103594496,2020-11,4217.2,3841.48,3267.64,5283.05,-1639.69,-18568.35
1911784529103594496,2020-12,997,4204.82,1877.58,1722.31,-3052.55,-21620.9
1912972826898300160,2020-01,6091.43,480.34,2114.92,6674.14,1051.87,1051.87
1912972826898300160,2020-02,3065.4,6805.06,878.41,2493.11,-5354.36,-4302.49
1912972826898300160,2020-03,3587.77,1180.98,5238.41,4987.5,2657.7,-1644.79
1912972826898300160,2020-04,4256.58,2069.46,2249.68,1370.47,3066.33,1421.54
1912972826898300160,2020-05,1394.27,5549.74,2450.09,3761.19,-5466.57,-4045.03
1912972826898300160,2020-06,3354.81,1697.11,4535.99,6896.34,-702.65,-4747.68
1912972826898300160,2020-07,2159.63,10810.73,1370.57,2632.49,-9913.02,-14660.7
1912972826898300160,2020-08,63.28,7498.77,4519.45,4714.38,-7630.42,-22291.12
1912972826898300160,2020-09,3334.89,3373.32,558.03,1251.82,-732.22,-23023.34
1912972826898300160,2020-10,2952.05,4289.04,3742.95,2792.36,-386.4,-23409.74
1912972826898300160,2020-11,2543.84,1941.9,1437.03,1607.52,431.45,-22978.29
1912972826898300160,2020-12,5996.52,3636.78,8789.55,1031.33,10117.96,-12860.33
1913152319760410880,2020-01,1568.87,3051.7,1554.41,1579.16,-1507.58,-1507.58
1913152319760410880,2020-02,2772.34,0,2391.83,0,5164.17,3656.59
1913152319760410880,2020-03,2593.17,1346.56,4470.65,953.3,4763.96,8420.55
1913152319760410880,2020-04,2121.01,1607.23,2971.26,1982.77,1502.27,9922.82
1913152319760410880,2020-05,4092.09,6188.63,1495.97,5053.8,-5654.37,4268.45
1913152319760410880,2020-06,2784.55,1448.49,3724.96,2174.06,2886.96,7155.41
1913152319760410880,2020-07,561.38,2266.41,596.66,3043.47,-4151.84,3003.57
1913152319760410880,2020-08,1474.43,4757.58,0,3937.29,-7220.44,-4216.87
1913152319760410880,2020-09,1426.3,1873.11,0,0,-446.81,-4663.68
1913152319760410880,2020-10,549.04,1351.63,4697.73,3782.33,112.81,-4550.87
1913152319760410880,2020-11,1738.26,4460.29,817.66,5212.74,-7117.11,-11667.98
1913152319760410880,2020-12,1119.12,3894.77,2527.96,0,-247.69,-11915.67
1914848051149800192,2020-01,1626.56,407.72,380.88,0,1599.72,1599.72
1914848051149800192,2020-02,688.21,304.99,0,1591.22,-1208,391.72
1914848051149800192,2020-03,982.18,1061.91,0,1047.32,-1127.05,-735.33
1914848051149800192,2020-04,982.51,0,1162.53,2182.09,-37.05,-772.38
1914848051149800192,2020-05,512.55,94.38,4.6,1834.03,-1411.26,-2183.64
1914848051149800192,2020-06,210.88,1467.89,2269.93,3779.47,-2766.55,-4950.19
1914848051149800192,2020-07,1477.91,2356.74,0,2834.75,-3713.58,-8663.77
1914848051149800192,2020-08,1695.79,387.22,1661.02,421.54,2548.05,-6115.72
1914848051149800192,2020-09,1006.84,1968.67,197.33,473.15,-1237.65,-7353.37
1914848051149800192,2020-10,3117.94,242.17,499.99,1341.67,2034.09,-5319.28
1914848051149800192,2020-11,0,3973.38,1177.3,1748.39,-4544.47,-9863.75
1915136660227173376,2020-01,8158.1,2949.67,10329.16,6700.43,8837.16,8837.16
1915136660227173376,2020-02,1663.37,5153.82,3602.17,3537.29,-3425.57,5411.59
1915136660227173376,2020-03,5736.29,3146.85,5052.65,406.99,7235.1,12646.69
1915136660227173376,2020-04,4743.34,2281.03,7719.07,5293.09,4888.29,17534.98
1915136660227173376,2020-05,3693.28,1460.26,5845.5,1810.72,6267.8,23802.78
1915136660227173376,2020-06,7885.88,0,5542.17,3197.78,10230.27,34033.05
1915136660227173376,2020-07,5623.29,4980.82,536.75,3157.99,-1978.77,32054.28
1915136660227173376,2020-08,9147.56,1552.38,4314.77,5055.7,6854.25,38908.53
1915136660227173376,2020-09,6281.29,1530.88,6622.45,6252.21,5120.65,44029.18
1915136660227173376,2020-10,2545.67,7352.01,4838.74,4675.4,-4643,39386.18
1915136660227173376,2020-11,4417.71,4239.81,1823.32,0,2001.22,41387.4
1915136660227173376,2020-12,3386.74,4190.74,6885.36,0,6081.36,47468.76
1916447720901689088,2020-01,2467.58,4929.59,3053.91,1060.41,-468.51,-468.51
1916447720901689088,2020-02,383.19,0,4977.86,2831.6,2529.45,2060.94
1916447720901689088,2020-03,4839.33,4078.29,2149.24,4484.89,-1574.61,486.33
1916447720901689088,2020-04,3372.23,7786.95,5219.44,1645.85,-841.13,-354.8
1916447720901689088,2020-05,641.84,2741.36,507.74,1713.78,-3305.56,-3660.36
1916447720901689088,2020-06,1660.28,3694.48,1027.2,3811.76,-4818.76,-8479.12
1916447720901689088,2020-07,5205.57,0,689.8,0,5895.37,-2583.75
1916447720901689088,2020-08,5173.43,0,1445.41,4980.22,1638.62,-945.13
1916447720901689088,2020-09,2291.37,3838.87,146.77,4253.64,-5654.37,-6599.5
1916447720901689088,2020-10,3891.69,2467.16,2394.3,1641.35,2177.48,-4422.02
1916447720901689088,2020-11,3346.49,2459.81,2009.06,2054.05,841.69,-3580.33
1916447720901689088,2020-12,2398.97,3946.08,3244.03,4546.63,-2849.71,-6430.04
1916487883528890368,2020-01,4349.89,885.78,5451.4,933.09,7982.42,7982.42
1916487883528890368,2020-02,3500,6367.02,3877.54,3117.94,-2107.42,5875
1916487883528890368,2020-03,5196.03,324.58,8642.11,4559.39,8954.17,14829.17
1916487883528890368,2020-04,2331.04,2926.06,4448.87,1636.03,2217.82,17046.99
1916487883528890368,2020-05,1222.03,1825.82,1957.02,2720.28,-1367.05,15679.94
1916487883528890368,2020-06,7765.82,3344.71,2690.53,5966.82,1144.82,16824.76
1916487883528890368,2020-07,1606.83,236.5,0,6972.49,-5602.16,11222.6
1916487883528890368,2020-08,4028.19,5944.11,3466.21,2205.44,-655.15,10567.45
1916487883528890368,2020-09,1934.13,5816.36,3946.2,5665.58,-5601.61,4965.84
1916487883528890368,2020-10,788.74,3083.45,3502.83,4127.22,-2919.1,2046.74
1916487883528890368,2020-11,1059.99,0,110.92,570.6,600.31,2647.05
1916487883528890368,2020-12,4078.35,3291.83,4941.03,7122.4,-1394.85,1252.2
1917554016060850688,2020-01,7821.1,3248.94,11113.92,2650.16,13035.92,13035.92
1917554016060850688,2020-02,3345.7,8739.53,1110.13,7252.47,-11536.17,1499.75
1917554016060850688,2020-03,3510.28,3002.04,2087.22,1498.86,1096.6,2596.35
1917554016060850688,2020-04,1787.74,4743.9,1832.92,5069.36,-6192.6,-3596.25
1917554016060850688,2020-05,5839.64,5957.45,3917.18,2829.83,969.54,-2626.71
1917554016060850688,2020-06,10055.67,2895.96,7282.35,3003.46,11438.6,8811.89
1917554016060850688,2020-07,3387.36,5987.67,2682.32,4673.68,-4591.67,4220.22
1917554016060850688,2020-08,5237.61,4178.02,7533.15,2951.72,5641.02,9861.24
1917554016060850688,2020-09,2627.91,3767.71,7489.29,5934.31,415.18,10276.42
1917554016060850688,2020-10,6796.07,8192.58,6517.16,347.2,4773.45,15049.87
1917554016060850688,2020-11,4096.15,6728.38,6526.03,1771.43,2122.37,17172.24
1917554016060850688,2020-12,4553.59,4386.84,916.97,529.47,554.25,17726.49
1918283512740164096,2020-01,6598.59,5317.42,3731.52,2980.28,2032.41,2032.41
1918283512740164096,2020-02,1958.11,8552.11,4347.04,1191.81,-3438.77,-1406.36
1918283512740164096,2020-03,606.7,3747.66,6504.34,2029.24,1334.14,-72.22
1918283512740164096,2020-04,1262.12,5601.51,374.09,0,-3965.3,-4037.52
1918283512740164096,2020-05,3399.16,2892.78,3005.36,3139.09,372.65,-3664.87
1918283512740164096,2020-06,2645.09,3365.24,3157.41,5426.97,-2989.71,-6654.58
1918283512740164096,2020-07,2833.12,9907.67,8628.83,2178.21,-623.93,-7278.51
1918283512740164096,2020-08,7849.87,5925.37,6076.72,4311.64,3689.58,-3588.93
1918283512740164096,2020-09,6205.92,985.21,2987.49,5736.99,2471.21,-1117.72
1918283512740164096,2020-10,3084.45,1403.36,7403.78,8243.35,841.52,-276.2
1918283512740164096,2020-11,4554.2,2247.08,1479.1,2944.88,841.34,565.14
1918283512740164096,2020-12,9293.81,3286.55,6863.1,3085.19,9785.17,10350.31
1918655490019310336,2020-01,19.89,0,2920.16,564.03,2376.02,2376.02
1918655490019310336,2020-02,300.57,2849.43,898.55,3488.71,-5139.02,-2763
1918655490019310336,2020-03,1940.87,0,303.69,1938.66,305.9,-2457.1
1918655490019310336,2020-04,0,730.95,4689.45,7815.11,-3856.61,-6313.71
1918655490019310336,2020-05,2540.18,3706.97,3327.73,1640.83,520.11,-5793.6
1918655490019310336,2020-06,5307.14,0,3362.79,1279.11,7390.82,1597.22
1918655490019310336,2020-07,0,2160.28,1468.81,445.55,-1137.02,460.2
1918655490019310336,2020-08,1272.73,946.45,4235.26,1490.16,3071.38,3531.58
1918655490019310336,2020-09,150.63,2295.12,3077.69,5732.78,-4799.58,-1268
1918655490019310336,2020-10,0,3697.65,2695.07,0,-1002.58,-2270.58
1918655490019310336,2020-11,1213.42,3867.61,896.6,3755.17,-5512.76,-7783.34
1918655490019310336,2020-12,6361.88,1415.99,341.4,3078.89,2208.4,-5574.94
1921037251290877440,2020-01,6839.92,2193.09,2935.82,4031.71,3550.94,3550.94
1921037251290877440,2020-02,2391.95,0,1968.41,2915.64,1444.72,4995.66
1921037251290877440,2020-03,79.53,1998.59,4794.96,1512.67,1363.23,6358.89
1921037251290877440,2020-04,2895.71,1695.01,1604,2372.42,432.28,6791.17
1921037251290877440,2020-05,5923.83,4923.94,4280.66,2951,2329.55,9120.72
1921037251290877440,2020-06,426.54,5024.99,3926.52,3664.97,-4336.9,4783.82
1921037251290877440,2020-07,3106.58,3869.85,0,0,-763.27,4020.55
1921037251290877440,2020-08,994.07,2480.01,3753.69,8.22,2259.53,6280.08
1921037251290877440,2020-09,3342.96,3341.35,4235.24,4788.13,-551.28,5728.8
1921037251290877440,2020-10,2872.93,1954.56,1982.74,177.24,2723.87,8452.67
1921037251290877440,2020-11,5036.36,3066.21,4516.33,81.6,6404.88,14857.55
1921037251290877440,2020-12,2944.97,1224.97,3406.78,3010.6,2116.18,16973.73
1921312883281050112,2020-01,1771.88,3591.84,4346.7,3343.1,-816.36,-816.36
1921312883281050112,2020-02,3371.88,7008,266.76,1440.99,-4810.35,-5626.71
1921312883281050112,2020-03,1995.89,4559.34,1476.66,1476.72,-2563.51,-8190.22
1921312883281050112,2020-04,1384.32,2013.58,3557.87,3739.52,-810.91,-9001.13
1921312883281050112,2020-05,3965.51,5711.88,1664.75,2666.49,-2748.11,-11749.24
1921312883281050112,2020-06,3822.49,1638.04,3331.23,256.08,5259.6,-6489.64
1921312883281050112,2020-07,1925.28,2894.72,1540.59,6259.85,-5688.7,-12178.34
1921312883281050112,2020-08,2020.8,2019.64,2338.55,3253.21,-913.5,-13091.84
1921312883281050112,2020-09,2501.42,2680.82,2308.76,6343.18,-4213.82,-17305.66
1921312883281050112,2020-10,2000.85,3288.07,3759.11,5605.51,-3133.62,-20439.28
1921312883281050112,2020-11,2949.18,2622.31,1425.93,3086.37,-1333.57,-21772.85
1921312883281050112,2020-12,724.78,0,3591.69,5541.63,-1225.16,-22998.01
1921396465200295936,2020-01,1632.2,1674,1588.45,6767.81,-5221.16,-5221.16
1921396465200295936,2020-02,370.33,2112.77,5294.61,2797.14,755.03,-4466.13
1921396465200295936,2020-03,2060.84,2828.43,4034.53,5899.37,-2632.43,-7098.56
1921396465200295936,2020-04,0,4417.9,1795.11,370.36,-2993.15,-10091.71
1921396465200295936,2020-05,1952.38,744.26,2319.13,3819.47,-292.22,-10383.93
1921396465200295936,2020-06,1194.08,2528,1675.57,1921.93,-1580.28,-11964.21
1921396465200295936,2020-07,687.48,0,2832.83,2137.22,1383.09,-10581.12
1921396465200295936,2020-08,2049.38,3609.92,911.86,1907.1,-2555.78,-13136.9
1921396465200295936,2020-09,1387.48,2453.52,1235.17,1352.18,-1183.05,-14319.95
1921396465200295936,2020-10,602.5,5152.7,733.22,1694.91,-5511.89,-19831.84
1921396465200295936,2020-11,1657.59,2246.32,4398.13,0,3809.4,-16022.44
1921396465200295936,2020-12,1035.02,1818.77,3066.23,1583.7,698.78,-15323.66
1922642443729469952,2020-01,546.33,1502.98,6362.88,4426.16,980.07,980.07
1922642443729469952,2020-02,488.85,819.63,3924.16,2914.47,678.91,1658.98
1922642443729469952,2020-03,636.46,3013.09,5122.47,416.36,2329.48,3988.46
1922642443729469952,2020-04,0,3054.79,1254.15,1448.82,-3249.46,739
1922642443729469952,2020-05,0,2592.07,1776.48,3133.74,-3949.33,-3210.33
1922642443729469952,2020-06,3272.36,4658.01,3960.49,2101.44,473.4,-2736.93
1922642443729469952,2020-07,0,1247.28,4934.42,4198.94,-511.8,-3248.73
1922642443729469952,2020-08,1630.21,611.84,3690.7,1580.77,3128.3,-120.43
1922642443729469952,2020-09,1323.08,3582.3,4088.42,0,1829.2,1708.77
1922642443729469952,2020-10,5141.72,0,195.03,1288.22,4048.53,5757.3
1922642443729469952,2020-11,1804.46,3641.72,6516.39,1579.62,3099.51,8856.81
1922642443729469952,2020-12,6290.07,0,691.72,3391.65,3590.14,12446.95
1923469440001817856,2020-01,5377.94,1993.71,4592.92,5683.3,2293.85,2293.85
1923469440001817856,2020-02,1145.37,1745.63,3375.06,3596.31,-821.51,1472.34
1923469440001817856,2020-03,3471.48,4878.94,3894.43,2975.97,-489,983.34
1923469440001817856,2020-04,2268.06,5904.76,1810.35,1623.72,-3450.07,-2466.73
1923469440001817856,2020-05,74.42,433.43,1023.42,3374.06,-2709.65,-5176.38
1923469440001817856,2020-06,3211.28,1039.6,3526.28,2382.39,3315.57,-1860.81
1923469440001817856,2020-07,3813.64,3590.67,3517.38,4414.34,-673.99,-2534.8
1923469440001817856,2020-08,1205.65,4177.17,302.77,852.86,-3521.61,-6056.41
1923469440001817856,2020-09,4465.36,6366.01,1116.05,3382.1,-4166.7,-10223.11
1923469440001817856,2020-10,6979.15,3070.69,6638.79,924.59,9622.66,-600.45
1923469440001817856,2020-12,4017.35,2160.27,2424.23,7736.7,-3455.39,-4055.84
1924159914821152768,2020-03,971.08,0,0,0,971.08,971.08
1924159914821152768,2020-09,0,1141.69,0,0,-1141.69,-170.61
1924159914821152768,2020-11,3253.8,0,0,0,3253.8,3083.19
1924159914821152768,2020-12,1916.67,0,1070.57,0,2987.24,6070.43
1924169836445591040,2020-01,2004.5,0,189.27,0,2193.77,2193.77
1924169836445591040,2020-04,434.37,0,766.46,0,1200.83,3394.6
1924169836445591040,2020-05,0,1070.89,606.81,1483.19,-1947.27,1447.33
1924169836445591040,2020-06,1688.18,0,0,1708.98,-20.8,1426.53
1924169836445591040,2020-07,1802.72,4939.24,0,0,-3136.52,-1709.99
1924169836445591040,2020-08,1209.93,0,1859.97,0,3069.9,1359.91
1924169836445591040,2020-09,0,1442.69,0,660.57,-2103.26,-743.35
1924169836445591040,2020-10,366.36,942.97,2192.16,0,1615.55,872.2
1924169836445591040,2020-11,2337.45,1805.89,0,0,531.56,1403.76
1924169836445591040,2020-12,1847.24,1370.41,1765.44,1097.43,1144.84,2548.6
1925423204255336448,2020-01,2616.16,4290.13,4907.4,2490.72,742.71,742.71
1925423204255336448,2020-02,3319.68,1245.56,7625.75,8898.74,801.13,1543.84
1925423204255336448,2020-03,4937.44,5568.05,3284.08,3839.51,-1186.04,357.8
1925423204255336448,2020-04,9480.3,12816.51,1543.96,7311.72,-9103.97,-8746.17
1925423204255336448,2020-05,5163.37,5882.42,5548.76,3667.24,1162.47,-7583.7
1925423204255336448,2020-06,3878.37,7139.67,5229.02,3656.58,-1688.86,-9272.56
1925423204255336448,2020-07,2753.36,5285.78,1404.75,7179.49,-8307.16,-17579.72
1925423204255336448,2020-08,4802.67,7671.73,4282.15,4292.66,-2879.57,-20459.29
1925423204255336448,2020-09,6689.55,4894.62,2395.59,7776.39,-3585.87,-24045.16
1925423204255336448,2020-10,4842.43,5519.2,3981.54,3407.93,-103.16,-24148.32
1925423204255336448,2020-11,3638.43,2123.61,1223.96,6714.27,-3975.49,-28123.81
1925423204255336448,2020-12,5244.69,3248.81,5819.49,9178.77,-1363.4,-29487.21
1926215778679508224,2020-01,9893,4256.15,5932.47,2022.18,9547.14,9547.14
1926215778679508224,2020-02,3251.57,2078.14,4871.13,3912.01,2132.55,11679.69
1926215778679508224,2020-03,2679.28,11333.87,4415.72,915.58,-5154.45,6525.24
1926215778679508224,2020-04,2208.34,6323.9,6914.6,4186.04,-1387,5138.24
1926215778679508224,2020-05,7914.9,2638.37,746.94,626.97,5396.5,10534.74
1926215778679508224,2020-06,432.9,1926.64,332.96,2463.01,-3623.79,6910.95
1926215778679508224,2020-07,6694.09,2871.05,3245.78,3140.84,3927.98,10838.93
1926215778679508224,2020-08,4556.1,2755.07,2278.43,5137.82,-1058.36,9780.57
1926215778679508224,2020-09,1418.04,5865.45,5047.94,5009.14,-4408.61,5371.96
1926215778679508224,2020-10,4553.3,4935.12,8784.47,5805.18,2597.47,7969.43
1926215778679508224,2020-11,852.06,2781.36,6426.71,3948.07,549.34,8518.77
1926215778679508224,2020-12,3704.7,2937.92,2387.78,6314.62,-3160.06,5358.71
1928442841913974528,2020-01,1897.16,0,0,206.98,1690.18,1690.18
1928442841913974528,2020-02,725.39,0,0,0,725.39,2415.57
1928442841913974528,2020-03,191.34,0,0,0,191.34,2606.91
1928442841913974528,2020-06,178.76,915.91,1226.05,858.35,-369.45,2237.46
1928442841913974528,2020-07,0,922.36,0,1497.22,-2419.58,-182.12
1928442841913974528,2020-09,1782.27,0,1409.24,3414.17,-222.66,-404.78
1928442841913974528,2020-10,2570.78,0,984.32,1659.48,1895.62,1490.84
1928442841913974528,2020-11,1703.06,0,0,2636.26,-933.2,557.64
1928442841913974528,2020-12,3288.81,1322.66,0,1659.2,306.95,864.59
1929222383055019520,2020-01,6878.08,2579.73,7273.94,6152.87,5419.42,5419.42
1929222383055019520,2020-02,2824.25,4665.04,5669.81,2909.91,919.11,6338.53
1929222383055019520,2020-03,1851.19,2903.37,623.14,0,-429.04,5909.49
1929222383055019520,2020-04,0,4666.73,2043.49,2421.96,-5045.2,864.29
1929222383055019520,2020-05,6364.17,1797.06,1957.65,3615.55,2909.21,3773.5
1929222383055019520,2020-06,2432.67,2040.61,4370.34,4704.54,57.86,3831.36
1929222383055019520,2020-07,1792.71,2185.22,4770.62,7950.22,-3572.11,259.25
1929222383055019520,2020-08,3340.66,1017.52,7629.53,2550.99,7401.68,7660.93
1929222383055019520,2020-09,2340.7,8119.3,3719.69,1426.59,-3485.5,4175.43
1929222383055019520,2020-10,3492.28,2544.59,9706.23,2820.81,7833.11,12008.54
1929222383055019520,2020-11,4730.37,0,4146.97,5298.24,3579.1,15587.64
1929222383055019520,2020-12,1983.05,2339.75,3401.13,2985.38,59.05,15646.69
1934557604844513536,2020-01,5770.17,1198.73,3082.71,3802.5,3851.65,3851.65
1934557604844513536,2020-02,5501.6,4934.86,4480.27,5283.82,-236.81,3614.84
1934557604844513536,2020-03,6604.58,7775.41,4179.03,4445.64,-1437.44,2177.4
1934557604844513536,2020-04,4771.08,1792.49,4486.83,4938.69,2526.73,4704.13
1934557604844513536,2020-05,3233.05,4011.19,4606.23,1454.71,2373.38,7077.51
1934557604844513536,2020-06,5739.22,604.95,0,5209.72,-75.45,7002.06
1934557604844513536,2020-07,6140.37,2858.41,0,1996.54,1285.42,8287.48
1934557604844513536,2020-08,9082.35,7301.17,7306.22,6254.15,2833.25,11120.73
1934557604844513536,2020-09,5325.64,3908.95,1666.34,1878.39,1204.64,12325.37
1934557604844513536,2020-10,5502.2,5764.33,1414.73,4033.08,-2880.48,9444.89
1934557604844513536,2020-11,5017.07,5272.79,4952.42,4189.77,506.93,9951.82
1934557604844513536,2020-12,5270.82,7799.86,6558.84,2870.42,1159.38,11111.2
1935998944591101696,2020-01,0,3451.62,1463.67,670.31,-2658.26,-2658.26
1935998944591101696,2020-02,1224.09,4133.37,0,2042.33,-4951.61,-7609.87
1935998944591101696,2020-03,352.39,1525.23,800.33,476.84,-849.35,-8459.22
1935998944591101696,2020-04,740.21,2380.36,0,0,-1640.15,-10099.37
1935998944591101696,2020-05,0,3274.44,2391.81,762.95,-1645.58,-11744.95
1935998944591101696,2020-06,0,1431.65,4835.07,1237.32,2166.1,-9578.85
1935998944591101696,2020-07,764.79,1790.19,61.81,0,-963.59,-10542.44
1935998944591101696,2020-08,1852.24,650.45,1268.93,0,2470.72,-8071.72
1935998944591101696,2020-09,4688.86,0,1708.29,1982.18,4414.97,-3656.75
1935998944591101696,2020-10,33.18,0,0,470.18,-437,-4093.75
1935998944591101696,2020-11,0,2208.95,0,686.86,-2895.81,-6989.56
1935998944591101696,2020-12,7858.49,409.1,573.81,2076,5947.2,-1042.36
1938831146590589440,2020-01,1307.81,1111.9,2010.87,2429.26,-222.48,-222.48
1938831146590589440,2020-02,3116.08,1350.4,0,721.55,1044.13,821.65
1938831146590589440,2020-03,1083.21,4007.55,0,3630.12,-6554.46,-5732.81
1938831146590589440,2020-04,3495.78,3378.82,602.15,1637.54,-918.43,-6651.24
1938831146590589440,2020-05,1005.24,0,3514.16,3644.91,874.49,-5776.75
1938831146590589440,2020-06,4500.81,2732.22,1913.95,2218.7,1463.84,-4312.91
1938831146590589440,2020-07,2732.21,0,0,5250.17,-2517.96,-6830.87
1938831146590589440,2020-08,2995.64,400.95,3398.85,0,5993.54,-837.33
1938831146590589440,2020-09,0,43.21,5041.94,71.76,4926.97,4089.64
1938831146590589440,2020-10,0,2923.84,563.33,2994.08,-5354.59,-1264.95
1938831146590589440,2020-11,3527.16,0,2637.82,714,5450.98,4186.03
1938831146590589440,2020-12,449.13,1300.76,38.42,1892.7,-2705.91,1480.12
1939402546244374016,2020-02,0,2052.89,1852.67,0,-200.22,-200.22
1939402546244374016,2020-03,0,1784.69,1454.84,1926.16,-2256.01,-2456.23
1939402546244374016,2020-05,227.26,2483.6,405.5,748.92,-2599.76,-5055.99
1939402546244374016,2020-06,2210.65,27.06,0,483.92,1699.67,-3356.32
1939402546244374016,2020-07,1146.79,1897.11,0,0,-750.32,-4106.64
1939402546244374016,2020-08,565.75,103.83,391.86,1153.96,-300.18,-4406.82
1939402546244374016,2020-10,2851.35,0,0,1946.98,904.37,-3502.45
1940564976545891840,2020-01,226.17,3589.5,0,2590.49,-5953.82,-5953.82
1940564976545891840,2020-02,2685.59,7374.53,2027.77,245.35,-2906.52,-8860.34
1940564976545891840,2020-03,0,2890.3,4289.5,3315.52,-1916.32,-10776.66
1940564976545891840,2020-04,2917.38,4328.43,2051.68,1873.04,-1232.41,-12009.07
1940564976545891840,2020-05,3203.96,7569.94,1443.69,5436.11,-8358.4,-20367.47
1940564976545891840,2020-06,3170.79,2086.65,3454.68,4781.69,-242.87,-20610.34
1940564976545891840,2020-07,247.03,3493.65,1376.78,2935.92,-4805.76,-25416.1
1940564976545891840,2020-08,2117.66,0,5532.1,4791.91,2857.85,-22558.25
1940564976545891840,2020-09,1251.97,2370.04,697.8,2962.84,-3383.11,-25941.36
1940564976545891840,2020-10,3263.7,3837.43,577.44,4230.71,-4227,-30168.36
1940564976545891840,2020-11,3521.87,3377.35,0,4799.38,-4654.86,-34823.22
1940564976545891840,2020-12,6733.03,2971.06,985.56,2812.18,1935.35,-32887.87
1941809889078829312,2020-06,0,1741.71,0,0,-1741.71,-1741.71
1942450447856802816,2020-02,728.81,0,0,0,728.81,728.81
1942450447856802816,2020-04,980.07,0,1479.9,1948.18,511.79,1240.6
1942450447856802816,2020-06,0,1630.91,0,1099.27,-2730.18,-1489.58
1942450447856802816,2020-11,1208.89,42.48,0,0,1166.41,-323.17
1943572092420033280,2020-02,3628.18,0,446.73,733.99,3340.92,3340.92
1943572092420033280,2020-04,1135.48,0,0,902.54,232.94,3573.86
1943572092420033280,2020-05,55.71,0,0,1334.03,-1278.32,2295.54
1943572092420033280,2020-06,653.73,1303.06,0,843.16,-1492.49,803.05
1943572092420033280,2020-08,2242.12,1204.66,466.26,1319.54,184.18,987.23
1943572092420033280,2020-09,0,2965.53,2082.32,1182.44,-2065.65,-1078.42
1943572092420033280,2020-10,0,1138.2,0,1369.65,-2507.85,-3586.27
1943572092420033280,2020-11,2357.11,540.29,0,422.83,1393.99,-2192.28
1943572092420033280,2020-12,4852.57,1334.34,1472.2,1428.95,3561.48,1369.2
1943692487052691456,2020-01,546.45,288.7,2698.94,1992.55,964.14,964.14
1943692487052691456,2020-04,911.18,647.3,3180.65,0,3444.53,4408.67
1943692487052691456,2020-07,910.75,2994.6,1424.98,5459.97,-6118.84,-1710.17
1943692487052691456,2020-08,1335.29,1582.96,0,1203.09,-1450.76,-3160.93
1943692487052691456,2020-09,880.1,211.77,1821.14,1800.08,689.39,-2471.54
1943692487052691456,2020-10,3602.92,2042.16,3515.9,2551.79,2524.87,53.33
1943692487052691456,2020-11,0,2542.92,0,1359.02,-3901.94,-3848.61
1943692487052691456,2020-12,0,1496.33,0,2439.8,-3936.13,-7784.74
1944597436332945152,2020-01,8574.5,774.79,5769.18,4116.59,9452.3,9452.3
1944597436332945152,2020-02,1059.75,2405.58,6246.12,4932.21,-31.92,9420.38
1944597436332945152,2020-03,9314.3,2338.09,3025.95,3182.59,6819.57,16239.95
1944597436332945152,2020-04,7207.69,2143.57,1855.3,8475.07,-1555.65,14684.3
1944597436332945152,2020-05,2636.58,10642.87,4996.71,4436.94,-7446.52,7237.78
1944597436332945152,2020-06,2907.7,6477.91,1526.84,8748.2,-10791.57,-3553.79
1944597436332945152,2020-07,0,2412.79,3377.29,3761.93,-2797.43,-6351.22
1944597436332945152,2020-08,348.38,6077.32,2603.44,5102.44,-8227.94,-14579.16
1944597436332945152,2020-09,3692.14,3001.79,2815.91,3503.49,2.77,-14576.39
1944597436332945152,2020-10,5806.29,3539.23,995.89,2744.94,518.01,-14058.38
1944597436332945152,2020-11,11016.01,3456.93,3511.62,4254.18,6816.52,-7241.86
1944597436332945152,2020-12,8155.91,6853.21,2290.51,4762.07,-1168.86,-8410.72
1945603367318672384,2020-01,0,2832.1,3208.72,3785.18,-3408.56,-3408.56
1945603367318672384,2020-02,786.9,4813.82,421.33,2385.26,-5990.85,-9399.41
1945603367318672384,2020-03,2848.92,3228.58,3673.98,1465.67,1828.65,-7570.76
1945603367318672384,2020-04,1773.49,6059.32,903.77,5043.18,-8425.24,-15996
1945603367318672384,2020-05,1226.55,5988.35,1791.62,3377.22,-6347.4,-22343.4
1945603367318672384,2020-06,3538.84,2996.06,5516.41,5855.84,203.35,-22140.05
1945603367318672384,2020-07,2660.3,260.3,3719.72,4164.51,1955.21,-20184.84
1945603367318672384,2020-08,5633.41,4315.49,6935.45,2122.34,6131.03,-14053.81
1945603367318672384,2020-09,3334.05,2393.92,4665.07,3577.77,2027.43,-12026.38
1945603367318672384,2020-10,5985.73,9111.63,1820.48,4465.18,-5770.6,-17796.98
1945603367318672384,2020-11,304.36,1908.9,3134.62,3723.52,-2193.44,-19990.42
1945603367318672384,2020-12,3921.54,9595.73,8477.01,2634.53,168.29,-19822.13
1948388502601509632,2020-01,1141.72,3419.92,1653.64,310.78,-935.34,-935.34
1948388502601509632,2020-02,1163.26,2497.56,3343.16,2307.97,-299.11,-1234.45
1948388502601509632,2020-03,3921.44,2396.47,3379.64,986.31,3918.3,2683.85
1948388502601509632,2020-04,3600.44,0,3148.44,1748.49,5000.39,7684.24
1948388502601509632,2020-05,5849.74,1040.92,2803.59,196.28,7416.13,15100.37
1948388502601509632,2020-06,428.07,0,0,3692.28,-3264.21,11836.16
1948388502601509632,2020-07,3004.53,0,1729.98,802.31,3932.2,15768.36
1948388502601509632,2020-08,1199.71,1812.22,4487.4,0,3874.89,19643.25
1948388502601509632,2020-09,1981.02,2274.7,124.59,1458.36,-1627.45,18015.8
1948388502601509632,2020-10,587.79,1065.46,2095.94,444.53,1173.74,19189.54
1948388502601509632,2020-11,1234.3,2633.51,5980.75,4840.56,-259.02,18930.52
1948388502601509632,2020-12,0,3324.39,3202.33,3463.64,-3585.7,15344.82
1948552165337271808,2020-01,5160.99,1459.3,1364.69,2783.1,2283.28,2283.28
1948552165337271808,2020-02,2067.89,2168.59,3940.86,3666.91,173.25,2456.53
1948552165337271808,2020-03,1337.5,6581.63,2861.02,6458.66,-8841.77,-6385.24
1948552165337271808,2020-04,2879.97,4121.3,3952.64,3314.82,-603.51,-6988.75
1948552165337271808,2020-05,0,1545.03,6170.16,4419.78,205.35,-6783.4
1948552165337271808,2020-06,4139,5916.85,6704.28,1804.68,3121.75,-3661.65
1948552165337271808,2020-07,3341.35,7175.44,9609.46,2682.32,3093.05,-568.6
1948552165337271808,2020-08,8785.86,4478.77,6913.39,5190.64,6029.84,5461.24
1948552165337271808,2020-09,343.9,4275.42,5394,4319.18,-2856.7,2604.54
1948552165337271808,2020-10,1962.28,6043.74,157.98,5582.13,-9505.61,-6901.07
1948552165337271808,2020-11,2594.52,8697.1,6669.33,7711.01,-7144.26,-14045.33
1948552165337271808,2020-12,3806.9,6143.62,5338.01,4085.08,-1083.79,-15129.12
1953112728923266048,2020-04,0,1295.5,0,0,-1295.5,-1295.5
1953112728923266048,2020-05,277.51,0,0,0,277.51,-1017.99
1953112728923266048,2020-10,1288.34,732.09,157.34,1146.81,-433.22,-1451.21
1953403675746750464,2020-01,0,985.28,2791.65,1822.35,-15.98,-15.98
1953403675746750464,2020-02,1300.94,1156.68,0,382.91,-238.65,-254.63
1953403675746750464,2020-03,989.73,1620.79,1090.63,306.43,153.14,-101.49
1953403675746750464,2020-05,0,2905.99,0,3192.78,-6098.77,-6200.26
1953403675746750464,2020-06,2900.61,2351.83,221.46,2528.21,-1757.97,-7958.23
1953403675746750464,2020-07,827.84,0,0,1443.08,-615.24,-8573.47
1953403675746750464,2020-08,206.72,1817.34,0,359.67,-1970.29,-10543.76
1953403675746750464,2020-09,1412.72,1992.35,0,556.94,-1136.57,-11680.33
1953403675746750464,2020-10,1258.89,3548.27,3189.99,173.73,726.88,-10953.45
1953403675746750464,2020-11,0,153.75,2176.98,0,2023.23,-8930.22
1953403675746750464,2020-12,251.29,1488.52,1538.4,1516.67,-1215.5,-10145.72
1953888712127537408,2020-01,8801.57,2523.99,3164.21,3633.79,5808,5808
1953888712127537408,2020-02,5105.43,2144.09,6671.03,8748.88,883.49,6691.49
1953888712127537408,2020-03,1499.96,8764.75,4511.82,2393.61,-5146.58,1544.91
1953888712127537408,2020-04,3171.12,1755.32,3571.62,3106.96,1880.46,3425.37
1953888712127537408,2020-05,3768.54,4356.52,4033.42,4928.62,-1483.18,1942.19
1953888712127537408,2020-06,2512.36,10219.25,5530.49,5322.93,-7499.33,-5557.14
1953888712127537408,2020-07,2970.46,6514.57,6895.87,3746.47,-394.71,-5951.85
1953888712127537408,2020-08,5035.28,4345.72,7097.02,279.74,7506.84,1554.99
1953888712127537408,2020-09,6781.96,1369.2,1006.29,3738.75,2680.3,4235.29
1953888712127537408,2020-10,7984.43,4246.45,0,6967.03,-3229.05,1006.24
1953888712127537408,2020-11,2573.8,945.13,3136.12,1743.02,3021.77,4028.01
1953888712127537408,2020-12,1639.14,2808.23,10995.44,2668.14,7158.21,11186.22
1954046449538448384,2020-01,4640.5,5240.18,247.12,4118.03,-4470.59,-4470.59
1954046449538448384,2020-02,4177.01,9103.56,5391.18,2283.46,-1818.83,-6289.42
1954046449538448384,2020-03,9020.8,8039.85,3452.46,5868.44,-1435.03,-7724.45
1954046449538448384,2020-04,4578.25,2806.25,3243.12,2962.47,2052.65,-5671.8
1954046449538448384,2020-05,3779.69,6149.21,4036.2,2463.49,-796.81,-6468.61
1954046449538448384,2020-06,4079.24,4102.09,3042.82,5067.72,-2047.75,-8516.36
1954046449538448384,2020-07,8888.43,116.17,4905.33,2359.67,11317.92,2801.56
1954046449538448384,2020-08,6022.56,1550.98,4410.31,2978.11,5903.78,8705.34
1954046449538448384,2020-09,1796.15,2564.26,4254.59,3591.68,-105.2,8600.14
1954046449538448384,2020-10,1452.84,5952.6,4798.77,2336.86,-2037.85,6562.29
1954046449538448384,2020-11,1974.4,3861.9,1301.74,4848.09,-5433.85,1128.44
1954046449538448384,2020-12,2283.68,9293.66,11640.88,4244.98,385.92,1514.36
1954910759338726912,2020-01,0,1121.37,2227.86,2055.38,-948.89,-948.89
1954910759338726912,2020-02,2455.97,2114.51,5708.44,2598.32,3451.58,2502.69
1954910759338726912,2020-03,3358.01,3036.8,222.76,842.92,-298.95,2203.74
1954910759338726912,2020-04,4033.79,1800.1,275.43,7083.32,-4574.2,-2370.46
1954910759338726912,2020-05,4764.49,1404.08,1053.09,1346.22,3067.28,696.82
1954910759338726912,2020-06,1032.49,1309,320.51,1707.16,-1663.16,-966.34
1954910759338726912,2020-07,1303.5,3010.59,1304.14,419.87,-822.82,-1789.16
1954910759338726912,2020-08,1819.48,3278.68,5937.62,913.64,3564.78,1775.62
1954910759338726912,2020-09,464.34,880.83,4867.79,1046.21,3405.09,5180.71
1954910759338726912,2020-10,1718.51,3480.72,1494.21,21.95,-289.95,4890.76
1954910759338726912,2020-11,5974.11,2273.08,597.44,0,4298.47,9189.23
1954910759338726912,2020-12,2602.97,1294.65,0,2783,-1474.68,7714.55
1955342249735495936,2020-02,0,115.49,0,0,-115.49,-115.49
1955342249735495936,2020-03,1738.41,0,2096.7,903.29,2931.82,2816.33
1955342249735495936,2020-04,509.2,1292.56,0,0,-783.36,2032.97
1955342249735495936,2020-06,952.03,330.12,0,1337.43,-715.52,1317.45
1955342249735495936,2020-08,0,883.25,441.73,1840.61,-2282.13,-964.68
1955342249735495936,2020-09,628.7,0,0,2387.9,-1759.2,-2723.88
1955342249735495936,2020-10,0,47.51,0,0,-47.51,-2771.39
1955342249735495936,2020-11,0,125.31,1413.91,0,1288.6,-1482.79
1955342249735495936,2020-12,0,1564.88,687.68,0,-877.2,-2359.99
1958747504009500672,2020-01,2230.91,352.05,0,5067.29,-3188.43,-3188.43
1958747504009500672,2020-02,0,904.11,55.97,2117.76,-2965.9,-6154.33
1958747504009500672,2020-03,661.56,617.25,2682.59,489.99,2236.91,-3917.42
1958747504009500672,2020-05,1031.73,2191.26,1031.44,0,-128.09,-4045.51
1958747504009500672,2020-06,226.76,871.11,1667.6,3108.7,-2085.45,-6130.96
1958747504009500672,2020-07,1096.62,1768.64,1853.33,1192.73,-11.42,-6142.38
1958747504009500672,2020-08,1334.04,1001.58,3059.3,1281.13,2110.63,-4031.75
1958747504009500672,2020-09,1053.85,3699.44,4985.11,0,2339.52,-1692.23
1958747504009500672,2020-10,3443.31,0,754.62,3769.23,428.7,-1263.53
1958747504009500672,2020-11,1050.2,1423.42,2144.03,1569.19,201.62,-1061.91
1958747504009500672,2020-12,1391.06,1934.78,0,2990.32,-3534.04,-4595.95
1958828896084349184,2020-01,4348.4,2813.05,571.91,629.41,1477.85,1477.85
1958828896084349184,2020-02,2865.21,1547.84,443.35,1731.37,29.35,1507.2
1958828896084349184,2020-03,2839.24,2706.34,1305.76,2551.31,-1112.65,394.55
1958828896084349184,2020-04,0,1.08,0,15.63,-16.71,377.84
1958828896084349184,2020-05,1539.52,2161.19,791.41,1004.64,-834.9,-457.06
1958828896084349184,2020-06,2588.41,4635.52,1073.56,0,-973.55,-1430.61
1958828896084349184,2020-07,0,1883.05,834.23,1626.1,-2674.92,-4105.53
1958828896084349184,2020-08,853.58,3038.59,2747.44,1228.25,-665.82,-4771.35
1958828896084349184,2020-09,1093.6,1347.29,0,1343.69,-1597.38,-6368.73
1958828896084349184,2020-10,4807.6,2726.96,818.24,5737.72,-2838.84,-9207.57
1958828896084349184,2020-11,1709.44,89.03,5558.87,0,7179.28,-2028.29
1958828896084349184,2020-12,0,3436.89,3742.72,3373.89,-3068.06,-5096.35
1959448192281450496,2020-01,0,2784.91,0,0,-2784.91,-2784.91
1959448192281450496,2020-03,1071.64,0,0,1629.27,-557.63,-3342.54
1959448192281450496,2020-04,0,486.82,1003.4,101.57,415.01,-2927.53
1959448192281450496,2020-05,219.83,307.95,0,3190.95,-3279.07,-6206.6
1959448192281450496,2020-06,259.29,0,0,2137.92,-1878.63,-8085.23
1959448192281450496,2020-07,5494.23,0,427.07,3994.57,1926.73,-6158.5
1959448192281450496,2020-08,0,587.38,245.05,187.45,-529.78,-6688.28
1959448192281450496,2020-09,2618.83,0,792.93,0,3411.76,-3276.52
1959448192281450496,2020-10,1658.86,1722.15,591.91,1440.11,-911.49,-4188.01
1959448192281450496,2020-11,2046.77,447.26,0,1573.81,25.7,-4162.31
1959448192281450496,2020-12,663.51,329.18,1743.68,7666.82,-5588.81,-9751.12
1960812770162024960,2020-01,244.52,0,0,542.57,-298.05,-298.05
1960812770162024960,2020-02,1886.39,2905.78,0,0,-1019.39,-1317.44
1960812770162024960,2020-03,2392.5,0,0,1332.15,1060.35,-257.09
1960812770162024960,2020-04,0,3141.97,0,2857.62,-5999.59,-6256.68
1960812770162024960,2020-05,1813.33,998.18,3189.5,668.09,3336.56,-2920.12
1960812770162024960,2020-06,2886.7,2435.39,1427.01,0,1878.32,-1041.8
1960812770162024960,2020-07,0,2817.11,0,0,-2817.11,-3858.91
1960812770162024960,2020-08,1966.65,0,0,59.83,1906.82,-1952.09
1960812770162024960,2020-09,941.16,321.96,0,0,619.2,-1332.89
1960812770162024960,2020-10,169.33,0,1823.8,0,1993.13,660.24
1960812770162024960,2020-12,1230.94,0,0,0,1230.94,1891.18
1961772406601338880,2020-02,436.62,1581.59,0,1264.4,-2409.37,-2409.37
1961772406601338880,2020-04,866.21,5267.64,0,1727.49,-6128.92,-8538.29
1961772406601338880,2020-05,1198.37,2150.87,514.06,0,-438.44,-8976.73
1961772406601338880,2020-06,6127.09,83.99,1623.92,1133.39,6533.63,-2443.1
1961772406601338880,2020-07,0,2782.02,3125.65,0,343.63,-2099.47
1961772406601338880,2020-08,2502.74,0,0,1587.02,915.72,-1183.75
1961772406601338880,2020-09,1539.03,0,84.81,3292.88,-1669.04,-2852.79
1961772406601338880,2020-10,0,1357.12,1247.72,0,-109.4,-2962.19
1961772406601338880,2020-11,285.52,1364.5,2902.15,0,1823.17,-1139.02
1961772406601338880,2020-12,845.37,603.43,1580.35,435.7,1386.59,247.57
1962590066672242176,2020-01,2105.38,1126.28,0,293.83,685.27,685.27
1962590066672242176,2020-02,211.69,0,2100.39,2300.28,11.8,697.07
1962590066672242176,2020-03,828.84,7894.18,3924.45,1187.5,-4328.39,-3631.32
1962590066672242176,2020-04,1895.6,389.63,452.88,3780,-1821.15,-5452.47
1962590066672242176,2020-05,3481.79,2533.68,1744.02,1711.62,980.51,-4471.96
1962590066672242176,2020-06,1818.57,2401.15,649.06,649.44,-582.96,-5054.92
1962590066672242176,2020-07,3943.16,889.8,5366.1,767.73,7651.73,2596.81
1962590066672242176,2020-08,5994.96,2903.93,5869.1,733.98,8226.15,10822.96
1962590066672242176,2020-09,1125.56,1949.42,3444.86,0,2621,13443.96
1962590066672242176,2020-10,1384.49,2442.44,1167.81,638.59,-528.73,12915.23
1962590066672242176,2020-11,1926.67,1241.62,1826.18,0,2511.23,15426.46
1962590066672242176,2020-12,2038.13,3601.74,1137.98,3211,-3636.63,11789.83
1963362588534690048,2020-01,117.15,2976.43,2059.22,7024.08,-7824.14,-7824.14
1963362588534690048,2020-02,6596.57,4381.25,3656.66,561.07,5310.91,-2513.23
1963362588534690048,2020-03,2240.2,4751.29,4525.43,3091.83,-1077.49,-3590.72
1963362588534690048,2020-04,3081.98,2291.95,5633.61,6171.28,252.36,-3338.36
1963362588534690048,2020-05,2818.9,8758.43,0,4782.73,-10722.26,-14060.62
1963362588534690048,2020-06,4847.46,1391.79,4284.09,1228.69,6511.07,-7549.55
1963362588534690048,2020-07,7296.29,3853.11,2414.76,1824.34,4033.6,-3515.95
1963362588534690048,2020-08,4224.95,7597.77,3938.76,1842.51,-1276.57,-4792.52
1963362588534690048,2020-09,8473.2,3560.92,3333.23,3147.26,5098.25,305.73
1963362588534690048,2020-10,4298.99,4118.27,1938.22,4419.77,-2300.83,-1995.1
1963362588534690048,2020-11,4117.85,2853.21,4871.86,0,6136.5,4141.4
1963362588534690048,2020-12,2073.2,1588.95,3772.49,2304.88,1951.86,6093.26
1964090389845520384,2020-01,2300.52,3313.01,2705.23,4784.98,-3092.24,-3092.24
1964090389845520384,2020-02,3361.26,3021.39,4805.69,5810.23,-664.67,-3756.91
1964090389845520384,2020-03,2378.29,651.59,1452.55,8909.81,-5730.56,-9487.47
1964090389845520384,2020-04,6866.03,3832.5,1391.73,1220.85,3204.41,-6283.06
1964090389845520384,2020-05,3449.48,0,5248.54,1622.51,7075.51,792.45
1964090389845520384,2020-06,2228.95,5096.21,6890.22,5651.13,-1628.17,-835.72
1964090389845520384,2020-07,2560.73,4712.26,574.26,4319.71,-5896.98,-6732.7
1964090389845520384,2020-08,1302.41,2741.33,3033.15,3327.66,-1733.43,-8466.13
1964090389845520384,2020-09,3409.38,4731.97,1108.11,4172.23,-4386.71,-12852.84
1964090389845520384,2020-10,4525.06,5171.06,6141.7,0,5495.7,-7357.14
1964090389845520384,2020-11,3099.09,4529.55,3841.65,4294.56,-1883.37,-9240.51
1964090389845520384,2020-12,3494.01,3064.44,1493.3,3617,-1694.13,-10934.64
1965971290693798912,2020-01,5730.2,6547.71,3363.75,2240.47,305.77,305.77
1965971290693798912,2020-02,4530.64,2082.16,3207.67,8597.62,-2941.47,-2635.7
1965971290693798912,2020-03,5873.38,2702.24,701.68,7466.67,-3593.85,-6229.55
1965971290693798912,2020-04,4822.11,10372.2,3077.3,4089.93,-6562.72,-12792.27
1965971290693798912,2020-05,5778.12,2389.7,7181.17,6552.33,4017.26,-8775.01
1965971290693798912,2020-06,6666.58,4519.41,3547.69,252.1,5442.76,-3332.25
1965971290693798912,2020-07,780.65,5881.65,3342.35,2104.11,-3862.76,-7195.01
1965971290693798912,2020-08,5059.97,7386.97,4715.9,1947.78,441.12,-6753.89
1965971290693798912,2020-09,5353.72,6185.9,4310.89,5138.58,-1659.87,-8413.76
1965971290693798912,2020-10,6716.84,2884.52,8308.91,7665.1,4476.13,-3937.63
1965971290693798912,2020-11,544.27,3318.68,1797.63,4078.67,-5055.45,-8993.08
1965971290693798912,2020-12,6185.68,4963.54,2144.68,6277.73,-2910.91,-11903.99
1967187999376396544,2020-01,2911.48,2381.61,0,2875.66,-2345.79,-2345.79
1967187999376396544,2020-02,3462.08,3843.34,3375.66,2581.48,412.92,-1932.87
1967187999376396544,2020-03,1979.11,2786.79,4238.09,4967.89,-1537.48,-3470.35
1967187999376396544,2020-04,8462.71,3756.24,400.58,1708.64,3398.41,-71.94
1967187999376396544,2020-05,325.86,2008.13,6324.94,1968.88,2673.79,2601.85
1967187999376396544,2020-06,2781.72,5499.76,1329.24,1661.26,-3050.06,-448.21
1967187999376396544,2020-07,4741.66,3530.41,657.14,870.53,997.86,549.65
1967187999376396544,2020-08,408.19,1266.52,0,186.78,-1045.11,-495.46
1967187999376396544,2020-09,3779.88,1884.63,2663.02,4062.94,495.33,-0.13
1967187999376396544,2020-10,2964.84,1994.18,4688.98,1674.97,3984.67,3984.54
1967187999376396544,2020-11,2580.22,1839.07,4835.13,2973.89,2602.39,6586.93
1967187999376396544,2020-12,0,3601.69,3208.35,2645.01,-3038.35,3548.58
1969255136321969920,2020-01,0,1631.39,0,939.49,-2570.88,-2570.88
1969255136321969920,2020-03,201.35,0,0,0,201.35,-2369.53
1969255136321969920,2020-04,2091.47,0,0,0,2091.47,-278.06
1969255136321969920,2020-08,905.8,0,0,1474.56,-568.76,-846.82
1969255136321969920,2020-12,0,1973.98,0,0,-1973.98,-2820.8
1970474654429153792,2020-01,5676.96,3036.5,5589.34,10906.34,-2676.54,-2676.54
1970474654429153792,2020-02,5387.66,5288.82,13112.02,1063.69,12147.17,9470.63
1970474654429153792,2020-03,5920.85,6089.22,1391.61,8764.45,-7541.21,1929.42
1970474654429153792,2020-04,8052.23,1269.08,5477.7,6389.84,5871.01,7800.43
1970474654429153792,2020-05,6404.63,3747.43,58.85,2892.08,-176.03,7624.4
1970474654429153792,2020-06,2751.5,0,5908.19,4918.85,3740.84,11365.24
1970474654429153792,2020-07,11189.82,1368.55,3294.51,5723.44,7392.34,18757.58
1970474654429153792,2020-08,5340.46,1790.84,8552.82,8670.11,3432.33,22189.91
1970474654429153792,2020-09,2526.67,4190.45,3594.46,5052.79,-3122.11,19067.8
1970474654429153792,2020-10,0,4252.18,3156.97,4706.99,-5802.2,13265.6
1970474654429153792,2020-11,7428.68,4445.85,4531.61,4173.55,3340.89,16606.49
1970474654429153792,2020-12,8692.19,3838.55,9842.75,6047,8649.39,25255.88
1971661652595684352,2020-01,922.7,2833.57,862.9,1493.76,-2541.73,-2541.73
1971661652595684352,2020-02,6069.23,0,1450.8,531.73,6988.3,4446.57
1971661652595684352,2020-03,0,1833.82,620.87,2353.89,-3566.84,879.73
1971661652595684352,2020-04,239.02,2852.11,634.73,3674.76,-5653.12,-4773.39
1971661652595684352,2020-05,2622.05,1479.84,1560.36,0,2702.57,-2070.82
1971661652595684352,2020-06,0,2338.7,3890.69,1744.02,-192.03,-2262.85
1971661652595684352,2020-07,6398.6,2371.93,4250.45,2435.65,5841.47,3578.62
1971661652595684352,2020-08,1834.55,0,1840.09,1940.71,1733.93,5312.55
1971661652595684352,2020-09,2753.18,4420.54,1592.48,406.66,-481.54,4831.01
1971661652595684352,2020-10,2897.29,2179.19,45.99,0,764.09,5595.1
1971661652595684352,2020-11,1457.18,4304.2,0,1394.37,-4241.39,1353.71
1971661652595684352,2020-12,758.88,2966.91,0,0,-2208.03,-854.32
1972296022102569216,2020-01,985.3,236.52,0,1384.79,-636.01,-636.01
1972296022102569216,2020-02,1586.29,90.73,514.38,1977.04,32.9,-603.11
1972296022102569216,2020-03,920.93,1054.37,2175.7,2828.09,-785.83,-1388.94
1972296022102569216,2020-04,3229.05,2766.64,2266.58,785.9,1943.09,554.15
1972296022102569216,2020-05,2411.09,2423.6,3969.86,1550.39,2406.96,2961.11
1972296022102569216,2020-06,3754.56,0,1326.25,3722.32,1358.49,4319.6
1972296022102569216,2020-07,4792.21,985.58,1329.6,6167.42,-1031.19,3288.41
1972296022102569216,2020-08,3080.45,4364.93,1724.34,2862.13,-2422.27,866.14
1972296022102569216,2020-09,3130.28,0,0,0,3130.28,3996.42
1972296022102569216,2020-10,0,2167.16,2333.66,1572.69,-1406.19,2590.23
1972296022102569216,2020-11,1409.98,0,499.11,1273.77,635.32,3225.55
1972296022102569216,2020-12,3635.62,0,2031.13,0,5666.75,8892.3
1972456641246457856,2020-01,2756.33,15470.76,3663.08,3761.18,-12812.53,-12812.53
1972456641246457856,2020-02,4600.48,3319.95,453.97,1171.25,563.25,-12249.28
1972456641246457856,2020-03,5991.24,5480.22,3257.59,4613.42,-844.81,-13094.09
1972456641246457856,2020-04,5420.07,2665.9,3181.62,5619.44,316.35,-12777.74
1972456641246457856,2020-05,8255.46,2832.63,3947.57,5598.96,3771.44,-9006.3
1972456641246457856,2020-06,2096.03,1950.09,2423.14,3891.76,-1322.68,-10328.98
1972456641246457856,2020-07,406.03,7120.99,3099.01,2859.24,-6475.19,-16804.17
1972456641246457856,2020-08,1469.86,3029.32,4057.82,4066.36,-1568,-18372.17
1972456641246457856,2020-09,3784.35,4895.18,5318.3,10349.05,-6141.58,-24513.75
1972456641246457856,2020-10,6481.47,10003.45,3527.24,0,5.26,-24508.49
1972456641246457856,2020-11,3765.82,3900,2371.28,5008.08,-2770.98,-27279.47
1972456641246457856,2020-12,3886.22,5908.41,2601.5,1050.66,-471.35,-27750.82
1973342107624265728,2020-01,2729.2,8439.23,2146.46,3791.52,-7355.09,-7355.09
1973342107624265728,2020-02,1847,2210.44,234.14,799.22,-928.52,-8283.61
1973342107624265728,2020-03,3739.62,3756.7,5927.27,3130.23,2779.96,-5503.65
1973342107624265728,2020-04,3377.62,3346.71,6227.07,2643.8,3614.18,-1889.47
1973342107624265728,2020-05,2810.71,5558.33,1784.59,3708.62,-4671.65,-6561.12
1973342107624265728,2020-07,4428.52,1224.49,2526.46,3550.14,2180.35,-4380.77
1973342107624265728,2020-08,2229.39,985.71,5302.19,2724.21,3821.66,-559.11
1973342107624265728,2020-09,0,61.18,2908.47,3369.8,-522.51,-1081.62
1973342107624265728,2020-10,2409.25,1274.92,0,4413.88,-3279.55,-4361.17
1973342107624265728,2020-11,44.08,1635.33,1075.44,2024.06,-2539.87,-6901.04
1974014533729869312,2020-01,8522.06,3876.71,259.16,4117.12,787.39,787.39
1974014533729869312,2020-02,4749.87,2708.93,1057.81,9719.76,-6621.01,-5833.62
1974014533729869312,2020-03,3278.04,1971.02,4470.55,4812.57,965,-4868.62
1974014533729869312,2020-04,10017.22,1776.54,3063.15,2451.92,8851.91,3983.29
1974014533729869312,2020-05,3390.2,8075.4,3894.89,3403.13,-4193.44,-210.15
1974014533729869312,2020-06,542.1,4280.66,5416.99,5961.73,-4283.3,-4493.45
1974014533729869312,2020-07,3886.24,4121.39,7006.36,2333.54,4437.67,-55.78
1974014533729869312,2020-08,8693.07,4836.32,11054.25,4402.06,10508.94,10453.16
1974014533729869312,2020-09,2092.22,1041.37,2053.77,4033.38,-928.76,9524.4
1974014533729869312,2020-10,6258.1,5108.79,6304.34,2832.23,4621.42,14145.82
1974014533729869312,2020-11,7089.04,8273.54,2911.83,6698.89,-4971.56,9174.26
1974014533729869312,2020-12,3408.63,4703.64,5955.17,6420.32,-1760.16,7414.1
1976905785592106240,2020-01,2253.49,2216.41,2349.43,285.57,2100.94,2100.94
1976905785592106240,2020-02,2343.18,4653.48,2257.44,7086.1,-7138.96,-5038.02
1976905785592106240,2020-03,5176.6,3223.95,1753.1,3888.03,-182.28,-5220.3
1976905785592106240,2020-04,797.91,2488.43,2987.83,6761.55,-5464.24,-10684.54
1976905785592106240,2020-05,1965.97,4177.41,1928.12,2810.37,-3093.69,-13778.23
1976905785592106240,2020-06,3543.83,3138.11,2961.99,5358.08,-1990.37,-15768.6
1976905785592106240,2020-07,2639.85,6052.77,3676.59,4274.36,-4010.69,-19779.29
1976905785592106240,2020-08,4649.32,4.87,6853.88,5669.96,5828.37,-13950.92
1976905785592106240,2020-09,64.73,6986.76,8446.29,2561.75,-1037.49,-14988.41
1976905785592106240,2020-10,6532.56,5023.51,5593.19,1897.5,5204.74,-9783.67
1976905785592106240,2020-11,3740.37,8532.66,3295.55,1368.97,-2865.71,-12649.38
1976905785592106240,2020-12,686.03,7631.04,9318.11,2676.24,-303.14,-12952.52
1977882419226454528,2020-02,541.17,0,0,1099.08,-557.91,-557.91
1977882419226454528,2020-05,0,1804.61,10.24,1455.23,-3249.6,-3807.51
1977882419226454528,2020-07,0,667.35,0,1152.55,-1819.9,-5627.41
1977882419226454528,2020-08,1117.74,0,0,1696.82,-579.08,-6206.49
1977882419226454528,2020-10,0,1274.8,0,1750.49,-3025.29,-9231.78
1979268275465772800,2020-01,620.3,0,0,0,620.3,620.3
1979268275465772800,2020-02,1293.79,0,1535.33,0,2829.12,3449.42
1979268275465772800,2020-09,832.26,15.89,0,0,816.37,4265.79
1979595813399433984,2020-01,6189.91,4943.97,2838.41,3278.51,805.84,805.84
1979595813399433984,2020-02,5295.56,4814.18,7226.99,2264.79,5443.58,6249.42
1979595813399433984,2020-03,319.33,4049.07,2760.75,1526.55,-2495.54,3753.88
1979595813399433984,2020-04,3856.69,3398.02,6947.88,7578.23,-171.68,3582.2
1979595813399433984,2020-05,5021.65,4697.78,1586.33,4958.06,-3047.86,534.34
1979595813399433984,2020-06,4481.96,6201.22,5266.52,5612.63,-2065.37,-1531.03
1979595813399433984,2020-07,3252.41,9281.94,3991,4826.78,-6865.31,-8396.34
1979595813399433984,2020-08,6456.5,5555.16,6244.91,8438.25,-1292,-9688.34
1979595813399433984,2020-09,4959.86,5547.53,1882.74,3223.78,-1928.71,-11617.05
1979595813399433984,2020-10,9454.67,814.61,9012.91,3083.31,14569.66,2952.61
1979595813399433984,2020-11,6596.04,2630.78,3795.44,5717.43,2043.27,4995.88
1979595813399433984,2020-12,3427.99,4074.25,4023,8503.57,-5126.83,-130.95
1980669090314435584,2020-01,1064.29,13163.46,2810.96,5005.1,-14293.31,-14293.31
1980669090314435584,2020-02,4378.81,4693.85,4626.23,0,4311.19,-9982.12
1980669090314435584,2020-03,3154.86,1650.19,3715.21,2395.1,2824.78,-7157.34
1980669090314435584,2020-04,7245.78,3999.11,971.31,4775.6,-557.62,-7714.96
1980669090314435584,2020-05,3443.53,5442.61,9333.11,3544.24,3789.79,-3925.17
1980669090314435584,2020-06,2916.18,761.03,2396.75,2750.13,1801.77,-2123.4
1980669090314435584,2020-07,4198.15,3513.35,6440.14,4408.51,2716.43,593.03
1980669090314435584,2020-08,5446.79,2798.6,2322.7,4385.26,585.63,1178.66
1980669090314435584,2020-09,1300.06,1166.87,3683.67,2335.16,1481.7,2660.36
1980669090314435584,2020-10,7571.09,6243.52,485.78,297.94,1515.41,4175.77
1980669090314435584,2020-11,5064.14,1390.06,5637.85,5178.09,4133.84,8309.61
1980669090314435584,2020-12,3848.55,1314.5,4174.45,3406.95,3301.55,11611.16
1980690092896733184,2020-01,3373.01,3709.62,7221.43,2928.47,3956.35,3956.35
1980690092896733184,2020-02,2908.21,2046.49,3339.2,3203.75,997.17,4953.52
1980690092896733184,2020-03,2022.81,2867.2,167.06,0,-677.33,4276.19
1980690092896733184,2020-04,2914.52,5985.82,4512.03,5144.11,-3703.38,572.81
1980690092896733184,2020-05,6216.68,1091.46,3645.18,1827.8,6942.6,7515.41
1980690092896733184,2020-06,866.21,6592.03,3571.83,694.62,-2848.61,4666.8
1980690092896733184,2020-07,1911.82,7194.9,2894.45,3567.86,-5956.49,-1289.69
1980690092896733184,2020-08,1039.77,5828.63,4749.4,3561.12,-3600.58,-4890.27
1980690092896733184,2020-09,6647.98,5677.1,6635,2369.89,5235.99,345.72
1980690092896733184,2020-10,2156.73,3943.16,5478.75,9253.64,-5561.32,-5215.6
1980690092896733184,2020-11,6065.44,5214.26,3510.53,0,4361.71,-853.89
1980690092896733184,2020-12,1069.73,2060.76,4195.72,2815.09,389.6,-464.29
1982323845610591488,2020-01,6272.15,7101.31,4799,4187.85,-218.01,-218.01
1982323845610591488,2020-02,6695.16,3504.79,8157.23,8858.08,2489.52,2271.51
1982323845610591488,2020-03,3488.87,2990.85,7440.89,4836.66,3102.25,5373.76
1982323845610591488,2020-04,2437.67,7489.22,6507.02,6937.63,-5482.16,-108.4
1982323845610591488,2020-05,7859.78,4854.61,5550.39,6802.48,1753.08,1644.68
1982323845610591488,2020-06,4075.42,1945.19,1527.9,4845.26,-1187.13,457.55
1982323845610591488,2020-07,4368.13,1933.92,10463.27,2711.55,10185.93,10643.48
1982323845610591488,2020-08,4037.94,4003.54,2882.58,2493.42,423.56,11067.04
1982323845610591488,2020-09,0,3602.84,4514.25,3293.27,-2381.86,8685.18
1982323845610591488,2020-10,1679.58,8154.04,9782.4,5431.54,-2123.6,6561.58
1982323845610591488,2020-11,8449.49,7220.71,1542.43,5893.22,-3122.01,3439.57
1982323845610591488,2020-12,2033.44,7043.29,2284.59,653.4,-3378.66,60.91
1983209911800934144,2020-01,816.96,0,0,352.03,464.93,464.93
1983209911800934144,2020-02,3035.12,0,0,0,3035.12,3500.05
1983209911800934144,2020-03,1937.64,710.36,1130.69,1966.34,391.63,3891.68
1983209911800934144,2020-09,0,616,905.94,1983.03,-1693.09,2198.59
1983209911800934144,2020-10,685.09,0,1265.11,1573.66,376.54,2575.13
1983209911800934144,2020-12,1963.84,0,1999.02,0,3962.86,6537.99
1983547629793632000,2020-01,1166.79,1520.46,1753.27,4587.98,-3188.38,-3188.38
1983547629793632000,2020-02,0,26.17,179.54,3062.64,-2909.27,-6097.65
1983547629793632000,2020-03,2639.95,1866.97,1965.16,0,2738.14,-3359.51
1983547629793632000,2020-04,0,648.25,1817.17,1946.86,-777.94,-4137.45
1983547629793632000,2020-05,1124.57,1170.46,0,1385.24,-1431.13,-5568.58
1983547629793632000,2020-06,3186.37,0,492.64,414.09,3264.92,-2303.66
1983547629793632000,2020-07,6958.36,3704.16,1428.36,5252.62,-570.06,-2873.72
1983547629793632000,2020-08,644.15,1564.86,1344.71,536.77,-112.77,-2986.49
1983547629793632000,2020-09,0,1822.21,2920.44,706.3,391.93,-2594.56
1983547629793632000,2020-10,3424.96,0,800.93,0,4225.89,1631.33
1983547629793632000,2020-11,2004.96,2602.26,773.06,1236.54,-1060.78,570.55
1983547629793632000,2020-12,3351.65,4759.46,1567.39,4804.79,-4645.21,-4074.66
1984504363953657600,2020-01,1985.35,0,1483.47,0,3468.82,3468.82
1984504363953657600,2020-02,1904.25,1026.34,1991.39,0,2869.3,6338.12
1984504363953657600,2020-03,4105.91,2605.61,4174.4,770.81,4903.89,11242.01
1984504363953657600,2020-05,4080.63,1590.75,1128.56,1158.35,2460.09,13702.1
1984504363953657600,2020-06,1676.18,920.86,1726.88,390.88,2091.32,15793.42
1984504363953657600,2020-07,14.45,834.48,660.16,1641.48,-1801.35,13992.07
1984504363953657600,2020-08,291.94,1937.43,758.28,2948.86,-3836.07,10156
1984504363953657600,2020-09,2258.72,909.49,2108.02,104.4,3352.85,13508.85
1984504363953657600,2020-10,2699.02,1995.21,719.13,3647.27,-2224.33,11284.52
1984504363953657600,2020-11,2160.08,3246.99,1540.32,2608.75,-2155.34,9129.18
1984504363953657600,2020-12,1167.47,4305.36,236.62,1502.82,-4404.09,4725.09
1985813703260410368,2020-01,8847.32,5807.33,7393.03,6868.13,3564.89,3564.89
1985813703260410368,2020-02,5208.7,1232.18,5450.77,1695.75,7731.54,11296.43
1985813703260410368,2020-03,2205.94,7509.25,3344.03,8462.16,-10421.44,874.99
1985813703260410368,2020-04,10502.13,4775.3,2792.59,4118.52,4400.9,5275.89
1985813703260410368,2020-05,6275.89,2880.68,6856.24,3462.61,6788.84,12064.73
1985813703260410368,2020-06,1339.81,3169.61,5540.45,7122.81,-3412.16,8652.57
1985813703260410368,2020-07,0,5766.71,5865.78,9681.45,-9582.38,-929.81
1985813703260410368,2020-08,4381.47,3944.22,4772.07,3609.77,1599.55,669.74
1985813703260410368,2020-09,5342.84,9210.52,2258.5,2460.79,-4069.97,-3400.23
1985813703260410368,2020-10,4761.24,2306.99,8139.83,3480.95,7113.13,3712.9
1985813703260410368,2020-11,2851.01,3290.11,1538.31,649.19,450.02,4162.92
1985813703260410368,2020-12,1905.3,3712.99,1772.31,6129.61,-6164.99,-2002.07
1985849640285794304,2020-02,0,1892.94,0,0,-1892.94,-1892.94
1985849640285794304,2020-05,1248.68,0,2959.92,0,4208.6,2315.66
1985849640285794304,2020-06,0,541.28,1454.04,4708.08,-3795.32,-1479.66
1985849640285794304,2020-07,3024.47,0,1081.79,680.45,3425.81,1946.15
1985849640285794304,2020-09,0,1351.26,1038.95,167.29,-479.6,1466.55
1985849640285794304,2020-10,0,34.86,915.57,0,880.71,2347.26
1985849640285794304,2020-11,0,462.76,845,0,382.24,2729.5
1985849640285794304,2020-12,389.93,2598.44,1421.18,0,-787.33,1942.17
1985983604725807104,2020-01,1220.95,0,2842.37,1855.29,2208.03,2208.03
1985983604725807104,2020-02,195.06,1209.5,1161.94,909.71,-762.21,1445.82
1985983604725807104,2020-03,1486.92,1155.79,3098.22,3280.75,148.6,1594.42
1985983604725807104,2020-04,1645.53,1891.18,77.02,1756.48,-1925.11,-330.69
1985983604725807104,2020-05,4481.75,1976.76,1457.33,4217.91,-255.59,-586.28
1985983604725807104,2020-06,2611.44,2316.49,1272.34,3631.46,-2064.17,-2650.45
1985983604725807104,2020-07,2631.87,727.81,5374.48,1479.65,5798.89,3148.44
1985983604725807104,2020-08,0,430.91,1392.57,2863.24,-1901.58,1246.86
1985983604725807104,2020-09,1266.69,3120.45,5191.39,1195.55,2142.08,3388.94
1985983604725807104,2020-10,4390.24,3179.29,6099.27,4080.42,3229.8,6618.74
1985983604725807104,2020-11,4069.24,3628.79,2271.91,4963.65,-2251.29,4367.45
1985983604725807104,2020-12,3775.43,0,1822.42,679.33,4918.52,9285.97
1986050916277486080,2020-01,2590.21,3404.61,2720.97,2228.41,-321.84,-321.84
1986050916277486080,2020-02,1742.85,4754.17,1966.97,2021.1,-3065.45,-3387.29
1986050916277486080,2020-03,0,1881.33,4832.22,4518.01,-1567.12,-4954.41
1986050916277486080,2020-04,1553.92,1880.58,119.4,2993.29,-3200.55,-8154.96
1986050916277486080,2020-05,1011.38,3160.25,520.51,1873.96,-3502.32,-11657.28
1986050916277486080,2020-06,2016.32,1725.45,4210.94,0,4501.81,-7155.47
1986050916277486080,2020-07,477.82,1837.57,0,1479.94,-2839.69,-9995.16
1986050916277486080,2020-08,4762.86,799.36,1258.13,326.08,4895.55,-5099.61
1986050916277486080,2020-09,1105.48,4925.41,816.44,1623.07,-4626.56,-9726.17
1986050916277486080,2020-10,1456.16,4009.35,2288.46,906.8,-1171.53,-10897.7
1986050916277486080,2020-11,5428.2,1013.08,1557.55,6293.34,-320.67,-11218.37
1986050916277486080,2020-12,5928.62,1735.66,577.41,0,4770.37,-6448
1986867237076998144,2020-01,1185.68,3151.03,3541.37,3072.49,-1496.47,-1496.47
1986867237076998144,2020-02,1407.36,4752.1,258,1825.13,-4911.87,-6408.34
1986867237076998144,2020-03,684.51,3305.33,3448.98,2186.66,-1358.5,-7766.84
1986867237076998144,2020-04,4965.99,2220.94,5117.1,990.12,6872.03,-894.81
1986867237076998144,2020-05,760.55,2266.21,1447.94,854.93,-912.65,-1807.46
1986867237076998144,2020-06,626.29,1822.35,1877.05,3800.72,-3119.73,-4927.19
1986867237076998144,2020-07,1330.11,1568.14,0,2742.65,-2980.68,-7907.87
1986867237076998144,2020-08,3.27,1772.11,3213.79,5022.65,-3577.7,-11485.57
1986867237076998144,2020-09,4348.43,2948.84,1877.14,2126.31,1150.42,-10335.15
1986867237076998144,2020-10,4448.17,2687.91,1748.94,1910.43,1598.77,-8736.38
1986867237076998144,2020-11,0,245.98,350.24,4341.18,-4236.92,-12973.3
1986867237076998144,2020-12,2297.65,1949.97,4885.92,4673.16,560.44,-12412.86
1987066060481299712,2020-04,896.11,768.15,1373.42,0,1501.38,1501.38
1987066060481299712,2020-05,3622.71,0,0,1104.62,2518.09,4019.47
1987066060481299712,2020-06,0,1136.42,0,1427.11,-2563.53,1455.94
1987066060481299712,2020-07,1885.72,3116.78,381.91,1451.33,-2300.48,-844.54
1987066060481299712,2020-08,0,583.87,1248.15,3218.41,-2554.13,-3398.67
1987066060481299712,2020-10,0,1147.75,0,1612.44,-2760.19,-6158.86
1987066060481299712,2020-12,727.15,539.71,2040.82,0,2228.26,-3930.6
1987250928101839872,2020-01,3209.75,0,0,4520.83,-1311.08,-1311.08
1987250928101839872,2020-02,6687.34,0,0,5315.79,1371.55,60.47
1987250928101839872,2020-03,1341.4,7225.05,1071.6,2017.38,-6829.43,-6768.96
1987250928101839872,2020-04,2290.31,0,0,3223.89,-933.58,-7702.54
1987250928101839872,2020-05,3350.46,2880.95,2023.77,0,2493.28,-5209.26
1987250928101839872,2020-06,4706.8,781.88,2646.01,1469.72,5101.21,-108.05
1987250928101839872,2020-07,612.34,3076.51,1933.91,2350.56,-2880.82,-2988.87
1987250928101839872,2020-08,2618.66,2214.11,1875.32,469.17,1810.7,-1178.17
1987250928101839872,2020-09,1606.04,3963.43,3906.64,498.57,1050.68,-127.49
1987250928101839872,2020-10,1837.12,5226.12,0,1592.26,-4981.26,-5108.75
1987250928101839872,2020-11,1951.65,3017.73,2087.04,3856.16,-2835.2,-7943.95
1987250928101839872,2020-12,674.51,0,1502.69,1229.25,947.95,-6996
1987852744476106240,2020-01,2309.94,3409.14,9440.67,1799.88,6541.59,6541.59
1987852744476106240,2020-02,4984.36,799.66,0,3245.56,939.14,7480.73
1987852744476106240,2020-03,1978.26,3858,3554.25,4467.08,-2792.57,4688.16
1987852744476106240,2020-04,925.42,2059.13,10124.19,6524.25,2466.23,7154.39
1987852744476106240,2020-05,4390.65,5884.1,5159.63,3366.96,299.22,7453.61
1987852744476106240,2020-06,9078.71,4643.83,6372.63,3125.65,7681.86,15135.47
1987852744476106240,2020-07,5760.69,8139.81,5409.7,10465.84,-7435.26,7700.21
1987852744476106240,2020-08,6423.17,5037.67,2657.49,3376.06,666.93,8367.14
1987852744476106240,2020-09,8319.82,2797.29,7650.53,5323.07,7849.99,16217.13
1987852744476106240,2020-10,5328.29,5658.69,3096.94,4321.89,-1555.35,14661.78
1987852744476106240,2020-11,5607.9,1394.51,5432.72,10410.24,-764.13,13897.65
1987852744476106240,2020-12,7523.1,3830.31,7004.21,4066.18,6630.82,20528.47
1990137957645979392,2020-01,2318.12,195.11,203.69,1207.55,1119.15,1119.15
1990137957645979392,2020-02,2040.05,4752.61,1554.33,1995.24,-3153.47,-2034.32
1990137957645979392,2020-03,0,1171.55,1556.44,3449.66,-3064.77,-5099.09
1990137957645979392,2020-04,3296.91,1324.57,4230.59,3386.56,2816.37,-2282.72
1990137957645979392,2020-05,1712.69,0,2051.89,3658.79,105.79,-2176.93
1990137957645979392,2020-06,1749.13,223.72,2073.17,2254.83,1343.75,-833.18
1990137957645979392,2020-07,3337.07,2332.65,3669.49,943.63,3730.28,2897.1
1990137957645979392,2020-08,1540.54,1922.91,3692.03,1883.12,1426.54,4323.64
1990137957645979392,2020-09,2077.55,3289.82,857.86,3249.48,-3603.89,719.75
1990137957645979392,2020-10,2051.27,827.87,1754.88,2601.6,376.68,1096.43
1990137957645979392,2020-11,1509.73,3820.38,2191.49,1769.99,-1889.15,-792.72
1990137957645979392,2020-12,4447.8,0,0,2712.28,1735.52,942.8
1990424655106801664,2020-01,1493.34,0,0,0,1493.34,1493.34
1990424655106801664,2020-02,2141.01,0,0,519.02,1621.99,3115.33
1990424655106801664,2020-03,323.59,0,1800.53,0,2124.12,5239.45
1990424655106801664,2020-05,0,237.57,356.03,0,118.46,5357.91
1990424655106801664,2020-06,244.2,0,1707.32,1525.54,425.98,5783.89
1990424655106801664,2020-07,0,712.42,2589.12,622.9,1253.8,7037.69
1990424655106801664,2020-08,888.5,0,0,0,888.5,7926.19
1990424655106801664,2020-11,0,1770.79,0,0,-1770.79,6155.4
1990424655106801664,2020-12,0,383,0,1494.71,-1877.71,4277.69
1990792314671320320,2020-01,3912.96,2846.38,2884.11,2257.77,1692.92,1692.92
1990792314671320320,2020-02,3468.63,2544,1810.36,2928.74,-193.75,1499.17
1990792314671320320,2020-03,410.5,2932.75,1840.51,2384.98,-3066.72,-1567.55
1990792314671320320,2020-04,1747.35,3059.12,0,2528.77,-3840.54,-5408.09
1990792314671320320,2020-05,4424.09,4056.95,458.09,469.16,356.07,-5052.02
1990792314671320320,2020-06,3589.84,2421.24,1970.7,2153.43,985.87,-4066.15
1990792314671320320,2020-07,5278.87,1007.24,3151.27,1930.71,5492.19,1426.04
1990792314671320320,2020-08,6252.45,3958.99,2082.7,3618.72,757.44,2183.48
1990792314671320320,2020-09,117.19,3276.43,1307.47,3017.23,-4869,-2685.52
1990792314671320320,2020-10,2096.69,977.34,521.64,1527.9,113.09,-2572.43
1990792314671320320,2020-11,0,1127.28,4224.55,3124.96,-27.69,-2600.12
1990792314671320320,2020-12,1176.68,3217.89,1104.05,1701.2,-2638.36,-5238.48
1991824557053180416,2020-01,4015.58,1823.32,4817.75,5937.84,1072.17,1072.17
1991824557053180416,2020-02,559.69,9253.24,5598.37,4430.11,-7525.29,-6453.12
1991824557053180416,2020-03,4604.15,4600.86,32.58,2744.74,-2708.87,-9161.99
1991824557053180416,2020-04,3423.44,5017.04,3273.46,1955.81,-275.95,-9437.94
1991824557053180416,2020-05,3240.68,5522.82,2175.35,4183.39,-4290.18,-13728.12
1991824557053180416,2020-06,5064.3,2016.07,13717.03,2861.7,13903.56,175.44
1991824557053180416,2020-07,9543.85,7568.79,4970.55,9004.04,-2058.43,-1882.99
1991824557053180416,2020-08,5982.87,4829.3,7027.94,5335.3,2846.21,963.22
1991824557053180416,2020-09,3247.85,1477.11,4859.2,3604.81,3025.13,3988.35
1991824557053180416,2020-10,5006.58,5787.84,4454.98,6676.57,-3002.85,985.5
1991824557053180416,2020-11,7843.09,5850.08,1231.45,5143.53,-1919.07,-933.57
1991824557053180416,2020-12,3965.65,1006.47,6828.83,1249.32,8538.69,7605.12
1992590115851488768,2020-01,1213.26,1591.01,2310.78,3222.45,-1289.42,-1289.42
1992590115851488768,2020-02,5079.99,3437.38,4109.66,1126.11,4626.16,3336.74
1992590115851488768,2020-03,1429.26,3262.44,2377.46,5446.31,-4902.03,-1565.29
1992590115851488768,2020-04,4439.96,5284.59,1860.82,1020.74,-4.55,-1569.84
1992590115851488768,2020-05,6177.79,4331.45,3125.35,3644.12,1327.57,-242.27
1992590115851488768,2020-06,3351.28,1529.92,3991.82,3782,2031.18,1788.91
1992590115851488768,2020-07,953.02,4367.91,513.8,1800.69,-4701.78,-2912.87
1992590115851488768,2020-08,1045.92,7233.69,2127.96,5063.44,-9123.25,-12036.12
1992590115851488768,2020-09,10600.61,3304.87,7144.76,157.83,14282.67,2246.55
1992590115851488768,2020-10,4159.06,2728.92,5279.69,4112.79,2597.04,4843.59
1992590115851488768,2020-11,7685.74,4457.1,1408.54,430.95,4206.23,9049.82
1992590115851488768,2020-12,6062.01,5471.25,4043.09,2876.81,1757.04,10806.86
1992787575733068800,2020-01,6289.48,1009.64,261.68,2950.08,2591.44,2591.44
1992787575733068800,2020-02,4788.53,3562.32,2937.04,8698.06,-4534.81,-1943.37
1992787575733068800,2020-03,6625.07,5394.32,4833.34,6604.44,-540.35,-2483.72
1992787575733068800,2020-04,3666.92,5520.27,2158.02,6047.15,-5742.48,-8226.2
1992787575733068800,2020-05,6833.51,5532.89,1698.53,7255.23,-4256.08,-12482.28
1992787575733068800,2020-06,1374.12,4739.13,3538.32,1629.5,-1456.19,-13938.47
1992787575733068800,2020-07,6982.43,668.16,4715.82,0,11030.09,-2908.38
1992787575733068800,2020-08,4709,1846.29,5139.54,1689.8,6312.45,3404.07
1992787575733068800,2020-09,2242.37,756.62,6108.71,5271.56,2322.9,5726.97
1992787575733068800,2020-10,2018.21,7669.89,3101.79,5226.9,-7776.79,-2049.82
1992787575733068800,2020-11,5787.72,1263.21,7662.38,3621.6,8565.29,6515.47
1992787575733068800,2020-12,2743.54,5521.16,1247.43,0,-1530.19,4985.28
1993441619698147072,2020-01,1448.35,3670.52,6008.46,5686.74,-1900.45,-1900.45
1993441619698147072,2020-02,1807.98,2760.34,2179.51,8165.91,-6938.76,-8839.21
1993441619698147072,2020-03,4036.39,4871.8,2081.68,528.19,718.08,-8121.13
1993441619698147072,2020-04,8167.09,3441.34,1809.27,1836.13,4698.89,-3422.24
1993441619698147072,2020-05,2686.03,2311.77,7151.42,271.49,7254.19,3831.95
1993441619698147072,2020-06,1493.76,5445.42,1003.48,5863.75,-8811.93,-4979.98
1993441619698147072,2020-07,3526.33,4628.19,4185.11,8778.14,-5694.89,-10674.87
1993441619698147072,2020-08,3306.07,4532.26,2557.85,2414.65,-1082.99,-11757.86
1993441619698147072,2020-09,2640.4,4100.27,1610.24,3883.52,-3733.15,-15491.01
1993441619698147072,2020-10,2098.55,3576.94,5113.61,1781.03,1854.19,-13636.82
1993441619698147072,2020-11,5633.37,1327.16,3360.96,811.04,6856.13,-6780.69
1993441619698147072,2020-12,5041.88,2063.67,4163.49,1610.51,5531.19,-1249.5
1994115117386893056,2020-01,1625.29,3277.39,8945.99,3404.7,3889.19,3889.19
1994115117386893056,2020-02,3013.19,2123.29,3948.88,3612.23,1226.55,5115.74
1994115117386893056,2020-03,2964.08,2612.37,2817.61,5602.03,-2432.71,2683.03
1994115117386893056,2020-04,6512.97,5181.8,5444.66,3399.14,3376.69,6059.72
1994115117386893056,2020-05,3758.55,7965.68,1610.79,3736.23,-6332.57,-272.85
1994115117386893056,2020-06,2716.47,2535.1,6945.88,7982.3,-855.05,-1127.9
1994115117386893056,2020-07,6727.54,8492.69,3740.02,342.59,1632.28,504.38
1994115117386893056,2020-08,11473.69,3715.39,3696.43,1210.33,10244.4,10748.78
1994115117386893056,2020-09,5290.65,7827.7,3852.36,5854.65,-4539.34,6209.44
1994115117386893056,2020-10,5192.59,1617.36,157.87,6014.62,-2281.52,3927.92
1994115117386893056,2020-11,6528.49,9121.98,0,1615.52,-4209.01,-281.09
1994115117386893056,2020-12,7706.25,4659.7,9191.49,1125.43,11112.61,10831.52
1995365391521085184,2020-01,868.93,2311.99,5217.9,3936.27,-161.43,-161.43
1995365391521085184,2020-02,6087.3,0,5631.45,2872.92,8845.83,8684.4
1995365391521085184,2020-03,1958.34,2935.01,2306.63,7823.61,-6493.65,2190.75
1995365391521085184,2020-04,1819.81,9010.01,915.75,6805.76,-13080.21,-10889.46
1995365391521085184,2020-05,5586.91,3800.06,4945.31,3835.56,2896.6,-7992.86
1995365391521085184,2020-06,4579.38,4440.36,4546.93,6042.9,-1356.95,-9349.81
1995365391521085184,2020-07,9875.93,6989.1,7422.64,2323.21,7986.26,-1363.55
1995365391521085184,2020-08,8323.48,6232,4920.02,2081.98,4929.52,3565.97
1995365391521085184,2020-09,2565.54,7482.28,10011.69,4645.14,449.81,4015.78
1995365391521085184,2020-10,3028.25,1511.58,2893.25,4120.53,289.39,4305.17
1995365391521085184,2020-11,2460.5,7214.16,4363.59,5087.93,-5478,-1172.83
1995365391521085184,2020-12,4925.95,7694.37,1464.17,7088.41,-8392.66,-9565.49
1996719935708697600,2020-01,4253.61,7045.1,4951.14,1675.8,483.85,483.85
1996719935708697600,2020-02,3086.98,1957.41,3021.71,1588.59,2562.69,3046.54
1996719935708697600,2020-03,3280.97,3007.95,4697.22,4444.36,525.88,3572.42
1996719935708697600,2020-04,5698.93,5362.33,5118.67,3779,1676.27,5248.69
1996719935708697600,2020-05,11374.82,5370.71,3607.58,5730.32,3881.37,9130.06
1996719935708697600,2020-06,9841.38,5736.96,1876.38,2525.81,3454.99,12585.05
1996719935708697600,2020-07,898.28,7475.94,2262.16,6636.28,-10951.78,1633.27
1996719935708697600,2020-08,11485.78,2090.36,1275.14,2563.77,8106.79,9740.06
1996719935708697600,2020-09,340.81,5965.22,2257.23,3363.02,-6730.2,3009.86
1996719935708697600,2020-10,560.56,2878.94,3877.66,606.12,953.16,3963.02
1996719935708697600,2020-11,4134.58,3023.5,3629.35,4066.83,673.6,4636.62
1996719935708697600,2020-12,3098.19,3014.11,4409.55,5702.44,-1208.81,3427.81
1997894109690595584,2020-01,0,2185.1,1038.58,1357.43,-2503.95,-2503.95
1997894109690595584,2020-02,157.35,193.69,2773.55,2497.19,240.02,-2263.93
1997894109690595584,2020-03,2025.84,3366.76,1222.32,1416.53,-1535.13,-3799.06
1997894109690595584,2020-04,609.16,1503.11,2509.73,0,1615.78,-2183.28
1997894109690595584,2020-05,1415.09,2258.58,1634.68,913.75,-122.56,-2305.84
1997894109690595584,2020-06,3122.17,1650.61,940.36,1768.57,643.35,-1662.49
1997894109690595584,2020-07,0,1342.95,1701.49,1637.78,-1279.24,-2941.73
1997894109690595584,2020-08,899.94,1335.76,3340.74,826.62,2078.3,-863.43
1997894109690595584,2020-10,111.39,0,3920.33,5240.07,-1208.35,-2071.78
1997894109690595584,2020-11,2025.6,1238.44,571.39,1441.47,-82.92,-2154.7
1997894109690595584,2020-12,1956.12,6100.66,0,1162.2,-5306.74,-7461.44
1998939298966649600,2020-01,514.37,0,2815.03,297.41,3031.99,3031.99
1998939298966649600,2020-02,412.15,3695.3,0,927.19,-4210.34,-1178.35
1998939298966649600,2020-03,6145.67,1395.25,2782.93,1898.43,5634.92,4456.57
1998939298966649600,2020-04,1123.97,0,2474.92,0,3598.89,8055.46
1998939298966649600,2020-05,0,1398.97,1811.19,0,412.22,8467.68
1998939298966649600,2020-07,1230.83,3183.49,1863.59,1666.18,-1755.25,6712.43
1998939298966649600,2020-08,1059.93,1124.17,0,286.12,-350.36,6362.07
1998939298966649600,2020-09,383.96,0,1831.49,1547.93,667.52,7029.59
1998939298966649600,2020-10,1538.27,1614.96,912.73,1407.11,-571.07,6458.52
1998939298966649600,2020-11,1914.11,1083.25,1504.42,0,2335.28,8793.8
1998939298966649600,2020-12,804.11,0,1206,2187.9,-177.79,8616.01
2000461829533284352,2020-01,2970.94,2667.18,3092.99,5223.7,-1826.95,-1826.95
2000461829533284352,2020-02,3382.39,2478.34,3467.48,2206.97,2164.56,337.61
2000461829533284352,2020-03,2189.28,4186.83,11.82,2583.54,-4569.27,-4231.66
2000461829533284352,2020-04,2800.7,3573.91,4621.24,13.11,3834.92,-396.74
2000461829533284352,2020-05,3857.58,1100.06,1697.77,568.99,3886.3,3489.56
2000461829533284352,2020-06,1754.95,6542.44,1507.63,3374.26,-6654.12,-3164.56
2000461829533284352,2020-07,6096.95,3055.76,6255.79,820.17,8476.81,5312.25
2000461829533284352,2020-08,5379.77,1983.33,2451.47,1619.04,4228.87,9541.12
2000461829533284352,2020-09,5101.21,3722.09,2058.57,2532.35,905.34,10446.46
2000461829533284352,2020-10,5722.66,6229.56,1131.46,3183.71,-2559.15,7887.31
2000461829533284352,2020-11,5215.51,2290.86,2161.03,9455.31,-4369.63,3517.68
2000461829533284352,2020-12,1472.28,800.77,5395.39,4444.45,1622.45,5140.13
2000495358643262720,2020-01,1258.61,7352.84,4201.64,349.38,-2241.97,-2241.97
2000495358643262720,2020-02,7298.93,1844.89,12603.7,5744.92,12312.82,10070.85
2000495358643262720,2020-03,5823.04,2885.42,0,6570.77,-3633.15,6437.7
2000495358643262720,2020-04,7722.33,2490.8,4360.16,5272.28,4319.41,10757.11
2000495358643262720,2020-05,2566.22,4074.33,7448.46,5730.93,209.42,10966.53
2000495358643262720,2020-06,6283.18,7102.33,8719.75,5364.22,2536.38,13502.91
2000495358643262720,2020-07,5471.5,1901.06,3969.8,6351.26,1188.98,14691.89
2000495358643262720,2020-08,8886.26,2528.44,8632.85,679.03,14311.64,29003.53
2000495358643262720,2020-09,5107.76,5054.97,3093.08,6581.25,-3435.38,25568.15
2000495358643262720,2020-10,3845.69,5969.35,2626.67,6216.98,-5713.97,19854.18
2000495358643262720,2020-11,4776.23,3710.73,5587.96,7696.56,-1043.1,18811.08
2000495358643262720,2020-12,2460.81,3034.56,1233.75,5190.57,-4530.57,14280.51
2001177018013626112,2020-01,1418.18,2833.19,115.73,4561.05,-5860.33,-5860.33
2001177018013626112,2020-02,3280.68,3005.23,1918.56,0,2194.01,-3666.32
2001177018013626112,2020-03,947.63,2709.79,952.97,1691.2,-2500.39,-6166.71
2001177018013626112,2020-04,521.78,4624.6,6902.36,4438.24,-1638.7,-7805.41
2001177018013626112,2020-05,1575.9,1643.1,4796.99,1234.4,3495.39,-4310.02
2001177018013626112,2020-06,3533.69,6324.04,6548.5,4757.52,-999.37,-5309.39
2001177018013626112,2020-07,2631.58,3227.57,2746.19,3077.24,-927.04,-6236.43
2001177018013626112,2020-08,3691.12,1547.85,2857.92,4116.13,885.06,-5351.37
2001177018013626112,2020-09,866.85,1580.52,1213.06,3262.47,-2763.08,-8114.45
2001177018013626112,2020-10,4604.1,4326.8,2268.96,3676.89,-1130.63,-9245.08
2001177018013626112,2020-11,2967.58,2067.3,4866.51,6571.4,-804.61,-10049.69
2001177018013626112,2020-12,1396.55,1526.94,388.04,1430.06,-1172.41,-11222.1
2001933071017552640,2020-01,1368.52,1597.69,974.84,2709.96,-1964.29,-1964.29
2001933071017552640,2020-02,853.51,0,1525.75,3257.63,-878.37,-2842.66
2001933071017552640,2020-03,0,5161.62,1126.7,3331.67,-7366.59,-10209.25
2001933071017552640,2020-04,42.17,0,512.15,1109.04,-554.72,-10763.97
2001933071017552640,2020-05,1520.86,485.96,1378.65,957.32,1456.23,-9307.74
2001933071017552640,2020-06,2291.2,4936.09,2638.04,2184.67,-2191.52,-11499.26
2001933071017552640,2020-07,1989.71,5204.19,1978.67,2129.82,-3365.63,-14864.89
2001933071017552640,2020-08,0,2662.23,1056.5,489.68,-2095.41,-16960.3
2001933071017552640,2020-09,721.22,1865.81,8000.91,0,6856.32,-10103.98
2001933071017552640,2020-10,2100.15,2390.13,3816.18,4744.55,-1218.35,-11322.33
2001933071017552640,2020-11,845.49,1120.21,198.93,4140.67,-4216.46,-15538.79
2001933071017552640,2020-12,4594.73,1126.27,81.2,0,3549.66,-11989.13
2002074641305011456,2020-01,2306.28,3857.53,172.23,605.95,-1984.97,-1984.97
2002074641305011456,2020-02,1776.58,2154.93,821.99,322.31,121.33,-1863.64
2002074641305011456,2020-03,1070.1,1165.41,2740.85,0,2645.54,781.9
2002074641305011456,2020-04,1616.03,0,0,1607.84,8.19,790.09
2002074641305011456,2020-05,0,565.57,0,2909.58,-3475.15,-2685.06
2002074641305011456,2020-06,668,2155.61,797.02,2903.63,-3594.22,-6279.28
2002074641305011456,2020-07,0,404.53,745.43,519.16,-178.26,-6457.54
2002074641305011456,2020-08,4404.94,1435.11,1245.84,2555.71,1659.96,-4797.58
2002074641305011456,2020-09,894.06,2250.39,1089.2,565.2,-832.33,-5629.91
2002074641305011456,2020-10,2952.61,0,1076.46,3001.63,1027.44,-4602.47
2002074641305011456,2020-11,3946.63,1674.13,0,1581.17,691.33,-3911.14
2002074641305011456,2020-12,0,2011.81,2782.49,1357.69,-587.01,-4498.15
2002707855059216640,2020-01,4760.84,1790.63,544.53,3800.94,-286.2,-286.2
2002707855059216640,2020-02,3804.48,4377.46,3675.75,343.85,2758.92,2472.72
2002707855059216640,2020-03,7459.47,3921.25,5142.37,2755.43,5925.16,8397.88
2002707855059216640,2020-04,1950.56,3095.05,4086.38,5196.29,-2254.4,6143.48
2002707855059216640,2020-05,4333.52,3920.22,7157.34,2420.73,5149.91,11293.39
2002707855059216640,2020-06,2756.45,2863.64,8959.5,1954.04,6898.27,18191.66
2002707855059216640,2020-07,10004.45,4718.86,1984.56,5251.51,2018.64,20210.3
2002707855059216640,2020-08,5552.36,6394.65,7938.72,5980.02,1116.41,21326.71
2002707855059216640,2020-09,5857.08,4489.86,5839.08,10211.64,-3005.34,18321.37
2002707855059216640,2020-10,8104.02,1807.35,8361.19,7186.32,7471.54,25792.91
2002707855059216640,2020-11,6074.28,3447.16,0,2179.62,447.5,26240.41
2002707855059216640,2020-12,2945.51,4217.91,4826.06,5377.68,-1824.02,24416.39
2004553981532849408,2020-01,6615.94,2851.93,4135.99,1849.29,6050.71,6050.71
2004553981532849408,2020-02,970.81,4809.85,7417.97,3392.73,186.2,6236.91
2004553981532849408,2020-03,3520.1,7175.67,4980.3,3381.51,-2056.78,4180.13
2004553981532849408,2020-04,11423.61,4454.79,7628.62,1790.93,12806.51,16986.64
2004553981532849408,2020-05,2477.11,10783.47,3631.35,3954.05,-8629.06,8357.58
2004553981532849408,2020-06,3809.4,5341.01,3567.35,5547.65,-3511.91,4845.67
2004553981532849408,2020-07,3314.84,4009.32,4266.53,5044.49,-1472.44,3373.23
2004553981532849408,2020-08,5817.94,229.39,2888.36,2688.74,5788.17,9161.4
2004553981532849408,2020-09,4544.28,6733.19,2688.76,4197.41,-3697.56,5463.84
2004553981532849408,2020-10,3230.69,6525.88,3515.78,3019.35,-2798.76,2665.08
2004553981532849408,2020-11,7955.42,2752.2,2855.59,2609.12,5449.69,8114.77
2004553981532849408,2020-12,3039.1,2716.14,2251.27,1526.52,1047.71,9162.48
2004669510233280768,2020-01,4039.45,2786.28,7903,3895.79,5260.38,5260.38
2004669510233280768,2020-02,3632.34,2804.85,1220.16,0,2047.65,7308.03
2004669510233280768,2020-03,2300.26,2857.48,4791.09,2590.39,1643.48,8951.51
2004669510233280768,2020-04,5321.94,1017.55,1209.94,6373.08,-858.75,8092.76
2004669510233280768,2020-05,0,1588.79,1354.56,4550.38,-4784.61,3308.15
2004669510233280768,2020-06,5930.59,1456.46,3142.85,5128.58,2488.4,5796.55
2004669510233280768,2020-07,2363.2,1060.82,1921.64,6927.4,-3703.38,2093.17
2004669510233280768,2020-08,6203.8,0,1853.89,4618.25,3439.44,5532.61
2004669510233280768,2020-09,4855.3,4350.21,1091.27,1437.74,158.62,5691.23
2004669510233280768,2020-10,3891.89,1080.62,3125.29,3875.68,2060.88,7752.11
2004669510233280768,2020-11,2243.72,990.18,2271.08,4667.97,-1143.35,6608.76
2004669510233280768,2020-12,3645.89,0,545.32,1392.8,2798.41,9407.17
2005384846770912512,2020-01,0,5249.19,1594.29,1962.76,-5617.66,-5617.66
2005384846770912512,2020-02,1082.99,2497.49,1768.4,0,353.9,-5263.76
2005384846770912512,2020-03,0,413.68,0,0,-413.68,-5677.44
2005384846770912512,2020-05,0,1499.79,0,884.2,-2383.99,-8061.43
2005384846770912512,2020-06,1166.09,0,0,3496.51,-2330.42,-10391.85
2005384846770912512,2020-07,0,393.63,3741.31,1419.12,1928.56,-8463.29
2005384846770912512,2020-08,0,2519.13,3127.55,754.8,-146.38,-8609.67
2005384846770912512,2020-09,0,1445.81,0,1839.4,-3285.21,-11894.88
2005384846770912512,2020-10,2324.95,2124.92,0,3372.46,-3172.43,-15067.31
2005384846770912512,2020-11,2461.84,1907.97,1517.99,1160.29,911.57,-14155.74
2005384846770912512,2020-12,3352.44,1298.35,1258.52,1688.17,1624.44,-12531.3
2006085453385085184,2020-01,4121.81,1045.66,1858.19,4921.36,12.98,12.98
2006085453385085184,2020-02,3067.61,2555.28,2263.55,1180.29,1595.59,1608.57
2006085453385085184,2020-03,1750.64,5915.1,8023.07,4970.07,-1111.46,497.11
2006085453385085184,2020-04,1818.01,76.61,0,2085.93,-344.53,152.58
2006085453385085184,2020-05,4929.03,546.16,5801.22,5092.36,5091.73,5244.31
2006085453385085184,2020-06,5401.72,1403.06,1625.27,2498.71,3125.22,8369.53
2006085453385085184,2020-07,2867.23,4415.18,4658.59,3082.24,28.4,8397.93
2006085453385085184,2020-08,3435.3,3412.68,2403.4,2279.54,146.48,8544.41
2006085453385085184,2020-09,3969.19,6210.52,969.39,3703.89,-4975.83,3568.58
2006085453385085184,2020-10,2392.46,0,2242.36,1681.55,2953.27,6521.85
2006085453385085184,2020-11,1648.25,1647.5,2611.51,3076.89,-464.63,6057.22
2006085453385085184,2020-12,1648.84,3367.14,4615.83,3668.87,-771.34,5285.88
2006088453406509824,2020-01,1167.02,325.14,2029.49,0,2871.37,2871.37
2006088453406509824,2020-02,0,3468.84,0,2658.86,-6127.7,-3256.33
2006088453406509824,2020-03,1630.25,1889.45,4699.38,805.53,3634.65,378.32
2006088453406509824,2020-04,0,483.57,368.34,2519.63,-2634.86,-2256.54
2006088453406509824,2020-05,1273.44,0,1875.24,1989.1,1159.58,-1096.96
2006088453406509824,2020-06,2870.11,2945.29,0,4923.7,-4998.88,-6095.84
2006088453406509824,2020-07,3053.12,0,1932.92,1251.64,3734.4,-2361.44
2006088453406509824,2020-08,1012.77,0,0,2622.03,-1609.26,-3970.7
2006088453406509824,2020-09,0,2615.07,2868.65,806.21,-552.63,-4523.33
2006088453406509824,2020-10,728.4,0,2397.88,4387.13,-1260.85,-5784.18
2006088453406509824,2020-11,0,1144.97,4297.78,1430.79,1722.02,-4062.16
2006088453406509824,2020-12,1459.73,0,73.64,1881.74,-348.37,-4410.53
2006326878903779840,2020-01,3441.48,3140.12,1116.09,315.71,1101.74,1101.74
2006326878903779840,2020-02,5902.48,6640.78,1047.74,2979.36,-2669.92,-1568.18
2006326878903779840,2020-03,5102.75,2329.47,0,3940.08,-1166.8,-2734.98
2006326878903779840,2020-04,1327.03,2829.81,3604.15,5475.3,-3373.93,-6108.91
2006326878903779840,2020-05,5843.63,1498.77,6984.76,4546.92,6782.7,673.79
2006326878903779840,2020-06,2472.12,3015.88,5414.59,1940.49,2930.34,3604.13
2006326878903779840,2020-07,7632.02,2662.78,6170.47,5606.33,5533.38,9137.51
2006326878903779840,2020-08,360.47,2387.78,2524.64,3050.62,-2553.29,6584.22
2006326878903779840,2020-09,4913.6,2031.39,1937.95,6771.96,-1951.8,4632.42
2006326878903779840,2020-10,454.13,3315.34,1742.91,3752.6,-4870.9,-238.48
2006326878903779840,2020-11,2565.15,1922.39,6018.13,3180.64,3480.25,3241.77
2006326878903779840,2020-12,3720.95,5156.56,3544.09,4835.29,-2726.81,514.96
2006503283769265664,2020-01,4487.65,1483.45,2768.27,2504.11,3268.36,3268.36
2006503283769265664,2020-02,3103.39,4042.29,2197.71,2379.06,-1120.25,2148.11
2006503283769265664,2020-03,3502.2,396.6,2158.28,3209.3,2054.58,4202.69
2006503283769265664,2020-04,3179.16,3666.16,0,279.47,-766.47,3436.22
2006503283769265664,2020-05,3426.54,5657.16,5738.18,3979.56,-472,2964.22
2006503283769265664,2020-06,4705.42,2247.74,2335.65,4323.78,469.55,3433.77
2006503283769265664,2020-07,6543.39,4476.48,2406.57,4777.88,-304.4,3129.37
2006503283769265664,2020-08,1326.63,3775.98,4190.05,405.05,1335.65,4465.02
2006503283769265664,2020-09,2341.13,5453.39,2677.89,810.29,-1244.66,3220.36
2006503283769265664,2020-10,4205.65,3096.61,3749.99,1183.99,3675.04,6895.4
2006503283769265664,2020-11,2528.53,5417.33,6350.27,1103.73,2357.74,9253.14
2006503283769265664,2020-12,6018.74,5743.64,2627.03,225.13,2677,11930.14
2007502617606320896,2020-01,3304.36,6548.09,2620.56,11153.25,-11776.42,-11776.42
2007502617606320896,2020-02,2308.3,2206.59,4994.9,7442.96,-2346.35,-14122.77
2007502617606320896,2020-03,4307.89,2254.44,2201.72,4267.13,-11.96,-14134.73
2007502617606320896,2020-04,1064.95,281.39,6563.97,3006.01,4341.52,-9793.21
2007502617606320896,2020-05,1335.09,5180.01,1678.58,247.21,-2413.55,-12206.76
2007502617606320896,2020-06,1305.63,0,5693.31,4662.8,2336.14,-9870.62
2007502617606320896,2020-07,7797.02,5655.87,7822.69,2721.25,7242.59,-2628.03
2007502617606320896,2020-08,1398.55,4309.96,3467.91,2575.49,-2018.99,-4647.02
2007502617606320896,2020-09,1812.47,2884.71,3238.09,2539.03,-373.18,-5020.2
2007502617606320896,2020-10,2493.33,6541.66,1588.29,3191.56,-5651.6,-10671.8
2007502617606320896,2020-11,6199.32,6526.23,2747.75,4396.41,-1975.57,-12647.37
2007502617606320896,2020-12,7489.61,2007.48,1438.66,4442.71,2478.08,-10169.29
2008052329966667776,2020-01,138.9,2570.1,3452.73,6182.58,-5161.05,-5161.05
2008052329966667776,2020-02,3641.01,2172.35,6882.17,148.12,8202.71,3041.66
2008052329966667776,2020-03,7294.98,4903.34,1431.45,1323.91,2499.18,5540.84
2008052329966667776,2020-04,3429.03,418.73,2717.28,6415.29,-687.71,4853.13
2008052329966667776,2020-05,6187.86,6051.2,1403.95,2279.74,-739.13,4114
2008052329966667776,2020-06,4419.63,1958.33,3650.42,3032.14,3079.58,7193.58
2008052329966667776,2020-07,6959.61,766.61,949.99,4968.69,2174.3,9367.88
2008052329966667776,2020-08,5914.61,1868.93,3120.12,5661.96,1503.84,10871.72
2008052329966667776,2020-09,1982.1,1356.25,1560,2371.98,-186.13,10685.59
2008052329966667776,2020-10,2835.63,6536.31,0,1851.08,-5551.76,5133.83
2008052329966667776,2020-11,993.37,842.34,3277.49,4111.49,-682.97,4450.86
2008052329966667776,2020-12,6372.89,3102.17,1390.5,479.1,4182.12,8632.98
2008331741596247808,2020-01,0,4092.08,406.56,0,-3685.52,-3685.52
2008331741596247808,2020-02,0,3587.36,1520.47,1852.41,-3919.3,-7604.82
2008331741596247808,2020-03,1282.95,2978.43,1196.75,2066.5,-2565.23,-10170.05
2008331741596247808,2020-04,560.01,1550.45,0,2706.89,-3697.33,-13867.38
2008331741596247808,2020-05,3036.32,34.49,6139.61,3611.15,5530.29,-8337.09
2008331741596247808,2020-06,2438.96,0,1105.86,0,3544.82,-4792.27
2008331741596247808,2020-07,193.21,2737.92,0,1365.49,-3910.2,-8702.47
2008331741596247808,2020-08,976.71,1668.45,1692.23,2118.06,-1117.57,-9820.04
2008331741596247808,2020-10,1500.9,3009.63,6045.01,1214.17,3322.11,-6497.93
2008331741596247808,2020-11,723.45,493.02,5132.5,0,5362.93,-1135
2008331741596247808,2020-12,162.22,2029.71,2032.11,2704.94,-2540.32,-3675.32
2008551805444429824,2020-01,4214.18,5610.35,5362.47,8035.6,-4069.3,-4069.3
2008551805444429824,2020-02,1561.26,911.82,3405.92,234.53,3820.83,-248.47
2008551805444429824,2020-03,1539.5,4080.69,3451.88,9030.54,-8119.85,-8368.32
2008551805444429824,2020-04,3398.85,6287.34,3580.51,3386.03,-2694.01,-11062.33
2008551805444429824,2020-05,4967.23,4142.72,4074.24,6792.25,-1893.5,-12955.83
2008551805444429824,2020-06,2732.58,2243.86,6335.12,3447.42,3376.42,-9579.41
2008551805444429824,2020-07,2585.74,7975.89,2297.1,6583.22,-9676.27,-19255.68
2008551805444429824,2020-08,3825.83,8615.58,2756.71,1586.56,-3619.6,-22875.28
2008551805444429824,2020-09,5979.42,5208.59,6493.19,6424.15,839.87,-22035.41
2008551805444429824,2020-10,3554.15,9907.13,5213.52,6111.85,-7251.31,-29286.72
2008551805444429824,2020-11,1335.94,5316.1,1992.96,8209.15,-10196.35,-39483.07
2008551805444429824,2020-12,3525.94,4124.25,7553.81,4775.99,2179.51,-37303.56
2010824797888699904,2020-01,1841.32,4071.33,3186.29,120.52,835.76,835.76
2010824797888699904,2020-02,5002.46,766.92,1844.95,2047.6,4032.89,4868.65
2010824797888699904,2020-03,5089.29,3646.59,7267.29,2929.26,5780.73,10649.38
2010824797888699904,2020-04,2408.53,0,3473.22,4931.04,950.71,11600.09
2010824797888699904,2020-05,3267.04,3705.15,2607.55,940.19,1229.25,12829.34
2010824797888699904,2020-06,3684.87,3291.35,3982.43,1744.12,2631.83,15461.17
2010824797888699904,2020-07,4624.75,3180.25,0,1729.1,-284.6,15176.57
2010824797888699904,2020-08,1965.45,5524.49,2460.22,142.6,-1241.42,13935.15
2010824797888699904,2020-09,1766.25,1694.21,4096.53,2431.25,1737.32,15672.47
2010824797888699904,2020-10,1908.86,724.37,4358.75,360.2,5183.04,20855.51
2010824797888699904,2020-11,0,3479.49,3779.64,695.69,-395.54,20459.97
2010824797888699904,2020-12,2087.25,0,0,3734.96,-1647.71,18812.26
2011546083761320704,2020-01,2635.94,2204.75,0,582.21,-151.02,-151.02
2011546083761320704,2020-02,4046.71,437.27,3346.32,930.64,6025.12,5874.1
2011546083761320704,2020-03,3614.56,2438.95,3280.98,3833.65,622.94,6497.04
2011546083761320704,2020-04,2042.01,5311.22,1356.63,1398.43,-3311.01,3186.03
2011546083761320704,2020-05,5106.11,4028.18,3471.79,1183.82,3365.9,6551.93
2011546083761320704,2020-06,2358.81,974.93,5236.27,2036,4584.15,11136.08
2011546083761320704,2020-07,2576.3,3161.69,5519.7,1922.38,3011.93,14148.01
2011546083761320704,2020-08,3617.94,0,3714.52,4032.8,3299.66,17447.67
2011546083761320704,2020-09,6099.79,920.26,3550.79,4625.52,4104.8,21552.47
2011546083761320704,2020-10,3976.37,4329.38,4867.66,1981.46,2533.19,24085.66
2011546083761320704,2020-11,3982.77,4532.78,865.01,5170.4,-4855.4,19230.26
2011546083761320704,2020-12,6747.29,2748.56,1059.77,1929.62,3128.88,22359.14
2013201911257763072,2020-01,109.42,2319.2,3333.07,1614.05,-490.76,-490.76
2013201911257763072,2020-02,2147.92,1750.93,2003.94,700.25,1700.68,1209.92
2013201911257763072,2020-03,1889.74,0,1045.42,0,2935.16,4145.08
2013201911257763072,2020-04,3206.78,1957.66,290.64,306.28,1233.48,5378.56
2013201911257763072,2020-05,253.15,0,1150.79,1321.83,82.11,5460.67
2013201911257763072,2020-06,2627.35,0,2042.57,149.59,4520.33,9981
2013201911257763072,2020-07,0,3255.33,1953.43,460.81,-1762.71,8218.29
2013201911257763072,2020-08,0,3162.65,1937.61,1129.46,-2354.5,5863.79
2013201911257763072,2020-09,3476.78,0,0,458.91,3017.87,8881.66
2013201911257763072,2020-11,0,1239.35,239.16,0,-1000.19,7881.47
2013221430120736256,2020-01,1542.17,2093.72,6904.25,1441.27,4911.43,4911.43
2013221430120736256,2020-02,448.71,3516.78,2908.03,1982.57,-2142.61,2768.82
2013221430120736256,2020-03,4024.76,2966.8,449.42,3370.43,-1863.05,905.77
2013221430120736256,2020-04,2203.46,0,2381.36,4323.3,261.52,1167.29
2013221430120736256,2020-05,1044.88,1900.67,3859.45,1594.83,1408.83,2576.12
2013221430120736256,2020-06,2870.95,1709.21,1501.45,2778.47,-115.28,2460.84
2013221430120736256,2020-07,836.22,825.57,1800.91,1657.33,154.23,2615.07
2013221430120736256,2020-08,0,2117.7,2451.08,2162,-1828.62,786.45
2013221430120736256,2020-09,2911.57,5023.49,4405.15,49.98,2243.25,3029.7
2013221430120736256,2020-10,3449.63,177.3,2627.34,2376,3523.67,6553.37
2013221430120736256,2020-11,1737.45,4154.38,1844.33,116.16,-688.76,5864.61
2013221430120736256,2020-12,2836.06,6372.71,2718.75,1551.56,-2369.46,3495.15
2013515877326876928,2020-01,371.24,1104.73,0,0,-733.49,-733.49
2013515877326876928,2020-02,2514.54,1997.53,0,0,517.01,-216.48
2013515877326876928,2020-03,426.08,1383.18,2163.3,1409.23,-203.03,-419.51
2013515877326876928,2020-04,0,3392.47,3180.73,0,-211.74,-631.25
2013515877326876928,2020-07,1267.8,0,0,1972.12,-704.32,-1335.57
2013515877326876928,2020-08,451.06,0,1508.44,0,1959.5,623.93
2013515877326876928,2020-09,2125.97,1285.67,0,1134.42,-294.12,329.81
2013515877326876928,2020-10,195.44,0,3653.65,0,3849.09,4178.9
2013515877326876928,2020-12,0,1497.35,333.89,0,-1163.46,3015.44
2013878208685592576,2020-01,2388.42,2304.37,3979.15,1954.26,2108.94,2108.94
2013878208685592576,2020-02,1946.16,0,3865.11,3351.29,2459.98,4568.92
2013878208685592576,2020-03,1175.69,1583.49,5763.74,1276.93,4079.01,8647.93
2013878208685592576,2020-04,2788.49,2299.65,2428.81,4393.99,-1476.34,7171.59
2013878208685592576,2020-05,1679.95,436.52,460.75,2253.49,-549.31,6622.28
2013878208685592576,2020-06,3261.91,7833.16,6804.37,4750.3,-2517.18,4105.1
2013878208685592576,2020-07,5305.7,4687.51,801.48,4050.35,-2630.68,1474.42
2013878208685592576,2020-08,5278.8,3897.24,5855.05,2529.12,4707.49,6181.91
2013878208685592576,2020-09,5364.11,3377.31,5359.25,109.17,7236.88,13418.79
2013878208685592576,2020-10,3909.65,6728.79,4780.16,2092.88,-131.86,13286.93
2013878208685592576,2020-11,858.71,2277.56,652.75,1549.28,-2315.38,10971.55
2013878208685592576,2020-12,1153.53,5159.8,6844.75,2810.32,28.16,10999.71
2014363109719554816,2020-01,5812.94,5471.32,5775.18,2418.45,3698.35,3698.35
2014363109719554816,2020-02,1908.54,9163.7,5086.73,6224.63,-8393.06,-4694.71
2014363109719554816,2020-03,3324.47,8142.31,5687.22,5486.35,-4616.97,-9311.68
2014363109719554816,2020-04,4096.55,5019.19,4094.19,4865.07,-1693.52,-11005.2
2014363109719554816,2020-05,2807.56,1979.42,3327.1,3873.19,282.05,-10723.15
2014363109719554816,2020-06,4173.72,4151.87,4594.56,3528,1088.41,-9634.74
2014363109719554816,2020-07,485.96,7880.13,1684.35,4862.75,-10572.57,-20207.31
2014363109719554816,2020-08,6241.75,3963.12,1819.42,5448.91,-1350.86,-21558.17
2014363109719554816,2020-09,3263.47,9316.41,5141.43,5484.71,-6396.22,-27954.39
2014363109719554816,2020-10,5095.21,1302.91,3054.47,3854.93,2991.84,-24962.55
2014363109719554816,2020-11,6761.82,2461.92,8185.07,6328.08,6156.89,-18805.66
2014363109719554816,2020-12,4093.17,4584.74,3830.51,3038.04,300.9,-18504.76
2015105755549337856,2020-01,923.83,7852.07,3670.11,5579.77,-8837.9,-8837.9
2015105755549337856,2020-02,4013.89,1701.57,3027.77,3450.44,1889.65,-6948.25
2015105755549337856,2020-03,1986.16,15693.65,2126.44,3089.64,-14670.69,-21618.94
2015105755549337856,2020-04,3016.07,5444.1,2210.32,1798.28,-2015.99,-23634.93
2015105755549337856,2020-05,2533.06,2091.62,3574.36,5230.87,-1215.07,-24850
2015105755549337856,2020-06,2019.24,2371.67,2916.05,1357.18,1206.44,-23643.56
2015105755549337856,2020-07,6104.81,3920.14,4514.71,6087.96,611.42,-23032.14
2015105755549337856,2020-08,4198.99,11210.86,1794.38,3262.96,-8480.45,-31512.59
2015105755549337856,2020-09,1634.75,972.49,791.91,7977.31,-6523.14,-38035.73
2015105755549337856,2020-10,4089.2,3543.06,7566.97,4580.66,3532.45,-34503.28
2015105755549337856,2020-11,4619.55,8625.21,866.99,206.97,-3345.64,-37848.92
2015105755549337856,2020-12,2165.48,690.34,2858.63,3010.98,1322.79,-36526.13
2016061164856503296,2020-01,4361.81,671.59,4695.94,54.5,8331.66,8331.66
2016061164856503296,2020-02,1441.94,0,2289.23,1405.67,2325.5,10657.16
2016061164856503296,2020-03,1989.32,5556.45,2421.87,2870.88,-4016.14,6641.02
2016061164856503296,2020-04,4706.32,885.35,838.46,0,4659.43,11300.45
2016061164856503296,2020-05,1371.43,2639.03,2946.27,2516.57,-837.9,10462.55
2016061164856503296,2020-06,1395.75,2089.7,0,1332.33,-2026.28,8436.27
2016061164856503296,2020-07,2906.16,2474.98,1463.31,1019.87,874.62,9310.89
2016061164856503296,2020-09,1994.14,74.86,4423.44,2022.12,4320.6,13631.49
2016061164856503296,2020-10,0,5515.33,1233.46,2904.22,-7186.09,6445.4
2016061164856503296,2020-11,2067.5,1989.19,2027.81,3974.03,-1867.91,4577.49
2016061164856503296,2020-12,5261.67,1315.35,4708.65,2762.07,5892.9,10470.39
2017133506555908608,2020-01,5800.14,3433.41,0,2060.52,306.21,306.21
2017133506555908608,2020-02,168.87,2220.36,0,1075.39,-3126.88,-2820.67
2017133506555908608,2020-03,1860.02,0,2002.65,421.2,3441.47,620.8
2017133506555908608,2020-04,4889.75,2284.59,1945.89,1571.61,2979.44,3600.24
2017133506555908608,2020-05,1449.18,878.61,819.39,502.29,887.67,4487.91
2017133506555908608,2020-06,0,6246.63,4738.2,99.32,-1607.75,2880.16
2017133506555908608,2020-07,845.41,3818.48,622.35,4783.95,-7134.67,-4254.51
2017133506555908608,2020-08,2529.34,1972.85,4911.16,2581.2,2886.45,-1368.06
2017133506555908608,2020-09,529.78,7677.72,4983.68,2145.91,-4310.17,-5678.23
2017133506555908608,2020-10,1606.23,4692.79,3123.42,2599.54,-2562.68,-8240.91
2017133506555908608,2020-11,4675.86,382.61,840.45,1698.85,3434.85,-4806.06
2017133506555908608,2020-12,2342.46,3479.18,5188.66,3976.59,75.35,-4730.71
2017700132356135168,2020-08,0,2.05,0,420.5,-422.55,-422.55
2017700132356135168,2020-11,1026.2,681.04,0,0,345.16,-77.39
2017700132356135168,2020-12,564.83,0,0,0,564.83,487.44
2021661465773919488,2020-01,9232.88,3264.52,3475.92,4076.67,5367.61,5367.61
2021661465773919488,2020-02,2349.43,5122.84,5553.62,1986.1,794.11,6161.72
2021661465773919488,2020-03,5513.62,6534.23,1848.79,973.12,-144.94,6016.78
2021661465773919488,2020-04,4763.76,4295.82,2753.68,9150.78,-5929.16,87.62
2021661465773919488,2020-05,2688.16,4245.95,9924.68,5046.77,3320.12,3407.74
2021661465773919488,2020-06,6004.15,4767.14,6104.11,2757.75,4583.37,7991.11
2021661465773919488,2020-07,4355.73,6064.43,6289.76,6268.22,-1687.16,6303.95
2021661465773919488,2020-08,4695.53,3747.52,2878.86,7189.05,-3362.18,2941.77
2021661465773919488,2020-09,2319.79,8484.3,1251.34,4434.17,-9347.34,-6405.57
2021661465773919488,2020-10,2495.6,7221.09,7700.28,924.73,2050.06,-4355.51
2021661465773919488,2020-11,3557.62,7243.75,4322.69,9754.06,-9117.5,-13473.01
2021661465773919488,2020-12,2660.16,4333.18,5070.06,1797.3,1599.74,-11873.27
2021672275944896256,2020-01,3343.84,3466.1,4275.28,2004.97,2148.05,2148.05
2021672275944896256,2020-02,4445.32,2860.3,4630.84,3341.93,2873.93,5021.98
2021672275944896256,2020-03,6196.08,7669.29,2801.81,6815.89,-5487.29,-465.31
2021672275944896256,2020-04,2823.38,1951.71,5067.31,2439.1,3499.88,3034.57
2021672275944896256,2020-05,5009.38,4887.64,1574.69,3002.56,-1306.13,1728.44
2021672275944896256,2020-06,3500.07,1221.29,5185.3,6515.69,948.39,2676.83
2021672275944896256,2020-07,4362.32,2677.4,4582.6,7540.02,-1272.5,1404.33
2021672275944896256,2020-08,3817.18,1803.49,5102,3315.03,3800.66,5204.99
2021672275944896256,2020-09,4621.39,790.3,0,4363.51,-532.42,4672.57
2021672275944896256,2020-10,3462.41,4368.45,9539.05,5504.99,3128.02,7800.59
2021672275944896256,2020-11,2387.29,3097.06,1973.4,164.09,1099.54,8900.13
2021672275944896256,2020-12,5373.2,6923.44,4863.49,13653.44,-10340.19,-1440.06
2021833615948403200,2020-01,1488.37,0,1741.78,1720.84,1509.31,1509.31
2021833615948403200,2020-02,0,463.4,1972.68,502.32,1006.96,2516.27
2021833615948403200,2020-03,234.38,0,820,1468.42,-414.04,2102.23
2021833615948403200,2020-04,0,1030.97,3356.58,2735.6,-409.99,1692.24
2021833615948403200,2020-05,0,3651.09,0,381.26,-4032.35,-2340.11
2021833615948403200,2020-06,0,1659.85,0,0,-1659.85,-3999.96
2021833615948403200,2020-07,3844.86,463.13,1122.54,0,4504.27,504.31
2021833615948403200,2020-08,2514.21,1029.45,1207.24,1788.69,903.31,1407.62
2021833615948403200,2020-09,984.38,1254.33,3504.71,2215,1019.76,2427.38
2021833615948403200,2020-10,2419.82,184.61,3903.17,1173.9,4964.48,7391.86
2021833615948403200,2020-11,162.42,2480.75,2108.16,2470.67,-2680.84,4711.02
2021833615948403200,2020-12,0,3710.62,0,4710.03,-8420.65,-3709.63
2022606109216780544,2020-01,5871.89,3312.35,2363.46,0,4923,4923
2022606109216780544,2020-02,1658.59,5303.11,2892.26,3787.5,-4539.76,383.24
2022606109216780544,2020-03,7159.19,3805.24,950.56,1205.46,3099.05,3482.29
2022606109216780544,2020-04,3802.49,2579.25,2786.71,4255.26,-245.31,3236.98
2022606109216780544,2020-05,6423.19,7608.95,2767.9,5188.35,-3606.21,-369.23
2022606109216780544,2020-06,2472.53,6544.4,4530.31,3085.27,-2626.83,-2996.06
2022606109216780544,2020-07,3206.25,4875.94,10505.26,2102.88,6732.69,3736.63
2022606109216780544,2020-08,1255.99,2276.87,5892.98,3224.57,1647.53,5384.16
2022606109216780544,2020-09,4722.2,5316.93,4684.58,10174.26,-6084.41,-700.25
2022606109216780544,2020-10,2684.19,4767.33,6759.6,10070.06,-5393.6,-6093.85
2022606109216780544,2020-11,5052.14,6137.15,4935.23,5022.87,-1172.65,-7266.5
2022606109216780544,2020-12,3557.98,7510.9,5148.41,3674.46,-2478.97,-9745.47
2024212624753621504,2020-01,1189.07,0,934.47,2772.85,-649.31,-649.31
2024212624753621504,2020-02,0,584.1,243.71,2431.41,-2771.8,-3421.11
2024212624753621504,2020-03,1339.2,1403.79,2118.03,3208.82,-1155.38,-4576.49
2024212624753621504,2020-04,2007.27,3243.84,0,1245.48,-2482.05,-7058.54
2024212624753621504,2020-05,2175.27,0,2498.18,0,4673.45,-2385.09
2024212624753621504,2020-06,4665.68,2362.7,0,1237.96,1065.02,-1320.07
2024212624753621504,2020-07,0,1286.01,623.88,0,-662.13,-1982.2
2024212624753621504,2020-09,2339.37,872.48,1618.36,0,3085.25,1103.05
2024212624753621504,2020-10,1873.81,0,1392.15,2610.15,655.81,1758.86
2024212624753621504,2020-11,2315.83,3598.7,0,751.03,-2033.9,-275.04
2024212624753621504,2020-12,696.73,1865.35,4775.23,141.34,3465.27,3190.23
2024539160597488640,2020-01,0,2628.74,632.63,0,-1996.11,-1996.11
2024539160597488640,2020-02,0,424.18,0,2555,-2979.18,-4975.29
2024539160597488640,2020-04,3438.74,0,0,0,3438.74,-1536.55
2024539160597488640,2020-05,0,1104.27,2071.41,3178.4,-2211.26,-3747.81
2024539160597488640,2020-06,0,950.82,0,0,-950.82,-4698.63
2024539160597488640,2020-07,2246.63,2041.91,164.19,0,368.91,-4329.72
2024539160597488640,2020-08,3722.51,3632.76,5393.86,0,5483.61,1153.89
2024539160597488640,2020-09,3392.78,3519.57,1841.3,2025.48,-310.97,842.92
2024539160597488640,2020-10,2170.58,1796.97,0,786.95,-413.34,429.58
2024539160597488640,2020-11,1006.13,0,1844.13,4884.17,-2033.91,-1604.33
2024539160597488640,2020-12,0,2486.49,1998.72,3811.38,-4299.15,-5903.48
2024987898392435200,2020-01,3832.19,5226.73,0,3567.42,-4961.96,-4961.96
2024987898392435200,2020-02,1100.54,215.82,2052.27,244.78,2692.21,-2269.75
2024987898392435200,2020-03,3065.43,954.27,3199.45,1571.11,3739.5,1469.75
2024987898392435200,2020-04,0,1813.12,535.69,1973.1,-3250.53,-1780.78
2024987898392435200,2020-05,3260.36,2923.12,1485.93,594.4,1228.77,-552.01
2024987898392435200,2020-06,2427.03,1117.43,1754.81,1293.01,1771.4,1219.39
2024987898392435200,2020-07,0,1675.66,3223.26,5592.99,-4045.39,-2826
2024987898392435200,2020-08,2312.71,5944.53,2351.52,121.97,-1402.27,-4228.27
2024987898392435200,2020-09,1447.12,0,82.76,809.09,720.79,-3507.48
2024987898392435200,2020-10,531.62,4240.32,2080.94,2838.88,-4466.64,-7974.12
2024987898392435200,2020-11,2497.56,1560.41,0,266.83,670.32,-7303.8
2024987898392435200,2020-12,960.59,1061.56,1055.37,2149.08,-1194.68,-8498.48
2025768480184369664,2020-01,6817.21,3490.94,1829.88,6359.38,-1203.23,-1203.23
2025768480184369664,2020-02,7089.78,4659.53,4074.26,4265.89,2238.62,1035.39
2025768480184369664,2020-03,3939.31,7308.56,1355.07,4268.79,-6282.97,-5247.58
2025768480184369664,2020-04,4933.49,2363.98,470.87,2110.58,929.8,-4317.78
2025768480184369664,2020-05,3125.75,2520.71,2772.72,5201.39,-1823.63,-6141.41
2025768480184369664,2020-06,2162.03,3895.48,5300.78,7048.81,-3481.48,-9622.89
2025768480184369664,2020-07,1768.04,10765.9,7108.89,6488.39,-8377.36,-18000.25
2025768480184369664,2020-08,7655.35,6888.65,2091.19,3403.68,-545.79,-18546.04
2025768480184369664,2020-09,4189.31,9123.84,2245.41,3523.39,-6212.51,-24758.55
2025768480184369664,2020-10,3436.29,5038.83,2403.45,994.92,-194.01,-24952.56
2025768480184369664,2020-11,3709.71,5721.41,240.02,7793.34,-9565.02,-34517.58
2025768480184369664,2020-12,9141.31,5095.77,6965.26,4007.92,7002.88,-27514.7
2026037209247281152,2020-01,605.4,20.01,2145.61,1983.16,747.84,747.84
2026037209247281152,2020-02,2531.74,2664.78,1595.67,3150.1,-1687.47,-939.63
2026037209247281152,2020-03,4923.65,2909.94,6410.99,127.01,8297.69,7358.06
2026037209247281152,2020-04,1043.99,0,0,2638.09,-1594.1,5763.96
2026037209247281152,2020-05,1452.09,2776.57,312.23,2210.86,-3223.11,2540.85
2026037209247281152,2020-06,5392.23,1569.44,0,1853.15,1969.64,4510.49
2026037209247281152,2020-07,5825.19,2837.85,2682.65,5540.75,129.24,4639.73
2026037209247281152,2020-08,2700.82,2112.91,4996.86,0,5584.77,10224.5
2026037209247281152,2020-09,123.13,0,0,1186.27,-1063.14,9161.36
2026037209247281152,2020-10,687.08,745.2,3787.34,4667.49,-938.27,8223.09
2026037209247281152,2020-11,2323.65,0,5469.34,1161.25,6631.74,14854.83
2026037209247281152,2020-12,1883.33,963.26,974.59,7429.33,-5534.67,9320.16
2028360947964291840,2020-01,4119.95,4984.59,5835.28,1531.49,3439.15,3439.15
2028360947964291840,2020-02,7553.98,1727.75,6882.15,6554.05,6154.33,9593.48
2028360947964291840,2020-03,6058.42,10723.48,2804.85,4493.21,-6353.42,3240.06
2028360947964291840,2020-04,10333.07,8565.36,2229.4,6198.62,-2201.51,1038.55
2028360947964291840,2020-05,4393.04,1873.57,6398.96,4908.91,4009.52,5048.07
2028360947964291840,2020-06,6759.1,9149.47,2199.81,4535.6,-4726.16,321.91
2028360947964291840,2020-07,8690.72,7503.4,3904.47,5959.82,-868.03,-546.12
2028360947964291840,2020-08,5762.99,3322.99,2506.37,4396.63,549.74,3.62
2028360947964291840,2020-09,252.89,2808.44,5977.17,7064.31,-3642.69,-3639.07
2028360947964291840,2020-10,10385.55,2240.91,6086.59,2373.01,11858.22,8219.15
2028360947964291840,2020-11,1054.78,7413.05,5608.5,5498.09,-6247.86,1971.29
2028360947964291840,2020-12,7381.96,3656.06,1021.73,4121.79,625.84,2597.13
2028908029051604992,2020-01,4719.58,0,4632.05,967.6,8384.03,8384.03
2028908029051604992,2020-02,2968.91,648.87,374.1,5421.77,-2727.63,5656.4
2028908029051604992,2020-03,3039.74,6270.41,1584.39,3055.97,-4702.25,954.15
2028908029051604992,2020-04,0,1613.25,0,1539.62,-3152.87,-2198.72
2028908029051604992,2020-05,0,3037.6,5872.71,4680.15,-1845.04,-4043.76
2028908029051604992,2020-06,1828.37,4926.31,1831.96,582.33,-1848.31,-5892.07
2028908029051604992,2020-07,1110.84,6085.38,2033.72,2632.7,-5573.52,-11465.59
2028908029051604992,2020-08,3529.73,4200.61,401.07,2190.34,-2460.15,-13925.74
2028908029051604992,2020-09,7437,1479.99,4915.99,2393.45,8479.55,-5446.19
2028908029051604992,2020-10,3167.77,4225.7,2513.85,3448.34,-1992.42,-7438.61
2028908029051604992,2020-11,1408.38,2144.18,2728.17,4667.99,-2675.62,-10114.23
2028908029051604992,2020-12,1909.03,3018.48,5034.72,4560.58,-635.31,-10749.54
2029235248023764480,2020-01,0,1076.15,2443.82,1839.07,-471.4,-471.4
2029235248023764480,2020-04,0,644.17,0,0,-644.17,-1115.57
2029235248023764480,2020-06,430.21,0,0,1199.86,-769.65,-1885.22
2029235248023764480,2020-07,0,1239.53,0,0,-1239.53,-3124.75
2029235248023764480,2020-11,0,585.77,0,337.08,-922.85,-4047.6
2029235248023764480,2020-12,382.13,0,0,0,382.13,-3665.47
2029467480050634240,2020-01,0,256.86,1998.52,0,1741.66,1741.66
2029467480050634240,2020-02,1214.1,0,1635.68,5976.41,-3126.63,-1384.97
2029467480050634240,2020-03,4217.98,1928.79,0,1506.26,782.93,-602.04
2029467480050634240,2020-04,663.32,2439.57,3824.42,157.07,1891.1,1289.06
2029467480050634240,2020-06,1157.19,2318.55,269.09,0,-892.27,396.79
2029467480050634240,2020-07,384.76,950.98,0,0,-566.22,-169.43
2029467480050634240,2020-08,0,3573.14,0,3716.65,-7289.79,-7459.22
2029467480050634240,2020-09,1941.04,0,2516.19,323,4134.23,-3324.99
2029467480050634240,2020-10,0,676.45,3270.39,2929.33,-335.39,-3660.38
2029467480050634240,2020-11,0,1632.84,0,1722.23,-3355.07,-7015.45
2029467480050634240,2020-12,2349.87,0,0,0,2349.87,-4665.58
2029973033866213632,2020-01,6147.42,3414.1,6205.19,1285.9,7652.61,7652.61
2029973033866213632,2020-02,4346.92,395.14,6543.58,1786.28,8709.08,16361.69
2029973033866213632,2020-03,1067.84,2635.06,2055.14,2011.22,-1523.3,14838.39
2029973033866213632,2020-04,6651.11,3703.11,4379.17,3087.28,4239.89,19078.28
2029973033866213632,2020-05,1075.54,681.61,2302.34,3890.87,-1194.6,17883.68
2029973033866213632,2020-06,4200.18,2463.32,1781.82,750.07,2768.61,20652.29
2029973033866213632,2020-07,4844.24,1673.85,6461.3,3511.19,6120.5,26772.79
2029973033866213632,2020-08,2772.1,4532.14,4280.8,2292.4,228.36,27001.15
2029973033866213632,2020-09,2141.63,3235.73,2891.18,0,1797.08,28798.23
2029973033866213632,2020-10,1178.09,3598.31,0,3103.22,-5523.44,23274.79
2029973033866213632,2020-11,7800.63,401.32,5326.98,7267.16,5459.13,28733.92
2029973033866213632,2020-12,1170.97,5413.72,2887.2,5202.41,-6557.96,22175.96
2030177969927839744,2020-01,1888.55,3393.12,6026.53,3277.34,1244.62,1244.62
2030177969927839744,2020-02,1745.19,4549.68,3369.23,3376.14,-2811.4,-1566.78
2030177969927839744,2020-03,7259.39,5969.33,6478.89,6009.63,1759.32,192.54
2030177969927839744,2020-04,7001.62,7927.4,4382.36,7352.45,-3895.87,-3703.33
2030177969927839744,2020-05,2347.77,7650.56,5331.19,8271.11,-8242.71,-11946.04
2030177969927839744,2020-06,4474.65,5316.03,6060.5,3326.01,1893.11,-10052.93
2030177969927839744,2020-07,4055.89,10226.61,1982.29,2526.77,-6715.2,-16768.13
2030177969927839744,2020-08,876.84,4053.77,4348.33,5229.68,-4058.28,-20826.41
2030177969927839744,2020-09,4407.81,5758.72,4909.17,2712.88,845.38,-19981.03
2030177969927839744,2020-10,7038.17,2289.13,6541.8,9251.72,2039.12,-17941.91
2030177969927839744,2020-11,0,4811.99,1424.48,7042.54,-10430.05,-28371.96
2030177969927839744,2020-12,1963.06,5598.26,2520.37,9921.76,-11036.59,-39408.55
2030851141073173504,2020-01,6830.27,4357.07,7309.15,4826.76,4955.59,4955.59
2030851141073173504,2020-02,10562.28,2484.48,6835.38,1579.01,13334.17,18289.76
2030851141073173504,2020-03,3081.85,9636.21,7297.63,5940.34,-5197.07,13092.69
2030851141073173504,2020-04,6352.29,3811.3,865.4,5467.3,-2060.91,11031.78
2030851141073173504,2020-05,2517.01,3827.63,3368.61,7262.36,-5204.37,5827.41
2030851141073173504,2020-06,3989.71,6002.22,339.9,3808.15,-5480.76,346.65
2030851141073173504,2020-07,3901.31,9611.06,6851.06,9551.37,-8410.06,-8063.41
2030851141073173504,2020-08,2842.56,649.01,6046.74,3402.26,4838.03,-3225.38
2030851141073173504,2020-09,1354.1,3389.66,4106.8,2540.21,-468.97,-3694.35
2030851141073173504,2020-10,4109.92,929.14,5860.06,6620.84,2420,-1274.35
2030851141073173504,2020-11,3539.91,1753.13,7104.87,3315.35,5576.3,4301.95
2030851141073173504,2020-12,555.9,10811.46,1562.58,1173.53,-9866.51,-5564.56
2031483866246487808,2020-01,0,1153.62,573.66,0,-579.96,-579.96
2031483866246487808,2020-02,0,3163.43,119.97,0,-3043.46,-3623.42
2031483866246487808,2020-03,1824.96,0,1669.83,400.13,3094.66,-528.76
2031483866246487808,2020-04,27.92,0,0,0,27.92,-500.84
2031483866246487808,2020-06,1432.38,0,939.87,1966.84,405.41,-95.43
2031483866246487808,2020-07,1614.72,1975.89,0,0,-361.17,-456.6
2031483866246487808,2020-09,0,1821.75,0,959.61,-2781.36,-3237.96
2031483866246487808,2020-10,0,1394.91,0,836.24,-2231.15,-5469.11
2031933492990545664,2020-01,7388.19,177.28,1.7,3664.81,3547.8,3547.8
2031933492990545664,2020-02,8439.23,3734.91,12193.79,2332.02,14566.09,18113.89
2031933492990545664,2020-03,4021.79,4020.3,2630.27,5426.98,-2795.22,15318.67
2031933492990545664,2020-04,4983.37,2095.69,1186.91,2437.45,1637.14,16955.81
2031933492990545664,2020-05,2501.75,2885,7393.27,1569.53,5440.49,22396.3
2031933492990545664,2020-06,3349.42,10982.74,933.24,1261.41,-7961.49,14434.81
2031933492990545664,2020-07,3702.59,3193.05,4980.31,3989.72,1500.13,15934.94
2031933492990545664,2020-08,6491.28,3232.28,7250.66,3849.8,6659.86,22594.8
2031933492990545664,2020-09,5271.05,1314.68,5504.05,3507.37,5953.05,28547.85
2031933492990545664,2020-10,2346.32,8496.93,5441.22,4590.5,-5299.89,23247.96
2031933492990545664,2020-11,4463.33,2668.32,7111.27,3045.69,5860.59,29108.55
2031933492990545664,2020-12,7388.21,4298.14,3301.66,3769.67,2622.06,31730.61
2032949788810590720,2020-01,1538.15,2888.12,320.17,1623.04,-2652.84,-2652.84
2032949788810590720,2020-02,0,1262.16,1126.22,0,-135.94,-2788.78
2032949788810590720,2020-03,0,2077.14,1296.69,0,-780.45,-3569.23
2032949788810590720,2020-04,2873.69,0,1115.41,2059.39,1929.71,-1639.52
2032949788810590720,2020-05,562.45,1228.35,447.97,0,-217.93,-1857.45
2032949788810590720,2020-06,1873.13,3132.71,916,0,-343.58,-2201.03
2032949788810590720,2020-07,2322.65,517.95,1071.37,4803.97,-1927.9,-4128.93
2032949788810590720,2020-08,248.73,1222.26,0,1873.91,-2847.44,-6976.37
2032949788810590720,2020-09,1261.35,2572.16,2899.32,0,1588.51,-5387.86
2032949788810590720,2020-10,247.86,29.69,500.81,683.24,35.74,-5352.12
2032949788810590720,2020-11,606.39,1350.05,0,0,-743.66,-6095.78
2032949788810590720,2020-12,675.53,1007.98,0,222.14,-554.59,-6650.37
2033061052027599872,2020-01,4303.48,8300.49,3117.69,3567.73,-4447.05,-4447.05
2033061052027599872,2020-02,8121.54,1924.49,1021.19,5747.09,1471.15,-2975.9
2033061052027599872,2020-03,2033.51,4093.69,6078.02,4560.56,-542.72,-3518.62
2033061052027599872,2020-04,1643.62,3043.37,4431.66,4646.03,-1614.12,-5132.74
2033061052027599872,2020-05,8474.01,3726.51,5658.92,3657.45,6748.97,1616.23
2033061052027599872,2020-06,3831.83,3762.24,2766.97,9903.45,-7066.89,-5450.66
2033061052027599872,2020-07,3630.36,7945.26,6608.09,1973.64,319.55,-5131.11
2033061052027599872,2020-08,4828.88,4169.01,1104.28,6798.6,-5034.45,-10165.56
2033061052027599872,2020-09,2695.75,5682.7,10767.6,3658.52,4122.13,-6043.43
2033061052027599872,2020-10,7241.87,5403.32,2133.63,4236.28,-264.1,-6307.53
2033061052027599872,2020-11,2948.98,2844.77,6562.95,3487.61,3179.55,-3127.98
2033061052027599872,2020-12,7469.56,3728.66,5523.47,7164.75,2099.62,-1028.36
2033433440091591424,2020-01,2121.8,339.98,0,0,1781.82,1781.82
2033433440091591424,2020-02,856.92,2106.45,0,501.91,-1751.44,30.38
2033433440091591424,2020-03,2646.55,1237.73,0,2800.85,-1392.03,-1361.65
2033433440091591424,2020-04,2731.54,2044.81,1568.74,1560.56,694.91,-666.74
2033433440091591424,2020-05,704.59,0,3478.85,0,4183.44,3516.7
2033433440091591424,2020-06,2686.54,793.16,771.04,275.4,2389.02,5905.72
2033433440091591424,2020-07,334.82,2919.69,1597.66,1395.51,-2382.72,3523
2033433440091591424,2020-08,514.44,0,3589.66,1956.09,2148.01,5671.01
2033433440091591424,2020-09,764.48,4991.64,1425.92,0,-2801.24,2869.77
2033433440091591424,2020-10,4287.05,4124.39,1934.65,4868.58,-2771.27,98.5
2033433440091591424,2020-11,1603.03,69.31,2559.95,1716.7,2376.97,2475.47
2033433440091591424,2020-12,1971.67,5180.51,1102.25,942.57,-3049.16,-573.69
2033741107095057664,2020-01,2360.32,2430.9,2630.4,4057.24,-1497.42,-1497.42
2033741107095057664,2020-02,565.75,4743.54,6121.04,4341.65,-2398.4,-3895.82
2033741107095057664,2020-03,3895.88,2838.36,8220.6,1969.64,7308.48,3412.66
2033741107095057664,2020-04,0,4352.65,3780.13,1538.68,-2111.2,1301.46
2033741107095057664,2020-05,2560.48,3650.02,6643.74,3969.66,1584.54,2886
2033741107095057664,2020-06,0,3665.85,4150.69,2010.04,-1525.2,1360.8
2033741107095057664,2020-07,3868.02,2436.68,1235.16,0,2666.5,4027.3
2033741107095057664,2020-08,4872.75,4596.04,1298.37,5159.32,-3584.24,443.06
2033741107095057664,2020-09,3906.38,8468.88,1143.46,3664.3,-7083.34,-6640.28
2033741107095057664,2020-10,2432.39,1705.75,2121.04,3497.93,-650.25,-7290.53
2033741107095057664,2020-11,2235.66,4050.79,1380.36,3932.99,-4367.76,-11658.29
2033741107095057664,2020-12,4270.9,4956.92,8714.58,3837.44,4191.12,-7467.17
2033994664562516736,2020-01,1038.29,1492.19,6553.44,5234.21,865.33,865.33
2033994664562516736,2020-02,10681.86,2194.06,2523.82,0,11011.62,11876.95
2033994664562516736,2020-03,5519.38,2277.98,9842.1,2947.51,10135.99,22012.94
2033994664562516736,2020-04,7964.62,3944.95,3101.9,3400.12,3721.45,25734.39
2033994664562516736,2020-05,3457.23,780.43,1435.37,9374.27,-5262.1,20472.29
2033994664562516736,2020-06,177.78,4635.03,8100.93,2853.43,790.25,21262.54
2033994664562516736,2020-07,1096.63,1763.94,938.25,596.58,-325.64,20936.9
2033994664562516736,2020-08,475.82,6204.54,2293.23,3679.92,-7115.41,13821.49
2033994664562516736,2020-09,2130.66,3693.67,5981.3,0,4418.29,18239.78
2033994664562516736,2020-10,1466.75,2648.75,4277.31,6060.99,-2965.68,15274.1
2033994664562516736,2020-11,1334.6,5607.92,5956.58,2745.49,-1062.23,14211.87
2033994664562516736,2020-12,2985.28,5507.3,5339.52,3911.88,-1094.38,13117.49
2034213366662874112,2020-02,1596.27,0,0,0,1596.27,1596.27
2034213366662874112,2020-12,0,757.23,0,0,-757.23,839.04
2034477831340720896,2020-01,0,1887.47,2779.18,5171.01,-4279.3,-4279.3
2034477831340720896,2020-02,1666.8,1883.35,1085.24,3596.12,-2727.43,-7006.73
2034477831340720896,2020-03,3197.67,1299.43,1886.11,0,3784.35,-3222.38
2034477831340720896,2020-04,793.86,3951.25,0,3388.44,-6545.83,-9768.21
2034477831340720896,2020-05,2314.76,578.14,5549.83,0,7286.45,-2481.76
2034477831340720896,2020-06,1350.37,460.79,272.42,3626.74,-2464.74,-4946.5
2034477831340720896,2020-07,5271.33,1948.74,369.94,0,3692.53,-1253.97
2034477831340720896,2020-08,3145.9,4155.23,0,1317.56,-2326.89,-3580.86
2034477831340720896,2020-09,0,2517.6,0,0,-2517.6,-6098.46
2034477831340720896,2020-10,1324.68,1842.69,0,1769.56,-2287.57,-8386.03
2034477831340720896,2020-11,0,818.11,0,1719.63,-2537.74,-10923.77
2034477831340720896,2020-12,1710.13,1067.53,1866.34,1709.49,799.45,-10124.32
2038414283053908224,2020-01,1834.68,3137.56,2293.01,2008.82,-1018.69,-1018.69
2038414283053908224,2020-02,1120.79,2019.59,4409.75,2860.5,650.45,-368.24
2038414283053908224,2020-03,378.34,2949.41,473.89,4362.1,-6459.28,-6827.52
2038414283053908224,2020-04,2350.05,4837.58,5415.92,1457.78,1470.61,-5356.91
2038414283053908224,2020-05,5670.97,2747.72,3243.37,2097.63,4068.99,-1287.92
2038414283053908224,2020-06,5679.53,4530.02,2497.28,2909.16,737.63,-550.29
2038414283053908224,2020-07,0,3558.69,3446.69,2270.6,-2382.6,-2932.89
2038414283053908224,2020-08,0,3778.29,102.14,3844.73,-7520.88,-10453.77
2038414283053908224,2020-09,2133.73,589.3,4701.46,1055.37,5190.52,-5263.25
2038414283053908224,2020-10,424.05,249.48,1555.32,3416.93,-1687.04,-6950.29
2038414283053908224,2020-11,1714.32,4803.51,2771.9,5231.25,-5548.54,-12498.83
2038414283053908224,2020-12,1516.97,1655.18,0,6061.87,-6200.08,-18698.91
2039452890425711360,2020-01,1811.47,4056.2,4203.45,11379.11,-9420.39,-9420.39
2039452890425711360,2020-02,5109.16,5021.63,3321.79,313.48,3095.84,-6324.55
2039452890425711360,2020-03,2643.81,7623.35,4771.84,3377.47,-3585.17,-9909.72
2039452890425711360,2020-04,4902.65,2741.82,1332.33,2080.7,1412.46,-8497.26
2039452890425711360,2020-05,2432.47,7703.79,1566.68,6103.9,-9808.54,-18305.8
2039452890425711360,2020-06,1485.21,4717.49,734.99,6942.52,-9439.81,-27745.61
2039452890425711360,2020-07,3861.26,5273.19,4963.17,4302.48,-751.24,-28496.85
2039452890425711360,2020-08,6270.49,6567.19,3057.9,2393.1,368.1,-28128.75
2039452890425711360,2020-09,5418.26,4618.69,2248,4976.22,-1928.65,-30057.4
2039452890425711360,2020-10,3469.37,4890.02,6854.2,5990.18,-556.63,-30614.03
2039452890425711360,2020-11,3538.74,5770.9,1460.62,2502.37,-3273.91,-33887.94
2039452890425711360,2020-12,4563.93,4985.88,6689.47,4994.63,1272.89,-32615.05
2041389728696890624,2020-01,359.98,1468.49,1431.87,6333.4,-6010.04,-6010.04
2041389728696890624,2020-02,1414.38,3608.34,1884.64,0,-309.32,-6319.36
2041389728696890624,2020-03,6180.1,2003,4633.69,814.75,7996.04,1676.68
2041389728696890624,2020-04,3971.72,415.97,3540.22,3253.05,3842.92,5519.6
2041389728696890624,2020-05,5506.79,3574.9,2481.71,8652.23,-4238.63,1280.97
2041389728696890624,2020-06,640.27,1821.11,2060,2028.12,-1148.96,132.01
2041389728696890624,2020-07,2261.33,2722.65,4932.13,1739.19,2731.62,2863.63
2041389728696890624,2020-08,7363.87,6156.63,2460.28,7087.59,-3420.07,-556.44
2041389728696890624,2020-09,2565.72,1467.48,1915.53,4552.35,-1538.58,-2095.02
2041389728696890624,2020-10,4196.16,2453.48,1124.29,2592.75,274.22,-1820.8
2041389728696890624,2020-11,1534.2,5956.82,1924.81,1276.04,-3773.85,-5594.65
2041389728696890624,2020-12,2355.76,3299.57,2070.67,2194.03,-1067.17,-6661.82
2041853200918799104,2020-01,886,4313.87,5224.05,4657.24,-2861.06,-2861.06
2041853200918799104,2020-02,2818.22,1555.42,1573.13,4029,-1193.07,-4054.13
2041853200918799104,2020-03,3224.62,4904.41,2872.43,8896.39,-7703.75,-11757.88
2041853200918799104,2020-04,7226.78,4013.15,7986.28,3428.23,7771.68,-3986.2
2041853200918799104,2020-05,7838.56,9141.49,4307.67,3313.36,-308.62,-4294.82
2041853200918799104,2020-06,5207.83,3942.37,6539.92,2938.7,4866.68,571.86
2041853200918799104,2020-07,1902.45,0,6547.95,1951.14,6499.26,7071.12
2041853200918799104,2020-08,5053.03,3781.11,3850.02,2524.73,2597.21,9668.33
2041853200918799104,2020-09,7118.9,54.37,2142.91,3132.93,6074.51,15742.84
2041853200918799104,2020-10,5940.21,5549.06,5679.85,3200.64,2870.36,18613.2
2041853200918799104,2020-11,10817.71,1265.74,7165.98,3832.3,12885.65,31498.85
2041853200918799104,2020-12,1705.24,3802.45,1860.12,8308.83,-8545.92,22952.93
2041877471771422720,2020-01,1429.48,4966.68,1880.11,4930.08,-6587.17,-6587.17
2041877471771422720,2020-02,620.06,0,3727.47,2582.4,1765.13,-4822.04
2041877471771422720,2020-03,7703.59,1888.78,1661.8,1544.17,5932.44,1110.4
2041877471771422720,2020-04,0,6091.54,2453.87,1687.91,-5325.58,-4215.18
2041877471771422720,2020-05,5577.08,2291.61,4748.2,733.87,7299.8,3084.62
2041877471771422720,2020-06,0,5104.31,2800.88,1067.04,-3370.47,-285.85
2041877471771422720,2020-07,0,2112.08,2136.54,342.05,-317.59,-603.44
2041877471771422720,2020-08,2802.08,4489.03,1623.41,1367.92,-1431.46,-2034.9
2041877471771422720,2020-09,2004.19,2285.76,1988.22,0,1706.65,-328.25
2041877471771422720,2020-10,4421.67,5123.07,0,858.47,-1559.87,-1888.12
2041877471771422720,2020-11,1354.27,2099.39,1991.03,4089.22,-2843.31,-4731.43
2041877471771422720,2020-12,0,2351.79,3611.04,0,1259.25,-3472.18
2041916531809737472,2020-01,3749.79,839.44,794.43,1853.59,1851.19,1851.19
2041916531809737472,2020-02,0,898.04,777.24,6216.11,-6336.91,-4485.72
2041916531809737472,2020-03,2435.04,1170.81,2831.29,1015.29,3080.23,-1405.49
2041916531809737472,2020-04,3349.57,412.66,5356.03,2489.14,5803.8,4398.31
2041916531809737472,2020-05,2514.58,2518.49,2303.62,6127.16,-3827.45,570.86
2041916531809737472,2020-06,3295,2274.13,2740.35,2568.73,1192.49,1763.35
2041916531809737472,2020-07,4120.39,3033.87,2413.7,0,3500.22,5263.57
2041916531809737472,2020-08,2034.68,3467.76,936.42,3071.45,-3568.11,1695.46
2041916531809737472,2020-09,4564.32,4120.84,5410.11,3355.66,2497.93,4193.39
2041916531809737472,2020-10,1429.96,4999.79,2290.89,3400.94,-4679.88,-486.49
2041916531809737472,2020-11,5246.27,1246.04,286.92,4261.79,25.36,-461.13
2041916531809737472,2020-12,0,1711.5,3415.74,913.68,790.56,329.43
2042053493491033344,2020-01,2395.93,4190.46,5875.26,3655.95,424.78,424.78
2042053493491033344,2020-02,6762.04,8047.22,10093.07,3510.73,5297.16,5721.94
2042053493491033344,2020-03,5960.81,4133.57,6105.95,2150.78,5782.41,11504.35
2042053493491033344,2020-04,3278.58,5255.9,4551.72,1100.5,1473.9,12978.25
2042053493491033344,2020-05,4579.59,7161.39,4773.93,2534.68,-342.55,12635.7
2042053493491033344,2020-06,3931.94,4105.14,2943.08,4562.17,-1792.29,10843.41
2042053493491033344,2020-07,5646.89,2762.96,2335.94,3204.5,2015.37,12858.78
2042053493491033344,2020-08,2205.06,2377.3,3120.52,4290.94,-1342.66,11516.12
2042053493491033344,2020-09,1288.8,5302.21,4587.11,8562.21,-7988.51,3527.61
2042053493491033344,2020-10,7162.86,4209.84,3194.24,11353.98,-5206.72,-1679.11
2042053493491033344,2020-11,2043.36,1061.32,3283.78,3821.56,444.26,-1234.85
2042053493491033344,2020-12,1126.98,11323.43,1975.86,3859.1,-12079.69,-13314.54
2046298759168853760,2020-01,4776.25,2492.5,0,868.96,1414.79,1414.79
2046298759168853760,2020-02,651.67,2354.91,2720.05,1236.43,-219.62,1195.17
2046298759168853760,2020-03,2584.56,1317.53,883.74,4662.8,-2512.03,-1316.86
2046298759168853760,2020-04,924.85,2115.47,1994.32,2664.42,-1860.72,-3177.58
2046298759168853760,2020-05,4501.01,2063.69,987.6,278.85,3146.07,-31.51
2046298759168853760,2020-06,302.94,3473.2,0,1239.41,-4409.67,-4441.18
2046298759168853760,2020-07,2814.18,2295.17,1069.44,2057.75,-469.3,-4910.48
2046298759168853760,2020-08,1032.88,1099.73,4760.63,922.08,3771.7,-1138.78
2046298759168853760,2020-09,770.34,3548.74,0,2583.67,-5362.07,-6500.85
2046298759168853760,2020-10,0,5173.82,1474.07,2472.45,-6172.2,-12673.05
2046298759168853760,2020-11,1971.02,3466.56,1889.44,0,393.9,-12279.15
2046298759168853760,2020-12,1986.04,2629.91,0,0,-643.87,-12923.02
2046511439346471936,2020-01,0,363.86,0,0,-363.86,-363.86
2046511439346471936,2020-02,0,583,0,0,-583,-946.86
2046511439346471936,2020-03,995.5,33.78,1279.69,0,2241.41,1294.55
2046511439346471936,2020-04,1879.95,1827.58,705.51,381.44,376.44,1670.99
2046511439346471936,2020-06,1323.37,103.4,0,0,1219.97,2890.96
2046511439346471936,2020-07,1946,1999.87,0,0,-53.87,2837.09
2046511439346471936,2020-09,1522.26,0,683.16,2619.78,-414.36,2422.73
2046511439346471936,2020-10,1631.51,0,13.76,134.08,1511.19,3933.92
2046626656805807616,2020-01,4783.96,5358.14,0,351.16,-925.34,-925.34
2046626656805807616,2020-02,1781.55,124.36,1079.03,1387.63,1348.59,423.25
2046626656805807616,2020-03,0,741.48,606.28,2789.91,-2925.11,-2501.86
2046626656805807616,2020-04,3397.25,2726.43,3768.89,0,4439.71,1937.85
2046626656805807616,2020-05,0,2495.43,2045,1624.33,-2074.76,-136.91
2046626656805807616,2020-06,0,1290.21,4718.12,2822.56,605.35,468.44
2046626656805807616,2020-07,2652.59,2538.58,1159.42,822.86,450.57,919.01
2046626656805807616,2020-08,3832.54,4207.72,1788.7,1977.03,-563.51,355.5
2046626656805807616,2020-09,1141.33,0,0,3958.1,-2816.77,-2461.27
2046626656805807616,2020-10,2853.33,1242.68,3155.62,962.07,3804.2,1342.93
2046626656805807616,2020-11,2293.59,0,1308.28,1743.99,1857.88,3200.81
2046626656805807616,2020-12,1719.4,1731.39,1895.36,1976.52,-93.15,3107.66
2047133178778858240,2020-01,0,1011.46,0,0,-1011.46,-1011.46
2047133178778858240,2020-02,1820.81,1305.75,1210.35,1964.97,-239.56,-1251.02
2047133178778858240,2020-03,670.11,1657.74,436.9,1506.27,-2057,-3308.02
2047133178778858240,2020-07,0,1319.04,0,745.94,-2064.98,-5373
2047133178778858240,2020-08,0,533.04,2699.95,0,2166.91,-3206.09
2047133178778858240,2020-09,0,596.37,0,0,-596.37,-3802.46
2047133178778858240,2020-10,273.47,2782.57,1115.69,271.83,-1665.24,-5467.7
2047133178778858240,2020-11,1692.07,0,4672.75,2339.15,4025.67,-1442.03
2047133178778858240,2020-12,0,1292.28,0,1824.14,-3116.42,-4558.45
2047335626149273856,2020-01,3325.55,2324.77,2445,6550.22,-3104.44,-3104.44
2047335626149273856,2020-02,2739.21,6723.09,3558.01,2128.31,-2554.18,-5658.62
2047335626149273856,2020-03,8655.31,3926.76,4403.09,3558.74,5572.9,-85.72
2047335626149273856,2020-04,7572.93,11222.93,3111.58,7096.03,-7634.45,-7720.17
2047335626149273856,2020-05,6650.38,5769.33,2930.1,4272.32,-461.17,-8181.34
2047335626149273856,2020-06,10647.46,390.94,1891.74,2742.33,9405.93,1224.59
2047335626149273856,2020-07,7778.57,3458.26,8057.3,7919.3,4458.31,5682.9
2047335626149273856,2020-08,627.87,1662.26,1264.71,7315.9,-7085.58,-1402.68
2047335626149273856,2020-09,4400.29,9142.48,4273.97,5331.51,-5799.73,-7202.41
2047335626149273856,2020-10,2454.4,2654.99,2850.91,3851.27,-1200.95,-8403.36
2047335626149273856,2020-11,1866.81,3696.07,6040.93,4341.23,-129.56,-8532.92
2047335626149273856,2020-12,1424.69,6037.86,7355.97,4665.39,-1922.59,-10455.51
2048815951131058432,2020-01,2421.37,1489.16,6286.7,719.4,6499.51,6499.51
2048815951131058432,2020-02,1269.38,0,1180.65,190.5,2259.53,8759.04
2048815951131058432,2020-03,8451.96,4924.32,5102.69,1731.99,6898.34,15657.38
2048815951131058432,2020-04,7099.66,4322.12,2126.9,9990.25,-5085.81,10571.57
2048815951131058432,2020-05,11684.99,5583.37,3860.83,3232.87,6729.58,17301.15
2048815951131058432,2020-06,7147.57,3835.56,5990.62,4766.11,4536.52,21837.67
2048815951131058432,2020-07,2945.6,12354.99,86.76,3631.54,-12954.17,8883.5
2048815951131058432,2020-08,6120.57,6492.75,3521.63,2659.58,489.87,9373.37
2048815951131058432,2020-09,1761.06,6037.55,5061.28,3503.47,-2718.68,6654.69
2048815951131058432,2020-10,1316.31,4302.94,267.01,6592.61,-9312.23,-2657.54
2048815951131058432,2020-11,3281.11,6229.31,1596.62,6096.79,-7448.37,-10105.91
2048815951131058432,2020-12,4844.39,2068.4,3700.85,2255.08,4221.76,-5884.15
2049726589355841280,2020-01,4501.56,2072.35,5514.79,2596,5348,5348
2049726589355841280,2020-02,5911.52,1983.43,3830.69,2982.32,4776.46,10124.46
2049726589355841280,2020-03,2763.44,2321.48,6462.66,5777.54,1127.08,11251.54
2049726589355841280,2020-04,3245.81,1391.56,1955.73,2194.73,1615.25,12866.79
2049726589355841280,2020-05,3270.62,4302.76,4575.82,6838.46,-3294.78,9572.01
2049726589355841280,2020-06,4783.26,1448.76,4344.27,1163.74,6515.03,16087.04
2049726589355841280,2020-07,2639.54,2997.59,2618.33,1892.37,367.91,16454.95
2049726589355841280,2020-08,1065.57,1933.2,1952.19,688.45,396.11,16851.06
2049726589355841280,2020-09,3924.6,3580.2,2830.77,3107.21,67.96,16919.02
2049726589355841280,2020-10,6812.77,1378.09,4384.16,2469.3,7349.54,24268.56
2049726589355841280,2020-11,5081.9,1253.35,2544.37,6286.45,86.47,24355.03
2049726589355841280,2020-12,2101.75,3252.15,2119.67,3766.91,-2797.64,21557.39
2050253362215924736,2020-01,3589.48,4775.77,0,2249.72,-3436.01,-3436.01
2050253362215924736,2020-02,5318.34,2474.36,5031.98,2219.38,5656.58,2220.57
2050253362215924736,2020-03,5848.24,3288.37,4174.77,1200.98,5533.66,7754.23
2050253362215924736,2020-04,3385.47,4552.34,2397.57,4878.08,-3647.38,4106.85
2050253362215924736,2020-05,3968.83,1109.03,3196.79,1994.62,4061.97,8168.82
2050253362215924736,2020-06,3423.86,4887.15,4577.65,0,3114.36,11283.18
2050253362215924736,2020-07,5326.88,4998.57,5327.17,2316.98,3338.5,14621.68
2050253362215924736,2020-08,384.04,1849.4,2352.78,6084.17,-5196.75,9424.93
2050253362215924736,2020-09,3722.69,0,3482.13,4659.37,2545.45,11970.38
2050253362215924736,2020-10,2046.61,1783.05,1533.62,5937.38,-4140.2,7830.18
2050253362215924736,2020-11,4369.4,6185.66,8342.51,2268.8,4257.45,12087.63
2050253362215924736,2020-12,3390,7038.34,2498.21,1719.26,-2869.39,9218.24
2054018529606849024,2020-01,491.86,7621.02,4375.61,2531.68,-5285.23,-5285.23
2054018529606849024,2020-02,1399.34,1053.62,2974.51,1662.33,1657.9,-3627.33
2054018529606849024,2020-03,2031.83,613.23,2697.88,3450.21,666.27,-2961.06
2054018529606849024,2020-04,1060.91,4081.7,2848,4820.66,-4993.45,-7954.51
2054018529606849024,2020-05,5166.25,2328.26,7805.18,4013.03,6630.14,-1324.37
2054018529606849024,2020-06,2454.43,1881.02,522.52,1433.94,-338.01,-1662.38
2054018529606849024,2020-07,5202.97,6493.64,2586.23,2877.72,-1582.16,-3244.54
2054018529606849024,2020-08,4199.23,5668.5,8003,1709.61,4824.12,1579.58
2054018529606849024,2020-09,3098.89,4054.7,3374.36,0,2418.55,3998.13
2054018529606849024,2020-10,1520.99,4539.28,2581.18,3815.22,-4252.33,-254.2
2054018529606849024,2020-11,2439.98,4435.97,4782.78,2745.7,41.09,-213.11
2054018529606849024,2020-12,6044.45,2168.88,3922.69,3609.36,4188.9,3975.79
2054314717949179904,2020-01,7873.61,8688.19,3306.42,6005.23,-3513.39,-3513.39
2054314717949179904,2020-02,5794.1,6252.07,6295.83,4152.57,1685.29,-1828.1
2054314717949179904,2020-03,4381.86,4860.02,3908.07,4126.63,-696.72,-2524.82
2054314717949179904,2020-04,4359.48,1268.65,2231.24,6646.85,-1324.78,-3849.6
2054314717949179904,2020-05,6628.38,9628.02,4555.46,13060.91,-11505.09,-15354.69
2054314717949179904,2020-06,2745.87,418.09,1188.95,6248.38,-2731.65,-18086.34
2054314717949179904,2020-07,2499.86,6216.85,234.52,5692.55,-9175.02,-27261.36
2054314717949179904,2020-08,2934.12,2631.66,4883.39,4316.34,869.51,-26391.85
2054314717949179904,2020-09,4626.49,0,5682.64,5809.28,4499.85,-21892
2054314717949179904,2020-10,12669.93,5610.87,6914.35,2916.9,11056.51,-10835.49
2054314717949179904,2020-11,1914.52,3364.65,2775.12,5328.34,-4003.35,-14838.84
2054314717949179904,2020-12,7044.6,4743.32,8611.53,1175.49,9737.32,-5101.52
2055680165065854720,2020-01,1431.43,533.62,1194.69,1114.81,977.69,977.69
2055680165065854720,2020-02,1361.37,2209.29,442.89,1707.63,-2112.66,-1134.97
2055680165065854720,2020-03,5277.08,3580.26,1430.11,4659.97,-1533.04,-2668.01
2055680165065854720,2020-04,1161.12,1524.51,3887.45,0,3524.06,856.05
2055680165065854720,2020-05,2188.86,4498.05,134.17,4456.64,-6631.66,-5775.61
2055680165065854720,2020-06,1957.97,1470.4,1847.69,456.19,1879.07,-3896.54
2055680165065854720,2020-08,4982.38,648.31,4671.11,0,9005.18,5108.64
2055680165065854720,2020-09,1738.37,1465.95,6054.22,5113.09,1213.55,6322.19
2055680165065854720,2020-10,1236.56,350.81,0,1715.2,-829.45,5492.74
2055680165065854720,2020-11,3323.93,7706.57,2127.31,296.48,-2551.81,2940.93
2055680165065854720,2020-12,6219.34,1983,3366.75,2573.34,5029.75,7970.68
2056115200409852160,2020-01,3476.01,3051.11,4172.34,0,4597.24,4597.24
2056115200409852160,2020-02,1669.4,959.22,2923.71,2341.14,1292.75,5889.99
2056115200409852160,2020-03,8385.37,7389.33,1540.2,3114.63,-578.39,5311.6
2056115200409852160,2020-04,4898.22,1818.75,2542.16,3140.47,2481.16,7792.76
2056115200409852160,2020-05,4854.43,4688.97,3279.61,1999.25,1445.82,9238.58
2056115200409852160,2020-06,2787.86,2368.09,0,4916.63,-4496.86,4741.72
2056115200409852160,2020-07,5417.65,5450.4,1846.09,2884.54,-1071.2,3670.52
2056115200409852160,2020-08,3684.09,507.18,2418.06,1297.92,4297.05,7967.57
2056115200409852160,2020-09,3482.96,1442.76,1797.71,3319.74,518.17,8485.74
2056115200409852160,2020-10,4289.9,5602.65,3185.57,3404.55,-1531.73,6954.01
2056115200409852160,2020-11,4258.43,4452.42,2641.73,2172.14,275.6,7229.61
2056115200409852160,2020-12,7061.74,7800.9,2083.96,2807.66,-1462.86,5766.75
2056254715589038592,2020-01,1504.48,2685.65,2872.54,10058.12,-8366.75,-8366.75
2056254715589038592,2020-02,7220.34,3738.18,4662.03,770.26,7373.93,-992.82
2056254715589038592,2020-03,2458.24,0,7018.74,8697.27,779.71,-213.11
2056254715589038592,2020-04,821.74,2616,2688.24,7098.03,-6204.05,-6417.16
2056254715589038592,2020-05,3405.66,5007.99,1358.29,4409.71,-4653.75,-11070.91
2056254715589038592,2020-06,6329.24,905.11,1112.68,3214.99,3321.82,-7749.09
2056254715589038592,2020-07,9065.44,4295.33,446.1,6479.41,-1263.2,-9012.29
2056254715589038592,2020-08,2679.12,2864.01,937.03,4167.56,-3415.42,-12427.71
2056254715589038592,2020-09,5256.8,5673.03,4975.55,4740.29,-180.97,-12608.68
2056254715589038592,2020-10,2368.9,0,6255.98,2647.99,5976.89,-6631.79
2056254715589038592,2020-11,3837.86,4575.65,1155.68,3250.25,-2832.36,-9464.15
2056254715589038592,2020-12,6585.8,3801.87,710.78,5677.57,-2182.86,-11647.01
2056321530289638912,2020-03,0,303.24,1417.29,0,1114.05,1114.05
2056321530289638912,2020-04,62.14,1358.83,224.7,1621.67,-2693.66,-1579.61
2056321530289638912,2020-05,1853.86,1852.81,0,0,1.05,-1578.56
2056321530289638912,2020-06,0,1906.98,1255.53,0,-651.45,-2230.01
2056321530289638912,2020-07,600.15,0,0,0,600.15,-1629.86
2056321530289638912,2020-08,1563.61,0,1955.3,0,3518.91,1889.05
2056321530289638912,2020-09,956.54,0,458.82,0,1415.36,3304.41
2056321530289638912,2020-10,1209.36,438.84,1491.13,0,2261.65,5566.06
2057842135790398720,2020-01,445.15,0,0,663.73,-218.58,-218.58
2057842135790398720,2020-05,0,389.89,782.26,0,392.37,173.79
2057842135790398720,2020-07,0,2320.34,0,0,-2320.34,-2146.55
2057842135790398720,2020-10,1805.48,0,1523.65,126.9,3202.23,1055.68
2057842135790398720,2020-12,1404.26,0,0,279.3,1124.96,2180.64
2058104580466501376,2020-02,1183.04,0,1853.56,478.52,2558.08,2558.08
2058104580466501376,2020-11,342.33,935.61,0,1358.05,-1951.33,606.75
2058712633918416640,2020-01,1892.31,0,2177.55,6513.64,-2443.78,-2443.78
2058712633918416640,2020-02,4808.22,0,4266.3,1834.53,7239.99,4796.21
2058712633918416640,2020-03,3653.48,2530.58,7421.97,4176.18,4368.69,9164.9
2058712633918416640,2020-04,5009.55,4872.54,406.76,3601.31,-3057.54,6107.36
2058712633918416640,2020-05,4804.63,8990.48,4673.14,8926.91,-8439.62,-2332.26
2058712633918416640,2020-06,3599.25,4495.02,6096.99,5136.43,64.79,-2267.47
2058712633918416640,2020-07,2313.48,386.71,4423.18,5367.5,982.45,-1285.02
2058712633918416640,2020-08,5978.68,6625.93,1698.96,1941.55,-889.84,-2174.86
2058712633918416640,2020-09,3029.29,5113.07,5842.45,2341.83,1416.84,-758.02
2058712633918416640,2020-10,1679.98,6494.71,5953.58,6249.91,-5111.06,-5869.08
2058712633918416640,2020-11,4237.46,2841.88,496.1,2515.75,-624.07,-6493.15
2058712633918416640,2020-12,4047.55,6403.65,4061.08,3392.1,-1687.12,-8180.27
2058780867809096960,2020-01,1802.76,1929.69,4065.66,4919.52,-980.79,-980.79
2058780867809096960,2020-02,3611.13,3138.42,4849.12,2954.98,2366.85,1386.06
2058780867809096960,2020-03,2756.51,5179.37,6169.79,3951.28,-204.35,1181.71
2058780867809096960,2020-04,5247.19,2645.7,4073.2,4863.87,1810.82,2992.53
2058780867809096960,2020-05,3024.28,10865.69,5403.04,1272.11,-3710.48,-717.95
2058780867809096960,2020-06,2121.51,5561.54,2492.89,4166.08,-5113.22,-5831.17
2058780867809096960,2020-07,2408.07,6116.17,1890.25,6977.26,-8795.11,-14626.28
2058780867809096960,2020-08,3634.9,0,9217.11,1393.58,11458.43,-3167.85
2058780867809096960,2020-09,3472.66,1529.4,4603.81,5477.14,1069.93,-2097.92
2058780867809096960,2020-10,4632.46,1644.3,357.09,5692.61,-2347.36,-4445.28
2058780867809096960,2020-11,5281.27,5346.15,2111.09,3739.6,-1693.39,-6138.67
2058780867809096960,2020-12,2116.37,2953.39,1502.23,1936.7,-1271.49,-7410.16
2058896826933046784,2020-01,112.27,1192.38,0,1820.7,-2900.81,-2900.81
2058896826933046784,2020-02,770.43,956.17,0,0,-185.74,-3086.55
2058896826933046784,2020-03,1640.6,3792.62,0,0,-2152.02,-5238.57
2058896826933046784,2020-04,1609.34,0,905.75,526.53,1988.56,-3250.01
2058896826933046784,2020-05,3924.58,1150.56,2139.52,0,4913.54,1663.53
2058896826933046784,2020-06,1716.96,546.51,740.07,0,1910.52,3574.05
2058896826933046784,2020-07,214.15,1080.75,2200.38,0,1333.78,4907.83
2058896826933046784,2020-08,235.17,1562.2,2823.77,0,1496.74,6404.57
2058896826933046784,2020-09,374.16,1992.96,664.94,1179.1,-2132.96,4271.61
2058896826933046784,2020-10,1276.42,514.77,2734.2,0,3495.85,7767.46
2058896826933046784,2020-11,469.24,1089.47,2599.98,3011.24,-1031.49,6735.97
2058896826933046784,2020-12,1480.77,0,1640.36,3962.46,-841.33,5894.64
2060497792918060544,2020-01,1648.59,9190.39,3269.73,6097.92,-10369.99,-10369.99
2060497792918060544,2020-02,3074.24,2344.33,3532.6,3115.37,1147.14,-9222.85
2060497792918060544,2020-03,5251.71,4667.51,4127.1,1959.74,2751.56,-6471.29
2060497792918060544,2020-04,8011.59,1569.2,1676.49,3949.94,4168.94,-2302.35
2060497792918060544,2020-05,4522.79,3134.11,3608.99,623.23,4374.44,2072.09
2060497792918060544,2020-06,3988.98,4874.75,2242.36,7025.51,-5668.92,-3596.83
2060497792918060544,2020-07,9714.65,897.96,4134.69,1334.7,11616.68,8019.85
2060497792918060544,2020-08,2081.61,3774.17,3105.58,2920.32,-1507.3,6512.55
2060497792918060544,2020-09,2960.22,4677.1,557.49,5681.77,-6841.16,-328.61
2060497792918060544,2020-10,7455.52,3030.16,6286,3245.28,7466.08,7137.47
2060497792918060544,2020-11,3260.85,789.39,1146.14,2902.01,715.59,7853.06
2060497792918060544,2020-12,574.99,1646.17,2312.65,4489.54,-3248.07,4604.99
2061498143081993728,2020-01,1187.97,0,0,0,1187.97,1187.97
2061498143081993728,2020-02,0,132.17,0,0,-132.17,1055.8
2061498143081993728,2020-03,0,1118.38,1678.23,0,559.85,1615.65
2061498143081993728,2020-04,0,344.96,0,193.19,-538.15,1077.5
2061498143081993728,2020-05,277.47,0,1498.83,0,1776.3,2853.8
2061498143081993728,2020-06,1679.89,239.46,1604.67,0,3045.1,5898.9
2061498143081993728,2020-08,367.47,0,0,2674.41,-2306.94,3591.96
2061498143081993728,2020-10,0,420.6,0,1552.8,-1973.4,1618.56
2061498143081993728,2020-12,0,901.8,0,1867.51,-2769.31,-1150.75
2062085282714886144,2020-01,6109.62,1222.71,678.83,4384.46,1181.28,1181.28
2062085282714886144,2020-02,1692.6,267.84,825.84,2937.25,-686.65,494.63
2062085282714886144,2020-03,7275.83,4200.66,3727.23,5335.72,1466.68,1961.31
2062085282714886144,2020-04,1638.38,3420.92,13307.95,3251.9,8273.51,10234.82
2062085282714886144,2020-05,9770.48,1670.98,3158.18,2047.02,9210.66,19445.48
2062085282714886144,2020-06,1865.79,4247.43,3515.97,4445.34,-3311.01,16134.47
2062085282714886144,2020-07,4037.91,3964.14,1635.17,5079.04,-3370.1,12764.37
2062085282714886144,2020-08,5580.13,9570.24,4813.79,2994.04,-2170.36,10594.01
2062085282714886144,2020-09,6381.86,3834.43,3833.55,1882.56,4498.42,15092.43
2062085282714886144,2020-10,6382.58,3767.52,4013.64,24.91,6603.79,21696.22
2062085282714886144,2020-11,3605.2,2818.05,2029.24,2039.53,776.86,22473.08
2062085282714886144,2020-12,7976.48,3509.37,0,3640.53,826.58,23299.66
2065072019821918976,2020-01,7098.14,2479.23,2127.78,4881.52,1865.17,1865.17
2065072019821918976,2020-02,6643.54,7150.76,5325.7,1920.48,2898,4763.17
2065072019821918976,2020-03,10687.9,2869.03,1741.28,4452.9,5107.25,9870.42
2065072019821918976,2020-05,898.09,4500.17,5824.59,476.72,1745.79,11616.21
2065072019821918976,2020-06,6475.3,2980.75,1622.77,8134.54,-3017.22,8598.99
2065072019821918976,2020-07,120.05,3542.84,4456.32,659.98,373.55,8972.54
2065072019821918976,2020-08,4203.1,4275.61,4882.84,4768.33,42,9014.54
2065072019821918976,2020-09,6384.04,3875.58,54.65,2828.74,-265.63,8748.91
2065072019821918976,2020-10,1964.06,3799.33,1322.16,3750.47,-4263.58,4485.33
2065072019821918976,2020-11,7268.57,2307.09,2754.69,8735.67,-1019.5,3465.83
2065072019821918976,2020-12,808.27,2109.24,6501.48,7038.09,-1837.58,1628.25
2065441937448028672,2020-01,3703.04,5301.09,2784.19,6250.11,-5063.97,-5063.97
2065441937448028672,2020-02,9400.47,1758.75,8516.68,6153.69,10004.71,4940.74
2065441937448028672,2020-03,5044.84,12566.45,4203.21,6699.91,-10018.31,-5077.57
2065441937448028672,2020-04,5609.13,3183.29,1548.68,3438.37,536.15,-4541.42
2065441937448028672,2020-05,2088.56,2275.01,3546.69,6639.3,-3279.06,-7820.48
2065441937448028672,2020-06,4142.58,2569.57,5582.94,3464,3691.95,-4128.53
2065441937448028672,2020-07,3679.12,1924.1,2170.86,9347.07,-5421.19,-9549.72
2065441937448028672,2020-08,3002.35,3874.87,3856.05,1836.44,1147.09,-8402.63
2065441937448028672,2020-09,4683.5,3041.18,0,6359.86,-4717.54,-13120.17
2065441937448028672,2020-10,3888.44,2190.57,2696.22,2172,2222.09,-10898.08
2065441937448028672,2020-11,5987.68,5013.69,5236.61,11066.16,-4855.56,-15753.64
2065441937448028672,2020-12,3822.23,6487.79,4046.26,9615.01,-8234.31,-23987.95
2065461453644014080,2020-01,5906.81,1527.91,3878.21,2688.13,5568.98,5568.98
2065461453644014080,2020-02,1675.82,1714.95,997.49,6262.86,-5304.5,264.48
2065461453644014080,2020-03,2821.32,3077.75,3643.27,4721,-1334.16,-1069.68
2065461453644014080,2020-04,1551.61,2498.4,3493.8,2031.14,515.87,-553.81
2065461453644014080,2020-05,2538.44,2562.57,799.41,3906.96,-3131.68,-3685.49
2065461453644014080,2020-06,2384.23,0,3431.43,814.16,5001.5,1316.01
2065461453644014080,2020-07,375.63,4698.15,7582.21,36.21,3223.48,4539.49
2065461453644014080,2020-08,4667.4,4754.9,1386.08,5823.7,-4525.12,14.37
2065461453644014080,2020-09,2805.78,2208,3682.76,2433.94,1846.6,1860.97
2065461453644014080,2020-10,2220.75,3064.39,3580.85,7306.28,-4569.07,-2708.1
2065461453644014080,2020-11,633.28,2838.26,2761.78,3574.35,-3017.55,-5725.65
2065461453644014080,2020-12,2593.96,2953.33,5097.74,2143.96,2594.41,-3131.24
2065593350303830016,2020-01,459.88,3863.14,3565.06,0,161.8,161.8
2065593350303830016,2020-02,2189.71,3203.57,0,169.77,-1183.63,-1021.83
2065593350303830016,2020-03,2054.19,1491.09,1669.55,9367.23,-7134.58,-8156.41
2065593350303830016,2020-04,2341.49,4768.88,6600.52,5472.66,-1299.53,-9455.94
2065593350303830016,2020-05,4350.45,4547.61,3478.45,756.16,2525.13,-6930.81
2065593350303830016,2020-06,2391.58,1735.49,846.75,6026.86,-4524.02,-11454.83
2065593350303830016,2020-07,3990.1,5018.82,2547.08,3677.08,-2158.72,-13613.55
2065593350303830016,2020-08,5491.07,1747.56,10153.44,2941.29,10955.66,-2657.89
2065593350303830016,2020-09,3186.1,6371.12,5365.53,160.89,2019.62,-638.27
2065593350303830016,2020-10,8203.34,1480.49,3678.91,5229.41,5172.35,4534.08
2065593350303830016,2020-11,4004.27,1871.67,2040.82,1942.95,2230.47,6764.55
2065593350303830016,2020-12,3171.93,2686.34,5047.18,2620.4,2912.37,9676.92
2065612921324553216,2020-01,3806.23,1588.03,1510.53,6028.94,-2300.21,-2300.21
2065612921324553216,2020-02,4309.78,7007.9,1334.8,6530.67,-7893.99,-10194.2
2065612921324553216,2020-03,3344.76,5385.69,4305.91,5320.57,-3055.59,-13249.79
2065612921324553216,2020-04,4282.21,4718.33,4980.41,4878.92,-334.63,-13584.42
2065612921324553216,2020-05,1509.46,7238.88,3243.84,7399.63,-9885.21,-23469.63
2065612921324553216,2020-06,2613.06,2189.61,6504.42,8285.71,-1357.84,-24827.47
2065612921324553216,2020-07,6513.1,2197.07,2805.99,7712.57,-590.55,-25418.02
2065612921324553216,2020-08,5762.97,4409.43,2453.79,2478.71,1328.62,-24089.4
2065612921324553216,2020-09,5827.41,1561.81,4522.31,7010.73,1777.18,-22312.22
2065612921324553216,2020-10,1808.09,783.37,10447.28,7226.77,4245.23,-18066.99
2065612921324553216,2020-11,2922.75,154.62,4186.17,3808.14,3146.16,-14920.83
2065612921324553216,2020-12,4556.95,3386.97,5166.93,4561.75,1775.16,-13145.67
2065710005671612416,2020-01,3854.58,3486.97,4412.66,1729.11,3051.16,3051.16
2065710005671612416,2020-02,2583.41,3055.24,1316.04,4519.5,-3675.29,-624.13
2065710005671612416,2020-03,3252.36,4797.77,6054.56,2780.28,1728.87,1104.74
2065710005671612416,2020-04,1919.89,3238.51,2634.64,1385.5,-69.48,1035.26
2065710005671612416,2020-05,4922.74,1217.65,155.46,915.05,2945.5,3980.76
2065710005671612416,2020-06,2271.49,1292.76,2730.09,2035.22,1673.6,5654.36
2065710005671612416,2020-07,274.6,997.89,3253.98,704.53,1826.16,7480.52
2065710005671612416,2020-08,2933.73,3554.56,3425.7,4433.66,-1628.79,5851.73
2065710005671612416,2020-09,4839.65,1854.14,6906.23,2253.59,7638.15,13489.88
2065710005671612416,2020-10,6912.47,1964.05,1517.82,3056.18,3410.06,16899.94
2065710005671612416,2020-11,1725.68,1543.64,2220.63,5531.12,-3128.45,13771.49
2065710005671612416,2020-12,3899.09,3040.32,5248.94,3822.49,2285.22,16056.71
2066216576378385920,2020-01,0,2037.03,726.86,170.51,-1480.68,-1480.68
2066216576378385920,2020-02,0,446.95,2674.4,1550.06,677.39,-803.29
2066216576378385920,2020-03,1577.99,4120.68,1603.98,0,-938.71,-1742
2066216576378385920,2020-04,0,383,296.19,1104.82,-1191.63,-2933.63
2066216576378385920,2020-05,4102.09,1756.54,965.71,134.38,3176.88,243.25
2066216576378385920,2020-06,1096.61,1537.96,597.36,1741.02,-1585.01,-1341.76
2066216576378385920,2020-07,0,833.77,1535.69,0,701.92,-639.84
2066216576378385920,2020-08,1904.5,1414.81,0,3684.01,-3194.32,-3834.16
2066216576378385920,2020-10,2344.09,1924.43,0,0,419.66,-3414.5
2066216576378385920,2020-11,0,143.73,3051.34,1906.55,1001.06,-2413.44
2066527308670583296,2020-01,3452.24,3796.37,4493.61,3539.9,609.58,609.58
2066527308670583296,2020-02,3355.11,62.43,1155.84,4117.46,331.06,940.64
2066527308670583296,2020-03,1924.73,10671.28,423.82,1599.78,-9922.51,-8981.87
2066527308670583296,2020-04,2292,2892.45,2587.74,7309.63,-5322.34,-14304.21
2066527308670583296,2020-05,3944.92,6928.01,6666,2385.39,1297.52,-13006.69
2066527308670583296,2020-06,7791.78,2344.89,1415.72,2750.23,4112.38,-8894.31
2066527308670583296,2020-07,0,1089.64,6654.71,7930.94,-2365.87,-11260.18
2066527308670583296,2020-08,3046.96,3601.34,3158.82,908.08,1696.36,-9563.82
2066527308670583296,2020-09,5220.1,7411.83,575.21,6949.98,-8566.5,-18130.32
2066527308670583296,2020-10,4035.61,622.51,2436.48,3500.2,2349.38,-15780.94
2066527308670583296,2020-11,8561.32,3880.96,1936.48,7241.24,-624.4,-16405.34
2066527308670583296,2020-12,5554.21,5122.37,10084.26,7488.35,3027.75,-13377.59
2067046635542224896,2020-02,59.34,993.17,1114.84,0,181.01,181.01
2067046635542224896,2020-03,1651,0,217.11,0,1868.11,2049.12
2067046635542224896,2020-04,1623.95,0,0,947.81,676.14,2725.26
2067046635542224896,2020-06,0,845.05,312.08,0,-532.97,2192.29
2067046635542224896,2020-07,0,946.04,0,581.98,-1528.02,664.27
2067046635542224896,2020-09,3649.53,2566.89,942.92,1924.15,101.41,765.68
2067046635542224896,2020-11,6208.4,2224.38,2482.88,589.82,5877.08,6642.76
2067046635542224896,2020-12,1001.07,0,0,0,1001.07,7643.83
2067651541475991808,2020-01,0,2525.4,3089.7,0,564.3,564.3
2067651541475991808,2020-02,1338.51,1565.8,0,153.52,-380.81,183.49
2067651541475991808,2020-03,770.43,2880.76,0,720.74,-2831.07,-2647.58
2067651541475991808,2020-04,3651.8,961.87,2108.06,114.18,4683.81,2036.23
2067651541475991808,2020-05,0,2257.73,0,0,-2257.73,-221.5
2067651541475991808,2020-06,3462.66,0,1449.1,1108.64,3803.12,3581.62
2067651541475991808,2020-07,7.56,3946.37,0,1268.55,-5207.36,-1625.74
2067651541475991808,2020-08,1558.09,0,390.84,128.58,1820.35,194.61
2067651541475991808,2020-09,1217.49,0,0,4035.38,-2817.89,-2623.28
2067651541475991808,2020-10,1901.15,2561.94,1706.5,2364.19,-1318.48,-3941.76
2067651541475991808,2020-11,672.65,0,3790.46,1747.27,2715.84,-1225.92
2067651541475991808,2020-12,0,1855.81,1336.73,0,-519.08,-1745
2068244080672996352,2020-01,0,1883.62,1965.5,8304.75,-8222.87,-8222.87
2068244080672996352,2020-02,2184.91,3076.38,0,2990.56,-3882.03,-12104.9
2068244080672996352,2020-03,5747.06,2951.14,3201.92,1944.6,4053.24,-8051.66
2068244080672996352,2020-04,7217.7,3736.56,1794.37,1498.32,3777.19,-4274.47
2068244080672996352,2020-05,4040.37,4026.33,3436.77,436.69,3014.12,-1260.35
2068244080672996352,2020-06,2077.27,2753.11,5460.96,2528.54,2256.58,996.23
2068244080672996352,2020-07,1861.27,1055.21,4516.06,1027.93,4294.19,5290.42
2068244080672996352,2020-08,2912.1,1851.46,1170.11,724.86,1505.89,6796.31
2068244080672996352,2020-09,789.83,4938.62,4093.63,5686.99,-5742.15,1054.16
2068244080672996352,2020-10,647.31,1434.68,1730.68,8920.56,-7977.25,-6923.09
2068244080672996352,2020-11,4082.78,1882.64,4294.7,0,6494.84,-428.25
2068244080672996352,2020-12,3103.79,4493.62,998.12,2903.68,-3295.39,-3723.64
2068622109737670656,2020-01,1131.83,321.8,2850.49,1283.63,2376.89,2376.89
2068622109737670656,2020-02,757.24,0,0,2113.75,-1356.51,1020.38
2068622109737670656,2020-03,886.78,0,0,0,886.78,1907.16
2068622109737670656,2020-04,1258.11,684.9,549.26,2726.38,-1603.91,303.25
2068622109737670656,2020-05,1055.44,1580.02,1060.98,0,536.4,839.65
2068622109737670656,2020-06,3441.5,990.22,707.4,1932.65,1226.03,2065.68
2068622109737670656,2020-09,1671.84,0,197.29,2318.53,-449.4,1616.28
2068622109737670656,2020-10,156.92,714.28,0,0,-557.36,1058.92
2068622109737670656,2020-11,128.77,3663.45,2628.8,1450.42,-2356.3,-1297.38
2068622109737670656,2020-12,563.9,885.77,229.24,0,-92.63,-1390.01
2071355715266916864,2020-01,6210.85,1780.69,1230.24,0,5660.4,5660.4
2071355715266916864,2020-02,425.36,0,0,368.96,56.4,5716.8
2071355715266916864,2020-03,5411.67,3280.37,1004.14,398.5,2736.94,8453.74
2071355715266916864,2020-04,1433,3435.78,2498.27,2309.95,-1814.46,6639.28
2071355715266916864,2020-05,804.84,0,2894.6,2351.53,1347.91,7987.19
2071355715266916864,2020-06,358.91,1674.27,544.38,2556.45,-3327.43,4659.76
2071355715266916864,2020-07,1783.73,0,2840.92,1550.24,3074.41,7734.17
2071355715266916864,2020-08,5602.36,3775,925.07,633.79,2118.64,9852.81
2071355715266916864,2020-09,1475.46,2425.04,2683.05,2955.9,-1222.43,8630.38
2071355715266916864,2020-10,1473.03,3678.78,2208.21,1642.8,-1640.34,6990.04
2071355715266916864,2020-11,501.51,2765.35,0,2794.47,-5058.31,1931.73
2071355715266916864,2020-12,509.02,425.73,0,970.36,-887.07,1044.66
2071688252907312640,2020-01,1483.69,902.17,0,3052.23,-2470.71,-2470.71
2071688252907312640,2020-03,2544.48,0,0,942.77,1601.71,-869
2071688252907312640,2020-04,1288.91,0,0,1470.84,-181.93,-1050.93
2071688252907312640,2020-05,0,153.76,769.65,0,615.89,-435.04
2071688252907312640,2020-06,1899.05,0,0,0,1899.05,1464.01
2071688252907312640,2020-07,0,2080.26,4114.18,0,2033.92,3497.93
2071688252907312640,2020-08,1438.79,0,1695.48,0,3134.27,6632.2
2071688252907312640,2020-10,2556.47,0,416.63,0,2973.1,9605.3
2071688252907312640,2020-12,1227.03,0,0,1222.33,4.7,9610
2072603460403802880,2020-01,11750.84,5907.61,11565.76,5024.24,12384.75,12384.75
2072603460403802880,2020-02,1820.93,2177.09,2829.47,3523,-1049.69,11335.06
2072603460403802880,2020-03,2295.08,1523.95,4430.84,2676.97,2525,13860.06
2072603460403802880,2020-04,4809.89,7185.63,5545.93,2771.95,398.24,14258.3
2072603460403802880,2020-05,5046.47,1090.34,2516.51,4508.3,1964.34,16222.64
2072603460403802880,2020-06,3654.85,5119.9,6857.79,2952.51,2440.23,18662.87
2072603460403802880,2020-07,5201.11,2871.09,2011.6,4059.26,282.36,18945.23
2072603460403802880,2020-08,9714.02,6982.75,7392.57,3741.62,6382.22,25327.45
2072603460403802880,2020-09,1330.95,5211.05,7527.98,5078.68,-1430.8,23896.65
2072603460403802880,2020-10,2718.55,2765.05,2518.95,1313.06,1159.39,25056.04
2072603460403802880,2020-11,4975.49,6695.04,3422.11,5188.55,-3485.99,21570.05
2072603460403802880,2020-12,4833.47,1437.7,9542.75,2587.73,10350.79,31920.84
2073966996690176256,2020-01,5207.62,235.89,11285.4,4236.47,12020.66,12020.66
2073966996690176256,2020-02,5685.81,1786.54,7172.64,2397.33,8674.58,20695.24
2073966996690176256,2020-03,6928.39,5048.47,3932.35,7928.65,-2116.38,18578.86
2073966996690176256,2020-04,4892.32,4210.56,6782.09,8101.34,-637.49,17941.37
2073966996690176256,2020-05,4604.58,8454.66,2552.92,882.3,-2179.46,15761.91
2073966996690176256,2020-06,2822.71,3920.47,5173.21,3583.09,492.36,16254.27
2073966996690176256,2020-07,4700.75,1441.91,6182.73,4998.93,4442.64,20696.91
2073966996690176256,2020-08,6103.82,2517.68,5111.95,4952.68,3745.41,24442.32
2073966996690176256,2020-09,3815.54,10539.49,3740.88,1681.15,-4664.22,19778.1
2073966996690176256,2020-10,5604.63,203.98,3376.76,5292.72,3484.69,23262.79
2073966996690176256,2020-11,1801.88,891.79,7085.05,1565.46,6429.68,29692.47
2073966996690176256,2020-12,7677.19,5584.57,4641.99,5294.75,1439.86,31132.33
2074732183890123008,2020-01,4383.07,3090.84,1920.23,3169.29,43.17,43.17
2074732183890123008,2020-02,4116.82,2004.95,4839.47,2523.82,4427.52,4470.69
2074732183890123008,2020-03,1225.52,1042.47,3808.37,3736.76,254.66,4725.35
2074732183890123008,2020-04,6752.26,2100.76,1049.5,2688.08,3012.92,7738.27
2074732183890123008,2020-05,1456.53,5280.84,2187.89,1116.5,-2752.92,4985.35
2074732183890123008,2020-06,3322.74,4208.74,3526.65,1617.82,1022.83,6008.18
2074732183890123008,2020-07,4500.81,5166.43,3585.53,5515.07,-2595.16,3413.02
2074732183890123008,2020-08,7671.43,7260.87,1701.85,3022.89,-910.48,2502.54
2074732183890123008,2020-09,3025.05,3948.54,6400.15,2325.78,3150.88,5653.42
2074732183890123008,2020-10,243.52,2413.28,2693.05,836.3,-313.01,5340.41
2074732183890123008,2020-11,3931.2,3926.21,2065.28,2483.62,-413.35,4927.06
2074732183890123008,2020-12,326.62,5554.24,9288.95,4101.59,-40.26,4886.8
2075730632855930880,2020-01,198.54,2849.16,5501.49,5136.94,-2286.07,-2286.07
2075730632855930880,2020-02,0,879.03,6208.03,3003.85,2325.15,39.08
2075730632855930880,2020-03,6583.54,0,4581.01,4806.33,6358.22,6397.3
2075730632855930880,2020-04,6582.9,3762.35,6096.04,2674.33,6242.26,12639.56
2075730632855930880,2020-05,3028.86,4300.18,3201.19,3089.44,-1159.57,11479.99
2075730632855930880,2020-06,1661.71,4653.3,1765.96,2483.8,-3709.43,7770.56
2075730632855930880,2020-07,5504.35,4322.95,463.24,1840.13,-195.49,7575.07
2075730632855930880,2020-08,3115.81,2590.42,610.67,3405.28,-2269.22,5305.85
2075730632855930880,2020-09,5029.05,3945.69,2958.07,2556.62,1484.81,6790.66
2075730632855930880,2020-10,1286.26,7414.67,4674.17,4189.94,-5644.18,1146.48
2075730632855930880,2020-11,2423.53,1452.82,1600.03,3488.74,-918,228.48
2075730632855930880,2020-12,2664.64,1040.15,1986.72,7098.49,-3487.28,-3258.8
2078081802782758912,2020-01,5458.86,6511.4,5230.98,7603.47,-3425.03,-3425.03
2078081802782758912,2020-02,3522.39,7254.93,5091.19,2803.72,-1445.07,-4870.1
2078081802782758912,2020-03,2074.91,737.27,4552.42,4967.1,922.96,-3947.14
2078081802782758912,2020-04,270.96,2818.18,2479.57,8240.08,-8307.73,-12254.87
2078081802782758912,2020-05,7414.19,5037.96,8270.45,7955.53,2691.15,-9563.72
2078081802782758912,2020-06,3841.96,6316.64,618.98,3435.27,-5290.97,-14854.69
2078081802782758912,2020-07,4857.47,6208.74,4791.7,437.23,3003.2,-11851.49
2078081802782758912,2020-08,9854.8,2853.43,3155.04,3521.21,6635.2,-5216.29
2078081802782758912,2020-09,3440.93,5862.92,5244.16,2766.25,55.92,-5160.37
2078081802782758912,2020-10,5364,1219.16,6377.34,7917.74,2604.44,-2555.93
2078081802782758912,2020-11,397.72,2000.94,5520.18,1946.68,1970.28,-585.65
2078081802782758912,2020-12,6556.78,2932.94,2447.04,8083.95,-2013.07,-2598.72
2078206225894566144,2020-01,7264.87,1367.55,3716.13,3390.2,6223.25,6223.25
2078206225894566144,2020-02,2405.13,864.67,0,4340.22,-2799.76,3423.49
2078206225894566144,2020-03,2140.61,2283.96,6780.37,2398.93,4238.09,7661.58
2078206225894566144,2020-04,3871.35,3264.59,5018.72,4046,1579.48,9241.06
2078206225894566144,2020-05,555.77,1362.99,6274.36,5514.48,-47.34,9193.72
2078206225894566144,2020-06,5140.86,3138.99,7496.11,3136.44,6361.54,15555.26
2078206225894566144,2020-07,4140.05,8947.13,103.49,5811.18,-10514.77,5040.49
2078206225894566144,2020-08,3885.97,3922.62,5345.5,1917.69,3391.16,8431.65
2078206225894566144,2020-09,3599.39,4901.29,2187.87,2000.75,-1114.78,7316.87
2078206225894566144,2020-10,2834.35,1546.64,2014.82,4832.69,-1530.16,5786.71
2078206225894566144,2020-11,7449.56,4398.48,7543.16,4702.06,5892.18,11678.89
2078206225894566144,2020-12,3901.75,0,2294.58,4508.23,1688.1,13366.99
2079505429345530624,2020-01,2865.62,1702.39,1251.01,1098.68,1315.56,1315.56
2079505429345530624,2020-02,1275.5,68.23,0,1002.45,204.82,1520.38
2079505429345530624,2020-03,2626.8,253.46,1820.06,1371.65,2821.75,4342.13
2079505429345530624,2020-04,3574.03,942.76,3301.42,1631.4,4301.29,8643.42
2079505429345530624,2020-05,1964.9,2709.97,1217.76,3541.34,-3068.65,5574.77
2079505429345530624,2020-06,1937.22,1901.2,2228.31,3295.24,-1030.91,4543.86
2079505429345530624,2020-07,2269.73,694.21,3223.72,3196.1,1603.14,6147
2079505429345530624,2020-08,3042.77,0,3236.41,1061.58,5217.6,11364.6
2079505429345530624,2020-09,1549.96,788.65,3350.27,1075.87,3035.71,14400.31
2079505429345530624,2020-10,5307.97,0,1358.7,3735.48,2931.19,17331.5
2079505429345530624,2020-11,1748.93,2001.43,0,962.78,-1215.28,16116.22
2079505429345530624,2020-12,0,1599.03,1005.89,1170.94,-1764.08,14352.14
2080188807101792512,2020-01,4655.89,5845.45,3193.12,2978.5,-974.94,-974.94
2080188807101792512,2020-02,4771.24,1109.88,3749.48,6857.42,553.42,-421.52
2080188807101792512,2020-03,3550.67,5262.49,4186.17,3173.33,-698.98,-1120.5
2080188807101792512,2020-04,6154.48,5021.21,3468.86,5132.63,-530.5,-1651
2080188807101792512,2020-05,491.4,0,5644.69,5809.53,326.56,-1324.44
2080188807101792512,2020-06,9097.98,3230.71,4064.62,9435.1,496.79,-827.65
2080188807101792512,2020-07,3115.03,12159.96,3306.48,8677.99,-14416.44,-15244.09
2080188807101792512,2020-08,2990.89,5086.24,14311.75,5642.52,6573.88,-8670.21
2080188807101792512,2020-09,1379.3,3623.32,3161.69,10247.68,-9330.01,-18000.22
2080188807101792512,2020-10,3449.53,4435.11,5858.7,4646.35,226.77,-17773.45
2080188807101792512,2020-11,2805.43,4138.51,3992.26,3060.38,-401.2,-18174.65
2080188807101792512,2020-12,3440.29,4520.21,3754.01,1371.3,1302.79,-16871.86
2081459696818761728,2020-01,1888.48,2617.74,1101.06,3988.8,-3617,-3617
2081459696818761728,2020-02,0,3550.87,3172.27,3391.21,-3769.81,-7386.81
2081459696818761728,2020-03,3701.93,2950.95,0,3857.56,-3106.58,-10493.39
2081459696818761728,2020-04,1509.43,3696.47,813.67,1034.41,-2407.78,-12901.17
2081459696818761728,2020-05,364.49,3839.61,933.36,906.05,-3447.81,-16348.98
2081459696818761728,2020-06,3212.91,1787.49,3888.05,1569.02,3744.45,-12604.53
2081459696818761728,2020-07,1755.81,364.5,2139.73,1129.63,2401.41,-10203.12
2081459696818761728,2020-08,2310.8,0,0,477.42,1833.38,-8369.74
2081459696818761728,2020-09,3177.07,0,888.78,4952.19,-886.34,-9256.08
2081459696818761728,2020-10,0,3138.49,700.46,0,-2438.03,-11694.11
2081459696818761728,2020-11,5214.46,2726.18,2001.24,1212.7,3276.82,-8417.29
2081459696818761728,2020-12,1029.52,1588.64,0,6101.6,-6660.72,-15078.01
2082179748504368896,2020-01,1.36,2343.61,1560.98,825.91,-1607.18,-1607.18
2082179748504368896,2020-02,174.53,1715.51,5124.22,5896.65,-2313.41,-3920.59
2082179748504368896,2020-03,1985.39,6792.79,2259.07,4268.87,-6817.2,-10737.79
2082179748504368896,2020-04,1412.6,0,1984.67,0,3397.27,-7340.52
2082179748504368896,2020-05,1656.32,5618.38,4238.28,2614.81,-2338.59,-9679.11
2082179748504368896,2020-06,908.69,2076.31,1486.9,2063.24,-1743.96,-11423.07
2082179748504368896,2020-07,2963.71,2340.75,4839.75,248.16,5214.55,-6208.52
2082179748504368896,2020-08,955.32,0,3898.76,4212.93,641.15,-5567.37
2082179748504368896,2020-09,611.7,918.66,0,0,-306.96,-5874.33
2082179748504368896,2020-10,3629.15,1589.69,2618.25,2715.52,1942.19,-3932.14
2082179748504368896,2020-11,0,228.87,2517.35,825.59,1462.89,-2469.25
2082179748504368896,2020-12,1691.68,2067.01,1402.56,1399.39,-372.16,-2841.41
2082501602581591552,2020-01,2630.6,1286.24,0,1943.14,-598.78,-598.78
2082501602581591552,2020-02,2615.89,269.51,727.71,5959.06,-2884.97,-3483.75
2082501602581591552,2020-03,0,474.84,0,562.98,-1037.82,-4521.57
2082501602581591552,2020-04,3064.05,1362.17,4272.5,1961.61,4012.77,-508.8
2082501602581591552,2020-05,1674.66,1024.25,1422.63,1956.06,116.98,-391.82
2082501602581591552,2020-06,3576.59,2777.9,2519.97,3174.49,144.17,-247.65
2082501602581591552,2020-07,0,889.22,0,1434.06,-2323.28,-2570.93
2082501602581591552,2020-08,3144.78,6068.81,4970.36,4966.23,-2919.9,-5490.83
2082501602581591552,2020-09,833.97,320.08,463.95,2558.01,-1580.17,-7071
2082501602581591552,2020-10,3282.75,2691.06,3723.63,505.5,3809.82,-3261.18
2082501602581591552,2020-11,168.94,832.55,3854.01,1544.87,1645.53,-1615.65
2082501602581591552,2020-12,1423.37,1293.47,6273.44,24.06,6379.28,4763.63
2085117856323456768,2020-01,3443.62,1473.19,457.35,1668,759.78,759.78
2085117856323456768,2020-02,3731.24,4404.09,1948.63,3090.35,-1814.57,-1054.79
2085117856323456768,2020-03,0,1607.33,0,2649.96,-4257.29,-5312.08
2085117856323456768,2020-04,0,1989.12,1223.05,866.14,-1632.21,-6944.29
2085117856323456768,2020-05,1924.13,1610.65,1867.79,2109.61,71.66,-6872.63
2085117856323456768,2020-06,2912.68,3214.9,2595.79,9406.17,-7112.6,-13985.23
2085117856323456768,2020-07,299.91,4957.96,1955.21,0,-2702.84,-16688.07
2085117856323456768,2020-08,4686.81,390.24,0,1427.24,2869.33,-13818.74
2085117856323456768,2020-09,1911.18,2806.19,3224.59,2376.22,-46.64,-13865.38
2085117856323456768,2020-10,2394.76,3820.14,94.13,0,-1331.25,-15196.63
2085117856323456768,2020-11,3343.6,4970.56,563.05,943.4,-2007.31,-17203.94
2085117856323456768,2020-12,2719.46,1819.29,0,0,900.17,-16303.77
2085252401242475520,2020-01,740.86,3052.44,0,1259.77,-3571.35,-3571.35
2085252401242475520,2020-02,3295.97,3711.95,3539.69,6257.76,-3134.05,-6705.4
2085252401242475520,2020-03,705.65,1459.55,1028.63,1648.31,-1373.58,-8078.98
2085252401242475520,2020-04,2398.18,2725.51,2571.71,1390.52,853.86,-7225.12
2085252401242475520,2020-05,2371.09,1636.48,4172.06,0,4906.67,-2318.45
2085252401242475520,2020-06,3184.05,2283.09,1120.09,3458.44,-1437.39,-3755.84
2085252401242475520,2020-07,1560.81,2922.51,4484.35,0,3122.65,-633.19
2085252401242475520,2020-08,6433.65,2279.35,3073.07,3008.44,4218.93,3585.74
2085252401242475520,2020-09,3912.76,1861.14,0,2657.15,-605.53,2980.21
2085252401242475520,2020-10,2540.7,1115.31,684.91,211.51,1898.79,4879
2085252401242475520,2020-11,2579.07,1825.39,2267.36,3107.72,-86.68,4792.32
2085252401242475520,2020-12,172.26,4200.04,0,2119.37,-6147.15,-1354.83
2085427516966057472,2020-01,1884.31,4057.05,987.74,2851.31,-4036.31,-4036.31
2085427516966057472,2020-02,2648.71,3924.7,4812.1,0,3536.11,-500.2
2085427516966057472,2020-03,0,4833.06,2779.64,8620.29,-10673.71,-11173.91
2085427516966057472,2020-04,3988.8,4504.4,1271.23,7431.59,-6675.96,-17849.87
2085427516966057472,2020-05,2901.19,2375.28,2666.18,4314.92,-1122.83,-18972.7
2085427516966057472,2020-06,4086.72,3508.31,1814.01,0,2392.42,-16580.28
2085427516966057472,2020-07,5980.9,3040.54,997.17,2077.57,1859.96,-14720.32
2085427516966057472,2020-08,3316.73,1937.46,932.18,6565.3,-4253.85,-18974.17
2085427516966057472,2020-09,1246.36,1319.07,5678.45,4901.37,704.37,-18269.8
2085427516966057472,2020-10,777.84,470.39,1437.92,3079.3,-1333.93,-19603.73
2085427516966057472,2020-11,4470.83,6339.64,3311.91,0,1443.1,-18160.63
2085427516966057472,2020-12,4181.85,7997.66,3461.89,3224.99,-3578.91,-21739.54
2085903329073651200,2020-03,0,1171.42,0,0,-1171.42,-1171.42
2085903329073651200,2020-04,0,514.68,0,0,-514.68,-1686.1
2085903329073651200,2020-07,0,1804.24,0,0,-1804.24,-3490.34
2085975246821816320,2020-01,276.48,1795.25,1971.9,2432.77,-1979.64,-1979.64
2085975246821816320,2020-02,3672.66,0,3531.15,1858.87,5344.94,3365.3
2085975246821816320,2020-03,2628.6,1263.68,3887.39,2291.91,2960.4,6325.7
2085975246821816320,2020-05,0,4526.37,595.33,511.13,-4442.17,1883.53
2085975246821816320,2020-06,1683.8,2904.73,4196.54,0,2975.61,4859.14
2085975246821816320,2020-07,2430.91,1547.75,4862.54,2011.42,3734.28,8593.42
2085975246821816320,2020-09,5106.84,642.11,1204.3,714.49,4954.54,13547.96
2085975246821816320,2020-10,0,4072.64,167.82,2307.86,-6212.68,7335.28
2085975246821816320,2020-11,3150.74,1738.76,0,1224.97,187.01,7522.29
2085975246821816320,2020-12,5301.95,280.65,1882.26,2629.04,4274.52,11796.81
2087017938001022976,2020-04,0,1923.58,0,0,-1923.58,-1923.58
2087017938001022976,2020-10,151.47,0,0,0,151.47,-1772.11
2087217487998514432,2020-01,1697.42,5304.13,6112.75,1286.78,1219.26,1219.26
2087217487998514432,2020-02,7604.53,5765.23,3838.29,2726.4,2951.19,4170.45
2087217487998514432,2020-03,1678,1710.63,1417.71,1341.82,43.26,4213.71
2087217487998514432,2020-04,1448.94,4768.74,210.03,1230.69,-4340.46,-126.75
2087217487998514432,2020-05,3373.81,1401.43,983.57,2251.93,704.02,577.27
2087217487998514432,2020-06,968.3,1167.86,5337.18,0,5137.62,5714.89
2087217487998514432,2020-07,1293.85,1727.54,1880.93,5237.59,-3790.35,1924.54
2087217487998514432,2020-08,1248.49,3284.39,429.31,526.9,-2133.49,-208.95
2087217487998514432,2020-09,424.56,2964.2,2350.03,279.34,-468.95,-677.9
2087217487998514432,2020-10,1808.66,1921.58,571.95,0,459.03,-218.87
2087217487998514432,2020-11,2479.59,202.31,0,1197.86,1079.42,860.55
2087217487998514432,2020-12,4442.11,0,810.48,1513.69,3738.9,4599.45
2087377604127156480,2020-01,10123.89,2003.35,3761.23,3207.06,8674.71,8674.71
2087377604127156480,2020-02,2540.84,0,3480.74,2256.95,3764.63,12439.34
2087377604127156480,2020-03,221.57,947.76,2730.72,5573.33,-3568.8,8870.54
2087377604127156480,2020-04,1697.26,1451.87,5286.26,5725.76,-194.11,8676.43
2087377604127156480,2020-05,695.47,2852.27,2178.09,6158.76,-6137.47,2538.96
2087377604127156480,2020-06,3094.97,2692.34,3004.2,5972.5,-2565.67,-26.71
2087377604127156480,2020-07,4215.53,2087.59,2796.73,1364.74,3559.93,3533.22
2087377604127156480,2020-08,2576.85,6623.2,3730.72,645.63,-961.26,2571.96
2087377604127156480,2020-09,4222.95,5725.88,2398.61,3298.21,-2402.53,169.43
2087377604127156480,2020-10,1962.23,4331.42,745.35,1091.9,-2715.74,-2546.31
2087377604127156480,2020-11,8142.59,4447.5,1407.27,3567.06,1535.3,-1011.01
2087377604127156480,2020-12,1135.61,8823.21,4606.56,3832.18,-6913.22,-7924.23
2089654327514129408,2020-02,1837.42,1169.59,1923.89,1940.85,650.87,650.87
2089654327514129408,2020-03,3674.08,1111.24,938.21,2806.61,694.44,1345.31
2089654327514129408,2020-04,0,1832.73,0,1276.67,-3109.4,-1764.09
2089654327514129408,2020-05,317.19,0,0,0,317.19,-1446.9
2089654327514129408,2020-06,1327.64,96.46,913.5,3363.48,-1218.8,-2665.7
2089654327514129408,2020-07,602.37,721.81,1341.79,799.91,422.44,-2243.26
2089654327514129408,2020-08,0,661.44,0,0,-661.44,-2904.7
2089654327514129408,2020-09,5571.45,1528.21,1128.14,1569.45,3601.93,697.23
2089654327514129408,2020-10,0,1172.73,0,0,-1172.73,-475.5
2089654327514129408,2020-11,1137.04,0,0,1541.99,-404.95,-880.45
2089654327514129408,2020-12,1656.64,1613.36,0,0,43.28,-837.17
2089654389202361856,2020-01,0,4902.14,1284.52,1682.17,-5299.79,-5299.79
2089654389202361856,2020-02,2140.7,0,799.02,0,2939.72,-2360.07
2089654389202361856,2020-03,1589,1477.86,533.73,0,644.87,-1715.2
2089654389202361856,2020-04,1849.37,3458.68,1156.93,126.58,-578.96,-2294.16
2089654389202361856,2020-05,714.63,0,610.84,1563.71,-238.24,-2532.4
2089654389202361856,2020-06,155.77,0,2629.05,3160.09,-375.27,-2907.67
2089654389202361856,2020-07,1428.01,2042.44,1565.16,195.2,755.53,-2152.14
2089654389202361856,2020-08,2302.22,2155.56,1799.41,0,1946.07,-206.07
2089654389202361856,2020-09,2098.4,1403.26,2477.94,0,3173.08,2967.01
2089654389202361856,2020-10,56.52,3339.14,2253.87,2944.46,-3973.21,-1006.2
2089654389202361856,2020-11,612.21,3106.84,3786.81,0,1292.18,285.98
2089654389202361856,2020-12,0,1418,2403.42,2137.68,-1152.26,-866.28
2089982977847375616,2020-01,687.01,2023.03,0,0,-1336.02,-1336.02
2089982977847375616,2020-03,1765.82,172.99,2316.22,484.9,3424.15,2088.13
2089982977847375616,2020-04,1423.7,2688.59,691.34,2758.26,-3331.81,-1243.68
2089982977847375616,2020-05,3405.52,0,0,0,3405.52,2161.84
2089982977847375616,2020-07,3505.71,3048.76,1422.72,0,1879.67,4041.51
2089982977847375616,2020-09,1325.96,1348.94,1578.28,367.64,1187.66,5229.17
2089982977847375616,2020-10,1109.12,0,1214.88,0,2324,7553.17
2089982977847375616,2020-11,1824.04,243.21,2477.79,2918.89,1139.73,8692.9
2089982977847375616,2020-12,2616.94,0,0,3074.05,-457.11,8235.79
2090463485711459840,2020-01,2238.97,5792.44,4675.09,1260.75,-139.13,-139.13
2090463485711459840,2020-02,3489.7,3643.74,2829.22,3231.44,-556.26,-695.39
2090463485711459840,2020-03,2005.92,3349.49,102.74,341.31,-1582.14,-2277.53
2090463485711459840,2020-04,0,5464.94,6770.51,3128.41,-1822.84,-4100.37
2090463485711459840,2020-05,2514.74,4575.43,3926.32,492.92,1372.71,-2727.66
2090463485711459840,2020-06,1898.46,1202.28,1558.69,485.49,1769.38,-958.28
2090463485711459840,2020-07,6690.98,2605.62,5153.76,6781.39,2457.73,1499.45
2090463485711459840,2020-08,637.99,6053.08,4911.2,3284.96,-3788.85,-2289.4
2090463485711459840,2020-09,2910.34,3912.99,1905.82,457.94,445.23,-1844.17
2090463485711459840,2020-10,3431.32,279.14,6734.27,2232.25,7654.2,5810.03
2090463485711459840,2020-11,4671.37,2691.92,5225.36,607.39,6597.42,12407.45
2090463485711459840,2020-12,1404.14,4435.48,3189.95,1038.88,-880.27,11527.18
2091110936989152768,2020-01,3585.26,1112.19,1239.86,3208.56,504.37,504.37
2091110936989152768,2020-02,2779.16,1103.64,5283.04,1085.08,5873.48,6377.85
2091110936989152768,2020-03,196.65,0,3086.84,2193.48,1090.01,7467.86
2091110936989152768,2020-04,4417.4,0,5159.97,494.38,9082.99,16550.85
2091110936989152768,2020-05,1326.24,3277.55,1050.25,1570.14,-2471.2,14079.65
2091110936989152768,2020-06,3238.84,1192.23,1438.6,187.14,3298.07,17377.72
2091110936989152768,2020-07,2322.78,1446.37,1955.94,3096.38,-264.03,17113.69
2091110936989152768,2020-08,2339.39,0,0,417.37,1922.02,19035.71
2091110936989152768,2020-09,1428.81,0,1435.49,2208.44,655.86,19691.57
2091110936989152768,2020-10,784.27,1751.91,723.37,0,-244.27,19447.3
2091110936989152768,2020-11,1687.6,1148.2,1750.71,986.83,1303.28,20750.58
2091110936989152768,2020-12,1222.23,265.59,1055.34,442,1569.98,22320.56
2092188111489217024,2020-01,1341.83,1507.38,1776.44,7542.09,-5931.2,-5931.2
2092188111489217024,2020-02,5568.86,1988.44,988.05,3982.41,586.06,-5345.14
2092188111489217024,2020-03,3374.34,4863.49,2392.39,1568.27,-665.03,-6010.17
2092188111489217024,2020-04,4364.53,7900.56,4410.88,3534.17,-2659.32,-8669.49
2092188111489217024,2020-05,914.57,2660.84,3653.43,4650.78,-2743.62,-11413.11
2092188111489217024,2020-06,4447.53,3478.59,3445.83,2927.18,1487.59,-9925.52
2092188111489217024,2020-07,1642.35,3978.15,2238.93,0,-96.87,-10022.39
2092188111489217024,2020-08,4838.87,2621.73,1469.06,3803.4,-117.2,-10139.59
2092188111489217024,2020-09,2519.48,5397.85,1892.27,231.8,-1217.9,-11357.49
2092188111489217024,2020-10,2665.21,2990.47,284.75,3771.9,-3812.41,-15169.9
2092188111489217024,2020-11,2499.18,767.55,3089.26,3758.24,1062.65,-14107.25
2092188111489217024,2020-12,5339.32,492.24,6702.48,395.14,11154.42,-2952.83
2092502286399757824,2020-01,4986.41,4130.84,3929.61,3183.09,1602.09,1602.09
2092502286399757824,2020-02,4546.09,7344.49,6947.55,3278.84,870.31,2472.4
2092502286399757824,2020-03,4909.21,2297.88,4671.1,5464.45,1817.98,4290.38
2092502286399757824,2020-04,3351.51,4480.49,2279.05,2914.82,-1764.75,2525.63
2092502286399757824,2020-05,2010.18,4943.05,7879.69,8616.91,-3670.09,-1144.46
2092502286399757824,2020-06,8996.67,4918.37,2673.81,208.5,6543.61,5399.15
2092502286399757824,2020-07,10449.53,1135.97,5864.13,7155.09,8022.6,13421.75
2092502286399757824,2020-08,4405.4,1734.31,2770.88,9425.55,-3983.58,9438.17
2092502286399757824,2020-09,4698.36,7408.28,1370.47,3774.75,-5114.2,4323.97
2092502286399757824,2020-10,3844.52,5627.87,1294.13,5780.95,-6270.17,-1946.2
2092502286399757824,2020-11,2578.86,6826.02,8513.9,3267.38,999.36,-946.84
2092502286399757824,2020-12,5804.93,5606.51,5385.3,5208.63,375.09,-571.75
2092892264188531968,2020-01,2805.25,2982.35,2573.8,2712.05,-315.35,-315.35
2092892264188531968,2020-02,2976.51,2662.65,425.48,2197.38,-1458.04,-1773.39
2092892264188531968,2020-03,2368.74,3010.58,3576.72,3372.09,-437.21,-2210.6
2092892264188531968,2020-04,2892.95,1151.05,5123.94,0,6865.84,4655.24
2092892264188531968,2020-05,5099.44,2512,1732.24,5655.5,-1335.82,3319.42
2092892264188531968,2020-06,2102.86,3476.16,460.67,1105.91,-2018.54,1300.88
2092892264188531968,2020-07,3153.9,1263.86,2633.37,4476.6,46.81,1347.69
2092892264188531968,2020-08,846.81,1822.11,3627.08,5651.64,-2999.86,-1652.17
2092892264188531968,2020-09,2228.03,999.54,3803.8,5574.94,-542.65,-2194.82
2092892264188531968,2020-10,1227.44,1943.22,2838.93,5299.12,-3175.97,-5370.79
2092892264188531968,2020-11,2542.64,2470.22,2127.55,6343.97,-4144,-9514.79
2092892264188531968,2020-12,4227.86,1313.08,4083.38,3122.58,3875.58,-5639.21
2095358230394345472,2020-01,0,1289.52,587.53,2330.83,-3032.82,-3032.82
2095358230394345472,2020-02,1711.76,2506.02,880.64,6031.38,-5945,-8977.82
2095358230394345472,2020-03,371.95,3946.68,3361,0,-213.73,-9191.55
2095358230394345472,2020-04,5040.48,5419.62,0,5304.05,-5683.19,-14874.74
2095358230394345472,2020-05,1866.24,6991.24,1701.42,4968.53,-8392.11,-23266.85
2095358230394345472,2020-06,2499.88,734.18,2597.59,3140.41,1222.88,-22043.97
2095358230394345472,2020-07,476.41,3956.77,3134.07,1827.01,-2173.3,-24217.27
2095358230394345472,2020-08,426.09,592.15,3471.45,0,3305.39,-20911.88
2095358230394345472,2020-09,29.01,1546.79,3580.19,276.23,1786.18,-19125.7
2095358230394345472,2020-10,1698.29,0,3565.76,4816.61,447.44,-18678.26
2095358230394345472,2020-11,1045.24,3825,4166.55,4508.69,-3121.9,-21800.16
2095358230394345472,2020-12,1709.72,6679.71,3889.78,2215.89,-3296.1,-25096.26
2096729095791190784,2020-02,0,454.22,0,0,-454.22,-454.22
2096729095791190784,2020-04,1607.08,0,0,0,1607.08,1152.86
2096729095791190784,2020-05,1258.49,0,1273.48,195.26,2336.71,3489.57
2096729095791190784,2020-06,2387.8,0,0,0,2387.8,5877.37
2096729095791190784,2020-08,0,1679.92,0,0,-1679.92,4197.45
2096729095791190784,2020-09,626.03,0,0,0,626.03,4823.48
2096729095791190784,2020-11,70.92,0,1645.53,0,1716.45,6539.93
2096729095791190784,2020-12,0,959.68,964.18,0,4.5,6544.43
2101209412311426560,2020-01,3096.59,544.47,5388.41,5177.06,2763.47,2763.47
2101209412311426560,2020-02,9624.12,3401.01,3579.14,3412.42,6389.83,9153.3
2101209412311426560,2020-03,4039.88,7285.91,138.1,2033.9,-5141.83,4011.47
2101209412311426560,2020-04,9698.15,4506.41,5480.23,7420.61,3251.36,7262.83
2101209412311426560,2020-05,5419.72,5836.29,8368.38,4513.38,3438.43,10701.26
2101209412311426560,2020-06,5051.39,4173.28,1761.39,2465.12,174.38,10875.64
2101209412311426560,2020-07,4715.98,3010.96,3682.34,3509.85,1877.51,12753.15
2101209412311426560,2020-08,6024.34,7909.75,8483.92,3427.6,3170.91,15924.06
2101209412311426560,2020-09,1073.73,4028.81,5736.02,7520.78,-4739.84,11184.22
2101209412311426560,2020-10,1373.05,885.57,11217.12,6999.84,4704.76,15888.98
2101209412311426560,2020-11,3014.36,5867.3,3075.62,4690.53,-4467.85,11421.13
2101209412311426560,2020-12,3661.49,1424.3,7786.37,5651.28,4372.28,15793.41
2101300711846212096,2020-01,632.83,5683.8,0,2429.75,-7480.72,-7480.72
2101300711846212096,2020-02,1191.93,820.94,58.57,2896.39,-2466.83,-9947.55
2101300711846212096,2020-03,2783.8,0,0,496.88,2286.92,-7660.63
2101300711846212096,2020-04,3786.74,2667.51,1195.85,882.98,1432.1,-6228.53
2101300711846212096,2020-05,1828.96,0,0,710.72,1118.24,-5110.29
2101300711846212096,2020-06,3053,866.52,0,1266.97,919.51,-4190.78
2101300711846212096,2020-07,3474.23,677.37,0,3887.56,-1090.7,-5281.48
2101300711846212096,2020-08,3861.65,466.31,523.73,0,3919.07,-1362.41
2101300711846212096,2020-09,943.63,0,3101.07,1996.8,2047.9,685.49
2101300711846212096,2020-10,1855.05,3386.91,3228.47,865.69,830.92,1516.41
2101300711846212096,2020-11,2153.22,0,0,0,2153.22,3669.63
2103557650791018752,2020-01,8736.03,4727.87,4083.02,1091.78,6999.4,6999.4
2103557650791018752,2020-02,3497.05,0,6686.45,4066.13,6117.37,13116.77
2103557650791018752,2020-03,12323.12,5087.7,4503.44,4175.54,7563.32,20680.09
2103557650791018752,2020-04,8534.37,1246.8,7825.29,3767.18,11345.68,32025.77
2103557650791018752,2020-05,7146.59,4504.64,3733.41,6754.65,-379.29,31646.48
2103557650791018752,2020-06,6400.75,6762.72,5503.56,4333.56,808.03,32454.51
2103557650791018752,2020-07,2774.63,4840.31,2195.91,8718.5,-8588.27,23866.24
2103557650791018752,2020-08,8497.19,1917.93,8749.1,4300.64,11027.72,34893.96
2103557650791018752,2020-09,5442.76,5927.88,3597.49,1763.83,1348.54,36242.5
2103557650791018752,2020-10,4164.15,9760.66,1408.54,6502.85,-10690.82,25551.68
2103557650791018752,2020-11,6274.71,4438.14,3295.97,2014.09,3118.45,28670.13
2103557650791018752,2020-12,5265.6,1752.45,2468.78,1499.49,4482.44,33152.57
2104006221885589248,2020-01,3292.33,0,6842.9,5503.57,4631.66,4631.66
2104006221885589248,2020-02,2546.91,9011.64,9145.27,1941.67,738.87,5370.53
2104006221885589248,2020-03,2773.07,1936.88,4747.79,3195.83,2388.15,7758.68
2104006221885589248,2020-04,1632.13,8949.41,3363.85,4775.34,-8728.77,-970.09
2104006221885589248,2020-05,167.94,6615.64,558.43,9136.52,-15025.79,-15995.88
2104006221885589248,2020-06,3542.74,2311.87,4012.96,3940.21,1303.62,-14692.26
2104006221885589248,2020-07,3772.36,5586.14,3191.02,7081.93,-5704.69,-20396.95
2104006221885589248,2020-08,3691.67,4001.07,4136.34,6536.26,-2709.32,-23106.27
2104006221885589248,2020-09,11653.77,3734,3512.42,2890.34,8541.85,-14564.42
2104006221885589248,2020-10,10288.29,6202.64,1073.03,5875.18,-716.5,-15280.92
2104006221885589248,2020-11,1886,1748.11,9155.7,7483.24,1810.35,-13470.57
2104006221885589248,2020-12,3119.12,5314.79,3421.3,6370.23,-5144.6,-18615.17
2104202613301350656,2020-02,2195.36,0,1188.81,1223.7,2160.47,2160.47
2104202613301350656,2020-06,91.89,1321.91,1627.54,0,397.52,2557.99
2104202613301350656,2020-07,3085.99,364.73,0,354.16,2367.1,4925.09
2104202613301350656,2020-09,1796.01,0,452.84,606.03,1642.82,6567.91
2104202613301350656,2020-10,1908.15,735.82,0,0,1172.33,7740.24
2104202613301350656,2020-11,0,1382.69,0,1846,-3228.69,4511.55
2104416999779767296,2020-01,5393.72,4007.83,4171.2,710.42,4846.67,4846.67
2104416999779767296,2020-02,4797.3,3034.27,5133.36,1978.55,4917.84,9764.51
2104416999779767296,2020-03,8157.44,8051.26,1813.61,2320.91,-401.12,9363.39
2104416999779767296,2020-04,321.46,7069.57,4144.49,1343.45,-3947.07,5416.32
2104416999779767296,2020-05,3061.5,1652.44,7796.96,1974.11,7231.91,12648.23
2104416999779767296,2020-06,7301.79,5633.08,849.18,3725.09,-1207.2,11441.03
2104416999779767296,2020-07,2656.61,1044.99,1834.69,3286.48,159.83,11600.86
2104416999779767296,2020-08,4159.52,1200.89,3196.14,4397.03,1757.74,13358.6
2104416999779767296,2020-09,2562.46,4463.41,7154.36,3976.04,1277.37,14635.97
2104416999779767296,2020-10,3133.91,1936.19,7624.91,5206.42,3616.21,18252.18
2104416999779767296,2020-11,7730.6,1700.62,1359,7349.39,39.59,18291.77
2104416999779767296,2020-12,1244.48,0,4213.5,3290.23,2167.75,20459.52
2105811096104644608,2020-01,0,1163.22,0,0,-1163.22,-1163.22
2105811096104644608,2020-02,0,1297.48,0,3796.83,-5094.31,-6257.53
2105811096104644608,2020-04,1459.03,1925.7,0,2387.66,-2854.33,-9111.86
2105811096104644608,2020-05,0,1195.41,828.47,686.28,-1053.22,-10165.08
2105811096104644608,2020-06,0,121.76,1095.25,0,973.49,-9191.59
2105811096104644608,2020-07,0,150.38,188.46,248.03,-209.95,-9401.54
2105811096104644608,2020-08,0,587.04,1272.01,0,684.97,-8716.57
2105811096104644608,2020-09,0,1213.85,0,4711.5,-5925.35,-14641.92
2105811096104644608,2020-10,628.93,280.54,2688.31,0,3036.7,-11605.22
2105811096104644608,2020-11,0,183.62,3144.2,0,2960.58,-8644.64
2108328106406789120,2020-01,1178.06,3898.22,4693.47,2011,-37.69,-37.69
2108328106406789120,2020-02,3182.62,8052.5,7191.48,2664.46,-342.86,-380.55
2108328106406789120,2020-03,5453.64,7115.31,1686.72,6809.57,-6784.52,-7165.07
2108328106406789120,2020-04,2498.39,2533,4113.12,3258.18,820.33,-6344.74
2108328106406789120,2020-05,5863.32,3794.98,8355.52,6475.46,3948.4,-2396.34
2108328106406789120,2020-06,5129.74,3200.17,4086.78,4359.04,1657.31,-739.03
2108328106406789120,2020-07,6091.75,4973.06,1933.96,1803.61,1249.04,510.01
2108328106406789120,2020-08,211.75,3857.14,961.33,915.62,-3599.68,-3089.67
2108328106406789120,2020-09,7190.46,0,7946.1,2616.67,12519.89,9430.22
2108328106406789120,2020-10,5585.55,2226.6,7124.1,8720.14,1762.91,11193.13
2108328106406789120,2020-11,12170.57,2631.33,3002.47,5676.68,6865.03,18058.16
2108328106406789120,2020-12,3482.55,2671.92,4544.18,1830.87,3523.94,21582.1
2108470597943052288,2020-02,1252.85,0,0,256.67,996.18,996.18
2108470597943052288,2020-03,2966.2,3417.35,0,1133.58,-1584.73,-588.55
2108470597943052288,2020-04,726.3,560.79,1519.33,0,1684.84,1096.29
2108470597943052288,2020-05,178.21,0,1466.29,0,1644.5,2740.79
2108470597943052288,2020-06,1875.47,553.8,0,349.21,972.46,3713.25
2108470597943052288,2020-07,2132.48,1031.01,260.4,306.67,1055.2,4768.45
2108470597943052288,2020-08,0,570.42,1628.43,570.76,487.25,5255.7
2108470597943052288,2020-09,0,556.74,0,0,-556.74,4698.96
2108470597943052288,2020-10,1201.97,0,2300.26,0,3502.23,8201.19
2108470597943052288,2020-11,846.23,0,0,1495.34,-649.11,7552.08
2108470597943052288,2020-12,0,1270.72,1304.1,3319.64,-3286.26,4265.82
2110297837544323072,2020-01,111.23,0,2322.82,3240.16,-806.11,-806.11
2110297837544323072,2020-02,2353.93,4435.35,0,2179.41,-4260.83,-5066.94
2110297837544323072,2020-03,35.71,1121.77,0,895.07,-1981.13,-7048.07
2110297837544323072,2020-04,5071.45,700.67,2816.16,2320.06,4866.88,-2181.19
2110297837544323072,2020-05,1633.65,1694.01,2540.26,0,2479.9,298.71
2110297837544323072,2020-06,3363.41,4662.61,0,7038.31,-8337.51,-8038.8
2110297837544323072,2020-07,0,3603.86,3135.56,1676.75,-2145.05,-10183.85
2110297837544323072,2020-08,2338.17,1488.37,1687.28,2561.34,-24.26,-10208.11
2110297837544323072,2020-09,3271.12,0,1989.38,2031.97,3228.53,-6979.58
2110297837544323072,2020-10,440.16,1407.23,5092.95,2392.45,1733.43,-5246.15
2110297837544323072,2020-11,618.71,1626.04,0,2538.04,-3545.37,-8791.52
2110297837544323072,2020-12,5418.81,115.76,0,2275.25,3027.8,-5763.72
2111943103932638976,2020-02,0,953.16,0,0,-953.16,-953.16
2111943103932638976,2020-03,1854.55,1746.31,4607.78,0,4716.02,3762.86
2111943103932638976,2020-04,1455.73,0,0,0,1455.73,5218.59
2111943103932638976,2020-06,1855.93,0,0,1487.16,368.77,5587.36
2111943103932638976,2020-07,465.76,0,0,0,465.76,6053.12
2111943103932638976,2020-12,1825.45,0,0,0,1825.45,7878.57
2112039096815940608,2020-01,400.94,0,0,2668.55,-2267.61,-2267.61
2112039096815940608,2020-02,1776.69,1286.55,866.5,872.2,484.44,-1783.17
2112039096815940608,2020-04,2745.47,1301.42,0,776.3,667.75,-1115.42
2112039096815940608,2020-05,1595.17,1760.06,1283.77,1224.66,-105.78,-1221.2
2112039096815940608,2020-06,0,1770,712.17,2242.08,-3299.91,-4521.11
2112039096815940608,2020-07,191.28,861.28,1215.3,0,545.3,-3975.81
2112039096815940608,2020-08,0,779.32,298.73,2171.82,-2652.41,-6628.22
2112039096815940608,2020-10,1975.72,0,1023.86,1710.03,1289.55,-5338.67
2112039096815940608,2020-12,1771.11,2115.54,0,389.96,-734.39,-6073.06
2112487368731592960,2020-01,3939.6,971.83,2071.76,2947.7,2091.83,2091.83
2112487368731592960,2020-02,1814.12,3050.25,1667.38,4215.44,-3784.19,-1692.36
2112487368731592960,2020-03,3251.42,2613.78,2467.99,836.53,2269.1,576.74
2112487368731592960,2020-04,4302.31,476.56,1917.46,2702.87,3040.34,3617.08
2112487368731592960,2020-05,0,4760.9,2439.9,2325.64,-4646.64,-1029.56
2112487368731592960,2020-06,1838.8,5988.48,3635.35,145.38,-659.71,-1689.27
2112487368731592960,2020-07,1500.66,1517.11,509.3,3284.87,-2792.02,-4481.29
2112487368731592960,2020-08,0,880.29,2426.19,87.84,1458.06,-3023.23
2112487368731592960,2020-09,1666.81,2425.22,2992.44,1577.8,656.23,-2367
2112487368731592960,2020-10,1773.76,892.32,0,577.14,304.3,-2062.7
2112487368731592960,2020-11,1161.01,4720.39,0,4612.33,-8171.71,-10234.41
2112487368731592960,2020-12,899.89,1535.8,0,1108.53,-1744.44,-11978.85
2113067334628205824,2020-01,2044.48,2989.61,0,3894.94,-4840.07,-4840.07
2113067334628205824,2020-02,717.97,211.1,0,871.68,-364.81,-5204.88
2113067334628205824,2020-03,899.41,286.42,140.58,1303.09,-549.52,-5754.4
2113067334628205824,2020-04,1007.9,0,0,1502.11,-494.21,-6248.61
2113067334628205824,2020-05,2022.52,2849.44,1479.1,2660.65,-2008.47,-8257.08
2113067334628205824,2020-06,3.54,1426.43,402.96,575.44,-1595.37,-9852.45
2113067334628205824,2020-07,592.33,0,3839.85,0,4432.18,-5420.27
2113067334628205824,2020-08,2004.94,3652.44,1321.63,3257.93,-3583.8,-9004.07
2113067334628205824,2020-09,1185.47,1126.45,1525.74,2497.07,-912.31,-9916.38
2113067334628205824,2020-10,1511.27,0,1831.93,1799.48,1543.72,-8372.66
2113067334628205824,2020-11,897.02,427.31,674.38,1587.44,-443.35,-8816.01
2113946093976634624,2020-01,6575.41,4410.81,1687.69,7151.37,-3299.08,-3299.08
2113946093976634624,2020-02,3242.95,9494.61,358.63,4771.79,-10664.82,-13963.9
2113946093976634624,2020-03,4039.05,3714.87,9029.76,8703,650.94,-13312.96
2113946093976634624,2020-04,4652.38,2926.54,3387.61,4729.17,384.28,-12928.68
2113946093976634624,2020-05,3314.72,4856.4,6766.23,935.36,4289.19,-8639.49
2113946093976634624,2020-06,6724.28,4810.92,5303.84,86.7,7130.5,-1508.99
2113946093976634624,2020-07,7173.43,2321.13,7636.3,6492.65,5995.95,4486.96
2113946093976634624,2020-08,1827.74,7957.45,5163.3,6378.92,-7345.33,-2858.37
2113946093976634624,2020-09,192.81,3646.66,4233.07,3803.61,-3024.39,-5882.76
2113946093976634624,2020-10,6292.5,2708.56,520.34,10534.43,-6430.15,-12312.91
2113946093976634624,2020-11,3155.74,2018.53,3741.55,9411.15,-4532.39,-16845.3
2113946093976634624,2020-12,6274.44,806.23,4939,4963.93,5443.28,-11402.02
2113966083857682176,2020-01,0,1849.32,2642.37,3983.44,-3190.39,-3190.39
2113966083857682176,2020-02,1298.18,0,1394.73,1810.41,882.5,-2307.89
2113966083857682176,2020-03,0,663.32,1188.65,1189.26,-663.93,-2971.82
2113966083857682176,2020-04,359.19,1635.93,7416.51,6314.14,-174.37,-3146.19
2113966083857682176,2020-05,1509.05,0,2214.49,0,3723.54,577.35
2113966083857682176,2020-06,174.22,0,1901.05,1215.09,860.18,1437.53
2113966083857682176,2020-07,1079.26,0,2427.05,0,3506.31,4943.84
2113966083857682176,2020-08,268.25,1832.2,0,0,-1563.95,3379.89
2113966083857682176,2020-09,1741.12,853.51,1847.14,215.72,2519.03,5898.92
2113966083857682176,2020-10,758.97,288.58,1813.9,1440.35,843.94,6742.86
2113966083857682176,2020-11,0,411.92,1744.84,186.09,1146.83,7889.69
2113966083857682176,2020-12,3592.66,1888.2,0,1351.13,353.33,8243.02
2115124899735367424,2020-01,3330.66,1971.17,1208.78,2235.83,332.44,332.44
2115124899735367424,2020-02,0,1841.53,2188.62,0,347.09,679.53
2115124899735367424,2020-03,932.9,3095.9,712.18,3286.38,-4737.2,-4057.67
2115124899735367424,2020-04,210.89,2710.15,800.93,2065.5,-3763.83,-7821.5
2115124899735367424,2020-05,3181.45,2629.67,1381.06,3402.29,-1469.45,-9290.95
2115124899735367424,2020-06,288.41,4157.44,3633.53,1595.15,-1830.65,-11121.6
2115124899735367424,2020-07,1214.33,1955.83,3644.2,2665.18,237.52,-10884.08
2115124899735367424,2020-08,3164.08,2208.06,2487.86,1786.1,1657.78,-9226.3
2115124899735367424,2020-09,3120.28,5101.5,2490.58,841.99,-332.63,-9558.93
2115124899735367424,2020-10,1118.9,871.1,1824.75,1519.59,552.96,-9005.97
2115124899735367424,2020-11,3199.24,0,919.68,2235.15,1883.77,-7122.2
2115124899735367424,2020-12,2397.96,1902.34,3739.3,3850.51,384.41,-6737.79
2116486034941190912,2020-01,4833.27,2727.49,724.06,0,2829.84,2829.84
2116486034941190912,2020-02,333.02,0,1860.5,0,2193.52,5023.36
2116486034941190912,2020-03,2814.39,2562.76,904.08,895.4,260.31,5283.67
2116486034941190912,2020-04,999.77,2203.12,3884.68,0,2681.33,7965
2116486034941190912,2020-05,1977.99,1939.53,226.44,1835.62,-1570.72,6394.28
2116486034941190912,2020-06,1231.39,897.98,0,2450.51,-2117.1,4277.18
2116486034941190912,2020-07,0,4286.06,0,1958.59,-6244.65,-1967.47
2116486034941190912,2020-08,0,975.41,1363.79,4699.74,-4311.36,-6278.83
2116486034941190912,2020-11,2110.88,858.33,2180.47,0,3433.02,-2845.81
2116486034941190912,2020-12,0,355.58,0,759.64,-1115.22,-3961.03
2117067335169318912,2020-01,4448.22,2511.5,6.89,0,1943.61,1943.61
2117067335169318912,2020-02,4188.09,992.87,3494.14,539.03,6150.33,8093.94
2117067335169318912,2020-03,3447.6,2041.05,1204.38,1925.11,685.82,8779.76
2117067335169318912,2020-04,1274.92,3479.52,0,5575.16,-7779.76,1000
2117067335169318912,2020-05,4891.02,1659.98,1167.82,879.18,3519.68,4519.68
2117067335169318912,2020-06,891.57,1675.1,2633.31,6170.03,-4320.25,199.43
2117067335169318912,2020-07,2428.76,8226.76,3440.19,2637.87,-4995.68,-4796.25
2117067335169318912,2020-08,885.58,1216.31,1775.55,2709.48,-1264.66,-6060.91
2117067335169318912,2020-09,1557.41,2473.68,4452.7,1476.87,2059.56,-4001.35
2117067335169318912,2020-10,3439.65,5292.87,1750.43,2818.77,-2921.56,-6922.91
2117067335169318912,2020-11,1456.09,3695.89,5277.65,2999.48,38.37,-6884.54
2117067335169318912,2020-12,5549.4,0,3583.98,1708.06,7425.32,540.78
2118390127904308992,2020-01,4962.28,3382.58,2704.92,354.16,3930.46,3930.46
2118390127904308992,2020-02,6592.63,5175.34,4985.13,1996.75,4405.67,8336.13
2118390127904308992,2020-03,2900.9,7425.68,1736.64,2407.61,-5195.75,3140.38
2118390127904308992,2020-04,2190,3902.37,3776.42,6935.99,-4871.94,-1731.56
2118390127904308992,2020-05,2069.73,6399.7,2946.66,1343.47,-2726.78,-4458.34
2118390127904308992,2020-06,3639.62,1801.5,4397.46,3000.24,3235.34,-1223
2118390127904308992,2020-07,2103.1,9069.23,2026.62,164.75,-5104.26,-6327.26
2118390127904308992,2020-08,2628.49,3899.63,2205.22,0,934.08,-5393.18
2118390127904308992,2020-09,4439.76,1630.12,7443.96,1155.3,9098.3,3705.12
2118390127904308992,2020-10,1017.48,3720.33,3770.46,4462.37,-3394.76,310.36
2118390127904308992,2020-11,1519.08,6749.11,4527.47,1836.2,-2538.76,-2228.4
2118390127904308992,2020-12,1985.81,4568.07,1993.37,2571.58,-3160.47,-5388.87
2119586258883631360,2020-01,1325.53,0,1105.35,190.1,2240.78,2240.78
2119586258883631360,2020-02,0,270.8,0,1506.95,-1777.75,463.03
2119586258883631360,2020-03,2429.52,923.69,1819.07,3711.16,-386.26,76.77
2119586258883631360,2020-04,0,289.48,0,2337.52,-2627,-2550.23
2119586258883631360,2020-05,0,305.81,1193.23,0,887.42,-1662.81
2119586258883631360,2020-06,1035.74,962.28,0,0,73.46,-1589.35
2119586258883631360,2020-07,0,2680.67,947.26,0,-1733.41,-3322.76
2119586258883631360,2020-08,2117.3,2250.48,0,2663.32,-2796.5,-6119.26
2119586258883631360,2020-09,0,388.48,0,947.48,-1335.96,-7455.22
2119586258883631360,2020-10,1618.41,2000.67,0,728.43,-1110.69,-8565.91
2119586258883631360,2020-11,0,1905.24,1196.95,1775.32,-2483.61,-11049.52
2119586258883631360,2020-12,328.17,0,0,360.48,-32.31,-11081.83
2119860016717632768,2020-01,5721.95,4861.58,2992.61,6208.32,-2355.34,-2355.34
2119860016717632768,2020-02,7601.44,4784.73,3260.69,4885.82,1191.58,-1163.76
2119860016717632768,2020-03,7417.4,4188.7,8978.77,5800.09,6407.38,5243.62
2119860016717632768,2020-04,4865.75,1385.97,3735.96,3810.32,3405.42,8649.04
2119860016717632768,2020-05,3521.52,0,4556.62,4012.82,4065.32,12714.36
2119860016717632768,2020-06,8806.66,5589.25,3204.7,8172.81,-1750.7,10963.66
2119860016717632768,2020-07,1561.25,2391.66,2453.42,2648.17,-1025.16,9938.5
2119860016717632768,2020-08,5186.36,3192.21,4632.88,8735.39,-2108.36,7830.14
2119860016717632768,2020-09,4288.88,4309.82,963.75,7083.05,-6140.24,1689.9
2119860016717632768,2020-10,1559.67,3332.95,5436.21,4732.91,-1069.98,619.92
2119860016717632768,2020-11,3042.89,1348.7,7336.66,5583.18,3447.67,4067.59
2119860016717632768,2020-12,4831.03,7307.51,6027.82,8781.56,-5230.22,-1162.63
2120043042502802944,2020-01,1690.74,0,550.28,0,2241.02,2241.02
2120043042502802944,2020-02,972.72,4008.83,3071.03,1317.94,-1283.02,958
2120043042502802944,2020-03,2518.77,202.36,627.46,5156.51,-2212.64,-1254.64
2120043042502802944,2020-04,2151.55,0,203.78,1800.11,555.22,-699.42
2120043042502802944,2020-05,1219.3,717.26,3764.3,2016.43,2249.91,1550.49
2120043042502802944,2020-06,4740.55,4109.7,0,109.48,521.37,2071.86
2120043042502802944,2020-07,3506.86,0,1912.54,1429.87,3989.53,6061.39
2120043042502802944,2020-08,1425.42,1655.03,0,3682.09,-3911.7,2149.69
2120043042502802944,2020-09,2345.24,301.17,2422.13,1990.83,2475.37,4625.06
2120043042502802944,2020-10,5716.06,1595.42,2627.91,712.78,6035.77,10660.83
2120043042502802944,2020-11,1136.92,4503.94,1626.61,0,-1740.41,8920.42
2120043042502802944,2020-12,2775.49,1037.73,2362.49,1871.58,2228.67,11149.09
2120317937170085120,2020-01,1845.96,4060.37,6100.09,1701.32,2184.36,2184.36
2120317937170085120,2020-02,2756.36,4169.48,1609.45,1350.97,-1154.64,1029.72
2120317937170085120,2020-03,4847.2,9666.79,349.65,746.71,-5216.65,-4186.93
2120317937170085120,2020-04,5541.82,1508.29,2803.62,1952.78,4884.37,697.44
2120317937170085120,2020-05,3915.33,2010.54,1267.1,2113.62,1058.27,1755.71
2120317937170085120,2020-06,636.06,1761.87,3570.13,0,2444.32,4200.03
2120317937170085120,2020-07,0,3106.56,0,1723.48,-4830.04,-630.01
2120317937170085120,2020-08,3547.52,1429.53,223.33,2794.09,-452.77,-1082.78
2120317937170085120,2020-09,2992.17,3631.71,4790.88,4645.1,-493.76,-1576.54
2120317937170085120,2020-10,0,4274.64,1289.9,752.05,-3736.79,-5313.33
2120317937170085120,2020-11,630.16,167.11,464.03,5209.32,-4282.24,-9595.57
2120317937170085120,2020-12,5796.1,3316.7,4185.9,1689.83,4975.47,-4620.1
2120668112085253632,2020-03,1422.11,0,944.87,0,2366.98,2366.98
2120668112085253632,2020-04,1503.63,0,1833.19,2872.51,464.31,2831.29
2120668112085253632,2020-06,1141.98,4186.97,380.58,0,-2664.41,166.88
2120668112085253632,2020-07,1041.79,1430.63,1938.37,0,1549.53,1716.41
2120668112085253632,2020-08,1318.84,2436.2,1872.43,1801.59,-1046.52,669.89
2120668112085253632,2020-09,1439.33,0,0,0,1439.33,2109.22
2120668112085253632,2020-10,1464.34,0,1367.65,0,2831.99,4941.21
2120668112085253632,2020-12,1326.3,0,0,0,1326.3,6267.51
2120829647327669248,2020-03,0,725.28,0,31.11,-756.39,-756.39
2120829647327669248,2020-04,2444.18,0,732.97,0,3177.15,2420.76
2120829647327669248,2020-09,0,1863.82,0,0,-1863.82,556.94
2120933399640111360,2020-01,3092.25,2029.78,2116.44,1957.62,1221.29,1221.29
2120933399640111360,2020-02,9217.71,8613.24,8989.79,1436.56,8157.7,9378.99
2120933399640111360,2020-03,4040.41,2662.13,871.47,353.32,1896.43,11275.42
2120933399640111360,2020-04,530.67,1408.62,378.48,3534.39,-4033.86,7241.56
2120933399640111360,2020-05,1896.7,4257.48,1728.95,2652.07,-3283.9,3957.66
2120933399640111360,2020-06,455.88,5918.13,4092.9,541.87,-1911.22,2046.44
2120933399640111360,2020-07,2895.98,3288.7,1680.84,8093.74,-6805.62,-4759.18
2120933399640111360,2020-08,1913.72,3372.86,2786.6,3744.85,-2417.39,-7176.57
2120933399640111360,2020-09,9984.64,965.39,4430.86,2717.83,10732.28,3555.71
2120933399640111360,2020-10,732.5,2380.03,2053.76,8325.3,-7919.07,-4363.36
2120933399640111360,2020-11,4327.3,3274.2,1247.25,2355.49,-55.14,-4418.5
2120933399640111360,2020-12,0,2914.07,1437.81,3293.41,-4769.67,-9188.17
2121120954446541824,2020-01,2613.34,2389.36,3674.6,641.6,3256.98,3256.98
2121120954446541824,2020-02,3285.41,4345.08,1578.89,896.86,-377.64,2879.34
2121120954446541824,2020-03,3024.61,714.87,1454.32,4338.5,-574.44,2304.9
2121120954446541824,2020-04,3153.99,3168.74,3497.78,3498.86,-15.83,2289.07
2121120954446541824,2020-05,1254.18,2671.11,1343.3,676.22,-749.85,1539.22
2121120954446541824,2020-06,0,427.27,0,2224.33,-2651.6,-1112.38
2121120954446541824,2020-07,1395.5,0,1183.64,2164.59,414.55,-697.83
2121120954446541824,2020-08,5560.95,3963.69,2900.38,805.01,3692.63,2994.8
2121120954446541824,2020-09,5053.07,1331.81,2871.66,4000.66,2592.26,5587.06
2121120954446541824,2020-10,2557.45,342.69,6465.45,1209.1,7471.11,13058.17
2121120954446541824,2020-11,2376.91,117.36,0,1132.53,1127.02,14185.19
2121120954446541824,2020-12,7024.41,0,692.95,5785,1932.36,16117.55
2122153656344962048,2020-01,0,40.64,0,0,-40.64,-40.64
2122153656344962048,2020-03,287,0,1334.19,0,1621.19,1580.55
2122153656344962048,2020-07,0,1297.43,0,451.1,-1748.53,-167.98
2122153656344962048,2020-08,1395.51,0,0,0,1395.51,1227.53
2122153656344962048,2020-09,521.84,0,0,0,521.84,1749.37
2122153656344962048,2020-10,0,507.32,2189.46,1772.93,-90.79,1658.58
2122153656344962048,2020-11,425.43,0,0,0,425.43,2084.01
2122153656344962048,2020-12,0,612.33,0,1707.35,-2319.68,-235.67
2124925437304919040,2020-01,4257.91,1025.2,672.41,2770.65,1134.47,1134.47
2124925437304919040,2020-02,1187.7,7105.71,1252.55,5283.58,-9949.04,-8814.57
2124925437304919040,2020-03,1170.48,3657.03,478.16,1477.4,-3485.79,-12300.36
2124925437304919040,2020-04,1186.89,72.95,979.1,4358.33,-2265.29,-14565.65
2124925437304919040,2020-05,3137.17,6210.56,1534.65,3921.68,-5460.42,-20026.07
2124925437304919040,2020-06,2716.68,1073.5,3057.79,2732.04,1968.93,-18057.14
2124925437304919040,2020-07,2749.07,591.39,6169.69,0,8327.37,-9729.77
2124925437304919040,2020-08,1824.16,1988.81,2148.93,5222.8,-3238.52,-12968.29
2124925437304919040,2020-09,0,2051.29,3297.8,1762.8,-516.29,-13484.58
2124925437304919040,2020-10,2984.97,188.67,370.79,4070.89,-903.8,-14388.38
2124925437304919040,2020-11,3642.62,1181.9,3565.45,500.83,5525.34,-8863.04
2124925437304919040,2020-12,2794.47,2729.41,3966.95,1195.68,2836.33,-6026.71
2127433475407403776,2020-01,4587.58,104,4827.66,4488.1,4823.14,4823.14
2127433475407403776,2020-02,4709.34,6111.02,3127.32,5004.6,-3278.96,1544.18
2127433475407403776,2020-03,2396.09,5674.64,2767.79,2594.52,-3105.28,-1561.1
2127433475407403776,2020-04,3458.93,2120.87,4690.51,0,6028.57,4467.47
2127433475407403776,2020-05,6382.74,6174.87,3259.54,1719.6,1747.81,6215.28
2127433475407403776,2020-06,3467.73,8953.02,2154.73,2680.47,-6011.03,204.25
2127433475407403776,2020-07,3541.98,150.05,4104.05,904.14,6591.84,6796.09
2127433475407403776,2020-08,3580.49,0,4132.35,1705.93,6006.91,12803
2127433475407403776,2020-09,4891.91,4025.21,861.3,3643.15,-1915.15,10887.85
2127433475407403776,2020-10,3323.81,2510.58,7660,7172.08,1301.15,12189
2127433475407403776,2020-11,4349.19,2869.92,5313.08,3016.18,3776.17,15965.17
2127433475407403776,2020-12,2893.2,6726.68,3461.11,4740.19,-5112.56,10852.61
2128424129345291264,2020-01,2352.27,3720.29,6381.51,5638.54,-625.05,-625.05
2128424129345291264,2020-02,2392.01,0,3468.26,1956.69,3903.58,3278.53
2128424129345291264,2020-03,0,3206.53,2962.85,2106.21,-2349.89,928.64
2128424129345291264,2020-04,4615.51,2421.56,4683.15,1781.95,5095.15,6023.79
2128424129345291264,2020-05,5045.89,3659.78,808.04,6471.82,-4277.67,1746.12
2128424129345291264,2020-06,3340.6,0,5393.2,366.04,8367.76,10113.88
2128424129345291264,2020-07,2196.63,530.97,613.32,4551.25,-2272.27,7841.61
2128424129345291264,2020-08,4022.76,2741.81,4503.83,2765.75,3019.03,10860.64
2128424129345291264,2020-09,2166.99,2874.09,1019.02,751.22,-439.3,10421.34
2128424129345291264,2020-10,1267.1,6410.24,5936.71,3189.12,-2395.55,8025.79
2128424129345291264,2020-11,8532.63,1537.11,3245.12,4441,5799.64,13825.43
2128424129345291264,2020-12,4103.18,2530.62,237.35,3801.17,-1991.26,11834.17
2129013948968909312,2020-01,4488.99,1003.57,3820.17,2295.01,5010.58,5010.58
2129013948968909312,2020-02,8656.86,5723.44,13964.73,10901.17,5996.98,11007.56
2129013948968909312,2020-03,4538.38,4366.44,4806.74,8503.69,-3525.01,7482.55
2129013948968909312,2020-04,2252.8,2930.35,7515.53,4864.85,1973.13,9455.68
2129013948968909312,2020-05,4720.77,4850.11,4731.52,6345.64,-1743.46,7712.22
2129013948968909312,2020-06,1848.22,4051.19,3264.82,5676.97,-4615.12,3097.1
2129013948968909312,2020-07,8805.88,3790.4,8109.92,3625.86,9499.54,12596.64
2129013948968909312,2020-08,4815.5,1568.38,7846.55,7943.44,3150.23,15746.87
2129013948968909312,2020-09,4079.73,6184.13,4611.14,5208.9,-2702.16,13044.71
2129013948968909312,2020-10,2754.74,4437.8,2640.08,6914.4,-5957.38,7087.33
2129013948968909312,2020-11,4429.18,3758.62,4845.02,2675.51,2840.07,9927.4
2129013948968909312,2020-12,1091.86,4302.82,9177.97,2502.23,3464.78,13392.18
2129299597022120448,2020-01,2311.92,4070.28,4118.62,4195.09,-1834.83,-1834.83
2129299597022120448,2020-02,5304.58,9046.14,6781.22,0,3039.66,1204.83
2129299597022120448,2020-03,1989.45,2895.95,156.74,4315.42,-5065.18,-3860.35
2129299597022120448,2020-04,1582.6,4403.17,5204.6,6434.64,-4050.61,-7910.96
2129299597022120448,2020-05,6944.15,4063.91,3323.29,2898.74,3304.79,-4606.17
2129299597022120448,2020-06,5417.23,1683.17,2284.12,582.42,5435.76,829.59
2129299597022120448,2020-07,4740.49,4213.69,4889.3,6831.45,-1415.35,-585.76
2129299597022120448,2020-08,5443.37,3848.47,2219.47,1294.82,2519.55,1933.79
2129299597022120448,2020-09,7162.9,6330.07,3300.23,3287.17,845.89,2779.68
2129299597022120448,2020-10,7254.2,226.78,3554.84,6125.25,4457.01,7236.69
2129299597022120448,2020-11,7491.38,3085.66,3180.6,2336.04,5250.28,12486.97
2129299597022120448,2020-12,0,4012.66,6884.11,3717.47,-846.02,11640.95
2131355563895003648,2020-01,1874.97,2319.42,1794.48,1321.53,28.5,28.5
2131355563895003648,2020-02,2347.87,2591.7,2010.6,1765.61,1.16,29.66
2131355563895003648,2020-03,5662.48,4181.47,2307.24,2052.08,1736.17,1765.83
2131355563895003648,2020-04,2593.81,550.89,2227,584.6,3685.32,5451.15
2131355563895003648,2020-05,3027.69,1624.05,0,143.86,1259.78,6710.93
2131355563895003648,2020-06,1968.92,88.77,1983.79,2929.08,934.86,7645.79
2131355563895003648,2020-07,4315.34,4054.07,2199.85,1824.48,636.64,8282.43
2131355563895003648,2020-08,1741.59,2413.27,2926.96,0,2255.28,10537.71
2131355563895003648,2020-09,2360.53,4581.98,3984.58,1485.42,277.71,10815.42
2131355563895003648,2020-10,1976.72,2683.85,1990.84,0,1283.71,12099.13
2131355563895003648,2020-11,1948.89,2957.28,1778.62,2181.35,-1411.12,10688.01
2131355563895003648,2020-12,56.29,290.94,714.92,5507.29,-5027.02,5660.99
2131656990788062208,2020-01,0,2997.64,0,1161,-4158.64,-4158.64
2131656990788062208,2020-02,1601.2,0,1687.29,2227.19,1061.3,-3097.34
2131656990788062208,2020-03,151.35,1856.43,1812.76,1780.71,-1673.03,-4770.37
2131656990788062208,2020-04,2832.52,690.59,991.06,2516.23,616.76,-4153.61
2131656990788062208,2020-05,2992.09,1275.28,1814.85,737.97,2793.69,-1359.92
2131656990788062208,2020-06,0,6489.14,0,2776.36,-9265.5,-10625.42
2131656990788062208,2020-07,3056.64,1300.14,0,1852.7,-96.2,-10721.62
2131656990788062208,2020-08,1708.72,1082.99,0,3102.86,-2477.13,-13198.75
2131656990788062208,2020-09,807.48,615.8,415.23,0,606.91,-12591.84
2131656990788062208,2020-10,1453.98,1625.57,0,0,-171.59,-12763.43
2131656990788062208,2020-11,499.11,1899.55,0,1859.13,-3259.57,-16023
2131656990788062208,2020-12,1668.23,1207.16,724.85,1092.87,93.05,-15929.95
2134214700317350912,2020-04,760.87,0,478.67,0,1239.54,1239.54
2134214700317350912,2020-05,845.86,0,0,0,845.86,2085.4
2134214700317350912,2020-07,2230.23,0,0,0,2230.23,4315.63
2134214700317350912,2020-08,0,905.88,0,228.12,-1134,3181.63
2134214700317350912,2020-10,2547.7,1386.02,1347.04,0,2508.72,5690.35
2134214700317350912,2020-11,0,22.92,0,1672.07,-1694.99,3995.36
2135527518220152576,2020-01,4976.36,584.92,2729.76,5959.3,1161.9,1161.9
2135527518220152576,2020-02,2483.02,2896.61,3130.59,1405.31,1311.69,2473.59
2135527518220152576,2020-03,4255.38,7727.58,2133.56,2617.53,-3956.17,-1482.58
2135527518220152576,2020-04,3683.3,808.5,3777.91,1085.52,5567.19,4084.61
2135527518220152576,2020-05,4277.1,4149.13,451.42,6834.57,-6255.18,-2170.57
2135527518220152576,2020-06,1117.44,5437.79,1998.18,3257.24,-5579.41,-7749.98
2135527518220152576,2020-07,1937.19,3492.9,982.4,1129.3,-1702.61,-9452.59
2135527518220152576,2020-08,7837.43,4494.31,1292.98,3171.02,1465.08,-7987.51
2135527518220152576,2020-09,4132.55,2929.36,2880.06,559.75,3523.5,-4464.01
2135527518220152576,2020-10,5039,3944.11,7377.34,2240.92,6231.31,1767.3
2135527518220152576,2020-11,11342.4,4531.28,2600.16,3551.74,5859.54,7626.84
2135527518220152576,2020-12,1281.36,2470.71,3325.08,5947.2,-3811.47,3815.37
2136383966654544128,2020-01,868.78,1048.53,221.48,0,41.73,41.73
2136383966654544128,2020-02,1981.46,1820.32,260.1,84.18,337.06,378.79
2136383966654544128,2020-04,450.77,0,0,194.78,255.99,634.78
2136383966654544128,2020-07,475.4,0,0,1078.92,-603.52,31.26
2136383966654544128,2020-08,2125.16,0,0,0,2125.16,2156.42
2136383966654544128,2020-09,487.68,0,1007.63,2402.99,-907.68,1248.74
2136383966654544128,2020-11,1457.6,2561.92,1264.41,0,160.09,1408.83
2136383966654544128,2020-12,772.79,1188.19,0,774.47,-1189.87,218.96
2136749260695403008,2020-01,3015.63,1933.7,4662.83,3679.2,2065.56,2065.56
2136749260695403008,2020-02,2214.76,4743.04,5917.88,0,3389.6,5455.16
2136749260695403008,2020-03,3929.31,6929.53,2680.84,1920.22,-2239.6,3215.56
2136749260695403008,2020-04,637.47,1795.89,723.27,3390.89,-3826.04,-610.48
2136749260695403008,2020-05,10495.63,954.22,1997.58,10116.32,1422.67,812.19
2136749260695403008,2020-06,1561.4,6187,987.51,3991.18,-7629.27,-6817.08
2136749260695403008,2020-07,5486.55,5984.35,4071.08,5317.48,-1744.2,-8561.28
2136749260695403008,2020-08,5264.86,1562.76,2106.53,2798.43,3010.2,-5551.08
2136749260695403008,2020-09,5296.57,5157.9,2205,2181.4,162.27,-5388.81
2136749260695403008,2020-10,419.87,1753.01,3631.41,2307.71,-9.44,-5398.25
2136749260695403008,2020-11,2177.54,6445.89,5367.36,4231.87,-3132.86,-8531.11
2136749260695403008,2020-12,4886.56,1483.8,4115.94,1988.58,5530.12,-3000.99
2137765045525244160,2020-02,0,1907.22,1213.39,0,-693.83,-693.83
2137765045525244160,2020-05,1598.42,0,265.72,1376.54,487.6,-206.23
2137765045525244160,2020-10,152.7,2238.53,1627.95,0,-457.88,-664.11
2137765045525244160,2020-11,0,1521.05,944.27,0,-576.78,-1240.89
2137765045525244160,2020-12,1095.8,0,2577.44,0,3673.24,2432.35
2137956045041483520,2020-01,2079.66,4173.84,832.84,1865.33,-3126.67,-3126.67
2137956045041483520,2020-02,0,358.33,2032.62,791.86,882.43,-2244.24
2137956045041483520,2020-03,3068.42,2523.86,1938.08,2156.44,326.2,-1918.04
2137956045041483520,2020-04,1659.03,3929.45,0,3379.92,-5650.34,-7568.38
2137956045041483520,2020-05,2863.53,3796.24,1587.57,1422.52,-767.66,-8336.04
2137956045041483520,2020-06,1206.93,1873.54,1018.03,581.39,-229.97,-8566.01
2137956045041483520,2020-07,1802.33,1861.62,2270.61,1791.46,419.86,-8146.15
2137956045041483520,2020-08,0,395.16,0,1332.82,-1727.98,-9874.13
2137956045041483520,2020-09,670.72,3571.36,0,1182.19,-4082.83,-13956.96
2137956045041483520,2020-10,0,4046.63,4718.2,2091.18,-1419.61,-15376.57
2137956045041483520,2020-11,3699.86,2057.54,1513.05,719.62,2435.75,-12940.82
2137956045041483520,2020-12,3206.89,1064.82,4547.67,771.9,5917.84,-7022.98
2138284857298809856,2020-01,2229.24,4653.44,4903.36,521.12,1958.04,1958.04
2138284857298809856,2020-02,4501.08,4419.84,1474.11,6239.81,-4684.46,-2726.42
2138284857298809856,2020-03,4886.47,6153.41,4362.39,3657.46,-562.01,-3288.43
2138284857298809856,2020-04,4210.41,530.02,5131.55,2634.95,6176.99,2888.56
2138284857298809856,2020-05,1215.27,3280.21,3723.88,4163.39,-2504.45,384.11
2138284857298809856,2020-06,9375.02,1118.53,325.37,6371.48,2210.38,2594.49
2138284857298809856,2020-07,6793.79,8423.12,3456.97,3240.08,-1412.44,1182.05
2138284857298809856,2020-08,2630.56,3108.7,2014.3,1764.34,-228.18,953.87
2138284857298809856,2020-09,3.1,2797.84,1949.67,3049.28,-3894.35,-2940.48
2138284857298809856,2020-10,4908.53,6533.96,4874.39,2741.43,507.53,-2432.95
2138284857298809856,2020-11,6003.79,5962.36,3217.35,2434.15,824.63,-1608.32
2138284857298809856,2020-12,4351.82,3446.5,7937.22,4412.51,4430.03,2821.71
2138424028943820032,2020-01,411.66,4662.16,4849.38,1622.98,-1024.1,-1024.1
2138424028943820032,2020-02,463.14,5332.44,3711.36,4777.79,-5935.73,-6959.83
2138424028943820032,2020-03,1614.9,1715.65,1731.15,1394.15,236.25,-6723.58
2138424028943820032,2020-04,5093.26,0,5639.09,1986.73,8745.62,2022.04
2138424028943820032,2020-05,1545.65,2057.57,2849.71,1242.18,1095.61,3117.65
2138424028943820032,2020-06,3956.35,1383.4,4402.75,0,6975.7,10093.35
2138424028943820032,2020-07,9112.54,0,2611.58,1294.59,10429.53,20522.88
2138424028943820032,2020-08,3906.57,2743.14,1593.4,2003.39,753.44,21276.32
2138424028943820032,2020-09,1950.52,880.71,4081.75,378.9,4772.66,26048.98
2138424028943820032,2020-10,3574.42,2900.55,638.99,3941.13,-2628.27,23420.71
2138424028943820032,2020-11,2987.6,2362.65,4720.05,3017.05,2327.95,25748.66
2138424028943820032,2020-12,1252.69,1190.81,2988.78,7431.83,-4381.17,21367.49
2140002685438476032,2020-01,4428.52,0,0,768.18,3660.34,3660.34
2140002685438476032,2020-02,0,1149.88,0,1397.73,-2547.61,1112.73
2140002685438476032,2020-03,2333.91,0,0,1669.68,664.23,1776.96
2140002685438476032,2020-04,1340.1,0,0,1791.35,-451.25,1325.71
2140002685438476032,2020-06,1227.49,612.59,3102.61,605.48,3112.03,4437.74
2140002685438476032,2020-07,675.49,0,228.5,749.75,154.24,4591.98
2140002685438476032,2020-08,2011.17,905.59,2437.81,0,3543.39,8135.37
2140002685438476032,2020-09,1990.58,0,1886.85,0,3877.43,12012.8
2140002685438476032,2020-10,0,900.69,0,0,-900.69,11112.11
2140002685438476032,2020-12,0,3633.18,1926.1,688.17,-2395.25,8716.86
2140350085908698368,2020-01,3108.72,2616.43,2345.25,1414.55,1422.99,1422.99
2140350085908698368,2020-02,1649.4,3494.2,31.34,2581.26,-4394.72,-2971.73
2140350085908698368,2020-03,3372.88,2557.51,2083.79,4419.77,-1520.61,-4492.34
2140350085908698368,2020-04,5198.02,3594.92,4085.78,2109.17,3579.71,-912.63
2140350085908698368,2020-05,2151.97,2432.44,4195.11,2182.85,1731.79,819.16
2140350085908698368,2020-06,1491.7,0,2969.15,1492.55,2968.3,3787.46
2140350085908698368,2020-07,2944.48,1787.93,8476.16,4536.48,5096.23,8883.69
2140350085908698368,2020-08,1818.44,5550.58,3644.37,105.49,-193.26,8690.43
2140350085908698368,2020-09,8554.12,4239.24,863.74,2435.6,2743.02,11433.45
2140350085908698368,2020-10,7219.44,3145.5,4859.93,4483.28,4450.59,15884.04
2140350085908698368,2020-11,3615.38,1968.39,0,4579.17,-2932.18,12951.86
2140350085908698368,2020-12,8825.19,1003.12,3300.39,2402.14,8720.32,21672.18
2140918619922447616,2020-01,5285.76,3417.36,4032.17,2599.3,3301.27,3301.27
2140918619922447616,2020-02,5992.51,3344.73,1207.15,3745.23,109.7,3410.97
2140918619922447616,2020-03,1780,4524.82,2871.6,6543.2,-6416.42,-3005.45
2140918619922447616,2020-04,1150.44,3485.47,2748.36,1280.19,-866.86,-3872.31
2140918619922447616,2020-05,8228.8,2161.04,6230.96,2036.39,10262.33,6390.02
2140918619922447616,2020-06,2891.36,4969.84,3558.77,346.45,1133.84,7523.86
2140918619922447616,2020-07,3246.63,1935.66,0,4437.61,-3126.64,4397.22
2140918619922447616,2020-08,2647.33,3886.77,2743.64,2759.16,-1254.96,3142.26
2140918619922447616,2020-09,4310.5,0,0,9894.28,-5583.78,-2441.52
2140918619922447616,2020-10,1311.63,472.84,5262.98,5057.88,1043.89,-1397.63
2140918619922447616,2020-11,2649.03,4714.49,1988.15,1997.47,-2074.78,-3472.41
2140918619922447616,2020-12,2910.45,10175.62,3815.8,2784.1,-6233.47,-9705.88
2141085595139931904,2020-01,316.91,8116.44,418.34,901.59,-8282.78,-8282.78
2141085595139931904,2020-02,495.51,2161.65,500.79,1410.41,-2575.76,-10858.54
2141085595139931904,2020-03,1188.78,1259.86,4331.25,141.84,4118.33,-6740.21
2141085595139931904,2020-04,1987.64,1019.76,1334.06,1920.89,381.05,-6359.16
2141085595139931904,2020-05,1735.37,0,0,708.8,1026.57,-5332.59
2141085595139931904,2020-06,1146.17,4811.05,1991.09,3427.03,-5100.82,-10433.41
2141085595139931904,2020-07,2867.19,2198.29,1884.19,2306.72,246.37,-10187.04
2141085595139931904,2020-08,259.49,0,1348.99,3471.3,-1862.82,-12049.86
2141085595139931904,2020-09,1314.51,1682.72,14.36,3508.98,-3862.83,-15912.69
2141085595139931904,2020-10,2294.92,2472.87,2860.34,0,2682.39,-13230.3
2141085595139931904,2020-11,2122.82,3116.89,4157.03,3519.37,-356.41,-13586.71
2141085595139931904,2020-12,0,3831.69,2324.28,1519.99,-3027.4,-16614.11
2141607253874302208,2020-01,0,1003.34,0,0,-1003.34,-1003.34
2141607253874302208,2020-02,20.5,1907.4,0,1533.62,-3420.52,-4423.86
2141607253874302208,2020-03,2765.68,1797.59,1940.2,0,2908.29,-1515.57
2141607253874302208,2020-05,0,331.87,849.47,0,517.6,-997.97
2141607253874302208,2020-07,1452.4,2073.84,0,0,-621.44,-1619.41
2141607253874302208,2020-08,0,1718.51,798.84,0,-919.67,-2539.08
2141607253874302208,2020-10,131.77,578.89,0,0,-447.12,-2986.2
2141607253874302208,2020-11,1618.66,0,2649.76,1266.95,3001.47,15.27
2141607253874302208,2020-12,940.29,1307.2,0,1011.75,-1378.66,-1363.39
2142709376111000320,2020-01,1995,3208.89,2643.62,549.84,879.89,879.89
2142709376111000320,2020-02,954.88,6440.27,3434.2,0,-2051.19,-1171.3
2142709376111000320,2020-03,3636.19,8207.43,3293.06,4901.11,-6179.29,-7350.59
2142709376111000320,2020-04,5762.85,6291.59,6043.64,2787.71,2727.19,-4623.4
2142709376111000320,2020-05,3233.58,2550.36,5483.65,6198.35,-31.48,-4654.88
2142709376111000320,2020-06,1067.32,5655.22,873.64,5490.98,-9205.24,-13860.12
2142709376111000320,2020-07,5187.26,7551.08,7278.04,1671.75,3242.47,-10617.65
2142709376111000320,2020-08,2646.72,7113.27,3042.06,2125.28,-3549.77,-14167.42
2142709376111000320,2020-09,1582.76,1683.03,3825.88,893.95,2831.66,-11335.76
2142709376111000320,2020-10,9377.83,1669.5,2112.06,4803.57,5016.82,-6318.94
2142709376111000320,2020-11,3574.98,5898.91,3980.36,2954.31,-1297.88,-7616.82
2142709376111000320,2020-12,4883.12,4841.37,5039.93,7300.13,-2218.45,-9835.27
2142872782173543680,2020-01,3366.31,1558.17,0,2358.58,-550.44,-550.44
2142872782173543680,2020-02,1973.71,1722.43,550.76,2307.12,-1505.08,-2055.52
2142872782173543680,2020-03,8879.83,3049.09,2494.23,2717.44,5607.53,3552.01
2142872782173543680,2020-04,970.49,1912.45,4104.66,0,3162.7,6714.71
2142872782173543680,2020-05,2426.78,1898.41,1879.23,2301.79,105.81,6820.52
2142872782173543680,2020-06,2384.73,285.57,2411.58,1677.68,2833.06,9653.58
2142872782173543680,2020-07,5504.94,1841.02,5488.81,4244.92,4907.81,14561.39
2142872782173543680,2020-08,4771.41,3156.58,3666.45,1997.36,3283.92,17845.31
2142872782173543680,2020-09,2846.63,4876.84,4897.34,2369.43,497.7,18343.01
2142872782173543680,2020-10,2954.57,4149.36,2692.72,1146.56,351.37,18694.38
2142872782173543680,2020-11,3220.07,1341.44,5338.9,1563.44,5654.09,24348.47
2142872782173543680,2020-12,4569.53,5613.67,604.29,1741.96,-2181.81,22166.66
2144093510591275776,2020-01,0,619.97,2388.49,0,1768.52,1768.52
2144093510591275776,2020-02,0,36.11,252.7,1265.24,-1048.65,719.87
2144093510591275776,2020-03,892.41,1964.41,0,0,-1072,-352.13
2144093510591275776,2020-04,1319.26,1025.94,0,0,293.32,-58.81
2144093510591275776,2020-05,0,786.64,0,0,-786.64,-845.45
2144093510591275776,2020-06,0,1344.34,698.41,1234.29,-1880.22,-2725.67
2144093510591275776,2020-07,1246.19,0,517.49,0,1763.68,-961.99
2144093510591275776,2020-08,823.19,0,0,1436.45,-613.26,-1575.25
2144093510591275776,2020-09,855.52,5360.49,0,1564.95,-6069.92,-7645.17
2144093510591275776,2020-10,1275.51,1635,0,0,-359.49,-8004.66
2144093510591275776,2020-11,412.45,322.5,1533.85,295.54,1328.26,-6676.4
2144093510591275776,2020-12,762.83,2633.08,0,1495.51,-3365.76,-10042.16
2145811048990289408,2020-01,2007.49,1371.78,3388.76,824.42,3200.05,3200.05
2145811048990289408,2020-02,3063.44,1264.59,0,2446.66,-647.81,2552.24
2145811048990289408,2020-03,1860.61,234.45,2361.74,2220.92,1766.98,4319.22
2145811048990289408,2020-04,3095.66,2719.07,0,883.21,-506.62,3812.6
2145811048990289408,2020-05,2017.75,6508.5,1805.47,507.49,-3192.77,619.83
2145811048990289408,2020-06,0,3516.08,31.79,1033.41,-4517.7,-3897.87
2145811048990289408,2020-07,2259.94,1711.46,0,2394.5,-1846.02,-5743.89
2145811048990289408,2020-08,4938.58,1578.91,192.11,4.18,3547.6,-2196.29
2145811048990289408,2020-09,0,1452.72,367.32,0,-1085.4,-3281.69
2145811048990289408,2020-10,1433.78,3131.13,1587.99,1941.76,-2051.12,-5332.81
2145811048990289408,2020-11,2176.75,703.47,4228.62,3797.19,1904.71,-3428.1
2145811048990289408,2020-12,55.55,3442.47,0,0,-3386.92,-6815.02
2146840335397634560,2020-01,1277.08,1516.9,1493.18,1604.09,-350.73,-350.73
2146840335397634560,2020-02,2019.27,430.3,3160.7,736.28,4013.39,3662.66
2146840335397634560,2020-03,2751.06,0,2551.08,1503.5,3798.64,7461.3
2146840335397634560,2020-04,70.34,1304.89,1961.12,969.78,-243.21,7218.09
2146840335397634560,2020-05,98.76,1878.11,2318.89,1248.39,-708.85,6509.24
2146840335397634560,2020-06,0,130.14,202.9,3534,-3461.24,3048
2146840335397634560,2020-07,2205.13,2655.88,387.56,1584.16,-1647.35,1400.65
2146840335397634560,2020-08,2102.97,2669.59,689.63,1590.06,-1467.05,-66.4
2146840335397634560,2020-09,2421.28,1364.45,1793.14,7122.35,-4272.38,-4338.78
2146840335397634560,2020-11,1194.38,598.08,1984.55,4372.38,-1791.53,-6130.31
2146840335397634560,2020-12,0,625.81,1500.56,0,874.75,-5255.56
2147432070132264704,2020-01,0,1125.32,713.77,0,-411.55,-411.55
2147432070132264704,2020-04,428.45,1096.26,1460.13,3904.16,-3111.84,-3523.39
2147432070132264704,2020-05,2579.86,0,2027.91,2683.43,1924.34,-1599.05
2147432070132264704,2020-06,982.5,2791.43,2772.36,1026.75,-63.32,-1662.37
2147432070132264704,2020-07,3980.33,0,4621.26,1592.3,7009.29,5346.92
2147432070132264704,2020-08,2399.23,1894.49,1248.71,0,1753.45,7100.37
2147432070132264704,2020-10,0,4221.8,2353.59,1001.37,-2869.58,4230.79
2147432070132264704,2020-11,2531.93,0,1281.93,0,3813.86,8044.65
2147432070132264704,2020-12,841.18,3501.22,2899.93,1138.42,-898.53,7146.12
2147674345954302208,2020-01,6126.52,3978.63,5218.91,1398.67,5968.13,5968.13
2147674345954302208,2020-02,6419.08,2304.46,1759.99,2970.26,2904.35,8872.48
2147674345954302208,2020-03,6107.71,1730.21,7372.3,6936.31,4813.49,13685.97
2147674345954302208,2020-04,109.45,5715.82,2414.66,2023.36,-5215.07,8470.9
2147674345954302208,2020-05,7918.1,5673.41,3247.47,3200.69,2291.47,10762.37
2147674345954302208,2020-06,4827.15,2597.53,1077.24,1963.97,1342.89,12105.26
2147674345954302208,2020-07,6493.73,2355.92,7481.85,1747.35,9872.31,21977.57
2147674345954302208,2020-08,522.03,2755.06,9434.14,1418.3,5782.81,27760.38
2147674345954302208,2020-09,2116.59,8217.65,5939.58,5204.4,-5365.88,22394.5
2147674345954302208,2020-10,4241.08,2728.3,3464.36,1228.44,3748.7,26143.2
2147674345954302208,2020-11,3690.72,3604.51,3841.46,3299.27,628.4,26771.6
2147674345954302208,2020-12,2931.37,5655.24,9430.88,8173.59,-1466.58,25305.02
2147983495529896192,2020-01,866.93,0,4088.82,2603.53,2352.22,2352.22
2147983495529896192,2020-02,0,288.98,2855.12,4455.21,-1889.07,463.15
2147983495529896192,2020-03,1830.06,0,2568.14,3041.49,1356.71,1819.86
2147983495529896192,2020-04,874.3,0,1781.7,2027.09,628.91,2448.77
2147983495529896192,2020-05,1110.3,927.31,3037.25,308.05,2912.19,5360.96
2147983495529896192,2020-06,3418.82,1040.18,153.95,1304.3,1228.29,6589.25
2147983495529896192,2020-07,0,2409.19,2542.07,145.61,-12.73,6576.52
2147983495529896192,2020-08,2443,0,4273.96,4627.7,2089.26,8665.78
2147983495529896192,2020-09,0,1024.76,167.52,1466.05,-2323.29,6342.49
2147983495529896192,2020-10,310.48,1754.5,1879.85,0,435.83,6778.32
2147983495529896192,2020-11,1968.07,1642.73,2901.63,772.35,2454.62,9232.94
2147983495529896192,2020-12,2831.95,0,814.28,2273.47,1372.76,10605.7
2148139559227873024,2020-01,1697.71,0,2653.19,20.97,4329.93,4329.93
2148139559227873024,2020-04,2247.56,0,0,261.62,1985.94,6315.87
2148139559227873024,2020-08,0,945.27,4307.25,3073.72,288.26,6604.13
2148139559227873024,2020-09,0,1961.23,0,0,-1961.23,4642.9
2148139559227873024,2020-10,107.93,0,0,1457.87,-1349.94,3292.96
2148752158172118272,2020-01,0,3690.18,0,1516.9,-5207.08,-5207.08
2148752158172118272,2020-02,2569.71,893.81,995.09,1260.17,1410.82,-3796.26
2148752158172118272,2020-05,0,212.46,0,0,-212.46,-4008.72
2148752158172118272,2020-06,0,880.14,3215.73,2210.46,125.13,-3883.59
2148752158172118272,2020-07,0,593.25,516.36,0,-76.89,-3960.48
2148752158172118272,2020-09,0,633.63,2284.28,0,1650.65,-2309.83
2148752158172118272,2020-10,3318.99,139.35,0,741.11,2438.53,128.7
2148752158172118272,2020-11,2627.98,405.73,0,0,2222.25,2350.95
2148752158172118272,2020-12,437.36,0,1414.64,0,1852,4202.95
2149205394686466560,2020-01,6004.83,2491.23,1830.7,3842.43,1501.87,1501.87
2149205394686466560,2020-02,5340.67,3543.63,1106.49,2487.75,415.78,1917.65
2149205394686466560,2020-03,6895.33,0,3500.8,5437.09,4959.04,6876.69
2149205394686466560,2020-04,1886.74,1849.9,3085.93,5718.99,-2596.22,4280.47
2149205394686466560,2020-05,4925.09,0,437.21,4933.2,429.1,4709.57
2149205394686466560,2020-06,1547.24,0,4980.46,3985.27,2542.43,7252
2149205394686466560,2020-07,1494.73,4890.12,3054.19,3272.22,-3613.42,3638.58
2149205394686466560,2020-08,1981.16,2576.51,499.19,4525.21,-4621.37,-982.79
2149205394686466560,2020-09,2503.77,3896.63,5670.62,2687.35,1590.41,607.62
2149205394686466560,2020-10,6045.27,3958.45,2897.83,2139.24,2845.41,3453.03
2149205394686466560,2020-11,8627.09,549.85,6782.3,1734.85,13124.69,16577.72
2149205394686466560,2020-12,5056.4,2609.77,1318.11,5494.33,-1729.59,14848.13
2149813291607729664,2020-01,6364.3,2678.82,1404.41,624.2,4465.69,4465.69
2149813291607729664,2020-02,4310.92,1781.4,0,57.37,2472.15,6937.84
2149813291607729664,2020-03,4206.88,4572.99,1117.16,1471.29,-720.24,6217.6
2149813291607729664,2020-04,1472.39,2194.46,2483.49,4156.45,-2395.03,3822.57
2149813291607729664,2020-05,1666.57,0,2138.32,1850.83,1954.06,5776.63
2149813291607729664,2020-06,531.49,2905.74,1033.01,2385.94,-3727.18,2049.45
2149813291607729664,2020-07,1492.82,0,312.85,4417.5,-2611.83,-562.38
2149813291607729664,2020-08,689.74,0,2807.42,0,3497.16,2934.78
2149813291607729664,2020-09,5001.48,0,1796.04,1999.56,4797.96,7732.74
2149813291607729664,2020-10,0,3943.28,3910.59,1464.58,-1497.27,6235.47
2149813291607729664,2020-11,4202.29,0,2586.23,701.11,6087.41,12322.88
2149813291607729664,2020-12,26.45,1964.58,2469.42,588.22,-56.93,12265.95
2152024807476609280,2020-01,0,1809.32,1610.93,1185.62,-1384.01,-1384.01
2152024807476609280,2020-02,0,1965.65,2131.99,1888.22,-1721.88,-3105.89
2152024807476609280,2020-04,2523.48,2886.32,0,1446.03,-1808.87,-4914.76
2152024807476609280,2020-05,3542.55,4873.21,2300.91,1051.94,-81.69,-4996.45
2152024807476609280,2020-06,1320.2,0,5111.65,1152.37,5279.48,283.03
2152024807476609280,2020-07,4104.84,2170.21,1761.58,2323.5,1372.71,1655.74
2152024807476609280,2020-08,1145.68,1155.06,335.6,3760.49,-3434.27,-1778.53
2152024807476609280,2020-09,4444.43,0,3689.09,0,8133.52,6354.99
2152024807476609280,2020-10,1593.52,2307.82,456.02,2479.46,-2737.74,3617.25
2152024807476609280,2020-11,1341.75,1757.92,0,1700.12,-2116.29,1500.96
2152024807476609280,2020-12,738.12,0,0,3375.02,-2636.9,-1135.94
2153519345373253376,2020-01,1577.18,1693.98,6606.12,4249.03,2240.29,2240.29
2153519345373253376,2020-02,0,7693.45,5923.8,1428.15,-3197.8,-957.51
2153519345373253376,2020-03,896.02,3006.14,1901.13,3259.81,-3468.8,-4426.31
2153519345373253376,2020-04,2940.26,6042.81,5223.39,3860.89,-1740.05,-6166.36
2153519345373253376,2020-05,1100.62,4387.85,900.05,4580.6,-6967.78,-13134.14
2153519345373253376,2020-06,703.53,4622.86,803.75,189.91,-3305.49,-16439.63
2153519345373253376,2020-07,3587.2,3699.61,3070.11,4510.46,-1552.76,-17992.39
2153519345373253376,2020-08,0,1995.86,3640.04,1836.37,-192.19,-18184.58
2153519345373253376,2020-09,5600.61,6297.16,3168.13,1743.3,728.28,-17456.3
2153519345373253376,2020-10,947.26,0,778.99,3116.88,-1390.63,-18846.93
2153519345373253376,2020-11,0,3624.81,6586.47,5284.77,-2323.11,-21170.04
2153519345373253376,2020-12,8393.46,4139.41,3714.24,120.12,7848.17,-13321.87
2154630684852369664,2020-02,1910.96,0,0,4543.48,-2632.52,-2632.52
2154630684852369664,2020-03,987.19,1500.96,0,126.35,-640.12,-3272.64
2154630684852369664,2020-04,1847.38,1249.13,2248.89,395.29,2451.85,-820.79
2154630684852369664,2020-05,1874.8,596.28,0,2947.99,-1669.47,-2490.26
2154630684852369664,2020-06,187.18,1898.84,4588.46,3589.44,-712.64,-3202.9
2154630684852369664,2020-07,1548.59,0,0,4882.06,-3333.47,-6536.37
2154630684852369664,2020-08,714.46,932.81,520.28,1419.55,-1117.62,-7653.99
2154630684852369664,2020-09,1631.24,0,0,0,1631.24,-6022.75
2154630684852369664,2020-10,2065,0,7625.64,1971.84,7718.8,1696.05
2154630684852369664,2020-11,1925.75,2507.46,1974.29,2182.12,-789.54,906.51
2154630684852369664,2020-12,1175.14,840.15,478.85,527.3,286.54,1193.05
2157653386629824512,2020-01,0,322.04,1571.87,511.14,738.69,738.69
2157653386629824512,2020-02,0,120.68,22.53,0,-98.15,640.54
2157653386629824512,2020-03,2759.19,2039.12,294.3,891.01,123.36,763.9
2157653386629824512,2020-04,337.08,1425.8,0,0,-1088.72,-324.82
2157653386629824512,2020-07,1823.07,3724.98,854.37,1849.88,-2897.42,-3222.24
2157653386629824512,2020-09,2310.04,0,603.8,1587.85,1325.99,-1896.25
2157653386629824512,2020-10,1154.54,3869.03,1616,1340.26,-2438.75,-4335
2157653386629824512,2020-11,0,1311.8,0,1884.76,-3196.56,-7531.56
2157653386629824512,2020-12,109.1,0,1292.29,0,1401.39,-6130.17
2158686093480355840,2020-01,2298.09,6333.99,8913.29,3003.94,1873.45,1873.45
2158686093480355840,2020-02,2070.2,4411.35,1461.73,3265.4,-4144.82,-2271.37
2158686093480355840,2020-03,1936.94,4007.9,3316.77,3142.88,-1897.07,-4168.44
2158686093480355840,2020-04,3366.2,2138.77,24.28,3633.39,-2381.68,-6550.12
2158686093480355840,2020-05,4552.04,3692.14,5617.47,219.2,6258.17,-291.95
2158686093480355840,2020-06,3689.99,4485.67,4591.48,1112.99,2682.81,2390.86
2158686093480355840,2020-07,818.17,5368.72,4890.06,761.03,-421.52,1969.34
2158686093480355840,2020-08,682.86,1823.87,0,2355.5,-3496.51,-1527.17
2158686093480355840,2020-09,5344.14,2458.09,5112.67,8211.07,-212.35,-1739.52
2158686093480355840,2020-10,2019.39,2316.9,5404.93,4546.04,561.38,-1178.14
2158686093480355840,2020-11,3302.27,2147.16,6397.3,2593.35,4959.06,3780.92
2158686093480355840,2020-12,2271.01,2084.65,2808.37,5956.39,-2961.66,819.26
2158822390500581888,2020-01,784.65,6950.02,5375.49,8143.65,-8933.53,-8933.53
2158822390500581888,2020-02,3236.72,0,2377.97,2041.37,3573.32,-5360.21
2158822390500581888,2020-03,5570.05,4824.87,2039.27,1507.61,1276.84,-4083.37
2158822390500581888,2020-04,295.05,2695.84,3849.15,956.37,491.99,-3591.38
2158822390500581888,2020-05,1029.7,4739.72,3173.65,190.33,-726.7,-4318.08
2158822390500581888,2020-06,8238.65,558.3,2014.51,1325.29,8369.57,4051.49
2158822390500581888,2020-07,1892.73,4550.81,3521.27,1053.2,-190.01,3861.48
2158822390500581888,2020-08,3357.95,0,1618.36,2351.23,2625.08,6486.56
2158822390500581888,2020-09,3812.08,0,3210.83,1968.72,5054.19,11540.75
2158822390500581888,2020-10,6586.71,3316.57,5754.31,1099.26,7925.19,19465.94
2158822390500581888,2020-11,577.33,298.17,757.55,2287.06,-1250.35,18215.59
2158822390500581888,2020-12,1853.22,1556.44,4642.72,4084.9,854.6,19070.19
2160425854722423552,2020-01,1711.59,2154.66,2118.47,2288.74,-613.34,-613.34
2160425854722423552,2020-02,5231.94,4665.59,6283.15,0,6849.5,6236.16
2160425854722423552,2020-03,4252.73,5017.14,4452.73,0,3688.32,9924.48
2160425854722423552,2020-04,0,1113.58,2.84,2399.96,-3510.7,6413.78
2160425854722423552,2020-05,2012.77,1279.09,3771,1873.64,2631.04,9044.82
2160425854722423552,2020-06,3320.04,5455.96,3946.13,0,1810.21,10855.03
2160425854722423552,2020-07,4914.16,5338.15,2552.48,5191.13,-3062.64,7792.39
2160425854722423552,2020-08,0,677.88,6648.01,6091.85,-121.72,7670.67
2160425854722423552,2020-09,5275.88,2479.47,2169.35,1983.49,2982.27,10652.94
2160425854722423552,2020-10,1771.48,2419.65,2447.65,2955.27,-1155.79,9497.15
2160425854722423552,2020-11,3618.64,1223.96,4004.45,2450.55,3948.58,13445.73
2160425854722423552,2020-12,2165.35,0,2929.23,638.28,4456.3,17902.03
2160550829418446848,2020-01,0,462.18,4309.2,1236.1,2610.92,2610.92
2160550829418446848,2020-02,3835.32,465,3630.8,0,7001.12,9612.04
2160550829418446848,2020-03,1969.25,2838.25,2084.13,3036.6,-1821.47,7790.57
2160550829418446848,2020-04,785.82,2984.03,0,4167.36,-6365.57,1425
2160550829418446848,2020-05,4016.85,149.66,0,0,3867.19,5292.19
2160550829418446848,2020-06,1617.38,4486.3,1393.91,1537.32,-3012.33,2279.86
2160550829418446848,2020-07,3058.63,0,3764.96,3789.21,3034.38,5314.24
2160550829418446848,2020-08,2545.48,0,1724.35,3518.41,751.42,6065.66
2160550829418446848,2020-09,594.29,2694.5,3024.01,0,923.8,6989.46
2160550829418446848,2020-11,839.9,0,1647.96,1788.68,699.18,7688.64
2160550829418446848,2020-12,1078.7,0,0,4494.56,-3415.86,4272.78
2161787212043691520,2020-01,817.06,1694.61,2998.64,5328.51,-3207.42,-3207.42
2161787212043691520,2020-02,1820.72,0,7217.13,4686.87,4350.98,1143.56
2161787212043691520,2020-03,3005.85,1361.97,1799.91,3511.82,-68.03,1075.53
2161787212043691520,2020-04,3482.68,3502.32,2143.69,3086.01,-961.96,113.57
2161787212043691520,2020-05,2633.32,856.17,1604.28,4553.54,-1172.11,-1058.54
2161787212043691520,2020-06,5849.36,2929.8,56.27,3087.88,-112.05,-1170.59
2161787212043691520,2020-07,3299.13,4347.26,4037.91,4131.96,-1142.18,-2312.77
2161787212043691520,2020-08,4119.43,2087.69,5001.52,3719.18,3314.08,1001.31
2161787212043691520,2020-09,1874.91,2003.37,3453.49,4888.83,-1563.8,-562.49
2161787212043691520,2020-10,3759.47,2777.79,4987.84,5327.85,641.67,79.18
2161787212043691520,2020-11,2435.48,1601.73,2228.59,3050.24,12.1,91.28
2161787212043691520,2020-12,1826.46,1539.94,6196.76,3452,3031.28,3122.56
2165158623349830656,2020-01,3510.16,3150.27,4434.4,6425.37,-1631.08,-1631.08
2165158623349830656,2020-02,3826.26,2928.43,2732.03,3127.53,502.33,-1128.75
2165158623349830656,2020-03,0,2068.94,2479.89,5351.7,-4940.75,-6069.5
2165158623349830656,2020-04,2654.34,883.97,923.18,0,2693.55,-3375.95
2165158623349830656,2020-05,3019.57,1474.4,1979.39,2870,654.56,-2721.39
2165158623349830656,2020-06,1775.57,289.18,0,1898.74,-412.35,-3133.74
2165158623349830656,2020-07,3127.68,2698.94,3377.71,976.9,2829.55,-304.19
2165158623349830656,2020-08,4312.6,3839.71,2068.14,4645.65,-2104.62,-2408.81
2165158623349830656,2020-09,1271.06,1146.99,2110.28,180.59,2053.76,-355.05
2165158623349830656,2020-10,689.52,7241.73,3301.34,971.77,-4222.64,-4577.69
2165158623349830656,2020-11,1478.71,1527.38,4666.85,5107.36,-489.18,-5066.87
2165158623349830656,2020-12,1088.5,2612.01,7898.05,6298.08,76.46,-4990.41
2165447838255510272,2020-01,31.5,0,94.34,0,125.84,125.84
2165447838255510272,2020-03,648.99,0,0,0,648.99,774.83
2165447838255510272,2020-05,0,1187.03,1675.77,0,488.74,1263.57
2165447838255510272,2020-07,1905.49,0,718.2,0,2623.69,3887.26
2165447838255510272,2020-08,0,1191.52,992.36,0,-199.16,3688.1
2165447838255510272,2020-09,337.03,282.9,0,578.29,-524.16,3163.94
2165447838255510272,2020-10,0,255,5120.94,0,4865.94,8029.88
2165447838255510272,2020-11,0,53.25,0,0,-53.25,7976.63
2166105522828340224,2020-01,990.28,1169.52,0,4435.76,-4615,-4615
2166105522828340224,2020-02,1960.3,0,0,0,1960.3,-2654.7
2166105522828340224,2020-03,588.39,1874.22,963.92,1496.47,-1818.38,-4473.08
2166105522828340224,2020-04,2956.02,1799.55,1272.68,0,2429.15,-2043.93
2166105522828340224,2020-05,459.06,2383.19,5945.42,1243.14,2778.15,734.22
2166105522828340224,2020-06,1960.61,0,0,305.63,1654.98,2389.2
2166105522828340224,2020-07,97.47,1491.43,4721.63,0,3327.67,5716.87
2166105522828340224,2020-08,0,1821.21,2845.38,0,1024.17,6741.04
2166105522828340224,2020-09,3185.55,472.3,2719.41,559.85,4872.81,11613.85
2166105522828340224,2020-10,0,113.12,0,0,-113.12,11500.73
2166105522828340224,2020-11,2069.21,2004.11,0,1465.56,-1400.46,10100.27
2166105522828340224,2020-12,1852.74,3020.4,0,4711.4,-5879.06,4221.21
2166393459143681280,2020-01,6603.02,541.25,1684.07,38.84,7707,7707
2166393459143681280,2020-02,768.23,3382.49,2475.1,0,-139.16,7567.84
2166393459143681280,2020-03,1876.56,0,1333.79,1517.1,1693.25,9261.09
2166393459143681280,2020-04,0,295.03,0,1640.93,-1935.96,7325.13
2166393459143681280,2020-05,1154.22,0,0,263.34,890.88,8216.01
2166393459143681280,2020-06,0.83,1108.79,0,997.3,-2105.26,6110.75
2166393459143681280,2020-07,536.27,0,0,490.67,45.6,6156.35
2166393459143681280,2020-09,6.2,3833.69,0,1494.87,-5322.36,833.99
2166393459143681280,2020-11,715.37,1074.64,3586.63,0,3227.36,4061.35
2166393459143681280,2020-12,1406.95,1403.6,258.37,307.09,-45.37,4015.98
2168075212003950336,2020-01,1161.72,4111.1,3536.75,1580.87,-993.5,-993.5
2168075212003950336,2020-02,3065.29,4391.16,2760.9,1802.05,-367.02,-1360.52
2168075212003950336,2020-03,2247.46,286.98,1390.9,0,3351.38,1990.86
2168075212003950336,2020-05,1982.39,1710.7,1122.26,627.62,766.33,2757.19
2168075212003950336,2020-06,1677.72,4919.27,6231.38,1395.15,1594.68,4351.87
2168075212003950336,2020-07,1796.47,5474.36,1304.39,716.84,-3090.34,1261.53
2168075212003950336,2020-08,3210.99,954.22,1365.11,1004.11,2617.77,3879.3
2168075212003950336,2020-09,1427.77,1384.72,997.06,931.43,108.68,3987.98
2168075212003950336,2020-10,3300.33,715.21,690.25,2215.65,1059.72,5047.7
2168075212003950336,2020-11,3082.08,3709.27,4194.57,1214.72,2352.66,7400.36
2168075212003950336,2020-12,4222.53,3235.56,0,666.18,320.79,7721.15
2168083316896978432,2020-01,4684.36,3077.81,1420.47,1426.16,1600.86,1600.86
2168083316896978432,2020-02,4574.16,4291.8,3272.3,1213.42,2341.24,3942.1
2168083316896978432,2020-03,895.68,450.13,4148.21,1916.78,2676.98,6619.08
2168083316896978432,2020-04,1011.51,423.83,6722.5,2184.5,5125.68,11744.76
2168083316896978432,2020-05,2656.13,6530.27,1304.07,1145.41,-3715.48,8029.28
2168083316896978432,2020-06,2266.17,1937.25,446.12,1292.99,-517.95,7511.33
2168083316896978432,2020-07,1906.42,1444.2,5496.54,4481.87,1476.89,8988.22
2168083316896978432,2020-08,0,2479.84,3279.78,2583.33,-1783.39,7204.83
2168083316896978432,2020-09,2722.7,747.42,1449.07,4671.26,-1246.91,5957.92
2168083316896978432,2020-10,6319.94,6549.62,2300.67,2679.27,-608.28,5349.64
2168083316896978432,2020-11,3672.45,1314.04,4075.86,2287.24,4147.03,9496.67
2168083316896978432,2020-12,1053.06,207.06,1701.02,5708.83,-3161.81,6334.86
2169873828769625856,2020-01,538.08,4489.01,535.19,875.31,-4291.05,-4291.05
2169873828769625856,2020-02,2081.91,0,0,0,2081.91,-2209.14
2169873828769625856,2020-03,12.71,5589.82,1677.21,0,-3899.9,-6109.04
2169873828769625856,2020-04,1699.65,4631.71,0,4732.24,-7664.3,-13773.34
2169873828769625856,2020-05,1112.86,3482.87,1997.58,317.14,-689.57,-14462.91
2169873828769625856,2020-06,3587.92,3131.17,1923.55,0,2380.3,-12082.61
2169873828769625856,2020-07,1480.1,1850.41,0,809.03,-1179.34,-13261.95
2169873828769625856,2020-08,4288.27,1614.99,2410.76,0,5084.04,-8177.91
2169873828769625856,2020-09,381,5474.88,5279.87,102.81,83.18,-8094.73
2169873828769625856,2020-10,2560.47,1927.52,1496.13,4170.51,-2041.43,-10136.16
2169873828769625856,2020-11,0,1443.56,1981.92,3414.47,-2876.11,-13012.27
2169873828769625856,2020-12,1810.69,1848.97,0,154.98,-193.26,-13205.53
2171273718636454400,2020-01,1679.09,0,2298.86,310.99,3666.96,3666.96
2171273718636454400,2020-02,1706.64,2006.09,6445.49,3662.32,2483.72,6150.68
2171273718636454400,2020-03,1061.85,0,353.55,3592.1,-2176.7,3973.98
2171273718636454400,2020-04,0,1340.12,3009.31,0,1669.19,5643.17
2171273718636454400,2020-05,0,3021.08,2764.28,618.66,-875.46,4767.71
2171273718636454400,2020-06,2126.38,4412.01,4485.02,660.72,1538.67,6306.38
2171273718636454400,2020-07,0,1870.37,2101.81,9117.83,-8886.39,-2580.01
2171273718636454400,2020-08,6850.97,822.51,0,2246.61,3781.85,1201.84
2171273718636454400,2020-09,0,3493.45,846.4,0,-2647.05,-1445.21
2171273718636454400,2020-10,1795.91,797.58,2665.07,2349.47,1313.93,-131.28
2171273718636454400,2020-11,4428.5,5965.38,3327.91,3140.9,-1349.87,-1481.15
2171273718636454400,2020-12,973.8,4908.46,1377.98,2495.62,-5052.3,-6533.45
2172857368234040064,2020-01,646.02,1584.33,0,2336.28,-3274.59,-3274.59
2172857368234040064,2020-02,2038.44,0,2656.34,1903.49,2791.29,-483.3
2172857368234040064,2020-03,1994.85,883.1,3687.12,724.36,4074.51,3591.21
2172857368234040064,2020-04,3694.61,263.68,4748.35,341.71,7837.57,11428.78
2172857368234040064,2020-05,3726.89,3577.73,1494.83,4739.54,-3095.55,8333.23
2172857368234040064,2020-06,1587.67,5009.97,1208.71,2427.98,-4641.57,3691.66
2172857368234040064,2020-07,1728.09,4009.35,1843.09,936.22,-1374.39,2317.27
2172857368234040064,2020-08,86.29,3372.53,2556.55,1270.04,-1999.73,317.54
2172857368234040064,2020-09,1482.29,663.52,1382.79,2748.24,-546.68,-229.14
2172857368234040064,2020-10,2957.72,0,3854.61,191.62,6620.71,6391.57
2172857368234040064,2020-11,5528.58,2919.41,0,0,2609.17,9000.74
2172857368234040064,2020-12,0,3346.74,5129.05,1902.52,-120.21,8880.53
2173761781908486656,2020-01,0,1989.77,341.23,0,-1648.54,-1648.54
2173761781908486656,2020-02,0,740.91,0,1903.19,-2644.1,-4292.64
2173761781908486656,2020-03,0,1877.84,0,1290.48,-3168.32,-7460.96
2173761781908486656,2020-04,0,764.87,0,0,-764.87,-8225.83
2173761781908486656,2020-05,5058.89,1851.02,459.29,873.4,2793.76,-5432.07
2173761781908486656,2020-06,739.76,1767.42,703.25,0,-324.41,-5756.48
2173761781908486656,2020-07,1082.46,0,1637.69,0,2720.15,-3036.33
2173761781908486656,2020-08,0,795.7,151.54,1433.87,-2078.03,-5114.36
2173761781908486656,2020-09,143.6,1123.64,0,301.99,-1282.03,-6396.39
2173761781908486656,2020-10,1597.81,1318.61,0,0,279.2,-6117.19
2173761781908486656,2020-11,1521.54,0,377.78,0,1899.32,-4217.87
2174363249652471296,2020-01,4417.49,4795.37,1687.73,6500.91,-5191.06,-5191.06
2174363249652471296,2020-02,3046.51,2813.73,5276.36,1694.88,3814.26,-1376.8
2174363249652471296,2020-03,610.97,1356.32,5589.13,3088.22,1755.56,378.76
2174363249652471296,2020-04,3062.45,3848.72,4391.28,6230.78,-2625.77,-2247.01
2174363249652471296,2020-05,2012.02,2270.35,7550.65,2501.15,4791.17,2544.16
2174363249652471296,2020-06,2189.96,6250.11,1597.13,3974.24,-6437.26,-3893.1
2174363249652471296,2020-07,7276.24,3731.83,6260.78,5903.85,3901.34,8.24
2174363249652471296,2020-08,9165.99,4410.2,2317.64,1160.58,5912.85,5921.09
2174363249652471296,2020-09,4588.85,4493.83,5595.59,4904.96,785.65,6706.74
2174363249652471296,2020-10,1771.71,5549.23,2636.45,3411.3,-4552.37,2154.37
2174363249652471296,2020-11,5118.97,7602.16,6729.41,2019.47,2226.75,4381.12
2174363249652471296,2020-12,2434.2,2777.77,2426.97,1844.87,238.53,4619.65
2174406698764919296,2020-01,374,0,1882.9,3863.26,-1606.36,-1606.36
2174406698764919296,2020-02,3139.1,34.99,1921.64,3791.17,1234.58,-371.78
2174406698764919296,2020-03,992.65,1968.71,0,1515.9,-2491.96,-2863.74
2174406698764919296,2020-04,1918.85,0,0,1495.69,423.16,-2440.58
2174406698764919296,2020-05,4539.5,2376.39,1242.24,0,3405.35,964.77
2174406698764919296,2020-06,2243.79,1019.7,1751.14,3607.66,-632.43,332.34
2174406698764919296,2020-07,1994.44,5261.95,1572.24,2012.74,-3708.01,-3375.67
2174406698764919296,2020-08,1140.1,3279.92,1165.37,513.89,-1488.34,-4864.01
2174406698764919296,2020-09,6371.64,2698.39,852.94,588.05,3938.14,-925.87
2174406698764919296,2020-10,1829.89,3149.07,558.72,2255.18,-3015.64,-3941.51
2174406698764919296,2020-11,105.82,0,1686.27,190.66,1601.43,-2340.08
2174406698764919296,2020-12,1918.37,807.28,378.83,654.26,835.66,-1504.42
2174685535848514048,2020-01,3954.92,4397.11,0,0,-442.19,-442.19
2174685535848514048,2020-02,564.11,1605.6,945.67,0,-95.82,-538.01
2174685535848514048,2020-03,6833.06,2901.58,698.63,0,4630.11,4092.1
2174685535848514048,2020-04,3388.43,204.84,11168.01,5724.46,8627.14,12719.24
2174685535848514048,2020-05,4657.04,2439.85,3580.33,2633.84,3163.68,15882.92
2174685535848514048,2020-06,1833.25,3917.51,1013.85,1019.13,-2089.54,13793.38
2174685535848514048,2020-07,1514.32,5139.61,1886.91,2973.59,-4711.97,9081.41
2174685535848514048,2020-08,663.26,7081.92,5020.95,1922.27,-3319.98,5761.43
2174685535848514048,2020-09,3937.95,0,4516.77,1335.43,7119.29,12880.72
2174685535848514048,2020-10,1564.78,1071.25,363.86,2071.74,-1214.35,11666.37
2174685535848514048,2020-11,5022.48,1260.34,3807.76,1860.07,5709.83,17376.2
2174685535848514048,2020-12,1472.21,5817.89,3768.36,4265.09,-4842.41,12533.79
2175445186977619200,2020-01,3534.73,840.96,4485.67,1316.02,5863.42,5863.42
2175445186977619200,2020-02,4784.68,4163.13,6288.7,6628.97,281.28,6144.7
2175445186977619200,2020-03,8530.31,3839.69,12527.38,8110.16,9107.84,15252.54
2175445186977619200,2020-04,4032.49,12281.32,3625.68,2031.68,-6654.83,8597.71
2175445186977619200,2020-05,4461.49,14209.23,5870.34,1102.99,-4980.39,3617.32
2175445186977619200,2020-06,4325.96,968.54,1392.97,4395.44,354.95,3972.27
2175445186977619200,2020-07,2966.26,2837.69,3938.23,2434.56,1632.24,5604.51
2175445186977619200,2020-08,5984.17,2870.36,4770.56,4227.27,3657.1,9261.61
2175445186977619200,2020-09,3240.06,1115.95,5343.67,1266.57,6201.21,15462.82
2175445186977619200,2020-10,5331.46,2264.07,3236.67,9281.65,-2977.59,12485.23
2175445186977619200,2020-11,5067.05,6273.1,6067.43,4592.65,268.73,12753.96
2175445186977619200,2020-12,3487.61,2729.76,2533.65,2288.32,1003.18,13757.14
2175491447602674176,2020-01,1538.74,0,3400.14,1291.44,3647.44,3647.44
2175491447602674176,2020-02,2291.35,0,1746.88,0,4038.23,7685.67
2175491447602674176,2020-03,0,1218.7,0,0,-1218.7,6466.97
2175491447602674176,2020-05,2526.67,1334.64,1839.97,0,3032,9498.97
2175491447602674176,2020-06,0,2373.23,130.74,0,-2242.49,7256.48
2175491447602674176,2020-08,1906.23,1116.62,1700.38,0,2489.99,9746.47
2175491447602674176,2020-09,847.3,1487.09,0,2707.78,-3347.57,6398.9
2175491447602674176,2020-10,1610.79,0,441.76,1757.95,294.6,6693.5
2175491447602674176,2020-11,408.45,631.56,1578,0,1354.89,8048.39
2176014399913735424,2020-01,3407.5,1824.89,0,1734.46,-151.85,-151.85
2176014399913735424,2020-02,2123.28,1275.4,986.34,1900.1,-65.88,-217.73
2176014399913735424,2020-03,705.57,3828.89,2652.92,3296.62,-3767.02,-3984.75
2176014399913735424,2020-04,2170.42,2897.57,2167.02,190.71,1249.16,-2735.59
2176014399913735424,2020-05,1081.01,4302.68,3636.8,1846.11,-1430.98,-4166.57
2176014399913735424,2020-06,3831.2,2729.66,840.81,3489.76,-1547.41,-5713.98
2176014399913735424,2020-07,2457.98,1832.53,1309.6,912.95,1022.1,-4691.88
2176014399913735424,2020-09,1614.99,3945.65,3084.18,44.26,709.26,-3982.62
2176014399913735424,2020-10,0,1921.86,0,2990.12,-4911.98,-8894.6
2176014399913735424,2020-11,1632.77,4321.65,1896.04,2471.12,-3263.96,-12158.56
2176014399913735424,2020-12,1316.31,3540.32,195.09,977.85,-3006.77,-15165.33
2176894684252415744,2020-01,947.26,1334.85,1388.43,80.15,920.69,920.69
2176894684252415744,2020-02,1357.5,0,437.08,0,1794.58,2715.27
2176894684252415744,2020-03,2935.23,0,0,2266.27,668.96,3384.23
2176894684252415744,2020-04,804,1684.67,681.45,148.61,-347.83,3036.4
2176894684252415744,2020-06,1941.4,0,0,839.43,1101.97,4138.37
2176894684252415744,2020-07,0,2585.13,4212.61,3078.45,-1450.97,2687.4
2176894684252415744,2020-08,157.97,1734.08,1046.05,1485.35,-2015.41,671.99
2176894684252415744,2020-09,2060.39,290.57,1133.71,1823.43,1080.1,1752.09
2176894684252415744,2020-10,4112.62,0,0,93.13,4019.49,5771.58
2176894684252415744,2020-11,1616.33,0,54.38,600.07,1070.64,6842.22
2176894684252415744,2020-12,1506.6,0,139.28,1171.11,474.77,7316.99
2177279922667199488,2020-01,285.73,0,2564.05,0,2849.78,2849.78
2177279922667199488,2020-02,1796.14,1075.16,1388.9,0,2109.88,4959.66
2177279922667199488,2020-03,0,94.08,326.26,0,232.18,5191.84
2177279922667199488,2020-04,218.34,721,0,0,-502.66,4689.18
2177279922667199488,2020-05,0,2298.71,5452.42,3275.31,-121.6,4567.58
2177279922667199488,2020-07,1039.32,472.91,0,0,566.41,5133.99
2177279922667199488,2020-08,1255.66,671.59,1957.95,1559.88,982.14,6116.13
2177279922667199488,2020-09,0,1808.57,987.65,0,-820.92,5295.21
2177279922667199488,2020-10,814.15,0,3143.91,1798.53,2159.53,7454.74
2177279922667199488,2020-12,1921.31,531.4,3880.13,1257.45,4012.59,11467.33
2177613971516443136,2020-01,6617.96,7098.82,4265.2,2712.34,1072,1072
2177613971516443136,2020-02,4578.75,0,2614.22,8698.01,-1505.04,-433.04
2177613971516443136,2020-03,3279.69,5093.1,2841.16,2751.25,-1723.5,-2156.54
2177613971516443136,2020-04,5373.2,1518.1,0,5228.61,-1373.51,-3530.05
2177613971516443136,2020-05,5855.65,2435.03,5105.21,5361.91,3163.92,-366.13
2177613971516443136,2020-06,3691.03,1295.87,1480.68,7513.32,-3637.48,-4003.61
2177613971516443136,2020-07,6341.87,3796.82,810.97,3706.14,-350.12,-4353.73
2177613971516443136,2020-08,2671.64,5711.07,5204.37,5211.09,-3046.15,-7399.88
2177613971516443136,2020-09,3900.42,3312.73,5507.31,4096.39,1998.61,-5401.27
2177613971516443136,2020-10,3807.67,6895,6417.62,4647.49,-1317.2,-6718.47
2177613971516443136,2020-11,5553.82,3031.71,1758.97,611.48,3669.6,-3048.87
2177613971516443136,2020-12,5522.49,5581.27,10000.11,6639.54,3301.79,252.92
2178348783045746176,2020-01,2762.16,6167.1,1626.24,4449.84,-6228.54,-6228.54
2178348783045746176,2020-02,1954.9,4661.42,2213.14,6240.45,-6733.83,-12962.37
2178348783045746176,2020-03,3250.52,2163.41,3459.7,9123.67,-4576.86,-17539.23
2178348783045746176,2020-04,0,3561.79,3967.35,4443.38,-4037.82,-21577.05
2178348783045746176,2020-05,5091.08,3680.14,3458.48,3347.79,1521.63,-20055.42
2178348783045746176,2020-06,4103.02,2879.12,4562.67,2066.75,3719.82,-16335.6
2178348783045746176,2020-07,8403.33,7751.29,0,4990.15,-4338.11,-20673.71
2178348783045746176,2020-08,5934.3,5530.61,3839.28,5945.76,-1702.79,-22376.5
2178348783045746176,2020-09,3395.56,0,1919.83,8122.54,-2807.15,-25183.65
2178348783045746176,2020-10,9267.38,1426.06,3133.58,4545.81,6429.09,-18754.56
2178348783045746176,2020-11,5006.92,4406.73,2172.49,2359.12,413.56,-18341
2178348783045746176,2020-12,4423.36,3304.47,3881.49,1959.51,3040.87,-15300.13
2178456108685749248,2020-01,941.46,6056.98,2562.48,5473.61,-8026.65,-8026.65
2178456108685749248,2020-02,3244.34,3912.99,0,85.99,-754.64,-8781.29
2178456108685749248,2020-03,5259.44,0,3940.74,1822.27,7377.91,-1403.38
2178456108685749248,2020-04,8050.96,4415.13,6310.99,0,9946.82,8543.44
2178456108685749248,2020-05,1735.15,3212.64,4112.46,6756.58,-4121.61,4421.83
2178456108685749248,2020-06,0,3792.36,6081.9,3109.5,-819.96,3601.87
2178456108685749248,2020-07,1744.23,3951.99,2886.7,2393.58,-1714.64,1887.23
2178456108685749248,2020-08,3801.12,4006.48,3500.42,4266.17,-971.11,916.12
2178456108685749248,2020-09,8567.49,1828.15,870.01,2456.79,5152.56,6068.68
2178456108685749248,2020-10,6761.11,870.95,1240.59,4560.3,2570.45,8639.13
2178456108685749248,2020-11,3649.54,2586.99,2124.58,3396.94,-209.81,8429.32
2178456108685749248,2020-12,927.77,1910.8,752.21,7817.51,-8048.33,380.99
2179408729947238912,2020-01,171.77,0,0,488.58,-316.81,-316.81
2179408729947238912,2020-03,0,3133.23,0,390.31,-3523.54,-3840.35
2179408729947238912,2020-04,0,216.28,2299.24,1155.5,927.46,-2912.89
2179408729947238912,2020-05,797.64,0,0,0,797.64,-2115.25
2179408729947238912,2020-07,1499.53,0,751.63,0,2251.16,135.91
2179408729947238912,2020-08,0,2428.83,335.8,760.64,-2853.67,-2717.76
2179408729947238912,2020-09,154.94,1945.67,0,0,-1790.73,-4508.49
2179408729947238912,2020-11,830.48,821.69,0,1610.75,-1601.96,-6110.45
2179851978812523776,2020-01,8115.67,2108.76,4484.76,9755.83,735.84,735.84
2179851978812523776,2020-02,2817.2,6036.93,6594.93,2355.69,1019.51,1755.35
2179851978812523776,2020-03,5312.89,4504.18,3565.7,1071.4,3303.01,5058.36
2179851978812523776,2020-04,2274.84,1175.81,3109.79,6145.02,-1936.2,3122.16
2179851978812523776,2020-05,3975.71,5743.16,3227.08,6467.71,-5008.08,-1885.92
2179851978812523776,2020-06,4306.58,6188.25,1539.14,4222.28,-4564.81,-6450.73
2179851978812523776,2020-07,4802.38,2614.99,6453.32,1256.81,7383.9,933.17
2179851978812523776,2020-08,4490.92,8438.23,4222,8573.39,-8298.7,-7365.53
2179851978812523776,2020-09,1501.38,7899.02,7961.36,3940.01,-2376.29,-9741.82
2179851978812523776,2020-10,6525.05,4561.82,4095.31,4108.91,1949.63,-7792.19
2179851978812523776,2020-11,5350.59,4923.23,2665.44,6249.56,-3156.76,-10948.95
2179851978812523776,2020-12,5738.85,2753.15,6510.57,6385.72,3110.55,-7838.4
2180705141345506304,2020-01,0,1212.02,0,693.36,-1905.38,-1905.38
2180705141345506304,2020-02,390.6,0,0,1231.96,-841.36,-2746.74
2180705141345506304,2020-03,2247.55,501.6,0,0,1745.95,-1000.79
2180705141345506304,2020-04,0,1232.9,1820.32,1544.18,-956.76,-1957.55
2180705141345506304,2020-05,971.33,0,0,0,971.33,-986.22
2180705141345506304,2020-06,1895.15,0,757,704.17,1947.98,961.76
2180705141345506304,2020-07,0,4452.98,1200.87,1046.53,-4298.64,-3336.88
2180705141345506304,2020-08,1918.22,0,0,0,1918.22,-1418.66
2180705141345506304,2020-09,466.05,1871.53,2528.32,1011.89,110.95,-1307.71
2180705141345506304,2020-10,0,1782.74,0,0,-1782.74,-3090.45
2180705141345506304,2020-11,1478.44,0,0,0,1478.44,-1612.01
2180705141345506304,2020-12,0,755.5,0,3445.28,-4200.78,-5812.79
2180792389472233216,2020-01,1465.64,0,0,0,1465.64,1465.64
2180792389472233216,2020-04,1760.07,0,0,0,1760.07,3225.71
2180792389472233216,2020-09,1378.39,0,1155.17,0,2533.56,5759.27
2180792389472233216,2020-12,566.33,4232.62,0,0,-3666.29,2092.98
2182665767758091520,2020-01,8153,0,7845.73,1735.64,14263.09,14263.09
2182665767758091520,2020-02,5594.36,1551.73,9053.03,5121.24,7974.42,22237.51
2182665767758091520,2020-03,0,7569.06,4512.07,6709.21,-9766.2,12471.31
2182665767758091520,2020-04,1807.22,4607.56,2003.05,1829.16,-2626.45,9844.86
2182665767758091520,2020-05,1467.1,317.05,0,2268.6,-1118.55,8726.31
2182665767758091520,2020-06,3795.93,5460.39,3985.49,3008.38,-687.35,8038.96
2182665767758091520,2020-07,4468.16,4699.62,8712.15,3422.98,5057.71,13096.67
2182665767758091520,2020-08,1834.06,7295.33,8276.73,6007.42,-3191.96,9904.71
2182665767758091520,2020-09,1166.5,1937.4,1820.6,4659.86,-3610.16,6294.55
2182665767758091520,2020-10,3594.27,5115.66,6129.49,3934.53,673.57,6968.12
2182665767758091520,2020-11,3170.31,2457.72,2431.43,2005.8,1138.22,8106.34
2182665767758091520,2020-12,4823.96,4493.99,2298.22,2350.86,277.33,8383.67
2183238034761822720,2020-01,2113.57,0,2650.08,1746.65,3017,3017
2183238034761822720,2020-02,0,1811.99,1094.15,404.35,-1122.19,1894.81
2183238034761822720,2020-03,1073.28,3779.36,372.62,0,-2333.46,-438.65
2183238034761822720,2020-04,705.69,670.78,20.22,0,55.13,-383.52
2183238034761822720,2020-06,846.2,0,0,1798.44,-952.24,-1335.76
2183238034761822720,2020-07,1024.14,0,1270.84,1859.86,435.12,-900.64
2183238034761822720,2020-08,1571.31,1871.1,0,308.66,-608.45,-1509.09
2183238034761822720,2020-09,2993.09,1418.36,344.57,0,1919.3,410.21
2183238034761822720,2020-11,1557.39,1004.38,1194.26,369.13,1378.14,1788.35
2183238034761822720,2020-12,1988.27,4069.25,128.61,1715.47,-3667.84,-1879.49
2184138415809222912,2020-01,0,272.98,0,0,-272.98,-272.98
2184138415809222912,2020-02,240.07,0,0,0,240.07,-32.91
2184138415809222912,2020-03,1197.41,0,0,1776.67,-579.26,-612.17
2184138415809222912,2020-04,841.07,0,1160.15,0,2001.22,1389.05
2184138415809222912,2020-05,200.59,0,0,0,200.59,1589.64
2184138415809222912,2020-06,460.08,0,0,0,460.08,2049.72
2184138415809222912,2020-07,585.36,0,654.3,0,1239.66,3289.38
2184138415809222912,2020-08,0,1838.4,163.59,1324.91,-2999.72,289.66
2184138415809222912,2020-10,0,259.29,794.61,0,535.32,824.98
2184138415809222912,2020-11,0,1681.65,0,978.67,-2660.32,-1835.34
2184249283009685248,2020-01,0,1994.39,2507.23,0,512.84,512.84
2184249283009685248,2020-02,3743.43,7978.39,1714.51,1591.21,-4111.66,-3598.82
2184249283009685248,2020-03,1302.14,1778.28,0,2744.74,-3220.88,-6819.7
2184249283009685248,2020-04,577.24,1772.07,1150.09,0,-44.74,-6864.44
2184249283009685248,2020-05,1733.64,3057.21,1305.47,1640.48,-1658.58,-8523.02
2184249283009685248,2020-06,5293.4,0,893.8,2670.03,3517.17,-5005.85
2184249283009685248,2020-07,56.06,2187.91,457.35,3599.2,-5273.7,-10279.55
2184249283009685248,2020-08,2772.55,1796.76,1244.03,277.3,1942.52,-8337.03
2184249283009685248,2020-09,1531.58,1825.65,0,3076.42,-3370.49,-11707.52
2184249283009685248,2020-10,2177.25,3265.58,3245.45,0,2157.12,-9550.4
2184249283009685248,2020-11,4731.9,0,3026.51,671.38,7087.03,-2463.37
2184249283009685248,2020-12,0,1905.31,646.49,4713.29,-5972.11,-8435.48
2185640567566135552,2020-01,4600.18,3770.71,3450.35,7436.19,-3156.37,-3156.37
2185640567566135552,2020-02,869.11,4177.39,5291.68,1292.56,690.84,-2465.53
2185640567566135552,2020-03,4710.55,9707.8,2088.33,9213.14,-12122.06,-14587.59
2185640567566135552,2020-04,1894.61,9253,6672.69,2720.77,-3406.47,-17994.06
2185640567566135552,2020-05,1123.73,2877.15,6806.62,6470.39,-1417.19,-19411.25
2185640567566135552,2020-06,6848.74,2751.61,1319.55,5846.8,-430.12,-19841.37
2185640567566135552,2020-07,2288.95,5582.2,4775.64,7569.04,-6086.65,-25928.02
2185640567566135552,2020-08,3040.13,4477.98,6950.94,8615.77,-3102.68,-29030.7
2185640567566135552,2020-09,3785.53,7487.69,903.15,6978.73,-9777.74,-38808.44
2185640567566135552,2020-10,4452.59,6002.58,5624.76,8346.73,-4271.96,-43080.4
2185640567566135552,2020-11,2743,4285.5,4873.5,5069.83,-1738.83,-44819.23
2185640567566135552,2020-12,361.58,1145.41,6257.42,6721.13,-1247.54,-46066.77
2186953013504682496,2020-01,0,4935.47,3928.96,0,-1006.51,-1006.51
2186953013504682496,2020-02,583.46,3456.48,0,1638.3,-4511.32,-5517.83
2186953013504682496,2020-03,1412.5,3447.54,3400.55,3534.65,-2169.14,-7686.97
2186953013504682496,2020-04,1390.57,2078.32,625.8,1384.44,-1446.39,-9133.36
2186953013504682496,2020-05,2068.08,3115.06,123.95,2573.18,-3496.21,-12629.57
2186953013504682496,2020-06,1319.94,1652.64,7181.85,1071.05,5778.1,-6851.47
2186953013504682496,2020-07,5118.44,4744.23,3476.16,1859.67,1990.7,-4860.77
2186953013504682496,2020-08,937.08,3606.44,2719.61,4287.15,-4236.9,-9097.67
2186953013504682496,2020-09,450.21,3490.12,1636.58,1488.22,-2891.55,-11989.22
2186953013504682496,2020-10,1213.08,0,3354.39,2995.12,1572.35,-10416.87
2186953013504682496,2020-11,2442.92,3928.9,2263.36,1394.81,-617.43,-11034.3
2186953013504682496,2020-12,1613.14,5081.1,3368.6,3419.99,-3519.35,-14553.65
2187549617400688384,2020-01,5092.35,2837.37,4538.76,1630.51,5163.23,5163.23
2187549617400688384,2020-02,5444.44,1293.47,5003.74,5481.18,3673.53,8836.76
2187549617400688384,2020-03,3046.2,5728.58,4233.4,4354.77,-2803.75,6033.01
2187549617400688384,2020-04,5488.73,2543.37,5429.51,3606.02,4768.85,10801.86
2187549617400688384,2020-05,3690.6,5696.37,1823.76,1708.19,-1890.2,8911.66
2187549617400688384,2020-06,6091.81,9008.91,5181.94,5842.04,-3577.2,5334.46
2187549617400688384,2020-07,8319.66,4287.49,5022.62,5571.54,3483.25,8817.71
2187549617400688384,2020-08,5198.41,4468.61,15579.65,4245.94,12063.51,20881.22
2187549617400688384,2020-09,0,6402.33,2890.48,5496.67,-9008.52,11872.7
2187549617400688384,2020-10,712.12,4912.06,1091.41,1734.4,-4842.93,7029.77
2187549617400688384,2020-11,7482.61,5295.87,7134.76,6385.76,2935.74,9965.51
2187549617400688384,2020-12,1811.99,6805.33,4147.13,9821.53,-10667.74,-702.23
2188125365811570944,2020-02,3012.31,0,0,0,3012.31,3012.31
2188125365811570944,2020-03,709.33,0,0,0,709.33,3721.64
2188125365811570944,2020-05,0,1159.64,0,0,-1159.64,2562
2188125365811570944,2020-09,1183.38,0,0,0,1183.38,3745.38
2188125365811570944,2020-12,1038.92,0,0,0,1038.92,4784.3
2190932626756097792,2020-01,736.62,3645.97,5717.07,0,2807.72,2807.72
2190932626756097792,2020-02,4544.76,2109.14,266.2,0,2701.82,5509.54
2190932626756097792,2020-03,1964.35,3572.82,1650.04,908.07,-866.5,4643.04
2190932626756097792,2020-04,2030.4,3282.42,56.02,1260.97,-2456.97,2186.07
2190932626756097792,2020-05,0,9208.51,3511.72,4480.13,-10176.92,-7990.85
2190932626756097792,2020-06,3652.56,639.92,1743.5,3430.21,1325.93,-6664.92
2190932626756097792,2020-07,502.99,2677.05,5300.78,4967.5,-1840.78,-8505.7
2190932626756097792,2020-08,916.54,2738.99,1213.1,132.81,-742.16,-9247.86
2190932626756097792,2020-09,3323.02,937.87,0,5276.41,-2891.26,-12139.12
2190932626756097792,2020-10,2088.86,3060.99,2063.79,518.18,573.48,-11565.64
2190932626756097792,2020-11,2092.13,0,842.16,3689.2,-754.91,-12320.55
2190932626756097792,2020-12,0,1317.07,0,1611.29,-2928.36,-15248.91
2191876245432339200,2020-01,1370.96,1596.27,1270.34,2633.53,-1588.5,-1588.5
2191876245432339200,2020-02,1781.11,1082.55,0,477.44,221.12,-1367.38
2191876245432339200,2020-03,1743.92,3845.61,1379.81,2047.8,-2769.68,-4137.06
2191876245432339200,2020-04,2098.51,1166.64,481.24,3630.95,-2217.84,-6354.9
2191876245432339200,2020-05,2874,1442.6,502.53,1994.94,-61.01,-6415.91
2191876245432339200,2020-06,0,420.39,1895.53,4966.6,-3491.46,-9907.37
2191876245432339200,2020-07,0,1653.86,948.44,1966.7,-2672.12,-12579.49
2191876245432339200,2020-08,1100.59,0,885.3,2910.76,-924.87,-13504.36
2191876245432339200,2020-09,0,1050.53,0,1178.45,-2228.98,-15733.34
2191876245432339200,2020-10,516.2,0,657.87,1320.4,-146.33,-15879.67
2191876245432339200,2020-11,446.07,1358,0,0,-911.93,-16791.6
2191876245432339200,2020-12,1668.79,1534.67,1075.23,1781.36,-572.01,-17363.61
2192603448602833664,2020-02,4606.61,473.03,1360.95,1022.46,4472.07,4472.07
2192603448602833664,2020-03,0,307.71,0,1121.06,-1428.77,3043.3
2192603448602833664,2020-04,1092.62,102.92,0,3751.8,-2762.1,281.2
2192603448602833664,2020-05,2367.01,0,0,2248.45,118.56,399.76
2192603448602833664,2020-07,1306.44,0,2627.57,0,3934.01,4333.77
2192603448602833664,2020-08,1582.61,1837.88,1108.21,0,852.94,5186.71
2192603448602833664,2020-09,0,1849.36,0,1834.44,-3683.8,1502.91
2192603448602833664,2020-10,1052.94,4367.95,71.99,0,-3243.02,-1740.11
2192603448602833664,2020-11,2420.33,0,0,1984.59,435.74,-1304.37
2192603448602833664,2020-12,3379.83,5994.12,1866.66,643.5,-1391.13,-2695.5
2193902919187585536,2020-01,3318.76,6334.75,1335.46,0,-1680.53,-1680.53
2193902919187585536,2020-02,6762.98,4151.94,3569.82,1713.17,4467.69,2787.16
2193902919187585536,2020-03,2108.64,4343.43,602.08,1069.62,-2702.33,84.83
2193902919187585536,2020-04,3354.82,1237.52,965.22,1946,1136.52,1221.35
2193902919187585536,2020-05,8479.73,0,1676.62,2231.39,7924.96,9146.31
2193902919187585536,2020-06,4203.23,251.3,1240.15,2928.11,2263.97,11410.28
2193902919187585536,2020-07,2240.1,0,0,2711.44,-471.34,10938.94
2193902919187585536,2020-08,4282.16,2993.84,3552.92,2032.83,2808.41,13747.35
2193902919187585536,2020-09,1893.44,3760.23,2290.88,942.4,-518.31,13229.04
2193902919187585536,2020-10,3687.74,587.9,0,771.21,2328.63,15557.67
2193902919187585536,2020-11,2478.75,3279.01,1037.82,1886.96,-1649.4,13908.27
2193902919187585536,2020-12,2561.36,3118.6,3998.35,1573.28,1867.83,15776.1
2194399052145590272,2020-01,7124.52,4297.66,7313.06,7102.56,3037.36,3037.36
2194399052145590272,2020-02,2271.27,3738.36,6746.15,4904.99,374.07,3411.43
2194399052145590272,2020-03,8528.09,3123.86,4253.81,2877.38,6780.66,10192.09
2194399052145590272,2020-04,6138.15,2380.43,449.34,3116.84,1090.22,11282.31
2194399052145590272,2020-05,2327.08,2474.1,1731.66,1794.97,-210.33,11071.98
2194399052145590272,2020-06,1962.73,7054.47,4353.9,4563.37,-5301.21,5770.77
2194399052145590272,2020-07,5684.54,3119.95,3608.44,2129.97,4043.06,9813.83
2194399052145590272,2020-08,4452.46,6164.89,7866.88,3777.74,2376.71,12190.54
2194399052145590272,2020-09,5871.17,2263.74,5632.76,6796,2444.19,14634.73
2194399052145590272,2020-10,3095.85,6746.02,9718,2094.39,3973.44,18608.17
2194399052145590272,2020-11,3136.18,2446.67,832.91,1739.13,-216.71,18391.46
2194399052145590272,2020-12,3214.06,4882.87,4545.46,6143.08,-3266.43,15125.03
2194694022297316608,2020-01,1298.15,2958.32,1945.35,412.64,-127.46,-127.46
2194694022297316608,2020-02,864.81,586.88,654.72,0,932.65,805.19
2194694022297316608,2020-03,509.38,2738.87,0,3600.99,-5830.48,-5025.29
2194694022297316608,2020-04,5842.12,0,5029.99,1079.58,9792.53,4767.24
2194694022297316608,2020-05,2672.93,0,0,0,2672.93,7440.17
2194694022297316608,2020-06,1675.48,131.35,1767.81,2224.29,1087.65,8527.82
2194694022297316608,2020-07,1159.48,1112.39,5150.93,43.22,5154.8,13682.62
2194694022297316608,2020-08,554.39,4530.57,0,591.96,-4568.14,9114.48
2194694022297316608,2020-09,3824.9,3907.95,3500.51,1593.6,1823.86,10938.34
2194694022297316608,2020-10,0,1110.03,183.57,3123.08,-4049.54,6888.8
2194694022297316608,2020-11,2566.22,1749.19,6974.38,3532.9,4258.51,11147.31
2194694022297316608,2020-12,1147.98,0,4880.72,3865.22,2163.48,13310.79
2195390154486733824,2020-01,630.44,1014.6,0,0,-384.16,-384.16
2195390154486733824,2020-02,0,819.27,205.21,243.49,-857.55,-1241.71
2195390154486733824,2020-04,0,1949.64,2240.46,0,290.82,-950.89
2195390154486733824,2020-05,0,1368.1,0,0,-1368.1,-2318.99
2195390154486733824,2020-07,1330.64,0,971.47,0,2302.11,-16.88
2195390154486733824,2020-08,0,3553.6,2457.74,453.07,-1548.93,-1565.81
2195390154486733824,2020-09,0,1718.59,1049.49,0,-669.1,-2234.91
2195390154486733824,2020-11,1391.78,802.42,0,0,589.36,-1645.55
2195390154486733824,2020-12,1685.74,132,746.91,1935.5,365.15,-1280.4
2196960646110952192,2020-01,6955.32,3178.33,2953.16,5387.53,1342.62,1342.62
2196960646110952192,2020-02,1850.17,5978.25,8499.32,6019.19,-1647.95,-305.33
2196960646110952192,2020-03,7464.77,9803.84,7740.93,5058.45,343.41,38.08
2196960646110952192,2020-04,4540.92,4384.09,912.93,1988.88,-919.12,-881.04
2196960646110952192,2020-05,4940.73,4016.73,7273.35,3426.47,4770.88,3889.84
2196960646110952192,2020-06,2597.57,7709.35,6397.68,6180.62,-4894.72,-1004.88
2196960646110952192,2020-07,1680.98,5398.91,623,5155.62,-8250.55,-9255.43
2196960646110952192,2020-08,4974.18,5767.48,1140.05,7294.38,-6947.63,-16203.06
2196960646110952192,2020-09,4796.43,12028.89,8286.81,3922.52,-2868.17,-19071.23
2196960646110952192,2020-10,4348.65,3036.82,262.85,3929.56,-2354.88,-21426.11
2196960646110952192,2020-11,3577.28,6143.52,5255.04,7370.27,-4681.47,-26107.58
2196960646110952192,2020-12,7884.46,851.98,5950.39,6399.2,6583.67,-19523.91
2197908630617576192,2020-01,1784.18,333.97,3192.41,1855.55,2787.07,2787.07
2197908630617576192,2020-02,2276.11,98.56,0,2449.88,-272.33,2514.74
2197908630617576192,2020-03,147.17,4890.87,491.85,1425.39,-5677.24,-3162.5
2197908630617576192,2020-04,0,1895.47,4135.72,336.29,1903.96,-1258.54
2197908630617576192,2020-05,6897.82,3081.05,4352.45,3614.97,4554.25,3295.71
2197908630617576192,2020-06,3596.11,3248.22,3275.56,1129.81,2493.64,5789.35
2197908630617576192,2020-07,4266.44,3380.72,5873.16,1440.55,5318.33,11107.68
2197908630617576192,2020-08,4764.44,4020.06,3756.87,1960.44,2540.81,13648.49
2197908630617576192,2020-09,1795.23,2306.16,7275.03,3133.11,3630.99,17279.48
2197908630617576192,2020-10,1696.67,7902.25,3823.02,0,-2382.56,14896.92
2197908630617576192,2020-11,4966.45,2445.36,1425.35,12.11,3934.33,18831.25
2197908630617576192,2020-12,3403.13,4918.34,4128.79,4036.32,-1422.74,17408.51
2198320815224209408,2020-01,0,961.07,3155.95,2503.8,-308.92,-308.92
2198320815224209408,2020-02,2110.58,3312.11,0,160.34,-1361.87,-1670.79
2198320815224209408,2020-04,1518.73,1945.61,2038.93,2755.96,-1143.91,-2814.7
2198320815224209408,2020-05,840.5,0,0,1222.65,-382.15,-3196.85
2198320815224209408,2020-06,636.35,375.72,0,0,260.63,-2936.22
2198320815224209408,2020-07,2742.95,0,0,1673.22,1069.73,-1866.49
2198320815224209408,2020-08,3045.92,2074.38,665.08,3374.74,-1738.12,-3604.61
2198320815224209408,2020-09,4428.09,3485.75,2004.13,0,2946.47,-658.14
2198320815224209408,2020-10,1647.91,2718.44,3294.06,0,2223.53,1565.39
2198320815224209408,2020-11,194.87,0,1982.86,2410.28,-232.55,1332.84
2198320815224209408,2020-12,424.83,630.05,2356.45,2240.34,-89.11,1243.73
2198729099913593088,2020-01,1163.99,0,1063.83,0,2227.82,2227.82
2198729099913593088,2020-02,2551.29,802.12,236.57,2639.05,-653.31,1574.51
2198729099913593088,2020-03,1885.72,0,0,2262.86,-377.14,1197.37
2198729099913593088,2020-04,1844.37,0,2627.12,0,4471.49,5668.86
2198729099913593088,2020-05,283.4,398.11,0,0,-114.71,5554.15
2198729099913593088,2020-06,2308.68,0,0,1982.07,326.61,5880.76
2198729099913593088,2020-07,1402.88,0,281.44,862.64,821.68,6702.44
2198729099913593088,2020-08,0,2419.23,0,0,-2419.23,4283.21
2198729099913593088,2020-09,0,393.71,1347.74,3112.61,-2158.58,2124.63
2198729099913593088,2020-10,1024,819.43,883.95,1124.58,-36.06,2088.57
2198729099913593088,2020-11,89.72,3489.85,0,1621.37,-5021.5,-2932.93
2198729099913593088,2020-12,0,1710.6,1325.83,0,-384.77,-3317.7
2199991586227031040,2020-01,1642.84,1021.43,0,0,621.41,621.41
2199991586227031040,2020-02,1829.6,0,0,504.52,1325.08,1946.49
2199991586227031040,2020-04,470.18,910.61,0,3131.16,-3571.59,-1625.1
2199991586227031040,2020-05,0,3129.29,0,0,-3129.29,-4754.39
2199991586227031040,2020-06,4001.11,2808.15,1280.27,0,2473.23,-2281.16
2199991586227031040,2020-07,1332.25,0,0,0,1332.25,-948.91
2199991586227031040,2020-08,0,1245.46,1452.79,0,207.33,-741.58
2199991586227031040,2020-09,2333.19,3471.37,0,0,-1138.18,-1879.76
2199991586227031040,2020-10,1068.41,557.05,1450.24,14.11,1947.49,67.73
2199991586227031040,2020-11,1008.39,0,362.86,0,1371.25,1438.98
2199991586227031040,2020-12,2489.39,2598.94,874.9,0,765.35,2204.33
2200221800078021120,2020-01,1218.29,1980.32,3802.81,0,3040.78,3040.78
2200221800078021120,2020-02,0,3173.72,1630.17,507.85,-2051.4,989.38
2200221800078021120,2020-03,903.54,0,0,548.25,355.29,1344.67
2200221800078021120,2020-05,3077.96,0,1798.86,1021.27,3855.55,5200.22
2200221800078021120,2020-06,910.39,0,0,0,910.39,6110.61
2200221800078021120,2020-07,0,1804.68,552.38,0,-1252.3,4858.31
2200221800078021120,2020-08,0,1321.36,3275.44,789.95,1164.13,6022.44
2200221800078021120,2020-09,1599.21,2718.05,17.55,0,-1101.29,4921.15
2200221800078021120,2020-10,1127.54,0,0,1423.19,-295.65,4625.5
2200221800078021120,2020-11,959.61,0,212.18,1195.65,-23.86,4601.64
2200221800078021120,2020-12,231.67,0,652.47,1497.09,-612.95,3988.69
2200674110408597248,2020-01,1956.59,1351.98,2923.53,970.28,2557.86,2557.86
2200674110408597248,2020-03,0,1310.02,76.47,2000.75,-3234.3,-676.44
2200674110408597248,2020-04,1124.89,0,2099.66,0,3224.55,2548.11
2200674110408597248,2020-05,0,130.28,1506.71,1857.22,-480.79,2067.32
2200674110408597248,2020-06,1074.03,1144.53,0,1246.3,-1316.8,750.52
2200674110408597248,2020-07,1316.49,781.63,1935.19,1244.26,1225.79,1976.31
2200674110408597248,2020-08,0,2584.76,690.99,1064.56,-2958.33,-982.02
2200674110408597248,2020-09,1122.1,0,866.06,2932.65,-944.49,-1926.51
2200674110408597248,2020-10,1719.28,162.63,2620.27,1779.73,2397.19,470.68
2200674110408597248,2020-12,2067.42,1145.51,0,0,921.91,1392.59
2201045501550167040,2020-01,875.4,1215.29,1283.66,0,943.77,943.77
2201045501550167040,2020-02,1523.75,0,1302.24,0,2825.99,3769.76
2201045501550167040,2020-03,1973.28,575.61,0,0,1397.67,5167.43
2201045501550167040,2020-04,3447.93,0,3240.61,973.4,5715.14,10882.57
2201045501550167040,2020-06,3080.85,0,0,1253.63,1827.22,12709.79
2201045501550167040,2020-07,151.74,0,0,0,151.74,12861.53
2201045501550167040,2020-09,0,1922.18,142.22,0,-1779.96,11081.57
2201045501550167040,2020-10,0,1752.63,0,0,-1752.63,9328.94
2201045501550167040,2020-11,228,0,0,0,228,9556.94
2201045501550167040,2020-12,748.2,0,0,105.23,642.97,10199.91
2202638589575794944,2020-01,711.72,2632.07,6383.28,9343.33,-4880.4,-4880.4
2202638589575794944,2020-02,3767.06,11010.5,4800.13,5140.27,-7583.58,-12463.98
2202638589575794944,2020-03,4081.13,6969.54,5657.8,5848.46,-3079.07,-15543.05
2202638589575794944,2020-04,10874.85,6181.67,4881.64,1961.19,7613.63,-7929.42
2202638589575794944,2020-05,1118.23,2188.46,2365.25,5491.9,-4196.88,-12126.3
2202638589575794944,2020-06,6465.54,4734.61,4382.68,3706.75,2406.86,-9719.44
2202638589575794944,2020-07,6935.32,3367.62,2777.63,2867.69,3477.64,-6241.8
2202638589575794944,2020-08,9356.27,4266.85,5184.95,4810.88,5463.49,-778.31
2202638589575794944,2020-09,4182.71,7749.81,1925.52,1417.49,-3059.07,-3837.38
2202638589575794944,2020-10,6525.71,0,4814.17,10361.89,977.99,-2859.39
2202638589575794944,2020-11,3445.37,3243.38,5865.48,5783.19,284.28,-2575.11
2202638589575794944,2020-12,8427.88,6811.57,5102.14,5210.73,1507.72,-1067.39
2203479485731741696,2020-01,8546.9,9704.21,5237.92,2435.62,1644.99,1644.99
2203479485731741696,2020-02,6763.24,5046.74,3199.72,2840.77,2075.45,3720.44
2203479485731741696,2020-03,4173.15,2963.89,4443.67,4316.56,1336.37,5056.81
2203479485731741696,2020-04,4341.2,1603.41,3265.28,2271.98,3731.09,8787.9
2203479485731741696,2020-05,4158.2,1334.66,6983.46,982.27,8824.73,17612.63
2203479485731741696,2020-06,0,5587.17,4391.82,4177.09,-5372.44,12240.19
2203479485731741696,2020-07,0,4214.4,4862.83,7227.04,-6578.61,5661.58
2203479485731741696,2020-08,4302.29,1762.53,4594.42,4495.98,2638.2,8299.78
2203479485731741696,2020-09,1919,7783.91,4988.59,872.5,-1748.82,6550.96
2203479485731741696,2020-10,4203.86,2367.99,6460.83,4502.24,3794.46,10345.42
2203479485731741696,2020-11,2193.42,3915.99,2585.85,289.61,573.67,10919.09
2203479485731741696,2020-12,1342.99,5268,1755.52,3480.48,-5649.97,5269.12
2204532748493270272,2020-01,4968.9,3062.22,1455.7,1735.21,1627.17,1627.17
2204532748493270272,2020-02,424.88,0,1018.97,4691.38,-3247.53,-1620.36
2204532748493270272,2020-03,6023.96,4220.38,768.95,4019.4,-1446.87,-3067.23
2204532748493270272,2020-04,6811.47,5587.54,4317.64,0,5541.57,2474.34
2204532748493270272,2020-05,2564.62,2908.51,5192.22,2625.18,2223.15,4697.49
2204532748493270272,2020-06,1433.04,87.16,388.34,6231.56,-4497.34,200.15
2204532748493270272,2020-07,3779.2,7171.45,2526.09,1558.61,-2424.77,-2224.62
2204532748493270272,2020-08,1744.92,2019.02,875.11,2876,-2274.99,-4499.61
2204532748493270272,2020-09,3047.58,3273.46,2899.58,916.43,1757.27,-2742.34
2204532748493270272,2020-10,6728.06,0,7159.87,45.15,13842.78,11100.44
2204532748493270272,2020-11,3394.33,2323.63,611.86,2848.29,-1165.73,9934.71
2204532748493270272,2020-12,744.61,7097.68,3465.17,941.11,-3829.01,6105.7
2206151069675144192,2020-01,4253.24,3897.81,2910.64,3398.18,-132.11,-132.11
2206151069675144192,2020-02,8004.95,4353.56,1626.1,5855.46,-577.97,-710.08
2206151069675144192,2020-03,3963.67,1463.48,2057.8,2435.12,2122.87,1412.79
2206151069675144192,2020-04,4970.41,2111.3,7373.49,5124.97,5107.63,6520.42
2206151069675144192,2020-05,4605.58,8471.5,5592.68,4015.08,-2288.32,4232.1
2206151069675144192,2020-06,5222.55,4488.88,7056.05,328.32,7461.4,11693.5
2206151069675144192,2020-07,5276.12,2096.02,5424.46,2941.31,5663.25,17356.75
2206151069675144192,2020-08,3752.82,5863.7,5789.9,5154.22,-1475.2,15881.55
2206151069675144192,2020-09,5550.02,2453.47,2198.2,1547.93,3746.82,19628.37
2206151069675144192,2020-10,8702.77,3931.94,0,2768.78,2002.05,21630.42
2206151069675144192,2020-11,2905.49,5378.56,2302.62,5723.78,-5894.23,15736.19
2206151069675144192,2020-12,7882.65,3683.7,5414.52,2413.87,7199.6,22935.79
2206566510438400256,2020-01,4943.7,826.47,2293.91,0,6411.14,6411.14
2206566510438400256,2020-02,228.13,0,0,328.78,-100.65,6310.49
2206566510438400256,2020-04,1979.4,0,0,0,1979.4,8289.89
2206566510438400256,2020-06,3683.28,0,62.91,0,3746.19,12036.08
2206566510438400256,2020-07,3817.05,0,0,603.54,3213.51,15249.59
2206566510438400256,2020-08,0,925.67,0,0,-925.67,14323.92
2206566510438400256,2020-09,1064.79,1237.76,877.34,0,704.37,15028.29
2206566510438400256,2020-10,2290.56,3065.12,681.43,867.51,-960.64,14067.65
2207020235492051968,2020-01,1949.96,550.72,2911.16,0,4310.4,4310.4
2207020235492051968,2020-02,7266.65,496.37,1018.02,772.23,7016.07,11326.47
2207020235492051968,2020-03,4295.41,3666.43,2920.46,0,3549.44,14875.91
2207020235492051968,2020-04,2720.36,0,3156.44,595.61,5281.19,20157.1
2207020235492051968,2020-05,2851.47,1305.56,0,536.22,1009.69,21166.79
2207020235492051968,2020-06,7150.57,0,3997.78,889.24,10259.11,31425.9
2207020235492051968,2020-08,0,5466.33,1438.02,2880.72,-6909.03,24516.87
2207020235492051968,2020-09,2498.47,299.1,3580.02,2364.97,3414.42,27931.29
2207020235492051968,2020-10,0,2010.55,5823.38,3589.8,223.03,28154.32
2207020235492051968,2020-11,1559.35,167.26,1695.14,1538.44,1548.79,29703.11
2207020235492051968,2020-12,4708.25,229.53,317.06,0,4795.78,34498.89
2208136940070074624,2020-01,132.57,1877.22,3743.75,1592.2,406.9,406.9
2208136940070074624,2020-03,784.94,0,0,3369.62,-2584.68,-2177.78
2208136940070074624,2020-04,3612.72,1834.8,1026.29,2510.24,293.97,-1883.81
2208136940070074624,2020-05,409.31,2639.72,339.81,0,-1890.6,-3774.41
2208136940070074624,2020-06,292.75,1076.62,1932.27,0,1148.4,-2626.01
2208136940070074624,2020-07,2275.64,1058.43,0,0,1217.21,-1408.8
2208136940070074624,2020-08,1334,1465.84,1672.04,3902.89,-2362.69,-3771.49
2208136940070074624,2020-09,2267.25,3312.36,2940.82,998.06,897.65,-2873.84
2208136940070074624,2020-10,1362.05,549.15,905.84,0,1718.74,-1155.1
2208136940070074624,2020-11,659.13,0,0,1489.06,-829.93,-1985.03
2208136940070074624,2020-12,4391.86,1994.91,1616.63,2072.1,1941.48,-43.55
2209295257158338048,2020-05,1778.27,0,1861.38,0,3639.65,3639.65
2209295257158338048,2020-06,1277.11,0,0,0,1277.11,4916.76
2209295257158338048,2020-08,637.58,0,1949.55,0,2587.13,7503.89
2210751711588044288,2020-01,1305.18,4245.69,1792.06,6919.41,-8067.86,-8067.86
2210751711588044288,2020-02,8820.96,4262.44,2975.78,902.1,6632.2,-1435.66
2210751711588044288,2020-03,2200.64,3748.58,5215.39,705.4,2962.05,1526.39
2210751711588044288,2020-04,3604.55,1621.32,1920.02,4007.04,-103.79,1422.6
2210751711588044288,2020-05,6978.77,6005.72,1424.82,325.25,2072.62,3495.22
2210751711588044288,2020-06,2837.28,2882.75,2280.04,6437.41,-4202.84,-707.62
2210751711588044288,2020-07,2836.13,7264.86,8545.25,778.42,3338.1,2630.48
2210751711588044288,2020-08,1752.79,10259.35,3937.73,5039.86,-9608.69,-6978.21
2210751711588044288,2020-09,4830.33,599.25,4645.43,8017.74,858.77,-6119.44
2210751711588044288,2020-10,3000.06,1110.41,8962.75,2643.48,8208.92,2089.48
2210751711588044288,2020-11,236.62,8246.11,9574.23,5166.71,-3601.97,-1512.49
2210751711588044288,2020-12,5769.22,6828.48,3340.41,2817.52,-536.37,-2048.86
2210849036922171136,2020-01,1683.72,0,0,0,1683.72,1683.72
2210849036922171136,2020-03,1621.39,0,0,0,1621.39,3305.11
2210849036922171136,2020-12,1841.92,1086.88,0,0,755.04,4060.15
2212853929898049280,2020-01,5190.37,5757.3,3919.65,3437.49,-84.77,-84.77
2212853929898049280,2020-02,2768.24,2977.01,2478.59,4428.36,-2158.54,-2243.31
2212853929898049280,2020-03,5305.37,1540.62,6290.79,6191.19,3864.35,1621.04
2212853929898049280,2020-04,2267.45,4706.4,5367.99,2114.08,814.96,2436
2212853929898049280,2020-05,3771.2,5409.59,503.34,4045.4,-5180.45,-2744.45
2212853929898049280,2020-06,837.33,2948.92,3468.77,5382.88,-4025.7,-6770.15
2212853929898049280,2020-07,1832.44,8470.2,6564.86,101.08,-173.98,-6944.13
2212853929898049280,2020-08,6663.73,7148.34,3508.69,2087.27,936.81,-6007.32
2212853929898049280,2020-09,3214.77,5916.92,3659.24,4765.64,-3808.55,-9815.87
2212853929898049280,2020-10,5807.8,6314.46,1923.89,4423.25,-3006.02,-12821.89
2212853929898049280,2020-11,6781.97,6826.19,7156.6,2574.44,4537.94,-8283.95
2212853929898049280,2020-12,5592.24,3982.07,6113.84,6800.32,923.69,-7360.26
2213562073001345536,2020-02,1805.02,1176.54,6429.74,1688.13,5370.09,5370.09
2213562073001345536,2020-03,0,1526.48,4358.12,896.35,1935.29,7305.38
2213562073001345536,2020-04,5479.92,2942.29,1601.93,3819.49,320.07,7625.45
2213562073001345536,2020-05,514.79,929.27,1093.3,5303.91,-4625.09,3000.36
2213562073001345536,2020-06,636.53,3825.05,4967.45,476.22,1302.71,4303.07
2213562073001345536,2020-07,2401.8,0,969.48,1621.86,1749.42,6052.49
2213562073001345536,2020-08,939.21,4227.75,2224.5,360.98,-1425.02,4627.47
2213562073001345536,2020-09,3921.15,384.29,1357.13,803.17,4090.82,8718.29
2213562073001345536,2020-10,547.81,1361.24,2250.67,1961.32,-524.08,8194.21
2213562073001345536,2020-11,0,536.22,3190.59,0,2654.37,10848.58
2213562073001345536,2020-12,102.44,2057.67,0,1856.46,-3811.69,7036.89
2214434589992021248,2020-02,551.08,363.03,1586.33,0,1774.38,1774.38
2214434589992021248,2020-03,3587.43,0,3543.63,0,7131.06,8905.44
2214434589992021248,2020-04,852.23,2790.15,0,1352.17,-3290.09,5615.35
2214434589992021248,2020-05,908.7,0,1815.88,0,2724.58,8339.93
2214434589992021248,2020-06,2101.02,0,958.04,1743.77,1315.29,9655.22
2214434589992021248,2020-07,1133.88,115.67,3242.33,0,4260.54,13915.76
2214434589992021248,2020-08,569.16,4713.21,0,0,-4144.05,9771.71
2214434589992021248,2020-09,1686.07,728.12,838.94,132.05,1664.84,11436.55
2214434589992021248,2020-10,0,1721.05,994.86,1992.9,-2719.09,8717.46
2214434589992021248,2020-11,1121.23,2723.28,719.93,0,-882.12,7835.34
2214434589992021248,2020-12,3358.51,0,2838.6,0,6197.11,14032.45
2214613405832631040,2020-01,1686.95,2475,723.56,1198.81,-1263.3,-1263.3
2214613405832631040,2020-02,5729.77,824.6,3562.42,3932.34,4535.25,3271.95
2214613405832631040,2020-03,1049.28,5864.41,813.95,0,-4001.18,-729.23
2214613405832631040,2020-04,2683.66,3603.47,0,0,-919.81,-1649.04
2214613405832631040,2020-05,1489.06,2219.46,1122.46,1685.83,-1293.77,-2942.81
2214613405832631040,2020-06,378.6,2027.29,1744.27,2707.25,-2611.67,-5554.48
2214613405832631040,2020-07,3171.99,1660.43,6671.09,1484.09,6698.56,1144.08
2214613405832631040,2020-08,2063.17,1730.65,1135.41,2992.69,-1524.76,-380.68
2214613405832631040,2020-09,1270.05,0,0,830.46,439.59,58.91
2214613405832631040,2020-10,0,1618.76,775.85,0,-842.91,-784
2214613405832631040,2020-11,1278.56,1819.58,1212.78,3861.63,-3189.87,-3973.87
2214613405832631040,2020-12,2291.16,3454.82,73.55,4194.63,-5284.74,-9258.61
2218206367459557120,2020-01,1115.9,3287.71,5038.24,7785.46,-4919.03,-4919.03
2218206367459557120,2020-02,3262.89,4519.19,3360.22,3510.08,-1406.16,-6325.19
2218206367459557120,2020-03,942.92,1782.59,410.78,1318.82,-1747.71,-8072.9
2218206367459557120,2020-04,4423.51,5876.27,3111.62,2578.39,-919.53,-8992.43
2218206367459557120,2020-05,774.9,4812.62,3324.01,6079.26,-6792.97,-15785.4
2218206367459557120,2020-06,1315.84,1797.1,552.77,1026.17,-954.66,-16740.06
2218206367459557120,2020-07,379.83,5549.02,2505.02,5710.68,-8374.85,-25114.91
2218206367459557120,2020-08,5004.52,4488.13,1047.67,1876.05,-311.99,-25426.9
2218206367459557120,2020-09,8133.38,0,3392.64,0,11526.02,-13900.88
2218206367459557120,2020-10,1505.59,2096.21,2852.63,3239.72,-977.71,-14878.59
2218206367459557120,2020-11,429.02,2844.21,607.78,2202.2,-4009.61,-18888.2
2218206367459557120,2020-12,2261.95,2893.36,236.79,1189.27,-1583.89,-20472.09
2219018645804484096,2020-03,1727.39,0,971.61,0,2699,2699
2219018645804484096,2020-05,0,1385.85,1530.4,0,144.55,2843.55
2219018645804484096,2020-06,476.85,1218.46,479.94,0,-261.67,2581.88
2219018645804484096,2020-08,0,1631.23,456.19,9.8,-1184.84,1397.04
2219018645804484096,2020-10,0,676.62,0,146.77,-823.39,573.65
2220547240425455104,2020-01,1325.65,0,1537.19,0,2862.84,2862.84
2220547240425455104,2020-02,1564.24,1169.47,0,84.8,309.97,3172.81
2220547240425455104,2020-07,2185.18,0,0,2952.61,-767.43,2405.38
2220547240425455104,2020-08,0,3576.38,0,0,-3576.38,-1171
2220547240425455104,2020-09,0,1905.42,1012.41,921.36,-1814.37,-2985.37
2220547240425455104,2020-11,934.85,3733.27,0,853.74,-3652.16,-6637.53
2222306161546634752,2020-01,1930.32,1941.62,5444.03,2784.31,2648.42,2648.42
2222306161546634752,2020-02,1596.6,1751.86,3947.82,809.74,2982.82,5631.24
2222306161546634752,2020-03,2603.3,2219.71,519.02,4023.48,-3120.87,2510.37
2222306161546634752,2020-04,8586.09,5026.85,3287.6,1232.48,5614.36,8124.73
2222306161546634752,2020-05,3616.34,3501.27,2075.09,1727.01,463.15,8587.88
2222306161546634752,2020-06,3328.24,1223.8,0,1842.27,262.17,8850.05
2222306161546634752,2020-07,3108.98,2766.54,387.5,6852.82,-6122.88,2727.17
2222306161546634752,2020-08,3293.71,3018.83,6489.45,6457.29,307.04,3034.21
2222306161546634752,2020-09,2176.77,1985.03,5113.91,3260.35,2045.3,5079.51
2222306161546634752,2020-10,2548.19,2901.23,512.76,4948.24,-4788.52,290.99
2222306161546634752,2020-11,7929.35,2691.7,5970.02,5206.04,6001.63,6292.62
2222306161546634752,2020-12,6613.77,6679.06,4439.65,3208.5,1165.86,7458.48
2225604430892188160,2020-01,1481.07,2306.37,1030.59,0,205.29,205.29
2225604430892188160,2020-03,0,2761.06,0,0,-2761.06,-2555.77
2225604430892188160,2020-04,2030.36,0,0,1697.38,332.98,-2222.79
2225604430892188160,2020-05,1323.47,3346.5,2739.09,0,716.06,-1506.73
2225604430892188160,2020-07,1640.78,1595.87,2337.83,0,2382.74,876.01
2225604430892188160,2020-08,1032.13,3706.41,2218.38,1725.9,-2181.8,-1305.79
2225604430892188160,2020-09,1409.85,2684.92,3517.96,1629.34,613.55,-692.24
2225604430892188160,2020-10,0,1874.64,666.07,1046.73,-2255.3,-2947.54
2225604430892188160,2020-11,1436.07,1985.32,0,3035.47,-3584.72,-6532.26
2225604430892188160,2020-12,65.83,0,1806.27,2216.15,-344.05,-6876.31
2226161073209697024,2020-01,3668.95,2817.66,6648.21,4856.12,2643.38,2643.38
2226161073209697024,2020-02,1560.86,4726.31,5265.6,0,2100.15,4743.53
2226161073209697024,2020-03,5102.35,2074.57,1403.38,825.89,3605.27,8348.8
2226161073209697024,2020-04,2264.03,5326.11,3637.06,5600.18,-5025.2,3323.6
2226161073209697024,2020-05,1389.54,3821.9,3310.93,1273.73,-395.16,2928.44
2226161073209697024,2020-06,3342.86,6482.86,454.79,0,-2685.21,243.23
2226161073209697024,2020-07,4510.54,6084.17,3919.37,5326.1,-2980.36,-2737.13
2226161073209697024,2020-08,1351.13,4605.95,6051.62,3724.6,-927.8,-3664.93
2226161073209697024,2020-09,1850.24,8737.87,2440.64,4295.3,-8742.29,-12407.22
2226161073209697024,2020-10,8323.84,2120.26,6411.63,2307.67,10307.54,-2099.68
2226161073209697024,2020-11,0,716.59,4076.49,3517.53,-157.63,-2257.31
2226161073209697024,2020-12,2476.53,4189.86,4237.06,1311.33,1212.4,-1044.91
2226491652616480000,2020-01,5075.32,177.03,1105.31,4947.29,1056.31,1056.31
2226491652616480000,2020-02,1870.33,3711.26,3331.57,4873.19,-3382.55,-2326.24
2226491652616480000,2020-03,12260.77,3280.78,6331.35,3911.93,11399.41,9073.17
2226491652616480000,2020-04,5925.8,2133.28,3650.61,8763.25,-1320.12,7753.05
2226491652616480000,2020-05,4007.49,5628.89,1021.3,151.15,-751.25,7001.8
2226491652616480000,2020-06,2351.05,0,9256.53,5767.89,5839.69,12841.49
2226491652616480000,2020-07,486.39,2031.49,3431.52,6198.08,-4311.66,8529.83
2226491652616480000,2020-08,3030.8,1948.09,661.87,4746.72,-3002.14,5527.69
2226491652616480000,2020-09,2414.72,3581.13,6758.59,1551.32,4040.86,9568.55
2226491652616480000,2020-10,77.41,6306.13,2324.05,4859.45,-8764.12,804.43
2226491652616480000,2020-11,6706.09,2145.33,872.96,2262.04,3171.68,3976.11
2226491652616480000,2020-12,2089.52,6680.05,1336.86,4427.09,-7680.76,-3704.65
2226527179820374528,2020-01,5278.97,7966.07,1725.43,2975.81,-3937.48,-3937.48
2226527179820374528,2020-02,9024.95,5916.92,4385.52,0,7493.55,3556.07
2226527179820374528,2020-03,2573.43,2807.92,1562.13,7915.75,-6588.11,-3032.04
2226527179820374528,2020-04,2367.65,1896.42,5225.75,13553.69,-7856.71,-10888.75
2226527179820374528,2020-05,4950.86,4154.27,1202.35,3820.54,-1821.6,-12710.35
2226527179820374528,2020-06,4660.85,6176.02,4405.06,11326.72,-8436.83,-21147.18
2226527179820374528,2020-07,2409.5,5082.59,5404.93,5605.78,-2873.94,-24021.12
2226527179820374528,2020-08,2847.19,3802.41,7985.49,4807.04,2223.23,-21797.89
2226527179820374528,2020-09,574.95,2304.2,2887.52,6825.36,-5667.09,-27464.98
2226527179820374528,2020-10,2946.9,6750.03,1873.98,4502.08,-6431.23,-33896.21
2226527179820374528,2020-11,4825.61,1306.89,5703.28,3280.81,5941.19,-27955.02
2226527179820374528,2020-12,3790.21,8445.17,4380.12,3250.74,-3525.58,-31480.6
2227588550329193216,2020-01,5163.83,5105.77,3485.84,2005.4,1538.5,1538.5
2227588550329193216,2020-02,2677.55,5957.06,5565.16,4953.2,-2667.55,-1129.05
2227588550329193216,2020-03,153.48,6704.7,3483.82,3580.87,-6648.27,-7777.32
2227588550329193216,2020-04,1438.78,1463.64,3451.8,9574.67,-6147.73,-13925.05
2227588550329193216,2020-05,2604.33,4754.65,7022.22,5018.02,-146.12,-14071.17
2227588550329193216,2020-06,4426.92,1869.52,5778.22,1833.87,6501.75,-7569.42
2227588550329193216,2020-07,7535.57,4594.4,4436.99,6105.73,1272.43,-6296.99
2227588550329193216,2020-08,3751.69,3195.97,1680.82,3475.29,-1238.75,-7535.74
2227588550329193216,2020-09,4708.42,6418.73,2680.65,3081.12,-2110.78,-9646.52
2227588550329193216,2020-10,3649.06,3652.71,6040.31,2985.69,3050.97,-6595.55
2227588550329193216,2020-11,5548.16,6055.67,5579.33,5232.95,-161.13,-6756.68
2227588550329193216,2020-12,6692.68,13096.44,8015.4,2392.79,-781.15,-7537.83
2227879023803067904,2020-01,1136.19,2816.41,2955.24,4999.4,-3724.38,-3724.38
2227879023803067904,2020-02,6452.61,6761.93,2268.46,2483.2,-524.06,-4248.44
2227879023803067904,2020-03,4711.84,1821.25,5627.77,4928.43,3589.93,-658.51
2227879023803067904,2020-04,5326.53,5106.99,6513.47,6216.28,516.73,-141.78
2227879023803067904,2020-05,2163.86,3964.87,2742.04,3746.17,-2805.14,-2946.92
2227879023803067904,2020-06,4628.57,6952.78,4310.04,855.67,1130.16,-1816.76
2227879023803067904,2020-07,556.47,6409.84,2635.21,1556.1,-4774.26,-6591.02
2227879023803067904,2020-08,5120.25,9650.8,1206.1,1269,-4593.45,-11184.47
2227879023803067904,2020-09,7729.86,1222.63,4882.9,3777.39,7612.74,-3571.73
2227879023803067904,2020-10,11770.76,1868.41,5483.2,7714.74,7670.81,4099.08
2227879023803067904,2020-11,5158.87,1736.3,5278.14,5226.28,3474.43,7573.51
2227879023803067904,2020-12,1555.25,4706.16,2187.14,2457.7,-3421.47,4152.04
2228165472441822208,2020-01,4898.6,5951.7,1990.94,8937.97,-8000.13,-8000.13
2228165472441822208,2020-02,4381.88,676.17,2630.17,287.28,6048.6,-1951.53
2228165472441822208,2020-03,1849.2,6913.66,2993.11,2642.01,-4713.36,-6664.89
2228165472441822208,2020-04,7218.08,249.2,3592.07,4193.99,6366.96,-297.93
2228165472441822208,2020-05,0,2664.56,4764.34,3508.46,-1408.68,-1706.61
2228165472441822208,2020-06,8650.42,4332.24,1211.35,3491.86,2037.67,331.06
2228165472441822208,2020-07,6354.88,809.15,2481.43,2316.57,5710.59,6041.65
2228165472441822208,2020-08,5773.25,5054.48,3952.71,2090.03,2581.45,8623.1
2228165472441822208,2020-09,9561.86,4442.82,5349.14,409.12,10059.06,18682.16
2228165472441822208,2020-10,1984.21,5652.32,1272.53,6086.02,-8481.6,10200.56
2228165472441822208,2020-11,2534.09,1465.49,2131.87,5955.27,-2754.8,7445.76
2228165472441822208,2020-12,2353.48,2801.18,6223.88,6342.64,-566.46,6879.3
2228425457319956736,2020-01,755.69,3599.83,2790.34,2428.29,-2482.09,-2482.09
2228425457319956736,2020-02,2779.87,0,1706.37,2609.14,1877.1,-604.99
2228425457319956736,2020-03,0,10429.02,1568.23,3858.23,-12719.02,-13324.01
2228425457319956736,2020-04,5526.96,0,5294.95,1170.73,9651.18,-3672.83
2228425457319956736,2020-05,0,1735.43,5091.82,1122.34,2234.05,-1438.78
2228425457319956736,2020-06,454.51,791.35,113.56,1956.22,-2179.5,-3618.28
2228425457319956736,2020-07,7185.4,233.92,3711.71,2462.22,8200.97,4582.69
2228425457319956736,2020-08,1842.43,5731.93,714.69,1354.26,-4529.07,53.62
2228425457319956736,2020-09,4947.86,2266.51,3417.82,731.34,5367.83,5421.45
2228425457319956736,2020-10,4446.88,533.97,1137.09,3537.17,1512.83,6934.28
2228425457319956736,2020-11,3117.99,4529.62,3760.1,0,2348.47,9282.75
2228425457319956736,2020-12,2184.28,1607.15,3472.46,3543.05,506.54,9789.29
2229028059498605312,2020-01,411.14,4773,3307.09,5440.27,-6495.04,-6495.04
2229028059498605312,2020-02,3372.32,902.06,1540.36,3159.86,850.76,-5644.28
2229028059498605312,2020-03,1915.25,5193.61,2553,2982.49,-3707.85,-9352.13
2229028059498605312,2020-04,4322.58,0,1522.63,1088.04,4757.17,-4594.96
2229028059498605312,2020-05,531.1,3724.32,7571.85,206.78,4171.85,-423.11
2229028059498605312,2020-06,671.72,3073.23,892.02,3683.58,-5193.07,-5616.18
2229028059498605312,2020-07,6729.26,1931.12,893.78,3261.64,2430.28,-3185.9
2229028059498605312,2020-08,2537.45,1493.41,5651.33,1829.24,4866.13,1680.23
2229028059498605312,2020-09,4026.02,1379.73,0,932.15,1714.14,3394.37
2229028059498605312,2020-10,1702.31,820.5,4760.25,0,5642.06,9036.43
2229028059498605312,2020-11,3035.96,3816.09,2986.7,264.11,1942.46,10978.89
2229028059498605312,2020-12,1657.64,1117.48,4457.03,6746.19,-1749,9229.89
2230847992859220992,2020-01,4395.67,2230.86,0,1848.42,316.39,316.39
2230847992859220992,2020-02,2370.36,3457.58,1841.08,883.5,-129.64,186.75
2230847992859220992,2020-04,1574.85,0,1266.37,1430.29,1410.93,1597.68
2230847992859220992,2020-06,1503.22,1093.87,451.49,0,860.84,2458.52
2230847992859220992,2020-07,1779.92,0,0,0,1779.92,4238.44
2230847992859220992,2020-09,1887.55,1097.54,501.74,1487.75,-196,4042.44
2230847992859220992,2020-10,4708.16,3692.55,0,2838.67,-1823.06,2219.38
2230847992859220992,2020-11,617.99,3097.15,0,923.98,-3403.14,-1183.76
2230847992859220992,2020-12,3463.61,3277.35,2375.1,721.92,1839.44,655.68
2231083811854383616,2020-01,525.69,4268.32,2299.21,2943.33,-4386.75,-4386.75
2231083811854383616,2020-02,2991.3,4032.52,4521.27,5794.11,-2314.06,-6700.81
2231083811854383616,2020-03,10812.98,2551.78,3075.16,8231.94,3104.42,-3596.39
2231083811854383616,2020-04,3086.67,4396.87,446.59,4903.43,-5767.04,-9363.43
2231083811854383616,2020-05,2407.58,2591.36,7893.08,6509.01,1200.29,-8163.14
2231083811854383616,2020-06,2277.59,401.13,3138.11,6605.14,-1590.57,-9753.71
2231083811854383616,2020-07,3955.29,2291.23,7660.77,2069.45,7255.38,-2498.33
2231083811854383616,2020-08,2340.16,2921.14,1931.99,4064.01,-2713,-5211.33
2231083811854383616,2020-09,2176.25,6232.27,4181.75,9291.21,-9165.48,-14376.81
2231083811854383616,2020-10,3910.35,4851.25,2710.79,3240.61,-1470.72,-15847.53
2231083811854383616,2020-11,2714.35,626.12,6782.08,1354.75,7515.56,-8331.97
2231083811854383616,2020-12,2836.57,2248.05,3545.28,3364.58,769.22,-7562.75
2231920299634318848,2020-01,146.15,1787.08,1668.95,0,28.02,28.02
2231920299634318848,2020-03,3817.55,0,2816.38,0,6633.93,6661.95
2231920299634318848,2020-04,856.87,1491.75,0,2327.44,-2962.32,3699.63
2231920299634318848,2020-05,421.74,1871.64,3455.45,1452.36,553.19,4252.82
2231920299634318848,2020-06,2998.74,3759.69,1006.53,0,245.58,4498.4
2231920299634318848,2020-07,3266.75,0,0,1066.52,2200.23,6698.63
2231920299634318848,2020-08,915.76,1533.73,0,1465.28,-2083.25,4615.38
2231920299634318848,2020-09,864,808.05,2982.49,1608.97,1429.47,6044.85
2231920299634318848,2020-10,2844.33,1908.03,3095.21,0,4031.51,10076.36
2231920299634318848,2020-11,1756.92,971.11,3104.17,4316.68,-426.7,9649.66
2231920299634318848,2020-12,507.83,2011.66,696.96,4776.74,-5583.61,4066.05
2232281912060855808,2020-01,1561.46,3955.25,1753.89,1272.79,-1912.69,-1912.69
2232281912060855808,2020-02,1554.58,2802.99,3677.66,1295.16,1134.09,-778.6
2232281912060855808,2020-03,5881.21,1162.6,2737.14,920.2,6535.55,5756.95
2232281912060855808,2020-04,0,5768.01,377.02,4165.13,-9556.12,-3799.17
2232281912060855808,2020-05,722.25,2241.17,3548.06,1613.22,415.92,-3383.25
2232281912060855808,2020-06,1573.14,965.15,0,3395.9,-2787.91,-6171.16
2232281912060855808,2020-07,5166.41,5443.64,2048.52,3029.35,-1258.06,-7429.22
2232281912060855808,2020-08,1956.72,3001.11,328.8,0,-715.59,-8144.81
2232281912060855808,2020-09,2973.17,1070.67,467.02,1542.73,826.79,-7318.02
2232281912060855808,2020-11,17.98,1423.34,0,2758.13,-4163.49,-11481.51
2232281912060855808,2020-12,5002.77,757.05,2150.55,2427.05,3969.22,-7512.29
2232347631952213504,2020-01,2039.38,6422.93,4000.26,3762.13,-4145.42,-4145.42
2232347631952213504,2020-02,4764.88,5817.24,6980.32,3286.17,2641.79,-1503.63
2232347631952213504,2020-03,6668.14,1555.3,7582.63,3674.89,9020.58,7516.95
2232347631952213504,2020-04,9065.56,2867.9,4744.56,6979.25,3962.97,11479.92
2232347631952213504,2020-05,3367.53,4787.04,1423.83,6131.99,-6127.67,5352.25
2232347631952213504,2020-06,3622.55,863.48,6458.61,6680.25,2537.43,7889.68
2232347631952213504,2020-07,2894.41,1972.27,1927.26,5405.92,-2556.52,5333.16
2232347631952213504,2020-08,3013.57,10207.87,7946.98,6411.93,-5659.25,-326.09
2232347631952213504,2020-09,417.94,8586.6,2913.21,3150.29,-8405.74,-8731.83
2232347631952213504,2020-10,5106.3,3406.99,8055.3,9671.5,83.11,-8648.72
2232347631952213504,2020-11,981.52,4567.42,4253.94,2883.33,-2215.29,-10864.01
2232347631952213504,2020-12,1879.8,2161.27,6827.62,3967.68,2578.47,-8285.54
2232720502674555904,2020-01,2452.27,230.78,1701.91,7819.62,-3896.22,-3896.22
2232720502674555904,2020-02,1041.64,2236.36,1651.22,1281,-824.5,-4720.72
2232720502674555904,2020-03,5342.43,2344.63,2656.04,3160.1,2493.74,-2226.98
2232720502674555904,2020-04,4568.55,3037.48,1380.6,1522.57,1389.1,-837.88
2232720502674555904,2020-05,5593.26,678.3,3977.99,0,8892.95,8055.07
2232720502674555904,2020-06,283.64,3036.82,4863.34,515.54,1594.62,9649.69
2232720502674555904,2020-07,1605.25,1879.78,1599.53,0,1325,10974.69
2232720502674555904,2020-08,2808.09,4121.4,1705.93,654.41,-261.79,10712.9
2232720502674555904,2020-09,1038.18,3197.96,1078.64,2705.91,-3787.05,6925.85
2232720502674555904,2020-10,144.02,434.14,1777.45,3308.33,-1821,5104.85
2232720502674555904,2020-11,0,1402.74,6329.22,1374.25,3552.23,8657.08
2232720502674555904,2020-12,1933.67,2234.58,6354.25,0,6053.34,14710.42
2233854888355300608,2020-01,7910.23,4742.28,1826.09,3525.31,1468.73,1468.73
2233854888355300608,2020-02,4873.29,1542.94,6875.23,8602.87,1602.71,3071.44
2233854888355300608,2020-03,3466.27,5966.19,5513.04,7666.33,-4653.21,-1581.77
2233854888355300608,2020-04,1922.53,5416.32,1844.46,8863.75,-10513.08,-12094.85
2233854888355300608,2020-05,12244.58,9344.43,8567.3,1525.91,9941.54,-2153.31
2233854888355300608,2020-06,6025.19,3894.17,1470.22,2582.77,1018.47,-1134.84
2233854888355300608,2020-07,2704.45,6460.15,0,4253.93,-8009.63,-9144.47
2233854888355300608,2020-08,7074.55,2173.44,5105.33,8703.29,1303.15,-7841.32
2233854888355300608,2020-09,4610.46,5258.55,4165.47,5597.99,-2080.61,-9921.93
2233854888355300608,2020-10,6866.13,5347.87,0,9063.48,-7545.22,-17467.15
2233854888355300608,2020-11,4301.81,4174.73,8460.58,2342.1,6245.56,-11221.59
2233854888355300608,2020-12,7584.26,3432.02,5306.55,3498.71,5960.08,-5261.51
2234163716607176448,2020-01,48.17,1925.99,1987.6,348.79,-239.01,-239.01
2234163716607176448,2020-02,2577.37,2113.87,0,0,463.5,224.49
2234163716607176448,2020-03,0,990.77,2275.46,1231.76,52.93,277.42
2234163716607176448,2020-05,4307.59,1416.98,2362.66,913.12,4340.15,4617.57
2234163716607176448,2020-06,158.11,2654.78,1258.39,0,-1238.28,3379.29
2234163716607176448,2020-07,0,3698.04,0,3301.99,-7000.03,-3620.74
2234163716607176448,2020-09,2987.91,52.99,2437.76,1604.59,3768.09,147.35
2234163716607176448,2020-10,266.38,1334.06,0,1178.12,-2245.8,-2098.45
2234163716607176448,2020-11,1312.28,0,3041.56,0,4353.84,2255.39
2234163716607176448,2020-12,0,2645.14,1899.82,1467.45,-2212.77,42.62
2236681670347993856,2020-01,6296.08,3175.84,6622.02,3898.19,5844.07,5844.07
2236681670347993856,2020-02,3047.74,6456.41,4697.27,665.61,622.99,6467.06
2236681670347993856,2020-03,217.85,8553.16,320.01,915.15,-8930.45,-2463.39
2236681670347993856,2020-04,1676.49,1520.3,4017.47,5625.83,-1452.17,-3915.56
2236681670347993856,2020-05,6038.8,1845.81,302.65,4068.75,426.89,-3488.67
2236681670347993856,2020-06,6571.15,1634.22,1793.99,0,6730.92,3242.25
2236681670347993856,2020-07,3812.91,2833.82,4838.51,2949.87,2867.73,6109.98
2236681670347993856,2020-08,2516.81,1985.13,5637.38,5599.55,569.51,6679.49
2236681670347993856,2020-09,1497.36,2550.13,2647.1,1261.97,332.36,7011.85
2236681670347993856,2020-10,3317.88,2370.56,6377.15,3256.66,4067.81,11079.66
2236681670347993856,2020-11,1363.12,0,5476.94,4944.74,1895.32,12974.98
2236681670347993856,2020-12,3194.58,3412.7,5733.1,980.71,4534.27,17509.25
2239100888537095424,2020-01,3198.2,4914.89,6981.61,3460.42,1804.5,1804.5
2239100888537095424,2020-02,2502.62,1991.58,6885.41,4279.79,3116.66,4921.16
2239100888537095424,2020-03,2431.94,2716.64,7270.14,4411.24,2574.2,7495.36
2239100888537095424,2020-04,3419.39,4465.6,5213.26,2285.35,1881.7,9377.06
2239100888537095424,2020-05,1371.93,7759.69,6177.98,5005.49,-5215.27,4161.79
2239100888537095424,2020-06,3649.67,6621.78,4332.58,8677.28,-7316.81,-3155.02
2239100888537095424,2020-07,1699.39,8073.58,9300.21,2738.97,187.05,-2967.97
2239100888537095424,2020-08,6297.9,3025.58,4325.55,6163.77,1434.1,-1533.87
2239100888537095424,2020-09,3261.96,7157.84,4656.93,7264.04,-6502.99,-8036.86
2239100888537095424,2020-10,4588.19,728.47,3047.96,3982.29,2925.39,-5111.47
2239100888537095424,2020-11,1070.94,2860.35,5372.83,4297.44,-714.02,-5825.49
2239100888537095424,2020-12,1951.95,8094.04,4636.32,3177.87,-4683.64,-10509.13
2241345359711316480,2020-01,0,796.29,1086.7,1896.87,-1606.46,-1606.46
2241345359711316480,2020-02,0,934.98,0,1693.29,-2628.27,-4234.73
2241345359711316480,2020-04,0,802.33,1173.26,0,370.93,-3863.8
2241345359711316480,2020-05,907.85,1129.69,0,1892.86,-2114.7,-5978.5
2241345359711316480,2020-06,1065,143.54,0,0,921.46,-5057.04
2241345359711316480,2020-07,1043.8,1127.57,0,0,-83.77,-5140.81
2241345359711316480,2020-09,1334.7,2984.61,0,0,-1649.91,-6790.72
2241345359711316480,2020-10,1235.17,1129.12,3407.08,0,3513.13,-3277.59
2241345359711316480,2020-11,0,3153.13,0,0,-3153.13,-6430.72
2241345359711316480,2020-12,0,834.58,0,576.98,-1411.56,-7842.28
2242399703599138048,2020-01,0,2168.71,4258.77,3871.46,-1781.4,-1781.4
2242399703599138048,2020-02,73.06,5210.62,1378.79,1783.39,-5542.16,-7323.56
2242399703599138048,2020-03,1394.81,1098.36,1907.22,6547.72,-4344.05,-11667.61
2242399703599138048,2020-04,4312.46,3767.63,3281.71,2570.45,1256.09,-10411.52
2242399703599138048,2020-05,3953.25,5911,6294.28,7873.31,-3536.78,-13948.3
2242399703599138048,2020-06,5828.21,656.7,3682.82,5008.9,3845.43,-10102.87
2242399703599138048,2020-07,1742.61,2522.72,3422.32,1641.71,1000.5,-9102.37
2242399703599138048,2020-08,3962.07,1500.29,1005.79,2934.12,533.45,-8568.92
2242399703599138048,2020-09,1988.28,5999.03,1964,3984.52,-6031.27,-14600.19
2242399703599138048,2020-10,2890.63,3820.49,2086.25,2871.38,-1714.99,-16315.18
2242399703599138048,2020-11,1320.76,4756.99,9129.06,5003.2,689.63,-15625.55
2242399703599138048,2020-12,122.3,6025.36,3122.24,6223.63,-9004.45,-24630
2243577405791411712,2020-01,2146.04,3365.34,0,1403.5,-2622.8,-2622.8
2243577405791411712,2020-02,3817.07,3626.13,1159.86,4780.29,-3429.49,-6052.29
2243577405791411712,2020-03,4437.15,2748.37,4189.1,1245.71,4632.17,-1420.12
2243577405791411712,2020-04,3656.36,3877.39,1489.76,1315.59,-46.86,-1466.98
2243577405791411712,2020-05,3643.31,6779.62,8381.39,1640.64,3604.44,2137.46
2243577405791411712,2020-06,128.03,2590.91,2608.39,2060.24,-1914.73,222.73
2243577405791411712,2020-07,3069.11,1439.35,587.8,1468.04,749.52,972.25
2243577405791411712,2020-08,1499.95,2071.4,1923.94,3474.23,-2121.74,-1149.49
2243577405791411712,2020-09,537.7,2282.19,2235.97,2470.76,-1979.28,-3128.77
2243577405791411712,2020-10,6683.79,1797.97,2243.38,2848.19,4281.01,1152.24
2243577405791411712,2020-11,6680.8,1411.4,6223.11,6717.38,4775.13,5927.37
2243577405791411712,2020-12,3946.17,3712.51,1771.99,1182.2,823.45,6750.82
2243629027947047424,2020-01,1140.54,4733.95,1552.24,5212.96,-7254.13,-7254.13
2243629027947047424,2020-02,1536.09,7222.46,2801.16,2278.69,-5163.9,-12418.03
2243629027947047424,2020-03,3473.95,3337.28,3547.18,7871.42,-4187.57,-16605.6
2243629027947047424,2020-04,6709.63,5944.01,2305.32,3596.1,-525.16,-17130.76
2243629027947047424,2020-05,4654.72,7131.81,5496.23,460.22,2558.92,-14571.84
2243629027947047424,2020-06,3800.15,6383.78,1514.33,3348.09,-4417.39,-18989.23
2243629027947047424,2020-07,5240.69,5368.42,4490.92,2773.74,1589.45,-17399.78
2243629027947047424,2020-08,5562.49,6815.06,5713.47,9679.81,-5218.91,-22618.69
2243629027947047424,2020-09,9102.89,8763.9,1015.66,2121.11,-766.46,-23385.15
2243629027947047424,2020-10,6271.24,3230.09,3189.47,5758.41,472.21,-22912.94
2243629027947047424,2020-11,4250.16,5991.19,4322.65,3938.26,-1356.64,-24269.58
2243629027947047424,2020-12,0,2671.97,1368.71,5140.53,-6443.79,-30713.37
2246836444947273728,2020-01,1503.99,1408.73,4684.28,787.16,3992.38,3992.38
2246836444947273728,2020-02,1166.77,4740.19,1741.24,5303.13,-7135.31,-3142.93
2246836444947273728,2020-03,5632.35,0,2844.73,3654.6,4822.48,1679.55
2246836444947273728,2020-04,3971.01,3716.53,5265.15,4292.48,1227.15,2906.7
2246836444947273728,2020-05,1175.34,8067.13,2612.22,4035.96,-8315.53,-5408.83
2246836444947273728,2020-06,2758.93,3009.12,8072.37,2723.9,5098.28,-310.55
2246836444947273728,2020-07,2520.95,2546.94,4022.99,3146.81,850.19,539.64
2246836444947273728,2020-08,0,2779.36,6136.73,874.65,2482.72,3022.36
2246836444947273728,2020-09,2984.47,6039.03,9808.47,1230.84,5523.07,8545.43
2246836444947273728,2020-10,4964.84,607.46,2003.13,1403.65,4956.86,13502.29
2246836444947273728,2020-11,1768.07,4580.77,4534.85,8434.06,-6711.91,6790.38
2246836444947273728,2020-12,1735.29,5970.44,8201.19,4601.58,-635.54,6154.84
2248278083951468032,2020-01,2948.64,0,2177.89,1445.66,3680.87,3680.87
2248278083951468032,2020-02,2019.69,0,2521.06,935.7,3605.05,7285.92
2248278083951468032,2020-03,2461.17,636.76,1658.82,1932.73,1550.5,8836.42
2248278083951468032,2020-04,1903.57,1700.67,5076.54,1397.76,3881.68,12718.1
2248278083951468032,2020-05,2890.88,1715.98,943.54,2339.11,-220.67,12497.43
2248278083951468032,2020-06,0,2527.68,1673.86,937.36,-1791.18,10706.25
2248278083951468032,2020-07,1826.95,1812.38,1628.41,2788.28,-1145.3,9560.95
2248278083951468032,2020-08,0,3731.94,0,1440.6,-5172.54,4388.41
2248278083951468032,2020-09,0,2864.98,1621.2,3231.75,-4475.53,-87.12
2248278083951468032,2020-10,3578.64,2919.42,0,2300.98,-1641.76,-1728.88
2248278083951468032,2020-11,2465.47,680.51,10.41,1533.66,261.71,-1467.17
2248278083951468032,2020-12,2103.99,339.71,735.28,0,2499.56,1032.39
2248547741503355904,2020-01,3253.67,1946.16,1350.58,2691.41,-33.32,-33.32
2248547741503355904,2020-02,5237.85,4220.59,5506.62,1682.17,4841.71,4808.39
2248547741503355904,2020-03,848.34,1935.93,908.26,3076.6,-3255.93,1552.46
2248547741503355904,2020-04,711.96,1220.41,2617.55,6657.17,-4548.07,-2995.61
2248547741503355904,2020-05,5320.82,3291.35,4848.92,1697.06,5181.33,2185.72
2248547741503355904,2020-06,2456.75,1416.94,3243.82,3323.36,960.27,3145.99
2248547741503355904,2020-07,199.63,4116.57,3552.4,2387.76,-2752.3,393.69
2248547741503355904,2020-08,650.19,1816.47,2949.61,1593.36,189.97,583.66
2248547741503355904,2020-09,4613.57,202.89,0,1612.02,2798.66,3382.32
2248547741503355904,2020-10,2929.58,3619.69,6471.05,0,5780.94,9163.26
2248547741503355904,2020-11,3006.88,2537.38,6293.59,3258.03,3505.06,12668.32
2248547741503355904,2020-12,4192.5,352.29,3994.5,3302.16,4532.55,17200.87
2249912244459725056,2020-01,6436.35,7084.87,7842.03,6376.81,816.7,816.7
2249912244459725056,2020-02,2993.56,4082.1,5299.74,9219.46,-5008.26,-4191.56
2249912244459725056,2020-03,5434.78,9188.65,9680.89,4667.29,1259.73,-2931.83
2249912244459725056,2020-04,1977.4,963.07,3097.98,2907.96,1204.35,-1727.48
2249912244459725056,2020-05,3874.82,7871.38,3659.2,11628.66,-11966.02,-13693.5
2249912244459725056,2020-06,2717.66,2297.03,6157.19,6213.37,364.45,-13329.05
2249912244459725056,2020-07,3777.2,6674.09,1888.9,6496.95,-7504.94,-20833.99
2249912244459725056,2020-08,3858.43,6932.93,6100.43,10781.74,-7755.81,-28589.8
2249912244459725056,2020-09,4059.53,11559.23,447.77,2259.05,-9310.98,-37900.78
2249912244459725056,2020-10,4519.37,0,1022.46,3821.77,1720.06,-36180.72
2249912244459725056,2020-11,3124.85,4983.52,4156.02,3173.18,-875.83,-37056.55
2249912244459725056,2020-12,3080.52,5535.2,4173.65,2251.14,-532.17,-37588.72
2251334511689657856,2020-01,1776.91,2614.1,3209.37,2838.46,-466.28,-466.28
2251334511689657856,2020-02,7876.82,2883.98,3457.7,3978.35,4472.19,4005.91
2251334511689657856,2020-03,4749.52,4267.24,6179.51,3451.82,3209.97,7215.88
2251334511689657856,2020-04,0,5631.9,2162.12,659.11,-4128.89,3086.99
2251334511689657856,2020-05,3151.04,4250.26,1324.69,5188.08,-4962.61,-1875.62
2251334511689657856,2020-06,3070.85,1713.52,3998.86,2668.73,2687.46,811.84
2251334511689657856,2020-07,2268.86,4078.94,2669.11,5766.28,-4907.25,-4095.41
2251334511689657856,2020-08,4512.34,1881.58,5168.73,2390.49,5409,1313.59
2251334511689657856,2020-09,3143.76,1229.58,0,4410.3,-2496.12,-1182.53
2251334511689657856,2020-10,197.22,1315.44,2437.85,4167.34,-2847.71,-4030.24
2251334511689657856,2020-11,1110.25,5416.89,0,3538.21,-7844.85,-11875.09
2251334511689657856,2020-12,1024.57,2789.6,3624.96,3252.85,-1392.92,-13268.01
2253080743478568192,2020-01,3560.39,9242.55,1815.07,2308.68,-6175.77,-6175.77
2253080743478568192,2020-02,6059.38,4321.96,0,0,1737.42,-4438.35
2253080743478568192,2020-03,5418.94,3844.28,1499.1,3300.71,-226.95,-4665.3
2253080743478568192,2020-04,0,2178.78,1982.46,3740.63,-3936.95,-8602.25
2253080743478568192,2020-05,1458.09,0,0,300.24,1157.85,-7444.4
2253080743478568192,2020-06,1742.11,1621.54,0,4235.6,-4115.03,-11559.43
2253080743478568192,2020-07,4571.94,2524.48,88.57,1799.82,336.21,-11223.22
2253080743478568192,2020-08,0,4561.2,4508.76,4718.59,-4771.03,-15994.25
2253080743478568192,2020-09,2151.84,690.62,1298.99,1185.72,1574.49,-14419.76
2253080743478568192,2020-10,2211.16,4627,5976.16,0,3560.32,-10859.44
2253080743478568192,2020-11,3307.26,989.47,0,2218.09,99.7,-10759.74
2253080743478568192,2020-12,0,3520.83,3348.62,3937.2,-4109.41,-14869.15
2253586325817857792,2020-01,1464.73,5394.3,3252.2,4938.17,-5615.54,-5615.54
2253586325817857792,2020-02,0,3374.74,1378.12,613.23,-2609.85,-8225.39
2253586325817857792,2020-03,3593.95,1430.97,3718.59,2759.09,3122.48,-5102.91
2253586325817857792,2020-04,2556.15,1215.81,1210.15,4055.55,-1505.06,-6607.97
2253586325817857792,2020-05,0,2200.33,4080.35,2511.67,-631.65,-7239.62
2253586325817857792,2020-06,874.86,1457.39,3319.24,6320.46,-3583.75,-10823.37
2253586325817857792,2020-07,3949.04,839.42,0,3751.96,-642.34,-11465.71
2253586325817857792,2020-08,7893.81,1809.64,1651,458.7,7276.47,-4189.24
2253586325817857792,2020-09,1900.79,6860.61,0,2710.79,-7670.61,-11859.85
2253586325817857792,2020-10,0,595.28,4387.89,1813.55,1979.06,-9880.79
2253586325817857792,2020-11,829.68,0,1843.51,2587.32,85.87,-9794.92
2253586325817857792,2020-12,1557.63,1701.97,3675.63,1409.33,2121.96,-7672.96
2253700469073051904,2020-01,3594.44,1780.3,1882.01,0,3696.15,3696.15
2253700469073051904,2020-03,2014.52,1230.52,1039.65,1225.29,598.36,4294.51
2253700469073051904,2020-04,1782.86,3373.37,1797.71,2299.35,-2092.15,2202.36
2253700469073051904,2020-05,1845.83,596.37,1503.72,2938.75,-185.57,2016.79
2253700469073051904,2020-06,727.79,1803.52,5902.43,3547.33,1279.37,3296.16
2253700469073051904,2020-07,607.9,1526.79,1985.14,3098.53,-2032.28,1263.88
2253700469073051904,2020-08,7370.4,659.74,2480.19,0,9190.85,10454.73
2253700469073051904,2020-09,1253.82,2591.98,769.43,852.65,-1421.38,9033.35
2253700469073051904,2020-10,0,1879.08,1877.8,0,-1.28,9032.07
2253700469073051904,2020-11,2519.35,380.78,0,1520.76,617.81,9649.88
2253700469073051904,2020-12,75.29,1742.98,4293.23,1400.87,1224.67,10874.55
2254484841803291904,2020-01,4973.06,2413.99,4682.18,5127.06,2114.19,2114.19
2254484841803291904,2020-02,3456.99,2184.43,1119.63,1956.76,435.43,2549.62
2254484841803291904,2020-03,1782.47,3736.63,5684.9,3026.76,703.98,3253.6
2254484841803291904,2020-04,3308.68,343.42,208.4,404.44,2769.22,6022.82
2254484841803291904,2020-05,5808.78,2554.35,2180.43,2463.13,2971.73,8994.55
2254484841803291904,2020-06,4442.22,2072.27,3205.2,0,5575.15,14569.7
2254484841803291904,2020-07,4147.97,1250.14,769.66,5528.7,-1861.21,12708.49
2254484841803291904,2020-08,246.78,0,2645.29,2126.26,765.81,13474.3
2254484841803291904,2020-10,1718.53,2026.75,2213.93,7361.64,-5455.93,8018.37
2254484841803291904,2020-11,2045.82,1941.4,651.79,1471.15,-714.94,7303.43
2254484841803291904,2020-12,1797.51,274.98,1756.92,3093.19,186.26,7489.69
2255372244110817792,2020-02,4492.4,5131.74,512.57,3603.52,-3730.29,-3730.29
2255372244110817792,2020-03,3569.01,3477.53,353.42,761.43,-316.53,-4046.82
2255372244110817792,2020-04,980.7,2518.88,0,2352.43,-3890.61,-7937.43
2255372244110817792,2020-05,1631.21,1340.21,4163.8,2822.16,1632.64,-6304.79
2255372244110817792,2020-06,1431.08,1005.67,1097.38,0,1522.79,-4782
2255372244110817792,2020-07,510.54,0,3731.3,3130.01,1111.83,-3670.17
2255372244110817792,2020-09,1281.13,0,983.27,1252.82,1011.58,-2658.59
2255372244110817792,2020-10,1240.19,1599.71,1951.85,4203.78,-2611.45,-5270.04
2255372244110817792,2020-11,1186.61,563.69,0,1863.3,-1240.38,-6510.42
2255377869527491328,2020-02,1379.04,0,0,0,1379.04,1379.04
2255377869527491328,2020-03,0,929.97,0,0,-929.97,449.07
2255377869527491328,2020-04,0,848.88,0,0,-848.88,-399.81
2255377869527491328,2020-05,0,1033.24,2331.9,0,1298.66,898.85
2255377869527491328,2020-07,1239.29,0,0,659.19,580.1,1478.95
2255377869527491328,2020-08,0,365.71,0,1719.13,-2084.84,-605.89
2255377869527491328,2020-10,2425.39,0,616.35,945,2096.74,1490.85
2255377869527491328,2020-11,0,671.65,227.68,0,-443.97,1046.88
2256437627562322944,2020-01,1654.32,5836.63,1383.13,3058.83,-5858.01,-5858.01
2256437627562322944,2020-02,9642.18,3512.48,5605.02,1695.71,10039.01,4181
2256437627562322944,2020-03,3514.57,3141.58,3151.69,4898.41,-1373.73,2807.27
2256437627562322944,2020-04,5739.39,3650.11,1317.13,6848.15,-3441.74,-634.47
2256437627562322944,2020-05,3850.35,6509.78,8698.34,5012.16,1026.75,392.28
2256437627562322944,2020-06,1992.61,4457.09,2050.63,4654.79,-5068.64,-4676.36
2256437627562322944,2020-07,3382.02,8646.72,3738.68,1105.94,-2631.96,-7308.32
2256437627562322944,2020-08,4803.67,4889.66,691.85,0,605.86,-6702.46
2256437627562322944,2020-09,4098.92,827.18,4049.6,6766.13,555.21,-6147.25
2256437627562322944,2020-10,6105.51,2523.82,3722.06,3953.54,3350.21,-2797.04
2256437627562322944,2020-11,5416.16,1308.61,4984.81,6860.54,2231.82,-565.22
2256437627562322944,2020-12,2526.16,3999.22,1341.95,1345.69,-1476.8,-2042.02
2256498309837981184,2020-01,938.65,5725.47,6619.32,2167.78,-335.28,-335.28
2256498309837981184,2020-02,4833.73,3017.64,2248.66,4531.33,-466.58,-801.86
2256498309837981184,2020-03,4860.17,3042,2141,3150.21,808.96,7.1
2256498309837981184,2020-04,7475.47,4766.82,3468.62,2800.35,3376.92,3384.02
2256498309837981184,2020-05,2230.17,9572.96,3535.55,2093.71,-5900.95,-2516.93
2256498309837981184,2020-06,2298.47,4420.57,7547.1,3631.91,1793.09,-723.84
2256498309837981184,2020-07,569.9,6245.49,1305.89,9678.26,-14047.96,-14771.8
2256498309837981184,2020-08,4682.54,1849.67,1711.37,5263.31,-719.07,-15490.87
2256498309837981184,2020-09,3078.3,5252.48,8460.97,2496.29,3790.5,-11700.37
2256498309837981184,2020-10,6097.6,30.27,3628.64,1520.45,8175.52,-3524.85
2256498309837981184,2020-11,2448.91,4311.43,3282.8,4424.98,-3004.7,-6529.55
2256498309837981184,2020-12,4042.83,2652.8,1829.55,4300.66,-1081.08,-7610.63
2259974970550245632,2020-02,485.23,73.94,0,0,411.29,411.29
2259974970550245632,2020-03,0,1246.26,1012.05,0,-234.21,177.08
2259974970550245632,2020-04,3091.73,0,0,0,3091.73,3268.81
2259974970550245632,2020-05,498.26,0,1876.95,0,2375.21,5644.02
2259974970550245632,2020-06,1848.96,549.81,2666.84,0,3965.99,9610.01
2259974970550245632,2020-07,0,2282.6,28.08,2457.21,-4711.73,4898.28
2259974970550245632,2020-08,1939.66,0,4329.17,1770.67,4498.16,9396.44
2259974970550245632,2020-09,1808.53,0,599.58,0,2408.11,11804.55
2259974970550245632,2020-10,0,3140.76,0,0,-3140.76,8663.79
2259974970550245632,2020-11,0,1262.1,277.85,0,-984.25,7679.54
2261068877213963520,2020-01,6091.39,790.93,5945.1,6465.31,4780.25,4780.25
2261068877213963520,2020-02,1034.49,3516.55,3855.15,6008.99,-4635.9,144.35
2261068877213963520,2020-03,8857.77,4201.81,2616.56,6804.1,468.42,612.77
2261068877213963520,2020-04,765.24,3454.36,8065.63,4471.21,905.3,1518.07
2261068877213963520,2020-05,3371,3162.9,6868.67,2113.79,4962.98,6481.05
2261068877213963520,2020-06,3184.18,5649,3407.79,5331.39,-4388.42,2092.63
2261068877213963520,2020-07,2499.15,5206.38,5310.85,4927.28,-2323.66,-231.03
2261068877213963520,2020-08,2144.53,2716.95,4159.19,0,3586.77,3355.74
2261068877213963520,2020-09,7465.43,1199.51,5428.02,3222.72,8471.22,11826.96
2261068877213963520,2020-10,6196.14,1800.7,9142.8,5430.88,8107.36,19934.32
2261068877213963520,2020-11,5075.74,7259.99,806.33,4876.54,-6254.46,13679.86
2261068877213963520,2020-12,5669.73,4646.46,3729.97,2844.58,1908.66,15588.52
2261283041871308288,2020-01,2487.53,6537.38,3515.97,1249.77,-1783.65,-1783.65
2261283041871308288,2020-02,2663.89,0,3971.29,3838.43,2796.75,1013.1
2261283041871308288,2020-03,2566.78,6666.23,5588.72,121.33,1367.94,2381.04
2261283041871308288,2020-04,1760.81,6473.98,125.07,0,-4588.1,-2207.06
2261283041871308288,2020-05,183.46,6955.7,2102.63,6379.79,-11049.4,-13256.46
2261283041871308288,2020-06,2568.68,684.98,393.6,1163.33,1113.97,-12142.49
2261283041871308288,2020-07,2898.17,4448.26,3086.37,2084.05,-547.77,-12690.26
2261283041871308288,2020-08,3195.61,9716.74,304.83,3751.41,-9967.71,-22657.97
2261283041871308288,2020-09,3265.03,2604.83,1807.72,3412.23,-944.31,-23602.28
2261283041871308288,2020-10,1779.03,1782.73,3935.62,2341.82,1590.1,-22012.18
2261283041871308288,2020-11,931.61,2255.35,4034.23,5062.47,-2351.98,-24364.16
2261283041871308288,2020-12,5364.43,6288.82,1311.59,364.38,22.82,-24341.34
2261915141714190592,2020-01,3142.27,3769.46,1470.16,0,842.97,842.97
2261915141714190592,2020-02,1189.71,3499.71,569.99,3120.43,-4860.44,-4017.47
2261915141714190592,2020-03,4384.33,2558.55,2948.16,3837.94,936,-3081.47
2261915141714190592,2020-04,5399.07,840.98,1341.08,3653.64,2245.53,-835.94
2261915141714190592,2020-05,1899.83,3651.88,1597.69,3185.14,-3339.5,-4175.44
2261915141714190592,2020-06,3442.43,874.54,374.73,2658.48,284.14,-3891.3
2261915141714190592,2020-07,3762.48,3911.11,1063.46,726.72,188.11,-3703.19
2261915141714190592,2020-08,1102.2,1642.39,4494.3,539.54,3414.57,-288.62
2261915141714190592,2020-09,0,782.93,2135.69,3930.38,-2577.62,-2866.24
2261915141714190592,2020-10,626.19,4141.65,3951.02,453.14,-17.58,-2883.82
2261915141714190592,2020-11,1596.24,4124.98,2024.26,54.64,-559.12,-3442.94
2261915141714190592,2020-12,5050.05,2111.28,4281.81,1766.72,5453.86,2010.92
2264856513006622720,2020-01,0,122.51,2530.52,189.24,2218.77,2218.77
2264856513006622720,2020-02,1860.45,4133.42,470.31,2910.4,-4713.06,-2494.29
2264856513006622720,2020-03,5308.36,4661.05,0,2375.61,-1728.3,-4222.59
2264856513006622720,2020-04,3791.33,0,4307.83,6581.79,1517.37,-2705.22
2264856513006622720,2020-05,616.01,1068.39,3157.74,4066.17,-1360.81,-4066.03
2264856513006622720,2020-06,1720.79,1421.76,2741.46,696.89,2343.6,-1722.43
2264856513006622720,2020-07,5753.05,1722.58,1599.3,4633.75,996.02,-726.41
2264856513006622720,2020-08,1166.27,2670.05,3373.6,0,1869.82,1143.41
2264856513006622720,2020-09,0,3101.48,4221.89,2217.03,-1096.62,46.79
2264856513006622720,2020-10,5642.1,1921.62,3054.31,2392.73,4382.06,4428.85
2264856513006622720,2020-11,2176.35,0,816.09,0,2992.44,7421.29
2264856513006622720,2020-12,546.15,4440.07,0,2318.25,-6212.17,1209.12
2265483701737460224,2020-01,2794.95,1778.55,854.17,3138.95,-1268.38,-1268.38
2265483701737460224,2020-02,0,879.29,3179.45,607.88,1692.28,423.9
2265483701737460224,2020-03,1791.44,2906.63,1334.3,842.36,-623.25,-199.35
2265483701737460224,2020-04,2474.22,0,2562.41,4177.29,859.34,659.99
2265483701737460224,2020-05,808.85,4409.56,4219,1357.39,-739.1,-79.11
2265483701737460224,2020-06,1208.62,3281.47,2699.03,427.35,198.83,119.72
2265483701737460224,2020-07,2575.16,4234.02,3344.79,3015.5,-1329.57,-1209.85
2265483701737460224,2020-08,1032.96,3203.74,1958.99,3593.19,-3804.98,-5014.83
2265483701737460224,2020-09,3133.54,1175.28,5552.54,748.65,6762.15,1747.32
2265483701737460224,2020-10,2880.23,5706.46,7484.89,3694.14,964.52,2711.84
2265483701737460224,2020-11,1812.66,836.48,4240.98,2430.6,2786.56,5498.4
2265483701737460224,2020-12,1115.04,2146.44,350.1,563.12,-1244.42,4253.98
2265616521804652800,2020-01,1552.59,0,0,2365.74,-813.15,-813.15
2265616521804652800,2020-02,94.57,0,1236.37,171.5,1159.44,346.29
2265616521804652800,2020-03,1185.16,419.2,0,0,765.96,1112.25
2265616521804652800,2020-04,0,1603.36,1605.46,0,2.1,1114.35
2265616521804652800,2020-05,2894.17,239.11,1460.98,0,4116.04,5230.39
2265616521804652800,2020-06,0,1020.07,0,2011.21,-3031.28,2199.11
2265616521804652800,2020-07,495.52,0,1027.89,2621.9,-1098.49,1100.62
2265616521804652800,2020-08,489.47,1716.45,1524.69,1769.23,-1471.52,-370.9
2265616521804652800,2020-09,2395.45,1818.03,163,227.34,513.08,142.18
2265616521804652800,2020-10,706.9,3757.29,1980.42,0,-1069.97,-927.79
2265616521804652800,2020-11,544.79,1060.45,2070.62,1989.96,-435,-1362.79
2265616521804652800,2020-12,0,2636.96,1682.53,0,-954.43,-2317.22
2267829849753998336,2020-01,2266.11,1032.58,4364.06,1504.64,4092.95,4092.95
2267829849753998336,2020-02,0,2696.65,3019.45,306.13,16.67,4109.62
2267829849753998336,2020-03,8422.65,3062.62,5600,1336.57,9623.46,13733.08
2267829849753998336,2020-04,4962.24,5839.42,532.29,7447.38,-7792.27,5940.81
2267829849753998336,2020-05,170.12,5453.7,5972.19,2977.05,-2288.44,3652.37
2267829849753998336,2020-06,3365.35,9447.73,4066.06,5013.02,-7029.34,-3376.97
2267829849753998336,2020-07,4096.22,7255.95,1368.39,3749.33,-5540.67,-8917.64
2267829849753998336,2020-08,2333.47,7321.55,7259.84,3662.2,-1390.44,-10308.08
2267829849753998336,2020-09,1958.91,5341.23,2557.01,1321.96,-2147.27,-12455.35
2267829849753998336,2020-10,3020.9,3830.59,3139.53,1213.84,1116,-11339.35
2267829849753998336,2020-11,4857.57,3544.24,2973.82,8116.61,-3829.46,-15168.81
2267829849753998336,2020-12,1474.07,2421.2,26.91,4450.49,-5370.71,-20539.52
2271287480952041472,2020-01,0,1152.82,1641.56,0,488.74,488.74
2271287480952041472,2020-02,1386.39,557.6,1837.82,1402.02,1264.59,1753.33
2271287480952041472,2020-03,3286.99,1991.31,699.56,1581.75,413.49,2166.82
2271287480952041472,2020-04,0,844.78,1511.45,0,666.67,2833.49
2271287480952041472,2020-06,1711.3,0,1775.28,1755.7,1730.88,4564.37
2271287480952041472,2020-07,0,1956.9,1758.81,1421.51,-1619.6,2944.77
2271287480952041472,2020-08,989.01,0,0,1622.62,-633.61,2311.16
2271287480952041472,2020-09,482.22,0,606.3,449.41,639.11,2950.27
2271287480952041472,2020-11,211.95,2740.98,0,0,-2529.03,421.24
2271287480952041472,2020-12,0,280.61,0,1165.75,-1446.36,-1025.12
2271652517474498304,2020-01,4724.98,2017.11,8814.09,5272.12,6249.84,6249.84
2271652517474498304,2020-02,2166.02,4320.34,2053.08,1749.59,-1850.83,4399.01
2271652517474498304,2020-03,3616.44,6166.17,2746.57,5058.63,-4861.79,-462.78
2271652517474498304,2020-04,4253.84,2739.75,4406.1,8728.24,-2808.05,-3270.83
2271652517474498304,2020-05,5149.06,2310.87,7082.53,4720.71,5200.01,1929.18
2271652517474498304,2020-06,1670.36,3998.04,5680.05,4602.21,-1249.84,679.34
2271652517474498304,2020-07,4273.46,3888.97,3216.06,668.79,2931.76,3611.1
2271652517474498304,2020-08,5886.46,3945.06,3117.57,4037.23,1021.74,4632.84
2271652517474498304,2020-09,5175.5,3349.48,5440.2,7089.55,176.67,4809.51
2271652517474498304,2020-10,1457.38,2877.05,3666.77,1786.5,460.6,5270.11
2271652517474498304,2020-11,5084.32,10403.65,9370.19,11762.65,-7711.79,-2441.68
2271652517474498304,2020-12,902.41,7825.28,2938.56,7871.58,-11855.89,-14297.57
2272107761294644736,2020-01,0,793.45,1680.53,376.95,510.13,510.13
2272107761294644736,2020-02,54.95,0,373.83,1570.37,-1141.59,-631.46
2272107761294644736,2020-03,0,273.41,291.16,1634.61,-1616.86,-2248.32
2272107761294644736,2020-05,1351.29,157.06,0,1665.58,-471.35,-2719.67
2272107761294644736,2020-07,1664.94,2171.09,0,119.03,-625.18,-3344.85
2272107761294644736,2020-08,1599.72,2211.39,494.36,0,-117.31,-3462.16
2272107761294644736,2020-09,1712.05,667.92,635.31,1294.16,385.28,-3076.88
2272107761294644736,2020-10,0,1295.64,1928.18,0,632.54,-2444.34
2272107761294644736,2020-11,670.65,1708.43,0,3077.08,-4114.86,-6559.2
2272107761294644736,2020-12,0,2062.74,0,2398.23,-4460.97,-11020.17
2273077190671060224,2020-01,2562.16,880.32,3463.67,3847.07,1298.44,1298.44
2273077190671060224,2020-02,1882.98,819.21,2916.59,2829.1,1151.26,2449.7
2273077190671060224,2020-03,295.05,762.53,2441.88,0,1974.4,4424.1
2273077190671060224,2020-04,2075.24,2607.81,5260.43,1899.79,2828.07,7252.17
2273077190671060224,2020-05,3226.08,4017.48,1833.6,0,1042.2,8294.37
2273077190671060224,2020-06,1727.46,3684.74,1785.22,3422.88,-3594.94,4699.43
2273077190671060224,2020-07,1221.63,1578.51,0,6054.28,-6411.16,-1711.73
2273077190671060224,2020-08,696.64,506.39,2485.94,1195.36,1480.83,-230.9
2273077190671060224,2020-09,3309.96,5089.01,3474.05,0,1695,1464.1
2273077190671060224,2020-10,846.44,1753.22,4299.87,4746.2,-1353.11,110.99
2273077190671060224,2020-11,0,3255.87,4086.21,3141.97,-2311.63,-2200.64
2273077190671060224,2020-12,4979.39,3167.71,917.8,655.97,2073.51,-127.13
2273481043813736192,2020-09,0,26.44,0,0,-26.44,-26.44
2273481043813736192,2020-10,1097.24,0,1656.58,0,2753.82,2727.38
2274904162734302464,2020-01,2468.75,8417.17,727.36,612.79,-5833.85,-5833.85
2274904162734302464,2020-02,2432.43,2981.41,2808,2074.53,184.49,-5649.36
2274904162734302464,2020-03,721.96,2983.2,5049.76,5946.43,-3157.91,-8807.27
2274904162734302464,2020-04,4473.14,425.46,3946.25,1110.51,6883.42,-1923.85
2274904162734302464,2020-05,7269.61,7719.13,4317.57,1248.32,2619.73,695.88
2274904162734302464,2020-06,4319.82,7203.64,1543.02,5275.41,-6616.21,-5920.33
2274904162734302464,2020-07,5510.35,2218.41,3248.63,1682.22,4858.35,-1061.98
2274904162734302464,2020-08,1676.17,6444.44,8355.17,1381.52,2205.38,1143.4
2274904162734302464,2020-09,4549.91,5553.4,2966.43,4186.67,-2223.73,-1080.33
2274904162734302464,2020-10,7189.76,2348.03,6687.03,6821.83,4706.93,3626.6
2274904162734302464,2020-11,5576.36,2177.1,2385.45,7070.19,-1285.48,2341.12
2274904162734302464,2020-12,2076.83,2888.31,1574.57,1187.91,-424.82,1916.3
2277995406393602304,2020-06,0,1034.42,0,0,-1034.42,-1034.42
2277995406393602304,2020-08,0,788.49,394.81,0,-393.68,-1428.1
2277995406393602304,2020-09,0,250.39,1183.28,1867.83,-934.94,-2363.04
2277995406393602304,2020-10,0,2438.84,0,1236.49,-3675.33,-6038.37
2280009194424209920,2020-01,1822.16,1777.29,2450.81,0,2495.68,2495.68
2280009194424209920,2020-02,965.85,10003.66,3898.96,4744.37,-9883.22,-7387.54
2280009194424209920,2020-03,3204.76,8618.26,3113.43,866.42,-3166.49,-10554.03
2280009194424209920,2020-04,7803.98,1998.88,1863.73,0,7668.83,-2885.2
2280009194424209920,2020-05,7764.43,3427.35,2218.54,6390.31,165.31,-2719.89
2280009194424209920,2020-06,5105.82,5020.86,1769.32,2184.56,-330.28,-3050.17
2280009194424209920,2020-07,3451,2434.1,2352.92,2344.8,1025.02,-2025.15
2280009194424209920,2020-08,1977.4,3400.44,2571.14,1066.45,81.65,-1943.5
2280009194424209920,2020-09,3490.11,1800.52,3001.7,1925.33,2765.96,822.46
2280009194424209920,2020-10,1349.01,2823.43,4749.93,5537.92,-2262.41,-1439.95
2280009194424209920,2020-11,3102.84,2104.91,1264.15,4773.94,-2511.86,-3951.81
2280009194424209920,2020-12,2511.61,3708.4,2547.44,2779.54,-1428.89,-5380.7
2282948755213666816,2020-01,2523.17,2694.31,3927.77,1925.17,1831.46,1831.46
2282948755213666816,2020-02,1905.03,1052.36,258.49,2800.45,-1689.29,142.17
2282948755213666816,2020-03,449.87,1577.09,0,1073.61,-2200.83,-2058.66
2282948755213666816,2020-04,870.39,0,0,2716.93,-1846.54,-3905.2
2282948755213666816,2020-05,4509.76,2995.86,0,3525.25,-2011.35,-5916.55
2282948755213666816,2020-06,1721.68,1056.99,199.31,5443.77,-4579.77,-10496.32
2282948755213666816,2020-07,4393.25,98.58,2375.45,1927.04,4743.08,-5753.24
2282948755213666816,2020-08,3719.63,3717.91,2938.37,173.84,2766.25,-2986.99
2282948755213666816,2020-09,542.89,0,2500.64,1322.3,1721.23,-1265.76
2282948755213666816,2020-10,1116.18,0,2541.17,1587.49,2069.86,804.1
2282948755213666816,2020-11,2731.6,1422.46,2150.52,1674.02,1785.64,2589.74
2282948755213666816,2020-12,1147.56,1908.27,718.12,3160.25,-3202.84,-613.1
2283519560534227200,2020-01,4054.11,3953.58,1572.89,3229.98,-1556.56,-1556.56
2283519560534227200,2020-02,4193.52,2611.96,3728.47,7131.89,-1821.86,-3378.42
2283519560534227200,2020-03,2901.35,1513.8,2198.72,2375.99,1210.28,-2168.14
2283519560534227200,2020-04,0,3589.04,6881.89,2154.12,1138.73,-1029.41
2283519560534227200,2020-05,3650.18,6667.58,1914.5,1993.21,-3096.11,-4125.52
2283519560534227200,2020-06,1697.83,860.5,5801.47,2746.42,3892.38,-233.14
2283519560534227200,2020-07,283.76,1300,0,1073.83,-2090.07,-2323.21
2283519560534227200,2020-08,2689.79,5626.03,83.47,1732.38,-4585.15,-6908.36
2283519560534227200,2020-09,2865.73,1441.72,3650.96,3358.16,1716.81,-5191.55
2283519560534227200,2020-10,0,2252.54,5611.07,2647.12,711.41,-4480.14
2283519560534227200,2020-12,1354.66,2839.37,3260.68,5433.59,-3657.62,-8137.76
2283821682958408704,2020-01,1635.44,6749.33,0,2266.91,-7380.8,-7380.8
2283821682958408704,2020-02,0,1203.07,224.94,656.87,-1635,-9015.8
2283821682958408704,2020-03,21.23,0,28.17,3865.81,-3816.41,-12832.21
2283821682958408704,2020-04,0,292.75,0,987.2,-1279.95,-14112.16
2283821682958408704,2020-05,1458.59,0,0,403.5,1055.09,-13057.07
2283821682958408704,2020-06,3416.69,2186.61,760.7,1166.54,824.24,-12232.83
2283821682958408704,2020-07,0,1308.45,210.07,4140.64,-5239.02,-17471.85
2283821682958408704,2020-08,1603.04,1592.11,0,580.3,-569.37,-18041.22
2283821682958408704,2020-09,0,451.03,0,0,-451.03,-18492.25
2283821682958408704,2020-11,657.73,0,2627.38,4189.57,-904.46,-19396.71
2283821682958408704,2020-12,3401.26,0,1435.56,0,4836.82,-14559.89
2286048572298639104,2020-01,128.09,1321.3,0,1041.99,-2235.2,-2235.2
2286048572298639104,2020-02,1497.29,1963.06,347.44,0,-118.33,-2353.53
2286048572298639104,2020-03,25.75,381.37,0,1451.19,-1806.81,-4160.34
2286048572298639104,2020-04,5446.18,4344.75,1791.48,0,2892.91,-1267.43
2286048572298639104,2020-05,2312.18,889.37,1445.57,3416.27,-547.89,-1815.32
2286048572298639104,2020-07,1717.12,1214.16,922.98,0,1425.94,-389.38
2286048572298639104,2020-08,3256.15,0,2621.95,0,5878.1,5488.72
2286048572298639104,2020-09,1923.91,1063.61,6341.83,1629.43,5572.7,11061.42
2286048572298639104,2020-10,2011.16,0,347.06,1126.04,1232.18,12293.6
2286048572298639104,2020-11,0,1469.17,1583.06,1657.35,-1543.46,10750.14
2286048572298639104,2020-12,2479.33,2161.23,0,419.39,-101.29,10648.85
2286577424825441280,2020-01,0,1494.69,1399.15,0,-95.54,-95.54
2286577424825441280,2020-02,1636.87,131.44,2998.34,1060.13,3443.64,3348.1
2286577424825441280,2020-03,0,1747.24,4052.44,196.16,2109.04,5457.14
2286577424825441280,2020-04,1848.74,2337.24,1402.24,3708.75,-2795.01,2662.13
2286577424825441280,2020-05,1974.72,1409.92,1482.85,989.3,1058.35,3720.48
2286577424825441280,2020-06,1456.32,3493.65,1748.17,3504.66,-3793.82,-73.34
2286577424825441280,2020-07,2515.14,1807.48,965.53,2947.6,-1274.41,-1347.75
2286577424825441280,2020-08,2014.42,1658.54,0,3029.28,-2673.4,-4021.15
2286577424825441280,2020-09,0,3001.25,1333.66,1583.37,-3250.96,-7272.11
2286577424825441280,2020-10,0,111.72,515.14,972.39,-568.97,-7841.08
2286577424825441280,2020-11,896.33,150.17,2016.37,0,2762.53,-5078.55
2286577424825441280,2020-12,1543.03,0,4072.36,3097.9,2517.49,-2561.06
2286936510519522816,2020-01,5609.34,5981.09,6240.76,5696.1,172.91,172.91
2286936510519522816,2020-02,7105.68,1982.26,2007.3,2027.45,5103.27,5276.18
2286936510519522816,2020-03,4046.72,240.45,3684.55,5833.82,1657,6933.18
2286936510519522816,2020-04,2048.63,2957.38,5255.67,889.63,3457.29,10390.47
2286936510519522816,2020-05,3747.23,6395.54,3404.03,1122.49,-366.77,10023.7
2286936510519522816,2020-06,1454.3,6509.97,1707.21,5477.93,-8826.39,1197.31
2286936510519522816,2020-07,3209.55,0,6851.96,3173.66,6887.85,8085.16
2286936510519522816,2020-08,7004.37,5233.61,71.8,1470.88,371.68,8456.84
2286936510519522816,2020-09,223.21,3524.59,2563.79,8363,-9100.59,-643.75
2286936510519522816,2020-10,3640.67,2424.77,4068.7,3464.44,1820.16,1176.41
2286936510519522816,2020-11,1782.25,3099.92,4583.24,2549.42,716.15,1892.56
2286936510519522816,2020-12,5376.13,2992.07,1817.37,5941.19,-1739.76,152.8
2287273727475731968,2020-03,0,1078.12,794.2,0,-283.92,-283.92
2287273727475731968,2020-07,0,721.03,0,0,-721.03,-1004.95
2287273727475731968,2020-10,0,884.13,0,0,-884.13,-1889.08
2289291147648721408,2020-01,2849.9,3324.56,7894.37,3287.99,4131.72,4131.72
2289291147648721408,2020-02,2025.7,6053.84,3338.54,4237.04,-4926.64,-794.92
2289291147648721408,2020-03,9200.99,6215.16,2209.9,2584.46,2611.27,1816.35
2289291147648721408,2020-04,1354.27,3402.95,3593.51,1751.08,-206.25,1610.1
2289291147648721408,2020-05,3162.74,5546.66,4732.31,5743.01,-3394.62,-1784.52
2289291147648721408,2020-06,7224.06,4563.05,3754.75,7244.06,-828.3,-2612.82
2289291147648721408,2020-07,6949.96,608.41,13837.51,4992.28,15186.78,12573.96
2289291147648721408,2020-08,7960.46,6545.56,4433.34,4738.17,1110.07,13684.03
2289291147648721408,2020-09,12154.42,4662.53,6346.6,4703.72,9134.77,22818.8
2289291147648721408,2020-10,3637.14,2917.12,4556.64,5953.17,-676.51,22142.29
2289291147648721408,2020-11,3650.38,4201.46,4544.4,2025.37,1967.95,24110.24
2289291147648721408,2020-12,6626.19,3924.73,3520.4,2617.47,3604.39,27714.63
2289672585280577280,2020-01,135.07,2750.11,0,2619.27,-5234.31,-5234.31
2289672585280577280,2020-02,2890.44,5906.03,461.47,1796.5,-4350.62,-9584.93
2289672585280577280,2020-03,2281.64,3516,5536.59,446.73,3855.5,-5729.43
2289672585280577280,2020-04,3204.58,609.47,998.15,6841.41,-3248.15,-8977.58
2289672585280577280,2020-05,2342.26,7654.08,1247.39,2627.23,-6691.66,-15669.24
2289672585280577280,2020-06,1188.01,3354.82,1588.09,1447.54,-2026.26,-17695.5
2289672585280577280,2020-07,2792.76,3709.63,3809.15,5720.18,-2827.9,-20523.4
2289672585280577280,2020-08,1545.62,8856.51,1718.34,1367.05,-6959.6,-27483
2289672585280577280,2020-09,2292.98,1255.34,3931.63,4852.34,116.93,-27366.07
2289672585280577280,2020-10,1855.33,2207.85,1037.44,1240.1,-555.18,-27921.25
2289672585280577280,2020-11,494.5,1418.16,1227.37,3431.76,-3128.05,-31049.3
2289672585280577280,2020-12,1625.02,1426.06,4357.27,2684.19,1872.04,-29177.26
2290164923911536384,2020-03,1041.29,0,1331.37,0,2372.66,2372.66
2290164923911536384,2020-04,1414.81,1404.12,0,0,10.69,2383.35
2290164923911536384,2020-08,0,1387.12,0,1599.71,-2986.83,-603.48
2291901824435565568,2020-01,1027.1,439.65,942.06,2272.39,-742.88,-742.88
2291901824435565568,2020-02,0,798.29,727.88,3520.2,-3590.61,-4333.49
2291901824435565568,2020-03,262.78,2796.01,3193.81,1411.46,-750.88,-5084.37
2291901824435565568,2020-04,1468.65,0,0,447.1,1021.55,-4062.82
2291901824435565568,2020-06,1734.01,1612.76,0,905.71,-784.46,-4847.28
2291901824435565568,2020-07,1967.77,3786.35,3193.41,1989.16,-614.33,-5461.61
2291901824435565568,2020-08,411.07,167.36,1957.94,527.38,1674.27,-3787.34
2291901824435565568,2020-09,5833.14,0,0,995.93,4837.21,1049.87
2291901824435565568,2020-10,1733.32,0,0,3652.25,-1918.93,-869.06
2291901824435565568,2020-11,1975.05,0,19.92,1474.81,520.16,-348.9
2291901824435565568,2020-12,2413.69,413.28,555.38,770.08,1785.71,1436.81
2292289988461508096,2020-01,2018.55,1662,1621.3,6074.98,-4097.13,-4097.13
2292289988461508096,2020-02,6686.63,5823.37,3315.87,2031.24,2147.89,-1949.24
2292289988461508096,2020-03,1545.29,4706.14,875.33,5379.19,-7664.71,-9613.95
2292289988461508096,2020-04,10227.52,4682.89,6363.53,5470.38,6437.78,-3176.17
2292289988461508096,2020-05,9939.61,6033.35,2148.13,4868.6,1185.79,-1990.38
2292289988461508096,2020-06,5738.92,3233.3,7711.01,4572.29,5644.34,3653.96
2292289988461508096,2020-07,5211.11,3614.01,7920.02,6534.73,2982.39,6636.35
2292289988461508096,2020-08,2865.32,6369.8,8170.43,11309.16,-6643.21,-6.86
2292289988461508096,2020-09,8290.19,1418.53,1039.96,4238.69,3672.93,3666.07
2292289988461508096,2020-10,4401.16,6052.36,9062.79,1976.4,5435.19,9101.26
2292289988461508096,2020-11,3914.55,2567.51,3634.22,931.93,4049.33,13150.59
2292289988461508096,2020-12,9161.46,8971.19,4027.39,4784.09,-566.43,12584.16
2292329323055182336,2020-01,2351.96,615.63,3705.67,2837.99,2604.01,2604.01
2292329323055182336,2020-02,2407.86,6575.14,4602.16,1823.02,-1388.14,1215.87
2292329323055182336,2020-03,4030.05,1640.91,2748.01,1359.57,3777.58,4993.45
2292329323055182336,2020-04,455.62,8374.54,3450.58,987.8,-5456.14,-462.69
2292329323055182336,2020-05,2823.58,1895.62,5351.08,0,6279.04,5816.35
2292329323055182336,2020-06,1017.78,2572.45,99.03,2168.39,-3624.03,2192.32
2292329323055182336,2020-07,1726.54,777.47,5346.75,2013.91,4281.91,6474.23
2292329323055182336,2020-08,5518.94,2170.18,2678.98,4526.1,1501.64,7975.87
2292329323055182336,2020-09,5552.03,678.04,1800.8,1655.63,5019.16,12995.03
2292329323055182336,2020-10,3450.08,0,1269.69,2000.43,2719.34,15714.37
2292329323055182336,2020-11,3775.48,538.72,2306.88,2581.25,2962.39,18676.76
2292329323055182336,2020-12,2848.19,2254.18,4177.58,1583.42,3188.17,21864.93
2292594730246765824,2020-01,6720.52,3693.56,2134.51,5426.21,-264.74,-264.74
2292594730246765824,2020-02,3266.46,2546.78,4725.03,912.88,4531.83,4267.09
2292594730246765824,2020-03,3636.21,3842.96,4326.42,3107.58,1012.09,5279.18
2292594730246765824,2020-04,7543.04,5462.87,5311.94,1557.69,5834.42,11113.6
2292594730246765824,2020-05,4216.17,10018.75,3543.25,3593.11,-5852.44,5261.16
2292594730246765824,2020-06,4723.62,2898.33,6910.78,6672.25,2063.82,7324.98
2292594730246765824,2020-07,4114.26,2870.09,7732.61,3427.83,5548.95,12873.93
2292594730246765824,2020-08,9691.88,7127.51,7584.76,3773.7,6375.43,19249.36
2292594730246765824,2020-09,6823.86,3724.19,5077.46,2306.91,5870.22,25119.58
2292594730246765824,2020-10,2086.35,5508.94,5221.41,2122.31,-323.49,24796.09
2292594730246765824,2020-11,4934.8,874.76,1949.53,7802.59,-1793.02,23003.07
2292594730246765824,2020-12,5381.89,1962.22,2513.94,469.27,5464.34,28467.41
2295041003909846784,2020-01,4381.13,6355.37,5750.39,1667.63,2108.52,2108.52
2295041003909846784,2020-02,10125.89,3878.08,3051.65,2325.07,6974.39,9082.91
2295041003909846784,2020-03,9366.28,4432.07,5305.56,3378.11,6861.66,15944.57
2295041003909846784,2020-04,9037.41,2843.93,5390.39,5093.6,6490.27,22434.84
2295041003909846784,2020-05,4325.47,1141.62,2502.95,1494,4192.8,26627.64
2295041003909846784,2020-06,5259.08,8062.82,3206.95,4234.89,-3831.68,22795.96
2295041003909846784,2020-07,7421.16,5194.6,4070.94,7530.51,-1233.01,21562.95
2295041003909846784,2020-08,3185.34,4616,6270.18,9021.83,-4182.31,17380.64
2295041003909846784,2020-09,501.84,7732.09,2110.46,5818.5,-10938.29,6442.35
2295041003909846784,2020-10,1759.95,1296.6,6025.78,4335.96,2153.17,8595.52
2295041003909846784,2020-11,3964,2657.87,5494.28,3447.07,3353.34,11948.86
2295041003909846784,2020-12,7451.22,3067.31,3503.96,8322.98,-435.11,11513.75
2296617043393408512,2020-06,1010.52,0,0,1654.63,-644.11,-644.11
2297310400858012672,2020-01,1540.7,0,1499.03,0,3039.73,3039.73
2297310400858012672,2020-02,0,2303.3,589.76,0,-1713.54,1326.19
2297310400858012672,2020-03,107.9,0,1550.29,952.2,705.99,2032.18
2297310400858012672,2020-04,0,704.59,12.97,0,-691.62,1340.56
2297310400858012672,2020-10,874.83,1572.2,1149.86,1026.04,-573.55,767.01
2297310400858012672,2020-11,3072.73,0,1713.67,1742.09,3044.31,3811.32
2297310400858012672,2020-12,1912.6,0,495.47,0,2408.07,6219.39
2297586590197551360,2020-06,1478.12,0,0,0,1478.12,1478.12
2297613130231550208,2020-01,8402.95,1928.56,3145.77,992.85,8627.31,8627.31
2297613130231550208,2020-02,0,2862.86,315.28,1922.13,-4469.71,4157.6
2297613130231550208,2020-03,3159.88,3799.97,760.96,2345.14,-2224.27,1933.33
2297613130231550208,2020-04,1184.49,830.47,1807.3,1023.17,1138.15,3071.48
2297613130231550208,2020-05,470.43,3741.05,0,109.75,-3380.37,-308.89
2297613130231550208,2020-06,1215.44,4624.57,757.76,1492.57,-4143.94,-4452.83
2297613130231550208,2020-07,1789.74,1782.67,3128.68,5200.8,-2065.05,-6517.88
2297613130231550208,2020-08,2419.73,1975.53,4059.38,3668.09,835.49,-5682.39
2297613130231550208,2020-09,0,1784.45,38.34,1493.27,-3239.38,-8921.77
2297613130231550208,2020-10,1738.4,6182.32,3896.09,4890.11,-5437.94,-14359.71
2297613130231550208,2020-11,1288.86,3443.51,7134.81,927.76,4052.4,-10307.31
2297613130231550208,2020-12,0,951.57,7286.88,537.85,5797.46,-4509.85
2299014478187109632,2020-01,3769.7,3495.11,2586.08,1099.32,1761.35,1761.35
2299014478187109632,2020-02,3266.15,2591.51,7070.78,2503.25,5242.17,7003.52
2299014478187109632,2020-03,1677.98,4276.8,4416.65,2371.97,-554.14,6449.38
2299014478187109632,2020-04,2826.02,2512.45,3092.04,5639.41,-2233.8,4215.58
2299014478187109632,2020-05,8328.45,4540.65,3391.5,3260.41,3918.89,8134.47
2299014478187109632,2020-06,7814.62,1153.15,5940.95,1229.67,11372.75,19507.22
2299014478187109632,2020-07,4854.49,2876.2,3870.21,5332.86,515.64,20022.86
2299014478187109632,2020-08,1035.39,3748.55,5012.66,7009.7,-4710.2,15312.66
2299014478187109632,2020-09,7159.22,2279.73,8728.99,9189.63,4418.85,19731.51
2299014478187109632,2020-10,6547.96,4151.98,2531.4,3961.45,965.93,20697.44
2299014478187109632,2020-11,2977.91,3220.98,3956.12,1437.51,2275.54,22972.98
2299014478187109632,2020-12,3412.73,5936.61,6114.3,6914.33,-3323.91,19649.07
2299047513319516928,2020-01,1816.93,1733.07,5245.28,2588.6,2740.54,2740.54
2299047513319516928,2020-02,4543.32,5298.93,3178.75,3819.79,-1396.65,1343.89
2299047513319516928,2020-03,3840.52,1583.18,2727.49,9006.64,-4021.81,-2677.92
2299047513319516928,2020-04,3801.09,1456.02,3277.23,2777.87,2844.43,166.51
2299047513319516928,2020-05,1219.83,3419.53,5078.74,228.01,2651.03,2817.54
2299047513319516928,2020-06,3294.51,6575.59,290.75,405.42,-3395.75,-578.21
2299047513319516928,2020-07,1424.47,389.83,2239.57,2982.65,291.56,-286.65
2299047513319516928,2020-08,4488.99,6008.37,2640.04,3495.72,-2375.06,-2661.71
2299047513319516928,2020-09,1251.65,2139.26,525.48,2853.56,-3215.69,-5877.4
2299047513319516928,2020-10,4367.81,3265.55,1616.28,1034.87,1683.67,-4193.73
2299047513319516928,2020-11,3531.78,4631.19,4223.75,5592.41,-2468.07,-6661.8
2299047513319516928,2020-12,1310.15,2596.8,3290.24,7869.4,-5865.81,-12527.61
2299331487127515904,2020-01,1733.6,2461.44,1861.63,1184.74,-50.95,-50.95
2299331487127515904,2020-02,0,1817.54,1896.96,0,79.42,28.47
2299331487127515904,2020-03,2259.9,346.88,3446.83,1102.67,4257.18,4285.65
2299331487127515904,2020-04,0,1291.27,614.22,0,-677.05,3608.6
2299331487127515904,2020-06,569.27,0,1716.68,100.48,2185.47,5794.07
2299331487127515904,2020-07,1024.01,0,901.23,865.14,1060.1,6854.17
2299331487127515904,2020-08,2078.19,669.18,0,3325.8,-1916.79,4937.38
2299331487127515904,2020-09,3532.69,1195.67,1540.19,2642.61,1234.6,6171.98
2299331487127515904,2020-10,99.08,1773.04,2910.21,6500.36,-5264.11,907.87
2299331487127515904,2020-11,649,0,2497.46,250.26,2896.2,3804.07
2299331487127515904,2020-12,583.06,1475,1580.37,1783.18,-1094.75,2709.32
2299915072135547136,2020-01,0,1517.36,1909.32,2225.79,-1833.83,-1833.83
2299915072135547136,2020-02,3874.85,511.97,0,1384.96,1977.92,144.09
2299915072135547136,2020-03,2351.18,0,4215.83,1224.01,5343,5487.09
2299915072135547136,2020-04,3606.78,5022.11,0,2761.76,-4177.09,1310
2299915072135547136,2020-05,1490.95,2544.24,2715.51,3090.4,-1428.18,-118.18
2299915072135547136,2020-06,1190.44,6973.09,0,2359.49,-8142.14,-8260.32
2299915072135547136,2020-07,2067.19,1642.16,1983.2,2694.92,-286.69,-8547.01
2299915072135547136,2020-08,0,1432.43,2306.02,212.22,661.37,-7885.64
2299915072135547136,2020-09,1142.96,6431.85,80.17,319.19,-5527.91,-13413.55
2299915072135547136,2020-10,107.25,1785.63,313.68,1574.25,-2938.95,-16352.5
2299915072135547136,2020-11,2450.54,5593.22,2067.8,5689.31,-6764.19,-23116.69
2299915072135547136,2020-12,1827.65,1052.37,4287.66,210.3,4852.64,-18264.05
2299949173782468864,2020-01,6522.54,6329.86,0,2042.42,-1849.74,-1849.74
2299949173782468864,2020-02,833.82,5564.35,868.4,3376.94,-7239.07,-9088.81
2299949173782468864,2020-03,1378.6,4042.78,2518.44,3491.59,-3637.33,-12726.14
2299949173782468864,2020-04,3477.6,1041.25,3378.06,0,5814.41,-6911.73
2299949173782468864,2020-05,6014.77,4415.49,3293.57,3958.9,933.95,-5977.78
2299949173782468864,2020-06,1552.34,2883.51,3429.59,3387.74,-1289.32,-7267.1
2299949173782468864,2020-07,1781.5,1957.04,5215.91,3557.36,1483.01,-5784.09
2299949173782468864,2020-08,1505.52,1801.77,3019.57,1468.76,1254.56,-4529.53
2299949173782468864,2020-09,2626.45,4378.27,3933.89,297.19,1884.88,-2644.65
2299949173782468864,2020-10,7669.62,4040.73,2333.27,1053.06,4909.1,2264.45
2299949173782468864,2020-11,1751.93,5914.01,3531.34,1898.22,-2528.96,-264.51
2299949173782468864,2020-12,1360.72,1322.64,1879.88,1718.18,199.78,-64.73
2300550437634078208,2020-01,6365.87,8581.17,4916.51,2556.21,145,145
2300550437634078208,2020-02,5945.31,3406.04,6608.6,5673.18,3474.69,3619.69
2300550437634078208,2020-03,5487.95,9629.99,2995.07,3366.47,-4513.44,-893.75
2300550437634078208,2020-04,3346.32,3918.09,3895.82,7627.47,-4303.42,-5197.17
2300550437634078208,2020-05,2095.19,5881.71,12918.37,5512.12,3619.73,-1577.44
2300550437634078208,2020-06,6714.02,4252.76,4029.49,315.35,6175.4,4597.96
2300550437634078208,2020-07,4445.59,4399.25,3986.91,4079.07,-45.82,4552.14
2300550437634078208,2020-08,3624.06,3624.73,5288.53,14972.73,-9684.87,-5132.73
2300550437634078208,2020-09,2444.48,3908.55,3438.18,5802.41,-3828.3,-8961.03
2300550437634078208,2020-10,5537.54,4720.75,288.42,7619.55,-6514.34,-15475.37
2300550437634078208,2020-11,4200.27,3504.53,3474.37,6860.93,-2690.82,-18166.19
2300550437634078208,2020-12,5403.99,6250.9,1823.93,4899.27,-3922.25,-22088.44
2302004254620707840,2020-01,6936.63,5215.11,7535.13,3128.05,6128.6,6128.6
2302004254620707840,2020-02,2495.64,4689.16,1988.73,5033.76,-5238.55,890.05
2302004254620707840,2020-03,5601.17,4827.3,3729.67,2904.48,1599.06,2489.11
2302004254620707840,2020-04,2785.36,6362.51,5560.6,3165.4,-1181.95,1307.16
2302004254620707840,2020-05,2560.36,3656.57,3374.49,5256.09,-2977.81,-1670.65
2302004254620707840,2020-06,5489.89,480.65,3061.69,4313.49,3757.44,2086.79
2302004254620707840,2020-07,1733.27,119.61,2263.46,4408.55,-531.43,1555.36
2302004254620707840,2020-08,2017.47,2492.14,4122.45,1999.65,1648.13,3203.49
2302004254620707840,2020-09,1565.28,1911.61,843.5,4425.96,-3928.79,-725.3
2302004254620707840,2020-10,5188.11,4707.48,1601.67,1657.95,424.35,-300.95
2302004254620707840,2020-11,4177.05,6474.06,2480.88,3035.8,-2851.93,-3152.88
2302004254620707840,2020-12,1234.06,2254.11,4057.43,717.8,2319.58,-833.3
2303009149229497600,2020-01,981.49,1407.87,3739.52,768.4,2544.74,2544.74
2303009149229497600,2020-02,4142.72,5623.97,4999.28,1601.21,1916.82,4461.56
2303009149229497600,2020-03,5116.32,1658.35,5596.3,3391.77,5662.5,10124.06
2303009149229497600,2020-04,4904.74,1943.75,1224.75,2970.42,1215.32,11339.38
2303009149229497600,2020-05,2421.74,2526.02,2055.31,29.85,1921.18,13260.56
2303009149229497600,2020-06,2470.3,1184.85,2771.53,2955.43,1101.55,14362.11
2303009149229497600,2020-07,2045.53,3533.25,2899.66,2175.3,-763.36,13598.75
2303009149229497600,2020-08,1059.87,5215.08,1017.11,1495.5,-4633.6,8965.15
2303009149229497600,2020-09,1725.54,193.03,4041.75,3224.5,2349.76,11314.91
2303009149229497600,2020-10,2450.78,1193.88,3079.62,2049.56,2286.96,13601.87
2303009149229497600,2020-11,3798.9,1412.39,0,1527.63,858.88,14460.75
2303009149229497600,2020-12,1360.51,2714.92,1901.94,0,547.53,15008.28
2303711202034298624,2020-01,2208.56,2079.34,2565.92,6295.63,-3600.49,-3600.49
2303711202034298624,2020-02,1263.51,1358.26,3294.41,6128.64,-2928.98,-6529.47
2303711202034298624,2020-03,3744.75,2922.92,2202.78,3222.45,-197.84,-6727.31
2303711202034298624,2020-04,1970,4856.15,2002.01,4251.33,-5135.47,-11862.78
2303711202034298624,2020-05,2130.62,3624.66,4735.66,1946.4,1295.22,-10567.56
2303711202034298624,2020-06,4340.04,5414.38,0,517.29,-1591.63,-12159.19
2303711202034298624,2020-07,1960.02,6234.92,5185.02,1952.07,-1041.95,-13201.14
2303711202034298624,2020-08,5900.88,7170.22,2422.91,2684.26,-1530.69,-14731.83
2303711202034298624,2020-09,9870.83,3668.62,3607.61,5670.21,4139.61,-10592.22
2303711202034298624,2020-10,5037.47,3961.71,4285.09,2809.31,2551.54,-8040.68
2303711202034298624,2020-11,6003.71,3439.67,9010.05,553.45,11020.64,2979.96
2303711202034298624,2020-12,1026.15,3794.13,6251.16,2322.76,1160.42,4140.38
2306020857111734784,2020-01,3521.64,5792.97,1815.22,5032.18,-5488.29,-5488.29
2306020857111734784,2020-02,3633.26,2073.94,1614.26,4603.8,-1430.22,-6918.51
2306020857111734784,2020-03,2474.08,9558.29,5546.31,878.4,-2416.3,-9334.81
2306020857111734784,2020-04,4044.29,2041.03,2739.9,4982.72,-239.56,-9574.37
2306020857111734784,2020-05,7285.4,7159.06,968.89,4660.03,-3564.8,-13139.17
2306020857111734784,2020-06,2289.36,4267.56,4925.45,7044.15,-4096.9,-17236.07
2306020857111734784,2020-07,6472.49,8556.23,5027.61,5579.14,-2635.27,-19871.34
2306020857111734784,2020-08,2118.98,5159.42,1882.2,3826.48,-4984.72,-24856.06
2306020857111734784,2020-09,152.95,4132.89,5176.83,2377.32,-1180.43,-26036.49
2306020857111734784,2020-10,0,1805.47,6985.29,5332,-152.18,-26188.67
2306020857111734784,2020-11,2055.6,6041.67,3618,3017.73,-3385.8,-29574.47
2306020857111734784,2020-12,3742.72,1669.38,10359.83,1723.93,10709.24,-18865.23
2306444016863822848,2020-01,3198.49,0,1026.49,1859.67,2365.31,2365.31
2306444016863822848,2020-02,87.16,0,1122.85,1367.67,-157.66,2207.65
2306444016863822848,2020-03,0,374.91,244.21,0,-130.7,2076.95
2306444016863822848,2020-05,0,2467.32,0,2011.71,-4479.03,-2402.08
2306444016863822848,2020-06,365.48,270.34,1579.7,3132.78,-1457.94,-3860.02
2306444016863822848,2020-07,1318.3,452.39,0,2209.39,-1343.48,-5203.5
2306444016863822848,2020-08,1487.75,0,1513.04,0,3000.79,-2202.71
2306444016863822848,2020-09,0,528.99,2725.96,3146.28,-949.31,-3152.02
2306444016863822848,2020-11,187.88,1572.64,3918.03,695.93,1837.34,-1314.68
2306444016863822848,2020-12,2285.47,1708.75,3279.74,1727.87,2128.59,813.91
2310401459574087680,2020-01,0,7139.1,5379.93,0,-1759.17,-1759.17
2310401459574087680,2020-02,3877.33,2652.37,819.97,1481.27,563.66,-1195.51
2310401459574087680,2020-03,664.48,819.78,3291.01,2090.95,1044.76,-150.75
2310401459574087680,2020-04,2923.13,0,832.15,853.86,2901.42,2750.67
2310401459574087680,2020-05,5533.3,549.79,4038.09,3499.54,5522.06,8272.73
2310401459574087680,2020-06,52.16,2666.26,4176.2,2548.43,-986.33,7286.4
2310401459574087680,2020-07,1500.72,5206.39,0,0,-3705.67,3580.73
2310401459574087680,2020-08,2180.51,1138.32,1740.84,2851.91,-68.88,3511.85
2310401459574087680,2020-09,2531.22,563.1,1927.44,677.34,3218.22,6730.07
2310401459574087680,2020-10,4852.94,2338.76,1229.56,1595.15,2148.59,8878.66
2310401459574087680,2020-11,1850.33,1788.13,498.92,1464.13,-903.01,7975.65
2310401459574087680,2020-12,1434.43,543.87,1661.88,4339.47,-1787.03,6188.62
2310935689455269376,2020-01,875.69,0,1180.38,734.79,1321.28,1321.28
2310935689455269376,2020-02,196.86,497.61,1771.24,0,1470.49,2791.77
2310935689455269376,2020-03,1303.56,1314.15,3151.5,0,3140.91,5932.68
2310935689455269376,2020-04,3204.74,2185.09,341.88,0,1361.53,7294.21
2310935689455269376,2020-05,2529.69,400.83,2696.71,0,4825.57,12119.78
2310935689455269376,2020-07,1025.84,1.64,0,3069.97,-2045.77,10074.01
2310935689455269376,2020-08,0,1507.38,1024.01,847.88,-1331.25,8742.76
2310935689455269376,2020-09,0,2527.07,443.31,1285.25,-3369.01,5373.75
2310935689455269376,2020-11,0,778.32,0,1425.82,-2204.14,3169.61
2311079965631437824,2020-01,6057.21,2853.82,4400.21,231.64,7371.96,7371.96
2311079965631437824,2020-02,1961.97,1594.57,1224.61,2118.18,-526.17,6845.79
2311079965631437824,2020-03,4833.66,1766.76,2766.94,2091.41,3742.43,10588.22
2311079965631437824,2020-04,0,3967.61,4026.4,0,58.79,10647.01
2311079965631437824,2020-05,1672.9,0,0,526.29,1146.61,11793.62
2311079965631437824,2020-06,2466.69,385.2,1154.69,300.9,2935.28,14728.9
2311079965631437824,2020-07,3262.6,3877.56,4056,2217.77,1223.27,15952.17
2311079965631437824,2020-08,165.86,206.76,1997.63,5900.42,-3943.69,12008.48
2311079965631437824,2020-09,716.34,4513.68,141.43,4851.76,-8507.67,3500.81
2311079965631437824,2020-10,1167.93,4494.12,110.51,3768.17,-6983.85,-3483.04
2311079965631437824,2020-11,2827.37,4986.07,1569.29,3484.54,-4073.95,-7556.99
2311079965631437824,2020-12,0,1246.69,3307.1,4406.82,-2346.41,-9903.4
2311412135521568768,2020-01,2911.69,2841.16,1394.77,2417.62,-952.32,-952.32
2311412135521568768,2020-02,1470.79,1168.88,3240.54,2090.66,1451.79,499.47
2311412135521568768,2020-03,1718.33,7991.77,8309.97,1952.63,83.9,583.37
2311412135521568768,2020-04,5272.87,2925.73,5874.82,7298.71,923.25,1506.62
2311412135521568768,2020-05,1491.51,5264.79,5722.43,3557.32,-1608.17,-101.55
2311412135521568768,2020-06,4012.38,2446.11,1426.16,2879.08,113.35,11.8
2311412135521568768,2020-07,4766.15,0,2990.53,3512.58,4244.1,4255.9
2311412135521568768,2020-08,6525.71,2405.66,207.8,3758.07,569.78,4825.68
2311412135521568768,2020-09,2462.86,4671.8,0,1479.88,-3688.82,1136.86
2311412135521568768,2020-10,2492.06,2205.45,3886.29,4113.6,59.3,1196.16
2311412135521568768,2020-11,4343.94,1844.37,5341.64,807.55,7033.66,8229.82
2311412135521568768,2020-12,2476.67,1439.71,2419.86,3760.2,-303.38,7926.44
2312205438924781568,2020-01,12081.16,6671.73,5136.43,903.98,9641.88,9641.88
2312205438924781568,2020-02,2277.4,2115.58,323.35,1772.49,-1287.32,8354.56
2312205438924781568,2020-03,8235.04,712.01,1381.06,1036.05,7868.04,16222.6
2312205438924781568,2020-04,0,3891.64,6111.66,3520.67,-1300.65,14921.95
2312205438924781568,2020-05,7400.23,5035.17,1455.79,3840.69,-19.84,14902.11
2312205438924781568,2020-06,396.75,3139.48,567.15,4120.58,-6296.16,8605.95
2312205438924781568,2020-07,2337.7,0,7759.28,184.15,9912.83,18518.78
2312205438924781568,2020-08,2849.04,4541.52,3675.63,3813.94,-1830.79,16687.99
2312205438924781568,2020-09,8179.08,3253.4,2270.11,1874.25,5321.54,22009.53
2312205438924781568,2020-10,1823.63,2507.02,3358.44,6976.56,-4301.51,17708.02
2312205438924781568,2020-11,3531.72,0,4797.77,6565.2,1764.29,19472.31
2312205438924781568,2020-12,3077.45,2748.23,6391.26,0,6720.48,26192.79
2316202346132320768,2020-01,3881.92,1978.84,1071.23,1542.79,1431.52,1431.52
2316202346132320768,2020-02,1587.07,72.92,4207.49,1851.89,3869.75,5301.27
2316202346132320768,2020-03,665.3,40.16,0,655.75,-30.61,5270.66
2316202346132320768,2020-04,0,1601.04,520.46,1212.5,-2293.08,2977.58
2316202346132320768,2020-05,3869.82,1458.7,5404.76,0,7815.88,10793.46
2316202346132320768,2020-06,966.71,510.63,4834.66,130.95,5159.79,15953.25
2316202346132320768,2020-07,2164.59,2259.55,2354.98,0,2260.02,18213.27
2316202346132320768,2020-08,3236.38,151.35,670.07,276.12,3478.98,21692.25
2316202346132320768,2020-09,301.75,0,1123.84,2704.69,-1279.1,20413.15
2316202346132320768,2020-10,0,751.32,1648.62,5149.84,-4252.54,16160.61
2316202346132320768,2020-11,1661.34,0,2902.61,2741.16,1822.79,17983.4
2316202346132320768,2020-12,850.99,2940.85,2111.09,3080.16,-3058.93,14924.47
2316547922174120960,2020-01,4397.15,2246.28,0,0,2150.87,2150.87
2316547922174120960,2020-02,0,936.69,309.17,0,-627.52,1523.35
2316547922174120960,2020-03,721.03,0,2846.63,0,3567.66,5091.01
2316547922174120960,2020-05,1007,709.93,232.71,0,529.78,5620.79
2316547922174120960,2020-06,86.86,3719.29,4432.37,610.6,189.34,5810.13
2316547922174120960,2020-07,1717.4,1871.69,2729.31,2074.82,500.2,6310.33
2316547922174120960,2020-08,2812.19,1368.26,1739.97,394.37,2789.53,9099.86
2316547922174120960,2020-09,562.62,1770.46,831.02,0,-376.82,8723.04
2316547922174120960,2020-10,797.36,314.07,633.84,0,1117.13,9840.17
2316547922174120960,2020-12,3142.28,1423.26,0,0,1719.02,11559.19
2316879883689699328,2020-01,859.06,40.48,0,0,818.58,818.58
2316879883689699328,2020-02,168.58,1904.08,0,0,-1735.5,-916.92
2316879883689699328,2020-03,1572.21,1210.4,2002.03,1928.1,435.74,-481.18
2316879883689699328,2020-04,1269.07,0,1453.51,0,2722.58,2241.4
2316879883689699328,2020-05,207.42,1836.19,2243.11,0,614.34,2855.74
2316879883689699328,2020-06,0,2100.27,3728.51,2380.66,-752.42,2103.32
2316879883689699328,2020-07,354.19,922.56,0,1574.78,-2143.15,-39.83
2316879883689699328,2020-08,678.01,198.22,0,1999.19,-1519.4,-1559.23
2316879883689699328,2020-09,1808.68,3979.33,755.87,0,-1414.78,-2974.01
2316879883689699328,2020-10,1992.82,336.71,1303.15,0,2959.26,-14.75
2316879883689699328,2020-11,2100.05,4623.46,0,1965.69,-4489.1,-4503.85
2316879883689699328,2020-12,1778.67,2592.12,0,730.47,-1543.92,-6047.77
2316988791745645568,2020-01,860.11,0,0,1136.53,-276.42,-276.42
2316988791745645568,2020-04,493.06,0,0,0,493.06,216.64
2316988791745645568,2020-05,0,1505.84,0,877.16,-2383,-2166.36
2316988791745645568,2020-06,0,94.96,0,0,-94.96,-2261.32
2317485633360963072,2020-02,700.73,0,0,0,700.73,700.73
2317485633360963072,2020-04,0,1476.63,0,499.23,-1975.86,-1275.13
2317485633360963072,2020-10,600.64,0,0,0,600.64,-674.49
2317485633360963072,2020-12,0,738.52,0,0,-738.52,-1413.01
2317551296193983488,2020-01,0,912.54,4178.82,0,3266.28,3266.28
2317551296193983488,2020-02,1374.69,0,1581.28,0,2955.97,6222.25
2317551296193983488,2020-03,3264.39,0,1071.52,2578.92,1756.99,7979.24
2317551296193983488,2020-04,1277.4,2498.66,3614.32,2019.34,373.72,8352.96
2317551296193983488,2020-05,1459.31,4646.39,2147.05,811.87,-1851.9,6501.06
2317551296193983488,2020-07,0,1786.3,0,0,-1786.3,4714.76
2317551296193983488,2020-08,959.33,2310.09,483.81,1878.23,-2745.18,1969.58
2317551296193983488,2020-09,0,1791.84,1300.79,1906.13,-2397.18,-427.6
2317551296193983488,2020-10,2678.9,0,123.07,1355.73,1446.24,1018.64
2317551296193983488,2020-11,0,1283.29,0,294.57,-1577.86,-559.22
2317551296193983488,2020-12,0,2354.82,1210.03,1585.32,-2730.11,-3289.33
2317679666659959808,2020-01,5890.7,7318.24,2951.83,1878.18,-353.89,-353.89
2317679666659959808,2020-02,1908.08,4612.57,5671.22,7988.6,-5021.87,-5375.76
2317679666659959808,2020-03,1855.2,1759,2360.81,4198.59,-1741.58,-7117.34
2317679666659959808,2020-04,5651.81,3945.86,6012.02,3110.7,4607.27,-2510.07
2317679666659959808,2020-05,6894.99,2372.99,4231.88,9040.85,-286.97,-2797.04
2317679666659959808,2020-06,3925.68,3244.6,2566.29,4377.83,-1130.46,-3927.5
2317679666659959808,2020-07,6109.43,5454.21,3834.49,4571.88,-82.17,-4009.67
2317679666659959808,2020-08,6323.9,5720.26,6242.76,6521.43,324.97,-3684.7
2317679666659959808,2020-09,3326.6,6962.74,9308.94,3727.44,1945.36,-1739.34
2317679666659959808,2020-10,5570.75,10374.2,6576.88,5750.76,-3977.33,-5716.67
2317679666659959808,2020-11,1767.71,467.73,6269.53,4040.74,3528.77,-2187.9
2317679666659959808,2020-12,4105.62,9877.18,5615.02,5211.38,-5367.92,-7555.82
2317955315120175104,2020-01,0,1954.17,571.51,677.98,-2060.64,-2060.64
2317955315120175104,2020-03,0,829.51,1512.12,0,682.61,-1378.03
2317955315120175104,2020-05,3330.18,0,0,440.4,2889.78,1511.75
2317955315120175104,2020-06,1713.33,0,2342.15,49.79,4005.69,5517.44
2317955315120175104,2020-07,0,845.98,0,1576.65,-2422.63,3094.81
2317955315120175104,2020-08,134.17,0,0,457.06,-322.89,2771.92
2317955315120175104,2020-09,2532.87,0,579.7,4099.48,-986.91,1785.01
2317955315120175104,2020-12,1785.58,0,1684.65,0,3470.23,5255.24
2318231791094333440,2020-01,2556.82,2845.84,0,1975.79,-2264.81,-2264.81
2318231791094333440,2020-02,2254.73,3961.27,0,3189.63,-4896.17,-7160.98
2318231791094333440,2020-03,1921.35,1943.78,7362.59,910.75,6429.41,-731.57
2318231791094333440,2020-04,579.04,3473.94,186.71,115.25,-2823.44,-3555.01
2318231791094333440,2020-05,2120.7,3124.46,1273.87,2709.9,-2439.79,-5994.8
2318231791094333440,2020-06,3693.28,829.73,1210.95,7822.49,-3747.99,-9742.79
2318231791094333440,2020-07,2302.26,2905.17,1701.9,3784,-2685.01,-12427.8
2318231791094333440,2020-08,2114.27,2275.47,37.26,1179.25,-1303.19,-13730.99
2318231791094333440,2020-09,3898.04,3421.42,0,415.21,61.41,-13669.58
2318231791094333440,2020-10,1061.58,122.59,892.61,1529.84,301.76,-13367.82
2318231791094333440,2020-11,804.59,3847.34,0,0,-3042.75,-16410.57
2318231791094333440,2020-12,5439.94,4047.06,0,0,1392.88,-15017.69
2318283118841375744,2020-01,3794.59,7418.88,1293.95,6271.44,-8601.78,-8601.78
2318283118841375744,2020-02,7549.16,3370.39,1957.9,3440.42,2696.25,-5905.53
2318283118841375744,2020-03,886.44,3214.04,1153.32,5027.9,-6202.18,-12107.71
2318283118841375744,2020-04,7135.69,2792.46,4378.77,1349.55,7372.45,-4735.26
2318283118841375744,2020-05,4765.95,3272.1,3927.3,5575.67,-154.52,-4889.78
2318283118841375744,2020-06,1922.59,1140.34,6093.88,4905.44,1970.69,-2919.09
2318283118841375744,2020-07,1054.19,1955.4,5063.84,1440.44,2722.19,-196.9
2318283118841375744,2020-08,4853.95,6022.99,4828.41,12041.65,-8382.28,-8579.18
2318283118841375744,2020-09,1891.44,6690.84,1988.86,4397.08,-7207.62,-15786.8
2318283118841375744,2020-10,3338.27,1147.79,5971.83,4643.44,3518.87,-12267.93
2318283118841375744,2020-11,516.86,8050.3,3765.56,4408.42,-8176.3,-20444.23
2318283118841375744,2020-12,11518.02,7536.17,351.31,4830.33,-497.17,-20941.4
2318900712621327872,2020-01,8244.22,5231.83,1429.08,2193.97,2247.5,2247.5
2318900712621327872,2020-02,3753.91,6993.57,751.33,2621.57,-5109.9,-2862.4
2318900712621327872,2020-03,2829.32,4696.48,3582.33,5470.46,-3755.29,-6617.69
2318900712621327872,2020-04,5261.08,2848.96,3852.51,3434.45,2830.18,-3787.51
2318900712621327872,2020-05,4669.87,2470.99,3651.11,3709.46,2140.53,-1646.98
2318900712621327872,2020-07,1543.91,4877.54,3203.99,3181.05,-3310.69,-4957.67
2318900712621327872,2020-08,4374.52,0,4804.89,4615.12,4564.29,-393.38
2318900712621327872,2020-09,5436.55,5508.19,1219.48,4494.91,-3347.07,-3740.45
2318900712621327872,2020-10,5696.76,974.81,1245.18,2685.73,3281.4,-459.05
2318900712621327872,2020-11,2449.52,1011.24,4391.24,1607.96,4221.56,3762.51
2318900712621327872,2020-12,2760.53,7385.23,1615.79,4073.66,-7082.57,-3320.06
2319555182996340224,2020-01,572.96,0,1169.06,3434.61,-1692.59,-1692.59
2319555182996340224,2020-02,3065.77,4349.83,1862.06,1770.68,-1192.68,-2885.27
2319555182996340224,2020-03,1825.21,1637.77,898.16,1867.03,-781.43,-3666.7
2319555182996340224,2020-04,3564.82,2538.75,1515.89,2759.76,-217.8,-3884.5
2319555182996340224,2020-05,149.83,879.33,1176.61,497.36,-50.25,-3934.75
2319555182996340224,2020-06,406.43,1023.49,2643.21,2951.06,-924.91,-4859.66
2319555182996340224,2020-07,0,1054.07,366.71,1518.59,-2205.95,-7065.61
2319555182996340224,2020-08,0,1206.24,2861.74,1340.89,314.61,-6751
2319555182996340224,2020-09,1915.64,1770.03,436.07,0,581.68,-6169.32
2319555182996340224,2020-10,2625.49,0,77.54,2906.54,-203.51,-6372.83
2319555182996340224,2020-11,1115.09,3919.64,0,0,-2804.55,-9177.38
2319555182996340224,2020-12,5627.4,2450.18,1387.38,335.94,4228.66,-4948.72
2320457909865983488,2020-01,1562.37,3951.55,1908.51,0,-480.67,-480.67
2320457909865983488,2020-02,4207.43,6992.36,4892.63,4388.88,-2281.18,-2761.85
2320457909865983488,2020-03,4686.81,6307.8,5470.7,7460.17,-3610.46,-6372.31
2320457909865983488,2020-04,4807.67,7643.25,5815.46,2391.46,588.42,-5783.89
2320457909865983488,2020-05,7384.3,3822.86,6535.13,9254.08,842.49,-4941.4
2320457909865983488,2020-06,5714.19,3706.29,2157.82,5060.99,-895.27,-5836.67
2320457909865983488,2020-07,3643.47,4494.63,2282.23,3925.76,-2494.69,-8331.36
2320457909865983488,2020-08,2651.6,3166.9,5480.46,7670.6,-2705.44,-11036.8
2320457909865983488,2020-09,4554.6,3510.28,4083.41,1161.66,3966.07,-7070.73
2320457909865983488,2020-10,4316.45,4106.23,3576.08,3487.25,299.05,-6771.68
2320457909865983488,2020-11,7140.6,3932.29,1059.98,4827.41,-559.12,-7330.8
2320457909865983488,2020-12,3769.83,1033.44,2038.15,3039.8,1734.74,-5596.06
2321541631533315072,2020-01,324.52,1501.23,2301.21,1980.04,-855.54,-855.54
2321541631533315072,2020-02,2207.62,1610.01,2224.43,324.07,2497.97,1642.43
2321541631533315072,2020-03,3567.51,1786.68,4093.5,1719.23,4155.1,5797.53
2321541631533315072,2020-04,4387.3,0,2243.41,2743,3887.71,9685.24
2321541631533315072,2020-05,0,325.78,1004.24,1976.25,-1297.79,8387.45
2321541631533315072,2020-06,3263.81,1809.51,3683.94,1845.49,3292.75,11680.2
2321541631533315072,2020-07,0,1611.36,255.4,2597.96,-3953.92,7726.28
2321541631533315072,2020-08,7284.2,4465.48,2256.01,1555.33,3519.4,11245.68
2321541631533315072,2020-09,1724.18,790.58,0,2708.8,-1775.2,9470.48
2321541631533315072,2020-10,0,2497.93,4736.68,30.52,2208.23,11678.71
2321541631533315072,2020-11,4828.96,473.75,609.49,2502.03,2462.67,14141.38
2321541631533315072,2020-12,1667.88,1945.68,0,3442.94,-3720.74,10420.64
2322156052298268672,2020-01,2406.47,1645.65,765.06,3227.42,-1701.54,-1701.54
2322156052298268672,2020-02,822.07,1725.29,0,891.16,-1794.38,-3495.92
2322156052298268672,2020-03,3184.2,1551.58,4421.36,1328.36,4725.62,1229.7
2322156052298268672,2020-04,863.88,2838.52,2299.1,1199.34,-874.88,354.82
2322156052298268672,2020-05,2260.22,543.46,351.98,1843.14,225.6,580.42
2322156052298268672,2020-06,850.8,889.59,830.79,711.66,80.34,660.76
2322156052298268672,2020-07,0,1988.47,4564.52,268.57,2307.48,2968.24
2322156052298268672,2020-08,1312.87,2905.67,1068.62,0,-524.18,2444.06
2322156052298268672,2020-09,1116.27,0,310.94,6466.57,-5039.36,-2595.3
2322156052298268672,2020-10,585.06,1098.82,636.75,0,122.99,-2472.31
2322156052298268672,2020-11,51.46,8430.49,0,2903.66,-11282.69,-13755
2322156052298268672,2020-12,554.82,848.3,1414.75,1428.67,-307.4,-14062.4
2322644236481386496,2020-01,612.84,0,0,35.91,576.93,576.93
2322644236481386496,2020-02,0,474.28,2327.32,0,1853.04,2429.97
2322644236481386496,2020-03,0,2851.71,0,1662.17,-4513.88,-2083.91
2322644236481386496,2020-04,3519.48,2097.63,0,2212.07,-790.22,-2874.13
2322644236481386496,2020-05,3382.15,333.38,0,1736.34,1312.43,-1561.7
2322644236481386496,2020-06,1900.7,1934.61,2036.74,38.53,1964.3,402.6
2322644236481386496,2020-08,2779.03,204.21,1496.06,1262.55,2808.33,3210.93
2322644236481386496,2020-09,2247.63,527.55,531.18,2282.01,-30.75,3180.18
2322644236481386496,2020-10,1259.92,1680.55,358.61,2831.2,-2893.22,286.96
2322644236481386496,2020-11,1170.41,0,0,1608.96,-438.55,-151.59
2322644236481386496,2020-12,0,1728.4,641.55,0,-1086.85,-1238.44
2323236305807938048,2020-01,480.58,700.54,1939.47,963.29,756.22,756.22
2323236305807938048,2020-02,570,2197.45,1123.07,1842.11,-2346.49,-1590.27
2323236305807938048,2020-03,1461.58,474.94,2827.16,4336.53,-522.73,-2113
2323236305807938048,2020-04,2065.38,983.42,612.83,1409.53,285.26,-1827.74
2323236305807938048,2020-05,1458.32,3110.22,485.01,0,-1166.89,-2994.63
2323236305807938048,2020-06,0,1017.07,0,1917.92,-2934.99,-5929.62
2323236305807938048,2020-07,0,1735.04,1164.61,3787.74,-4358.17,-10287.79
2323236305807938048,2020-08,6113.77,3823.66,897.8,1680.55,1507.36,-8780.43
2323236305807938048,2020-09,741.01,0,26.91,457.31,310.61,-8469.82
2323236305807938048,2020-10,446.95,3730.99,1697.33,3716.37,-5303.08,-13772.9
2323236305807938048,2020-11,5027.75,1444.55,2183.06,2686.14,3080.12,-10692.78
2323236305807938048,2020-12,1421.15,842.4,1432.22,882.68,1128.29,-9564.49
2323978542897495040,2020-01,1253.53,5071.68,2482.94,4332.93,-5668.14,-5668.14
2323978542897495040,2020-02,340.15,95.07,3495.4,4886.69,-1146.21,-6814.35
2323978542897495040,2020-03,1175.31,3001.99,6986.9,0,5160.22,-1654.13
2323978542897495040,2020-04,11191.83,3490.25,4037.83,2895.22,8844.19,7190.06
2323978542897495040,2020-05,6795.55,2359.97,4020.76,4377.45,4078.89,11268.95
2323978542897495040,2020-06,2542.52,2825.64,1931.57,4401.84,-2753.39,8515.56
2323978542897495040,2020-07,4347.13,2767.43,9907.17,1050.32,10436.55,18952.11
2323978542897495040,2020-08,1537.26,945.82,3460.63,1953.47,2098.6,21050.71
2323978542897495040,2020-09,5662.09,4026.05,5149.77,2861.84,3923.97,24974.68
2323978542897495040,2020-10,6247.73,6191.16,3037.14,3397.56,-303.85,24670.83
2323978542897495040,2020-11,4741.75,4441.25,1617.48,6959.63,-5041.65,19629.18
2323978542897495040,2020-12,484.58,1230.01,1745.04,2282.17,-1282.56,18346.62
2324099637014438912,2020-01,0,72.71,1137.49,828.9,235.88,235.88
2324099637014438912,2020-02,733.02,2784.23,0,0,-2051.21,-1815.33
2324099637014438912,2020-03,701.07,0,0,0,701.07,-1114.26
2324099637014438912,2020-04,2513.7,0,0,896.6,1617.1,502.84
2324099637014438912,2020-05,0,665.85,0,102.12,-767.97,-265.13
2324099637014438912,2020-06,0,1156.19,258.29,0,-897.9,-1163.03
2324099637014438912,2020-10,1092.97,995.12,1364.31,684.29,777.87,-385.16
2324099637014438912,2020-11,1510.44,0,0,0,1510.44,1125.28
2324099637014438912,2020-12,0,2489.79,0,0,-2489.79,-1364.51
2329914553128725504,2020-01,4415.97,11970.99,9092.97,4828.36,-3290.41,-3290.41
2329914553128725504,2020-02,3106.09,7957.29,6070.16,2082.47,-863.51,-4153.92
2329914553128725504,2020-03,3961.54,1803.3,3826.12,7263.16,-1278.8,-5432.72
2329914553128725504,2020-04,6844.21,1721.88,3828.36,3549.92,5400.77,-31.95
2329914553128725504,2020-05,2535.36,5363.25,3685.44,6060.43,-5202.88,-5234.83
2329914553128725504,2020-06,5741.26,1545.43,2202.9,3053.19,3345.54,-1889.29
2329914553128725504,2020-07,5062.63,6160.38,2824.21,10954.45,-9227.99,-11117.28
2329914553128725504,2020-08,4625.13,3207.63,5356.93,637.07,6137.36,-4979.92
2329914553128725504,2020-09,11359.48,4123.51,6664.7,2193.89,11706.78,6726.86
2329914553128725504,2020-10,3919.94,4538.67,5832.99,3561.2,1653.06,8379.92
2329914553128725504,2020-11,6605.61,4420.65,3484.47,3397.01,2272.42,10652.34
2329914553128725504,2020-12,6530.55,4717.35,16519.58,6148.47,12184.31,22836.65
2332849556588752384,2020-02,1095.86,0,1579.61,0,2675.47,2675.47
2332849556588752384,2020-03,0,75.87,0,0,-75.87,2599.6
2332849556588752384,2020-04,0,1496.61,0,990.57,-2487.18,112.42
2332849556588752384,2020-05,1301.16,293.36,1651.01,1885.87,772.94,885.36
2332849556588752384,2020-06,1682.34,1929.77,0,0,-247.43,637.93
2332849556588752384,2020-07,1712.77,3314.09,0,0,-1601.32,-963.39
2332849556588752384,2020-08,1874.52,761.12,1093.74,583.97,1623.17,659.78
2332849556588752384,2020-09,0,97.41,1140.36,0,1042.95,1702.73
2332849556588752384,2020-10,0,643.8,0,1405.68,-2049.48,-346.75
2333557098018106880,2020-01,1979.93,5793.86,0,325.88,-4139.81,-4139.81
2333557098018106880,2020-02,5312.04,4234.32,2401.88,2862.73,616.87,-3522.94
2333557098018106880,2020-03,2321.55,4198.42,3458.53,5705.26,-4123.6,-7646.54
2333557098018106880,2020-04,3399.08,4344.84,1121.67,0,175.91,-7470.63
2333557098018106880,2020-05,2920.18,5074.86,5372.65,7502.85,-4284.88,-11755.51
2333557098018106880,2020-06,4498.24,2009.97,2581.71,3151.16,1918.82,-9836.69
2333557098018106880,2020-07,3496.15,3632.9,5291.93,5311.63,-156.45,-9993.14
2333557098018106880,2020-08,5760.26,8600.38,8139.9,4481.05,818.73,-9174.41
2333557098018106880,2020-09,3262.87,5670.15,5396.33,1339.17,1649.88,-7524.53
2333557098018106880,2020-10,927.31,8804.98,7660.08,2992.14,-3209.73,-10734.26
2333557098018106880,2020-11,2787.11,4625.99,3349.36,3992.14,-2481.66,-13215.92
2333557098018106880,2020-12,4259.08,439.82,3173.32,4076.01,2916.57,-10299.35
2333671447070834176,2020-01,1893.13,2385.46,1463.21,2785.83,-1814.95,-1814.95
2333671447070834176,2020-02,2621.75,779.94,1839.86,84.47,3597.2,1782.25
2333671447070834176,2020-03,306.29,0,1877.39,0,2183.68,3965.93
2333671447070834176,2020-04,6954.76,1679.1,1695.13,5632.66,1338.13,5304.06
2333671447070834176,2020-05,2621.1,5440.33,3393.34,5347.76,-4773.65,530.41
2333671447070834176,2020-06,3096.06,4299.34,1316.05,2708.01,-2595.24,-2064.83
2333671447070834176,2020-07,1407.21,1277.58,4396.24,736.86,3789.01,1724.18
2333671447070834176,2020-08,2195.49,9000.91,4000.42,2221.35,-5026.35,-3302.17
2333671447070834176,2020-09,6614.1,3535.53,7714.41,57.26,10735.72,7433.55
2333671447070834176,2020-10,2756.21,1401.03,3335.39,3248.89,1441.68,8875.23
2333671447070834176,2020-11,2421.21,1933.88,1210.73,4333.47,-2635.41,6239.82
2333671447070834176,2020-12,0,4085.17,4384.19,0,299.02,6538.84
2335462919642447872,2020-01,0,4446.41,6821.33,955.72,1419.2,1419.2
2335462919642447872,2020-02,0,5691.42,4293.86,1813.67,-3211.23,-1792.03
2335462919642447872,2020-03,1017.54,4876.22,3483.81,340,-714.87,-2506.9
2335462919642447872,2020-04,705.86,2741.39,753.12,525.68,-1808.09,-4314.99
2335462919642447872,2020-05,2601.17,675.27,1041.19,1881.97,1085.12,-3229.87
2335462919642447872,2020-07,5354.04,786.15,0,143.85,4424.04,1194.17
2335462919642447872,2020-08,4272.56,3718.25,1380.41,1884.05,50.67,1244.84
2335462919642447872,2020-09,1043.95,2271.98,2383.57,3803.25,-2647.71,-1402.87
2335462919642447872,2020-10,3791.77,2418.27,1402.99,757.65,2018.84,615.97
2335462919642447872,2020-11,2095.13,4029.2,6781.79,0,4847.72,5463.69
2335462919642447872,2020-12,1950.71,2558.43,3269.8,2128.6,533.48,5997.17
2336384165151694336,2020-01,6372.58,833.88,6840,536.8,11841.9,11841.9
2336384165151694336,2020-02,3138.68,6622.77,0,2890.13,-6374.22,5467.68
2336384165151694336,2020-03,1437.95,87.07,3886.26,3353.91,1883.23,7350.91
2336384165151694336,2020-04,1327.32,424.88,1769.15,3703.53,-1031.94,6318.97
2336384165151694336,2020-05,0,186.3,3593.54,2368.87,1038.37,7357.34
2336384165151694336,2020-06,1233.46,5430.31,5686.49,3582.85,-2093.21,5264.13
2336384165151694336,2020-07,3917.71,6372.2,0,1337.84,-3792.33,1471.8
2336384165151694336,2020-08,3006.19,4642.13,2671.78,5486.55,-4450.71,-2978.91
2336384165151694336,2020-09,1896.24,2604.06,2662.36,1722.76,231.78,-2747.13
2336384165151694336,2020-10,1285.59,1790.93,2993.74,3311.24,-822.84,-3569.97
2336384165151694336,2020-11,5913.81,2183.74,2188.06,123.72,5794.41,2224.44
2336384165151694336,2020-12,3803.78,1428.89,3131.02,813.83,4692.08,6916.52
2337630591804161536,2020-01,466.05,0,0,884.14,-418.09,-418.09
2337630591804161536,2020-02,0,895.6,988.68,0,93.08,-325.01
2337630591804161536,2020-04,1915.76,0,0,0,1915.76,1590.75
2337630591804161536,2020-06,880.93,1897.6,0,2081.84,-3098.51,-1507.76
2337630591804161536,2020-07,0,902.27,359.45,0,-542.82,-2050.58
2337630591804161536,2020-08,2443.48,0,0,1558.13,885.35,-1165.23
2337630591804161536,2020-09,1891.42,0,2437.38,1844.24,2484.56,1319.33
2337630591804161536,2020-10,0,2404.01,0,83.7,-2487.71,-1168.38
2337630591804161536,2020-11,441.39,0,1333.94,274.33,1501,332.62
2337630591804161536,2020-12,2768.33,0,0,898.93,1869.4,2202.02
2339621949705038848,2020-01,1077.51,0,2308.48,1554.16,1831.83,1831.83
2339621949705038848,2020-02,0,1818.21,0,4426.4,-6244.61,-4412.78
2339621949705038848,2020-03,1339.17,1836.84,1508.6,1859.04,-848.11,-5260.89
2339621949705038848,2020-04,1500.37,2254.06,0,2844.54,-3598.23,-8859.12
2339621949705038848,2020-05,0,2592.12,0,1862.99,-4455.11,-13314.23
2339621949705038848,2020-06,2391.89,0,0,2615.74,-223.85,-13538.08
2339621949705038848,2020-07,0,1163.35,0,1444.41,-2607.76,-16145.84
2339621949705038848,2020-08,1194.16,2258.35,15.71,0,-1048.48,-17194.32
2339621949705038848,2020-09,0,1628.35,0,2435.21,-4063.56,-21257.88
2339621949705038848,2020-10,178.18,3158.04,312.61,0,-2667.25,-23925.13
2339621949705038848,2020-11,0,1086.27,1436.32,554.84,-204.79,-24129.92
2339621949705038848,2020-12,1974.21,1943.53,1108.36,5495.44,-4356.4,-28486.32
2340975950418127872,2020-01,1001.84,3765.25,823.5,1497.81,-3437.72,-3437.72
2340975950418127872,2020-02,969.73,9443.56,4600.74,3153.52,-7026.61,-10464.33
2340975950418127872,2020-03,4060.85,2530.42,1299.43,7389.62,-4559.76,-15024.09
2340975950418127872,2020-04,2228.67,9217.14,1889.02,0,-5099.45,-20123.54
2340975950418127872,2020-05,6552.41,2756.59,3185.24,1031.27,5949.79,-14173.75
2340975950418127872,2020-06,4196.81,6715.42,9142.25,7296.79,-673.15,-14846.9
2340975950418127872,2020-07,6783.09,5800.42,6795,3567.83,4209.84,-10637.06
2340975950418127872,2020-08,2495.88,5374,5188.17,0,2310.05,-8327.01
2340975950418127872,2020-09,5816.65,823.44,2776.97,5231.57,2538.61,-5788.4
2340975950418127872,2020-10,4382.34,1064.14,5064.41,2773.08,5609.53,-178.87
2340975950418127872,2020-11,8787.35,889.54,5185.51,4622.83,8460.49,8281.62
2340975950418127872,2020-12,2542.1,4260.86,9790,5328.27,2742.97,11024.59
2342331876900662272,2020-01,7820.87,9805.1,3727.53,3835.7,-2092.4,-2092.4
2342331876900662272,2020-02,1851.88,5718.61,1697.58,7606.46,-9775.61,-11868.01
2342331876900662272,2020-03,7686.25,6771.64,6694.56,4147.21,3461.96,-8406.05
2342331876900662272,2020-04,2039.14,4286.02,2178.01,4832.4,-4901.27,-13307.32
2342331876900662272,2020-05,4792.71,5380.05,1604.56,936.31,80.91,-13226.41
2342331876900662272,2020-06,2004.8,2083.12,4041.22,3162.8,800.1,-12426.31
2342331876900662272,2020-07,5665.95,5307.98,9689.5,6177.65,3869.82,-8556.49
2342331876900662272,2020-08,5924.55,7412.75,2535.31,4828.28,-3781.17,-12337.66
2342331876900662272,2020-09,0,1963.89,7177.68,1811.15,3402.64,-8935.02
2342331876900662272,2020-10,3546.13,4178.08,0,507.68,-1139.63,-10074.65
2342331876900662272,2020-11,3154.62,4713.77,8671.17,3699.77,3412.25,-6662.4
2342331876900662272,2020-12,11184.48,4552.59,219.41,3363.42,3487.88,-3174.52
2342600622362918400,2020-01,945.09,2346.1,1577.11,0,176.1,176.1
2342600622362918400,2020-02,0,1106.07,0,0,-1106.07,-929.97
2342600622362918400,2020-04,0,666.72,0,1593.31,-2260.03,-3190
2342600622362918400,2020-07,1441.51,0,0,0,1441.51,-1748.49
2342600622362918400,2020-09,1040.32,0,453.3,0,1493.62,-254.87
2342600622362918400,2020-10,3837.05,1241.04,0,0,2596.01,2341.14
2342600622362918400,2020-12,0,2908.31,705.29,1028.08,-3231.1,-889.96
2343348094973914112,2020-01,6915.64,2184.99,1594.6,4632.26,1692.99,1692.99
2343348094973914112,2020-02,3875.69,3305.96,3012.37,1021.6,2560.5,4253.49
2343348094973914112,2020-03,4219.73,3499.8,2337.45,5538.17,-2480.79,1772.7
2343348094973914112,2020-04,4873.34,7422.26,8285.87,5840.45,-103.5,1669.2
2343348094973914112,2020-05,11987.64,8945.82,2726.21,3287.25,2480.78,4149.98
2343348094973914112,2020-06,7836.89,1835.11,5869.86,3870.2,8001.44,12151.42
2343348094973914112,2020-07,5055.03,3054.32,2242.26,1830.2,2412.77,14564.19
2343348094973914112,2020-08,4020.51,464.55,10452.3,2558.16,11450.1,26014.29
2343348094973914112,2020-09,2894.11,0,3114.35,4634.95,1373.51,27387.8
2343348094973914112,2020-10,3848.33,2760.26,4345.05,3139.86,2293.26,29681.06
2343348094973914112,2020-11,3618.89,3168.15,2617.12,8355.35,-5287.49,24393.57
2343348094973914112,2020-12,3409.37,6169.95,375.57,1459.43,-3844.44,20549.13
2343703426899179008,2020-01,9377.38,4237.47,8625.97,3312.61,10453.27,10453.27
2343703426899179008,2020-02,3791.37,3987.62,2644.99,2330.53,118.21,10571.48
2343703426899179008,2020-03,3254.01,5344.66,1553.19,4382.77,-4920.23,5651.25
2343703426899179008,2020-04,2749.94,4114.03,6040.51,4540.81,135.61,5786.86
2343703426899179008,2020-05,598.71,7737.42,2751.75,4299.69,-8686.65,-2899.79
2343703426899179008,2020-06,1047.29,3861.63,1651.61,3604.72,-4767.45,-7667.24
2343703426899179008,2020-07,3431.21,2753.84,8091.11,0,8768.48,1101.24
2343703426899179008,2020-08,1962.72,3249.45,1968.01,3887.81,-3206.53,-2105.29
2343703426899179008,2020-09,7637.67,2119.55,2591.07,6731.76,1377.43,-727.86
2343703426899179008,2020-10,8065.61,4207.86,5.05,2773.93,1088.87,361.01
2343703426899179008,2020-11,1219.27,4258.53,3057.28,1378.58,-1360.56,-999.55
2343703426899179008,2020-12,4657.07,8211.7,1913.8,0,-1640.83,-2640.38
2343772775428169216,2020-01,3124.66,4816.98,2849.12,3773.72,-2616.92,-2616.92
2343772775428169216,2020-02,1625.11,6343.23,6462.37,6895.08,-5150.83,-7767.75
2343772775428169216,2020-03,4656.72,6490.52,1109.97,6809.06,-7532.89,-15300.64
2343772775428169216,2020-04,5883.32,2485.79,4525.11,6253.16,1669.48,-13631.16
2343772775428169216,2020-05,8410.42,3588.44,2671.43,6217.07,1276.34,-12354.82
2343772775428169216,2020-06,4165.93,6384.32,6611.74,6728.09,-2334.74,-14689.56
2343772775428169216,2020-07,1438.46,1253.78,1304.55,4112.11,-2622.88,-17312.44
2343772775428169216,2020-08,2432.32,7408.5,1172.82,5857.9,-9661.26,-26973.7
2343772775428169216,2020-09,9432.85,6604.24,2673.01,4471.83,1029.79,-25943.91
2343772775428169216,2020-10,1199.39,5597.91,6529.27,1037.61,1093.14,-24850.77
2343772775428169216,2020-11,6584.75,6626.6,4600.74,5236.48,-677.59,-25528.36
2343772775428169216,2020-12,4815.28,1577.1,4588.04,6829.54,996.68,-24531.68
2345122273571355648,2020-01,473.67,4322.41,7639.21,1726.58,2063.89,2063.89
2345122273571355648,2020-02,1496.62,1886.18,4819.11,1061.61,3367.94,5431.83
2345122273571355648,2020-03,3490.85,1933.44,4749.21,0,6306.62,11738.45
2345122273571355648,2020-04,1802.79,1793.6,1804.92,4324.53,-2510.42,9228.03
2345122273571355648,2020-05,5457.37,4620.77,5446.82,0,6283.42,15511.45
2345122273571355648,2020-06,2870.49,2673.74,2952.86,289.87,2859.74,18371.19
2345122273571355648,2020-07,4458.96,1630.41,4387.28,1070.83,6145,24516.19
2345122273571355648,2020-08,1673.7,1329.49,5731.36,1779.33,4296.24,28812.43
2345122273571355648,2020-09,2211.88,0,0,1847.87,364.01,29176.44
2345122273571355648,2020-10,5141.99,6813.5,4359.15,1696.1,991.54,30167.98
2345122273571355648,2020-11,2355.09,5923.5,335.43,4642.36,-7875.34,22292.64
2345122273571355648,2020-12,2215.42,149.74,1870.82,4150.11,-213.61,22079.03
2347097847898244608,2020-01,768.58,2362.26,5385.11,3011.97,779.46,779.46
2347097847898244608,2020-02,4750.74,1206.05,2079.61,2331.52,3292.78,4072.24
2347097847898244608,2020-03,4811.9,1919.09,3429.48,5975.47,346.82,4419.06
2347097847898244608,2020-04,1588.72,1045.74,4728.74,1283.66,3988.06,8407.12
2347097847898244608,2020-05,3882.33,2285.79,2982.12,3789.83,788.83,9195.95
2347097847898244608,2020-06,1131.74,5274.59,4282.87,6109.7,-5969.68,3226.27
2347097847898244608,2020-07,1858.08,3308.55,4634.58,4333.02,-1148.91,2077.36
2347097847898244608,2020-08,4394.86,8242.52,3142.56,4473.51,-5178.61,-3101.25
2347097847898244608,2020-09,1150.32,3589.23,4932.85,1714.13,779.81,-2321.44
2347097847898244608,2020-10,1942.57,3601.88,2638.34,584.74,394.29,-1927.15
2347097847898244608,2020-11,39.36,271.44,1735.88,144.23,1359.57,-567.58
2347097847898244608,2020-12,1806.75,4282.59,4415.68,0,1939.84,1372.26
2347246643197181952,2020-01,1816.63,2589.5,1630.18,3609.5,-2752.19,-2752.19
2347246643197181952,2020-02,3174.58,0,0,3064.14,110.44,-2641.75
2347246643197181952,2020-03,1118.82,1800.51,2555.53,3677.34,-1803.5,-4445.25
2347246643197181952,2020-05,2830.2,1311.37,3605.71,565.64,4558.9,113.65
2347246643197181952,2020-06,99.9,1219.6,2278.7,428.44,730.56,844.21
2347246643197181952,2020-07,606.8,3009.38,2771.33,2551.95,-2183.2,-1338.99
2347246643197181952,2020-08,1695.59,3376.16,0,362.39,-2042.96,-3381.95
2347246643197181952,2020-09,0,1423.73,1639.81,1405.25,-1189.17,-4571.12
2347246643197181952,2020-10,2063.41,521.31,1522.24,88.87,2975.47,-1595.65
2347246643197181952,2020-11,2787.65,3057.05,2594.86,0,2325.46,729.81
2347246643197181952,2020-12,937.98,2057.17,2489.85,0,1370.66,2100.47
2348481340578612736,2020-01,5815.53,1703.27,2340.6,6531.11,-78.25,-78.25
2348481340578612736,2020-02,1853.1,3584.32,4729.96,319.34,2679.4,2601.15
2348481340578612736,2020-03,73.13,1744.42,628.2,927.34,-1970.43,630.72
2348481340578612736,2020-04,2243.51,3898.11,3687.98,4448.33,-2414.95,-1784.23
2348481340578612736,2020-05,5979.32,1299.99,1257.59,892.91,5044.01,3259.78
2348481340578612736,2020-06,6481.97,4864.18,3323.01,2243.41,2697.39,5957.17
2348481340578612736,2020-07,3738.41,1352.34,1883.3,6020.89,-1751.52,4205.65
2348481340578612736,2020-08,52.45,495.17,331.2,2366.02,-2477.54,1728.11
2348481340578612736,2020-09,2858.77,828.12,5906.63,2104.72,5832.56,7560.67
2348481340578612736,2020-10,1940.25,2143.43,4658.58,6250,-1794.6,5766.07
2348481340578612736,2020-11,4187.28,4373.8,4474.05,4432.28,-144.75,5621.32
2348481340578612736,2020-12,2540.2,4602.45,5233.23,3800.6,-629.62,4991.7
2348513355398095360,2020-01,0,1673.65,1873.82,574.22,-374.05,-374.05
2348513355398095360,2020-02,1444.25,223.38,1528.47,1381.14,1368.2,994.15
2348513355398095360,2020-03,0,2479.05,275.26,1514.29,-3718.08,-2723.93
2348513355398095360,2020-04,1170.89,1936.97,2589.76,0,1823.68,-900.25
2348513355398095360,2020-05,1287.63,0,1953.31,1814.13,1426.81,526.56
2348513355398095360,2020-06,919.34,858.11,0,0,61.23,587.79
2348513355398095360,2020-07,1042.96,1860.1,0,966.53,-1783.67,-1195.88
2348513355398095360,2020-08,363.36,1669.97,0,2801.71,-4108.32,-5304.2
2348513355398095360,2020-09,0,256.94,0,2245.55,-2502.49,-7806.69
2348513355398095360,2020-10,975.48,744.89,440.77,50.45,620.91,-7185.78
2348513355398095360,2020-11,740.16,306.91,0,0,433.25,-6752.53
2348513355398095360,2020-12,1837.04,237.02,0,149.59,1450.43,-5302.1
2350002886944352256,2020-01,0,2942.54,1288.85,1668.27,-3321.96,-3321.96
2350002886944352256,2020-02,0,2863.43,2001.27,387.21,-1249.37,-4571.33
2350002886944352256,2020-03,0,850.84,0,3216.93,-4067.77,-8639.1
2350002886944352256,2020-04,0,2267.92,0,712.65,-2980.57,-11619.67
2350002886944352256,2020-05,1230.63,1937.75,150.37,925.55,-1482.3,-13101.97
2350002886944352256,2020-06,665.7,862.31,744.78,2328.85,-1780.68,-14882.65
2350002886944352256,2020-08,1908.85,0,0,1601.18,307.67,-14574.98
2350002886944352256,2020-09,0,1029.92,1663.78,1988.91,-1355.05,-15930.03
2350002886944352256,2020-10,3609.75,0,1267.32,1370.2,3506.87,-12423.16
2350002886944352256,2020-11,0,1264.02,1039.31,0,-224.71,-12647.87
2350002886944352256,2020-12,2120.99,1573.12,1711.69,1665.87,593.69,-12054.18
2352113013219256832,2020-01,12638.29,4398.78,5298.34,1553.61,11984.24,11984.24
2352113013219256832,2020-02,4658.98,281.1,5839.33,3386.44,6830.77,18815.01
2352113013219256832,2020-03,7473.64,4296.2,2546.93,6983.79,-1259.42,17555.59
2352113013219256832,2020-04,5505.19,6887.06,3293.31,2189.23,-277.79,17277.8
2352113013219256832,2020-05,5648.88,13113.64,3941.78,3505.39,-7028.37,10249.43
2352113013219256832,2020-06,9412.08,9605.38,3952.25,7168.64,-3409.69,6839.74
2352113013219256832,2020-07,3559.39,6456.33,4250.02,944.89,408.19,7247.93
2352113013219256832,2020-08,3501.47,2431.93,5972.09,2912.95,4128.68,11376.61
2352113013219256832,2020-09,1055.34,3740.07,5012.74,0,2328.01,13704.62
2352113013219256832,2020-10,6136.55,7845.34,6242.12,5644.38,-1111.05,12593.57
2352113013219256832,2020-11,3280.25,3757.21,5924.1,1589.07,3858.07,16451.64
2352113013219256832,2020-12,7869.16,4805.51,2292.04,3216.52,2139.17,18590.81
2352657235622706176,2020-01,6791.09,4752.1,3210.93,5960.29,-710.37,-710.37
2352657235622706176,2020-02,2821.96,1788.87,3588.15,9132.78,-4511.54,-5221.91
2352657235622706176,2020-03,3765.86,5217.95,9378.58,3143.86,4782.63,-439.28
2352657235622706176,2020-04,6687.69,3910.19,4688.27,6048.82,1416.95,977.67
2352657235622706176,2020-05,2613.78,5498.94,7345,9570.76,-5110.92,-4133.25
2352657235622706176,2020-06,7319.44,0,4305.76,6985.5,4639.7,506.45
2352657235622706176,2020-07,6406.36,5290,12322.2,4669.42,8769.14,9275.59
2352657235622706176,2020-08,7379.77,5389.69,2180.26,2811.05,1359.29,10634.88
2352657235622706176,2020-09,2494.42,2548.45,1359.64,5235.16,-3929.55,6705.33
2352657235622706176,2020-10,5111.56,1884.42,4885.04,6599.51,1512.67,8218
2352657235622706176,2020-11,6780.35,3045.25,5321.33,5706.35,3350.08,11568.08
2352657235622706176,2020-12,4246.53,6195.18,1848,1829.32,-1929.97,9638.11
2353496498221665280,2020-02,191.29,1618.94,0,0,-1427.65,-1427.65
2353496498221665280,2020-03,0,854.27,0,1805.28,-2659.55,-4087.2
2353496498221665280,2020-06,1904.37,0,0,0,1904.37,-2182.83
2353496498221665280,2020-07,3417.81,3373.38,0,0,44.43,-2138.4
2353496498221665280,2020-11,1077.85,0,1999.09,0,3076.94,938.54
2353715241838808064,2020-01,1621.17,1754.62,2350.58,598.75,1618.38,1618.38
2353715241838808064,2020-02,6217.24,0,0,7351.73,-1134.49,483.89
2353715241838808064,2020-03,899.96,2369.09,1723.51,2608.59,-2354.21,-1870.32
2353715241838808064,2020-04,1588.61,4615.98,4784.84,1339.63,417.84,-1452.48
2353715241838808064,2020-05,8017.09,3214.17,1197.93,1659.51,4341.34,2888.86
2353715241838808064,2020-06,623.17,3014.93,600.34,5883,-7674.42,-4785.56
2353715241838808064,2020-07,2896.26,3601,2818.73,1821.14,292.85,-4492.71
2353715241838808064,2020-08,1958.79,3479.04,190.62,608.03,-1937.66,-6430.37
2353715241838808064,2020-09,2173.5,72.15,2715.52,1466.02,3350.85,-3079.52
2353715241838808064,2020-10,3735.57,2255.46,388.85,3580.55,-1711.59,-4791.11
2353715241838808064,2020-11,971.5,3296.83,2159.77,2649.63,-2815.19,-7606.3
2353715241838808064,2020-12,3514.55,1465.59,0,2087.16,-38.2,-7644.5
2354157519703808512,2020-01,0,1770.03,0,0,-1770.03,-1770.03
2354157519703808512,2020-02,1893.17,0,0,0,1893.17,123.14
2354157519703808512,2020-04,730.97,0,0,798.28,-67.31,55.83
2354157519703808512,2020-06,936.11,0,0,0,936.11,991.94
2354157519703808512,2020-07,1267.98,0,1740.93,2756.53,252.38,1244.32
2354157519703808512,2020-09,1894.04,0,0,1633.39,260.65,1504.97
2354157519703808512,2020-10,869.83,1978.01,0,0,-1108.18,396.79
2354157519703808512,2020-11,623.97,0,0,1460.35,-836.38,-439.59
2354288469390111744,2020-01,4410.33,3528.2,3388.83,5556.77,-1285.81,-1285.81
2354288469390111744,2020-02,6163.73,2905.99,2614.51,5622.23,250.02,-1035.79
2354288469390111744,2020-03,5301.15,7482.08,6327.04,3093.86,1052.25,16.46
2354288469390111744,2020-04,66.5,4236.87,3830.99,6191.96,-6531.34,-6514.88
2354288469390111744,2020-05,2061.27,4165.9,9164.28,5929.04,1130.61,-5384.27
2354288469390111744,2020-06,6195.87,2099.45,7041.02,6577.59,4559.85,-824.42
2354288469390111744,2020-07,9814.1,7757.9,1723.47,1506.97,2272.7,1448.28
2354288469390111744,2020-08,6174.02,7382.38,6710.81,3467.59,2034.86,3483.14
2354288469390111744,2020-09,3071.67,8793.15,5547.77,2895.21,-3068.92,414.22
2354288469390111744,2020-10,5210.26,2236.49,5886.72,2088.95,6771.54,7185.76
2354288469390111744,2020-11,2248.02,4626.68,3575.78,9009.97,-7812.85,-627.09
2354288469390111744,2020-12,5544.8,3369.67,2928.78,3837.51,1266.4,639.31
2354961350639845376,2020-01,3820.94,525.31,6714.78,3358.61,6651.8,6651.8
2354961350639845376,2020-02,11605.01,2659.22,2755.45,5182.45,6518.79,13170.59
2354961350639845376,2020-03,6606.26,3965.06,3846.07,5406.52,1080.75,14251.34
2354961350639845376,2020-04,1948.47,3990.46,6893.68,5528.73,-677.04,13574.3
2354961350639845376,2020-05,2902.94,3737.35,7926.7,9453.53,-2361.24,11213.06
2354961350639845376,2020-06,5646.17,5755.6,4598.78,8226.13,-3736.78,7476.28
2354961350639845376,2020-07,5034.27,1478.15,7103.84,7604.59,3055.37,10531.65
2354961350639845376,2020-08,2385.74,6257.18,2962.28,3778.66,-4687.82,5843.83
2354961350639845376,2020-09,8843.27,1134.54,2863.02,5531.35,5040.4,10884.23
2354961350639845376,2020-10,1939.98,277.46,1295.03,8882.03,-5924.48,4959.75
2354961350639845376,2020-11,5100.12,0,6597.57,2625.63,9072.06,14031.81
2354961350639845376,2020-12,2712.07,1497.71,8719.06,1845.12,8088.3,22120.11
2355369301267373056,2020-01,1281.07,403.71,0,0,877.36,877.36
2355369301267373056,2020-02,0,293.53,1731.96,1484.54,-46.11,831.25
2355369301267373056,2020-03,697.54,0,1175.23,0,1872.77,2704.02
2355369301267373056,2020-04,2186.79,0,2359.06,0,4545.85,7249.87
2355369301267373056,2020-05,0,1660.28,1783.27,0,122.99,7372.86
2355369301267373056,2020-06,1159.38,3107.51,0,0,-1948.13,5424.73
2355369301267373056,2020-07,1869.94,1439.35,0,3311.11,-2880.52,2544.21
2355369301267373056,2020-08,1133.68,0,574.58,0,1708.26,4252.47
2355369301267373056,2020-09,1620.47,0,1358.23,480.87,2497.83,6750.3
2355369301267373056,2020-10,757.44,2828.06,1433.72,0,-636.9,6113.4
2355369301267373056,2020-11,318.69,0,0,1018.23,-699.54,5413.86
2355369301267373056,2020-12,0,1620.51,781.51,0,-839,4574.86
2355555030391447040,2020-02,916.33,0,0,0,916.33,916.33
2355555030391447040,2020-03,3487.89,3952.65,3449.16,1138.17,1846.23,2762.56
2355555030391447040,2020-05,1749.31,0,0,0,1749.31,4511.87
2355555030391447040,2020-06,414.92,0,1102.51,1509.34,8.09,4519.96
2355555030391447040,2020-07,1753.38,671.31,1266.52,3523.8,-1175.21,3344.75
2355555030391447040,2020-08,422.88,0,0,1339.72,-916.84,2427.91
2355555030391447040,2020-09,1372.87,1882.77,1651.73,1004.8,137.03,2564.94
2355555030391447040,2020-10,0,2406.82,4939.85,3461.69,-928.66,1636.28
2355555030391447040,2020-11,824.37,3031.36,0,2671.49,-4878.48,-3242.2
2355555030391447040,2020-12,0,1266.7,1265.81,0,-0.89,-3243.09
2356354562736624640,2020-06,0,1782.72,0,0,-1782.72,-1782.72
2356354562736624640,2020-10,1615.61,0,1701.49,0,3317.1,1534.38
2356354562736624640,2020-12,0,533.51,0,3398.37,-3931.88,-2397.5
2356634169975249920,2020-02,0,671.4,0,330.81,-1002.21,-1002.21
2356634169975249920,2020-03,0,1456.63,3.48,0,-1453.15,-2455.36
2356634169975249920,2020-04,0,1454.88,0,0,-1454.88,-3910.24
2356634169975249920,2020-10,0,1703.04,0,0,-1703.04,-5613.28
2356634169975249920,2020-12,1234.03,0,0,0,1234.03,-4379.25
2356661094756744704,2020-01,208.56,2888.63,419.18,2335.24,-4596.13,-4596.13
2356661094756744704,2020-02,1861.2,1718.14,773.16,3121.36,-2205.14,-6801.27
2356661094756744704,2020-03,1140.65,556.17,1021.18,687.33,918.33,-5882.94
2356661094756744704,2020-04,2488.39,4974.66,710.78,2994.78,-4770.27,-10653.21
2356661094756744704,2020-05,727.63,124.28,2763.91,1268.39,2098.87,-8554.34
2356661094756744704,2020-06,1057.51,2950.84,3985.85,2094.9,-2.38,-8556.72
2356661094756744704,2020-07,3397.51,1904.68,2089.24,2572.13,1009.94,-7546.78
2356661094756744704,2020-08,4243.1,2778.4,970.9,1944.22,491.38,-7055.4
2356661094756744704,2020-09,1167.94,4625.34,272.08,3155.56,-6340.88,-13396.28
2356661094756744704,2020-10,156.48,2919.77,540.76,0,-2222.53,-15618.81
2356661094756744704,2020-11,1806.42,816.57,1798.05,2203.56,584.34,-15034.47
2356661094756744704,2020-12,1389.99,2645.74,541.59,3017.54,-3731.7,-18766.17
2357711964064690688,2020-01,1856.67,4593.7,5116.34,2454.89,-75.58,-75.58
2357711964064690688,2020-02,1036.63,1629.01,3262.26,0,2669.88,2594.3
2357711964064690688,2020-03,1079.39,2116.51,3707.86,4891.82,-2221.08,373.22
2357711964064690688,2020-04,3482.2,1122.96,3316.82,1095.61,4580.45,4953.67
2357711964064690688,2020-05,3223.21,227.04,3402.3,970.85,5427.62,10381.29
2357711964064690688,2020-06,1843.76,1580.49,118.26,4998.32,-4616.79,5764.5
2357711964064690688,2020-07,7111.92,590.76,3563.91,2257.76,7827.31,13591.81
2357711964064690688,2020-08,0,2011.79,392.44,2702.1,-4321.45,9270.36
2357711964064690688,2020-09,1810.5,1063.07,1031.14,2150.38,-371.81,8898.55
2357711964064690688,2020-10,2974.67,2828.31,1235.54,4126.31,-2744.41,6154.14
2357711964064690688,2020-11,1986.35,4025.76,2353.2,995.75,-681.96,5472.18
2357711964064690688,2020-12,59.14,3807.45,4958.61,1483.67,-273.37,5198.81
2357816559811238912,2020-01,6595.22,5087.21,1994.43,1925.37,1577.07,1577.07
2357816559811238912,2020-02,5864.9,4711.63,2218.68,6517.95,-3146,-1568.93
2357816559811238912,2020-03,6431.37,6941.04,4675.05,4379.07,-213.69,-1782.62
2357816559811238912,2020-04,6251.98,1717.77,2185.9,1145.99,5574.12,3791.5
2357816559811238912,2020-05,3471.39,4618.15,5445.85,2425.76,1873.33,5664.83
2357816559811238912,2020-06,4478.42,5430.15,6438.2,4749.51,736.96,6401.79
2357816559811238912,2020-07,4122.26,814.47,4885.43,7300.02,893.2,7294.99
2357816559811238912,2020-08,2654.06,1861.52,3412.77,2785.75,1419.56,8714.55
2357816559811238912,2020-09,2739.29,4550.44,6117.07,599.87,3706.05,12420.6
2357816559811238912,2020-10,3386.4,1346.13,4464.05,6010.53,493.79,12914.39
2357816559811238912,2020-11,4764.77,4326.09,3068.83,10382.98,-6875.47,6038.92
2357816559811238912,2020-12,6190.98,4265.81,495.97,7933.82,-5512.68,526.24
2361555576852939264,2020-01,3172.97,6446.57,5574.95,8612.35,-6311,-6311
2361555576852939264,2020-02,5505.56,1461.7,1169.39,5210.22,3.03,-6307.97
2361555576852939264,2020-03,6726.56,2544.68,795.91,1972.13,3005.66,-3302.31
2361555576852939264,2020-04,6745.7,3697.5,6905.31,6734.29,3219.22,-83.09
2361555576852939264,2020-05,4176.79,4774.5,8007.66,4185.25,3224.7,3141.61
2361555576852939264,2020-06,5884.79,2601.25,7693.47,3450.66,7526.35,10667.96
2361555576852939264,2020-07,5869,2273.93,3431.9,1160.61,5866.36,16534.32
2361555576852939264,2020-08,3365.95,7080.56,4279.5,4404.44,-3839.55,12694.77
2361555576852939264,2020-09,4614.71,4870.3,8684.77,7420.54,1008.64,13703.41
2361555576852939264,2020-10,10792.68,3312.86,3719.91,4165.89,7033.84,20737.25
2361555576852939264,2020-11,5151.54,332.68,2818.35,3123.27,4513.94,25251.19
2361555576852939264,2020-12,1797.47,6305.4,2824.57,0,-1683.36,23567.83
2363549915758511616,2020-03,1888.06,0,1728.31,0,3616.37,3616.37
2363549915758511616,2020-04,0,1627.51,0,0,-1627.51,1988.86
2363549915758511616,2020-05,0,3346.81,1834.54,1230.29,-2742.56,-753.7
2363549915758511616,2020-06,920.35,0,0,135.57,784.78,31.08
2363549915758511616,2020-07,0,1698.9,1934.44,0,235.54,266.62
2363549915758511616,2020-08,1068.02,1710.7,0,150.45,-793.13,-526.51
2363549915758511616,2020-09,526.53,1866.56,0,176.49,-1516.52,-2043.03
2363549915758511616,2020-10,0,1536.11,0,735.54,-2271.65,-4314.68
2363549915758511616,2020-11,0,1022.69,0,0,-1022.69,-5337.37
2363549915758511616,2020-12,635.73,0,507.94,2280.17,-1136.5,-6473.87
2363794691379914752,2020-01,0,3150.04,1507.02,0,-1643.02,-1643.02
2363794691379914752,2020-02,0,5226.61,0,913.33,-6139.94,-7782.96
2363794691379914752,2020-03,392.03,0,1930.59,316.1,2006.52,-5776.44
2363794691379914752,2020-04,1318.8,0,0,3991.45,-2672.65,-8449.09
2363794691379914752,2020-05,2289.74,1971.85,1611.83,2516.4,-586.68,-9035.77
2363794691379914752,2020-06,1474.25,2825.65,1033.88,2083.81,-2401.33,-11437.1
2363794691379914752,2020-07,1889.37,2525.1,1043.59,1866.76,-1458.9,-12896
2363794691379914752,2020-08,333.23,1265.94,1926.38,3507.67,-2514,-15410
2363794691379914752,2020-09,102.87,0,1164.23,4855.54,-3588.44,-18998.44
2363794691379914752,2020-10,0,3727.81,1863.26,4655.14,-6519.69,-25518.13
2363794691379914752,2020-11,0,2462.61,1577.41,827.07,-1712.27,-27230.4
2363794691379914752,2020-12,0,354.31,3759.11,0,3404.8,-23825.6
2363861767971650560,2020-01,3931.88,4339.86,6855.55,842.38,5605.19,5605.19
2363861767971650560,2020-02,9149.18,955.77,3509.47,681.97,11020.91,16626.1
2363861767971650560,2020-03,3019.06,3758.25,3320.73,1736.34,845.2,17471.3
2363861767971650560,2020-04,2725.61,0,1226.12,1948.82,2002.91,19474.21
2363861767971650560,2020-05,5548.65,3047.37,2779.41,1217.61,4063.08,23537.29
2363861767971650560,2020-06,6112.92,1742.27,4843.8,645.42,8569.03,32106.32
2363861767971650560,2020-07,4902.61,5114.62,2573.25,3355.03,-993.79,31112.53
2363861767971650560,2020-08,4175.33,11982.02,2948.07,1933.12,-6791.74,24320.79
2363861767971650560,2020-09,3396.6,2932.69,2715.26,7061.1,-3881.93,20438.86
2363861767971650560,2020-10,2349.26,9162.12,7891.01,2544.71,-1466.56,18972.3
2363861767971650560,2020-11,2447.59,0,8610.16,5952.67,5105.08,24077.38
2363861767971650560,2020-12,3300.1,2623.18,2398.88,4390.49,-1314.69,22762.69
2364324214943538688,2020-01,4953.35,8015.1,2906.5,9430.41,-9585.66,-9585.66
2364324214943538688,2020-02,3786.34,5626.64,3575.21,5492.39,-3757.48,-13343.14
2364324214943538688,2020-03,2596.33,5204.86,3969.25,6859.73,-5499.01,-18842.15
2364324214943538688,2020-04,244.63,0,4052.57,2832.1,1465.1,-17377.05
2364324214943538688,2020-05,4404.97,6071.42,2306.61,7418.24,-6778.08,-24155.13
2364324214943538688,2020-06,1536.8,7321.05,1301.8,8672.96,-13155.41,-37310.54
2364324214943538688,2020-07,4438.84,7383.49,7722.72,7535.52,-2757.45,-40067.99
2364324214943538688,2020-08,3507.05,6178.02,4986.8,5837.06,-3521.23,-43589.22
2364324214943538688,2020-09,6719.59,3497.37,4976.22,11642.11,-3443.67,-47032.89
2364324214943538688,2020-10,2701.53,654.66,0,5313.84,-3266.97,-50299.86
2364324214943538688,2020-11,789.9,3107.36,1690.81,5289.11,-5915.76,-56215.62
2364324214943538688,2020-12,2433.63,4048.99,2614.9,2255.08,-1255.54,-57471.16
2364835205160216064,2020-01,0,1814.7,0,0,-1814.7,-1814.7
2364835205160216064,2020-03,0,1076.48,380.84,0,-695.64,-2510.34
2364835205160216064,2020-04,0,2240.91,0,0,-2240.91,-4751.25
2364835205160216064,2020-08,0,3559.77,397.57,962.94,-4125.14,-8876.39
2364835205160216064,2020-09,1413.44,0,747.13,0,2160.57,-6715.82
2364835205160216064,2020-10,972.08,0,0,2393.26,-1421.18,-8137
2364835205160216064,2020-11,0,2526.89,1435.88,177.64,-1268.65,-9405.65
2364835205160216064,2020-12,1955.3,1184.28,1795.42,0,2566.44,-6839.21
2365594246675929088,2020-01,554.96,3275.29,602.49,3402.13,-5519.97,-5519.97
2365594246675929088,2020-02,4288.1,1993.91,1267.21,459.64,3101.76,-2418.21
2365594246675929088,2020-03,2899.32,4691.58,1509.13,5035.41,-5318.54,-7736.75
2365594246675929088,2020-04,6743.45,1644.92,2219.94,0,7318.47,-418.28
2365594246675929088,2020-05,1986.47,3059.05,6107.79,2589.91,2445.3,2027.02
2365594246675929088,2020-06,5118.75,2926.23,3636.8,1717.06,4112.26,6139.28
2365594246675929088,2020-07,1158.61,2174.11,4538.03,936.47,2586.06,8725.34
2365594246675929088,2020-08,3900.09,4048.72,4284.81,380.88,3755.3,12480.64
2365594246675929088,2020-09,1564.43,5154.26,3165.5,623.77,-1048.1,11432.54
2365594246675929088,2020-10,2772.95,2696.67,3055.38,6482.32,-3350.66,8081.88
2365594246675929088,2020-11,5023.38,0,750.65,743.01,5031.02,13112.9
2365594246675929088,2020-12,80.4,3786.64,3551.26,1081.53,-1236.51,11876.39
2365686326905317376,2020-01,3295.87,0,1025.9,0,4321.77,4321.77
2365686326905317376,2020-02,1891.49,1293,0,2335.41,-1736.92,2584.85
2365686326905317376,2020-03,0,1598.01,0,0,-1598.01,986.84
2365686326905317376,2020-04,436.63,690.59,3282.6,0,3028.64,4015.48
2365686326905317376,2020-05,950.82,2977.07,2548.41,2897.56,-2375.4,1640.08
2365686326905317376,2020-06,0,1478.3,1329.09,0,-149.21,1490.87
2365686326905317376,2020-07,0,504.05,736.89,1236.11,-1003.27,487.6
2365686326905317376,2020-08,1914.85,3791.9,1712.21,0,-164.84,322.76
2365686326905317376,2020-11,0,995,2879.15,415.58,1468.57,1791.33
2365686326905317376,2020-12,1984.34,0,0,1144.89,839.45,2630.78
2366000792733122048,2020-01,8092.24,1433.54,3502.15,8033.06,2127.79,2127.79
2366000792733122048,2020-02,724.46,2523.18,4930.25,2260.6,870.93,2998.72
2366000792733122048,2020-03,3170.46,5371.01,2344.42,522.33,-378.46,2620.26
2366000792733122048,2020-04,826.56,2157.07,1536.43,2401.02,-2195.1,425.16
2366000792733122048,2020-05,4197.42,2371.84,10049.1,1870.77,10003.91,10429.07
2366000792733122048,2020-06,3470.16,7401.77,0,3166.46,-7098.07,3331
2366000792733122048,2020-07,819.58,7493.09,2787.38,749,-4635.13,-1304.13
2366000792733122048,2020-08,856.73,1622.96,4185.68,6897.57,-3478.12,-4782.25
2366000792733122048,2020-09,1026.82,5164.97,5191.5,0,1053.35,-3728.9
2366000792733122048,2020-10,6177.07,2626.26,3880.83,2598.61,4833.03,1104.13
2366000792733122048,2020-11,2205.92,1321.28,2817.32,595.67,3106.29,4210.42
2366000792733122048,2020-12,6217.55,0,1327.34,4671.85,2873.04,7083.46
2367115971340684800,2020-01,0,723.61,0,0,-723.61,-723.61
2367115971340684800,2020-07,377.15,0,0,0,377.15,-346.46
2367925938493628416,2020-01,113.98,255.54,1326.38,4182.5,-2997.68,-2997.68
2367925938493628416,2020-02,3193.18,3050.52,701.85,4798.98,-3954.47,-6952.15
2367925938493628416,2020-03,1682.82,3163.58,3634.15,1029.24,1124.15,-5828
2367925938493628416,2020-04,3877.11,1728.79,4232.07,2169.94,4210.45,-1617.55
2367925938493628416,2020-05,4111.14,3839.06,1931.33,996.65,1206.76,-410.79
2367925938493628416,2020-06,3497.44,0,0,1680.62,1816.82,1406.03
2367925938493628416,2020-07,2712.54,1298.81,2683.4,1098.19,2998.94,4404.97
2367925938493628416,2020-08,375.35,3478.89,0,1795.55,-4899.09,-494.12
2367925938493628416,2020-09,1707.46,1495.62,0,4033.52,-3821.68,-4315.8
2367925938493628416,2020-10,1374.67,573.8,2532.42,333.49,2999.8,-1316
2367925938493628416,2020-11,1364.64,4848.63,1969.52,320.96,-1835.43,-3151.43
2367925938493628416,2020-12,217.83,1648.64,2917.73,1671.15,-184.23,-3335.66
2368414625192041984,2020-01,1823.27,0,0,0,1823.27,1823.27
2368414625192041984,2020-06,0,710.81,0,0,-710.81,1112.46
2368414625192041984,2020-09,0,735.48,0,0,-735.48,376.98
2369132834403627008,2020-01,3960.52,1955.34,2698.05,3562.4,1140.83,1140.83
2369132834403627008,2020-02,2455.43,0,3059.25,2791.62,2723.06,3863.89
2369132834403627008,2020-03,9404.96,3170.46,2449.32,4514.41,4169.41,8033.3
2369132834403627008,2020-04,2928.05,958.68,6343.29,6135.15,2177.51,10210.81
2369132834403627008,2020-05,368.15,764.3,0,830.46,-1226.61,8984.2
2369132834403627008,2020-06,1585.95,0,2684.38,3260.34,1009.99,9994.19
2369132834403627008,2020-07,1346.81,2023.31,3365.81,6256.43,-3567.12,6427.07
2369132834403627008,2020-08,1373.86,1398.28,1753.21,1675.18,53.61,6480.68
2369132834403627008,2020-09,2294.2,4052.1,569.1,2193.04,-3381.84,3098.84
2369132834403627008,2020-10,4189.36,0,6013.57,5182.11,5020.82,8119.66
2369132834403627008,2020-11,0,2709.91,2072.84,1478.21,-2115.28,6004.38
2369132834403627008,2020-12,4795.8,5935.05,1359.04,2701.36,-2481.57,3522.81
2369148549985959424,2020-01,1027.3,0,2273.76,524.1,2776.96,2776.96
2369148549985959424,2020-02,0,4682.36,0,240.21,-4922.57,-2145.61
2369148549985959424,2020-03,3154.95,2074.53,1147.37,1580.06,647.73,-1497.88
2369148549985959424,2020-04,2164.13,803.39,1448.52,689.58,2119.68,621.8
2369148549985959424,2020-05,2279.7,362.86,0,4107.77,-2190.93,-1569.13
2369148549985959424,2020-06,4091.59,0,2316.14,0,6407.73,4838.6
2369148549985959424,2020-07,1573.3,1311.59,0,1648.82,-1387.11,3451.49
2369148549985959424,2020-08,3457.68,1472.13,0,3009.44,-1023.89,2427.6
2369148549985959424,2020-09,860.43,227.73,0,637.03,-4.33,2423.27
2369148549985959424,2020-10,2683.55,0,456.29,2809.66,330.18,2753.45
2369148549985959424,2020-11,30.04,2525.96,3294.35,2669.45,-1871.02,882.43
2369148549985959424,2020-12,3626.34,1205.94,1030.72,1803.85,1647.27,2529.7
2369751766521788416,2020-01,4868.75,11214.54,5925.59,3988.22,-4408.42,-4408.42
2369751766521788416,2020-02,4861.41,5073.06,7202.46,2586.38,4404.43,-3.99
2369751766521788416,2020-03,2849.58,0,4736.38,5084.54,2501.42,2497.43
2369751766521788416,2020-04,5949.91,3990.11,1987.99,4212.16,-264.37,2233.06
2369751766521788416,2020-05,7821.13,2457.05,2467.7,1836.32,5995.46,8228.52
2369751766521788416,2020-06,2812.36,4964.98,6658.23,4203.01,302.6,8531.12
2369751766521788416,2020-07,5032.43,2373.93,2691.87,3956.97,1393.4,9924.52
2369751766521788416,2020-08,3645.13,6420.3,7243.34,3526.97,941.2,10865.72
2369751766521788416,2020-09,2494.85,7200.86,9848.21,2749.81,2392.39,13258.11
2369751766521788416,2020-10,3209.29,5629.32,2766.72,7116.74,-6770.05,6488.06
2369751766521788416,2020-11,3903.93,3686.55,5747.73,5894.7,70.41,6558.47
2369751766521788416,2020-12,4362.15,1779.64,6450.7,2250.89,6782.32,13340.79
2369930355869639168,2020-01,5705.34,10587.81,2331.75,4522.59,-7073.31,-7073.31
2369930355869639168,2020-02,5181.44,5078.98,4222.78,1221.71,3103.53,-3969.78
2369930355869639168,2020-03,4498.51,468.11,8099.51,4248.22,7881.69,3911.91
2369930355869639168,2020-04,3842.45,1886.55,2477.89,4577.8,-144.01,3767.9
2369930355869639168,2020-05,7057.46,7456.15,4781.29,1974.38,2408.22,6176.12
2369930355869639168,2020-06,7655.55,9463.32,607.1,7979.89,-9180.56,-3004.44
2369930355869639168,2020-07,1059.27,2419.38,3143.94,3135.72,-1351.89,-4356.33
2369930355869639168,2020-08,1997.96,3767.41,3560.75,3390.93,-1599.63,-5955.96
2369930355869639168,2020-09,6398.55,1990.22,8522.54,1948.66,10982.21,5026.25
2369930355869639168,2020-10,5906.59,7494.12,1862.02,3347.03,-3072.54,1953.71
2369930355869639168,2020-11,2352.84,1319.58,8127.82,4193.33,4967.75,6921.46
2369930355869639168,2020-12,804.13,0,10202.85,5808.05,5198.93,12120.39
2370546823604280832,2020-01,4090.69,5466.39,7834.76,11508.12,-5049.06,-5049.06
2370546823604280832,2020-02,4371.37,8130.39,4913.19,5737.14,-4582.97,-9632.03
2370546823604280832,2020-03,6399.98,7889.31,9211.04,2870.19,4851.52,-4780.51
2370546823604280832,2020-04,4441.29,6760.34,4175.31,10161.29,-8305.03,-13085.54
2370546823604280832,2020-05,9438.85,6219.36,4251.09,5948.26,1522.32,-11563.22
2370546823604280832,2020-06,3216.42,1560.85,12238.95,5365.29,8529.23,-3033.99
2370546823604280832,2020-07,3024.4,1458.64,4387.59,895.86,5057.49,2023.5
2370546823604280832,2020-08,7807.62,7084.92,2420.87,4938.33,-1794.76,228.74
2370546823604280832,2020-09,3300.4,8471.65,3531.59,2718.49,-4358.15,-4129.41
2370546823604280832,2020-10,583.9,7398.81,8582.06,5983.26,-4216.11,-8345.52
2370546823604280832,2020-11,1498.27,8837.14,4144.67,2435.6,-5629.8,-13975.32
2370546823604280832,2020-12,4427.08,6204.61,7143.07,6064.94,-699.4,-14674.72
2371142644640968704,2020-01,2585.46,3087.74,2068.52,828.3,737.94,737.94
2371142644640968704,2020-02,1087.05,1226.73,0,2609.37,-2749.05,-2011.11
2371142644640968704,2020-03,2577.41,1450.26,1547.57,1796.53,878.19,-1132.92
2371142644640968704,2020-04,3384.07,3652.27,3422.88,1241.68,1913,780.08
2371142644640968704,2020-05,0,848.43,3035.07,3098.6,-911.96,-131.88
2371142644640968704,2020-06,2216.91,5048.56,3729.49,895.01,2.83,-129.05
2371142644640968704,2020-07,1888.07,3653.6,272.81,1584.14,-3076.86,-3205.91
2371142644640968704,2020-08,3358.88,1022.31,1531.9,1828.64,2039.83,-1166.08
2371142644640968704,2020-09,1929.38,416.98,754.2,47.81,2218.79,1052.71
2371142644640968704,2020-10,3303.08,5962.02,4757.57,2269.78,-171.15,881.56
2371142644640968704,2020-11,4842.67,4574.48,2473.09,4595.41,-1854.13,-972.57
2371142644640968704,2020-12,4315.64,4732.1,2584.65,4120.45,-1952.26,-2924.83
2373281886101728768,2020-01,353.22,1004.39,969.76,5533.5,-5214.91,-5214.91
2373281886101728768,2020-02,1783.26,1353.33,805.94,1861.84,-625.97,-5840.88
2373281886101728768,2020-03,0,3550.08,0,2555.11,-6105.19,-11946.07
2373281886101728768,2020-04,2083.68,5263.49,3551.25,0,371.44,-11574.63
2373281886101728768,2020-05,2871.91,1801.44,4186.61,930.91,4326.17,-7248.46
2373281886101728768,2020-06,86.34,2335.42,1139.48,1969.45,-3079.05,-10327.51
2373281886101728768,2020-08,1481.08,0,0,4466.1,-2985.02,-13312.53
2373281886101728768,2020-09,215.24,4923.18,3433.37,1986.25,-3260.82,-16573.35
2373281886101728768,2020-11,1821.67,2965.96,0,0,-1144.29,-17717.64
2373281886101728768,2020-12,7491.24,2803.86,2457.99,3817.72,3327.65,-14389.99
2374047525083468800,2020-01,2593.97,2295.33,1654.45,3635.14,-1682.05,-1682.05
2374047525083468800,2020-02,0,4735.88,4637.84,2191.35,-2289.39,-3971.44
2374047525083468800,2020-03,3588.62,1856.64,681.1,3874.98,-1461.9,-5433.34
2374047525083468800,2020-04,3465.93,5728.99,4055.21,5030.83,-3238.68,-8672.02
2374047525083468800,2020-05,2192.58,4239.53,809.72,2445.67,-3682.9,-12354.92
2374047525083468800,2020-06,3661.08,1991.63,2242.34,1599.1,2312.69,-10042.23
2374047525083468800,2020-07,741.07,8716.55,6568.98,0,-1406.5,-11448.73
2374047525083468800,2020-08,0,7346.16,5448.53,1018.69,-2916.32,-14365.05
2374047525083468800,2020-09,6126.23,1203.77,0,239.81,4682.65,-9682.4
2374047525083468800,2020-10,5082.32,1307.33,5022.79,3357.2,5440.58,-4241.82
2374047525083468800,2020-11,1588.93,0,3177.5,1609.69,3156.74,-1085.08
2374047525083468800,2020-12,2234.13,3322.34,6733.04,1540.3,4104.53,3019.45
2374961495178809856,2020-01,1880.57,0,3935.26,2981.64,2834.19,2834.19
2374961495178809856,2020-02,1347.2,0,1741.33,647.24,2441.29,5275.48
2374961495178809856,2020-03,3388.42,1515.32,3805.64,1729.68,3949.06,9224.54
2374961495178809856,2020-04,4394.11,3571.83,301.86,0,1124.14,10348.68
2374961495178809856,2020-05,627.5,2851.32,0,2039.57,-4263.39,6085.29
2374961495178809856,2020-06,2331.96,1003.98,0,0,1327.98,7413.27
2374961495178809856,2020-07,1082.9,428.49,1811.82,4148.1,-1681.87,5731.4
2374961495178809856,2020-08,0,2446.87,0,1983.15,-4430.02,1301.38
2374961495178809856,2020-09,1823.12,2533.89,0,1783.09,-2493.86,-1192.48
2374961495178809856,2020-10,1072.71,155.01,333.59,1697.28,-445.99,-1638.47
2374961495178809856,2020-11,0,2214.02,596.88,2260.34,-3877.48,-5515.95
2375464037009931264,2020-01,2522.65,7573.41,1583.61,4486.25,-7953.4,-7953.4
2375464037009931264,2020-02,2638.3,1860.98,6844.16,3580.48,4041,-3912.4
2375464037009931264,2020-03,5108.67,3719.5,521.15,6326.3,-4415.98,-8328.38
2375464037009931264,2020-04,5474.63,6829.33,3215.63,63.11,1797.82,-6530.56
2375464037009931264,2020-05,7263.67,3273.29,1989.54,4034.85,1945.07,-4585.49
2375464037009931264,2020-06,4332.76,4119.39,2606.43,8651.28,-5831.48,-10416.97
2375464037009931264,2020-07,1409.13,1456.35,0,3193.08,-3240.3,-13657.27
2375464037009931264,2020-08,8395.74,3889.12,6900.31,3665.72,7741.21,-5916.06
2375464037009931264,2020-09,2543.54,6715.04,1473.75,3900.59,-6598.34,-12514.4
2375464037009931264,2020-10,4619.89,709.16,5934.53,6523.15,3322.11,-9192.29
2375464037009931264,2020-11,3404.66,5314.4,1281.02,4234.75,-4863.47,-14055.76
2375464037009931264,2020-12,3090.87,5248.54,1415.7,1848.29,-2590.26,-16646.02
2376630986760712704,2020-01,2880.26,7502.49,3392.72,1943.13,-3172.64,-3172.64
2376630986760712704,2020-02,5938.15,3196.42,6531.62,5143.71,4129.64,957
2376630986760712704,2020-03,4890.99,1305.74,5392.1,592.78,8384.57,9341.57
2376630986760712704,2020-04,1236.77,2509.55,6024.76,4403.53,348.45,9690.02
2376630986760712704,2020-05,4956.44,5687.2,2748.18,3574.3,-1556.88,8133.14
2376630986760712704,2020-06,2560.52,5193.69,1872.75,5389.97,-6150.39,1982.75
2376630986760712704,2020-07,7243.79,2263.69,6897.84,5286.73,6591.21,8573.96
2376630986760712704,2020-08,2951.19,2518.98,2023.03,3780.37,-1325.13,7248.83
2376630986760712704,2020-09,1729.14,1771.46,3654.16,4976.01,-1364.17,5884.66
2376630986760712704,2020-10,3151.35,3602.01,2966.71,2991.29,-475.24,5409.42
2376630986760712704,2020-11,2302.21,5426.73,8148.67,5450.23,-426.08,4983.34
2376630986760712704,2020-12,1259.95,4319.77,1167.94,9161.86,-11053.74,-6070.4
2377450054336485376,2020-01,3887.03,592.38,2749.41,3750.18,2293.88,2293.88
2377450054336485376,2020-02,1765.48,5017.96,1865.63,2547.65,-3934.5,-1640.62
2377450054336485376,2020-03,3233.55,1391.07,3909.29,4416.98,1334.79,-305.83
2377450054336485376,2020-04,2361.53,4964.42,1357.64,2833.94,-4079.19,-4385.02
2377450054336485376,2020-05,2606.94,2193.05,3936.57,3897.46,453,-3932.02
2377450054336485376,2020-06,2251.14,6373.44,5632.83,4370.35,-2859.82,-6791.84
2377450054336485376,2020-07,0,1678.89,5893.72,1764.66,2450.17,-4341.67
2377450054336485376,2020-08,3168.2,5.95,0,2453.34,708.91,-3632.76
2377450054336485376,2020-09,477.97,4498.08,340.11,2455.4,-6135.4,-9768.16
2377450054336485376,2020-10,1753.7,884.61,1108.44,2139.25,-161.72,-9929.88
2377450054336485376,2020-11,1886.8,1403.36,1282,1146.35,619.09,-9310.79
2377450054336485376,2020-12,3182.16,7064.71,1330.34,517.82,-3070.03,-12380.82
2378275692584560128,2020-01,1509.12,4585.08,1788.78,409.4,-1696.58,-1696.58
2378275692584560128,2020-02,1604.99,1291.42,1709,3211.51,-1188.94,-2885.52
2378275692584560128,2020-03,3165.39,374.97,6541.73,4877.83,4454.32,1568.8
2378275692584560128,2020-04,1127.42,1272.29,1514.16,1997.46,-628.17,940.63
2378275692584560128,2020-06,1202.18,1615.47,3616.81,512.37,2691.15,3631.78
2378275692584560128,2020-07,1089.99,3296.19,1998.21,231.18,-439.17,3192.61
2378275692584560128,2020-08,5933.16,2178.22,3357.85,2269.24,4843.55,8036.16
2378275692584560128,2020-09,5354.67,1890.72,1262.9,1699.79,3027.06,11063.22
2378275692584560128,2020-10,185.51,586.06,0,1175.37,-1575.92,9487.3
2378275692584560128,2020-11,0,3239.35,777.78,1008.99,-3470.56,6016.74
2378275692584560128,2020-12,3073.89,2067.4,2801.16,2940.28,867.37,6884.11
2379154729671679488,2020-01,1496.59,1148.06,1273,851.59,769.94,769.94
2379154729671679488,2020-02,1827.25,0,0,1436.22,391.03,1160.97
2379154729671679488,2020-03,0,946.61,0,964.99,-1911.6,-750.63
2379154729671679488,2020-04,1734.31,0,0,343.05,1391.26,640.63
2379154729671679488,2020-05,0,2939.44,0,1195.25,-4134.69,-3494.06
2379154729671679488,2020-06,0,643.28,928.71,3686.55,-3401.12,-6895.18
2379154729671679488,2020-07,1937.29,5348.51,3367.91,1033.44,-1076.75,-7971.93
2379154729671679488,2020-08,1735.51,3252.01,1445.49,0,-71.01,-8042.94
2379154729671679488,2020-09,0,1146.63,1779.51,1214.39,-581.51,-8624.45
2379154729671679488,2020-10,1876.72,4481.4,0,3154.76,-5759.44,-14383.89
2379154729671679488,2020-11,0,1214.86,59.54,1624.9,-2780.22,-17164.11
2379154729671679488,2020-12,0,1720.56,1420.53,746.94,-1046.97,-18211.08
2379396689747850240,2020-10,794.7,0,1162.56,0,1957.26,1957.26
2379396689747850240,2020-11,1243.27,0,0,0,1243.27,3200.53
2379712026004843520,2020-01,2126.53,7188.26,4263.51,2502.67,-3300.89,-3300.89
2379712026004843520,2020-02,4732.32,5522.42,6710.07,2539.46,3380.51,79.62
2379712026004843520,2020-03,1754.62,7784.19,9030.3,4610.33,-1609.6,-1529.98
2379712026004843520,2020-04,5112.08,4202.88,2338.55,2387.6,860.15,-669.83
2379712026004843520,2020-05,6236.94,1152.49,2473.58,8017.37,-459.34,-1129.17
2379712026004843520,2020-06,1453.82,1529.35,6311.78,3135.84,3100.41,1971.24
2379712026004843520,2020-07,7100.73,7105.43,4314.12,680.1,3629.32,5600.56
2379712026004843520,2020-08,4501.7,1772.71,4869.13,3720.49,3877.63,9478.19
2379712026004843520,2020-09,3709.02,4482.21,3646.41,1065,1808.22,11286.41
2379712026004843520,2020-10,4214.19,1341.41,2967.69,5691.28,149.19,11435.6
2379712026004843520,2020-11,1979.49,5652.73,3522.27,6623.78,-6774.75,4660.85
2379712026004843520,2020-12,2420.17,7045.45,4084.86,3120.81,-3661.23,999.62
2380587775143334400,2020-01,2940.2,6485.56,1357.24,3539.38,-5727.5,-5727.5
2380587775143334400,2020-02,1775.75,912.16,1930.88,1537.64,1256.83,-4470.67
2380587775143334400,2020-03,2898.41,3991.32,1867.39,5069.44,-4294.96,-8765.63
2380587775143334400,2020-04,1666.91,6358.31,1912.68,4365.64,-7144.36,-15909.99
2380587775143334400,2020-05,2992.81,2459.34,4222.93,1768.44,2987.96,-12922.03
2380587775143334400,2020-06,4772.06,4042.75,0,1729.28,-999.97,-13922
2380587775143334400,2020-07,4084.57,1319.86,1517.2,5350.85,-1068.94,-14990.94
2380587775143334400,2020-08,1987.09,4690.31,2342.39,1611.25,-1972.08,-16963.02
2380587775143334400,2020-09,3507.92,5906.09,1584.17,6121.55,-6935.55,-23898.57
2380587775143334400,2020-10,3460.65,3775.01,2345.12,3157.92,-1127.16,-25025.73
2380587775143334400,2020-11,2497.05,704.28,1728.12,3798.19,-277.3,-25303.03
2380587775143334400,2020-12,731.69,1766.77,4827.65,3956.43,-163.86,-25466.89
2380613254082021376,2020-01,1340.86,4856.47,0,2316.62,-5832.23,-5832.23
2380613254082021376,2020-02,660.91,1424.19,4280.08,1797.34,1719.46,-4112.77
2380613254082021376,2020-03,0,987.46,173.63,1355.9,-2169.73,-6282.5
2380613254082021376,2020-04,337.71,1132.21,0,2526.71,-3321.21,-9603.71
2380613254082021376,2020-05,2218.53,713.54,2425.57,0,3930.56,-5673.15
2380613254082021376,2020-06,2563.67,2839.48,0,1980.82,-2256.63,-7929.78
2380613254082021376,2020-07,3648.45,1847.11,2401.96,0,4203.3,-3726.48
2380613254082021376,2020-08,0,1631.88,2307.79,641.29,34.62,-3691.86
2380613254082021376,2020-09,1199.98,3496.6,3611.43,473.01,841.8,-2850.06
2380613254082021376,2020-10,0,1862.63,86.02,1601.5,-3378.11,-6228.17
2380613254082021376,2020-11,0,811.69,1090.28,205.87,72.72,-6155.45
2380613254082021376,2020-12,0,1903.37,3622.38,533.07,1185.94,-4969.51
2380852143177390592,2020-01,0,1409.56,411.11,1415.22,-2413.67,-2413.67
2380852143177390592,2020-02,4458.33,4382.72,1529.51,6089.73,-4484.61,-6898.28
2380852143177390592,2020-03,1147.71,1224.99,3263.71,1967.2,1219.23,-5679.05
2380852143177390592,2020-04,2641.68,0,2113.3,162.68,4592.3,-1086.75
2380852143177390592,2020-05,2216.05,4044.02,3404.18,1384.51,191.7,-895.05
2380852143177390592,2020-06,1182.37,3467.24,3438.18,699.27,454.04,-441.01
2380852143177390592,2020-07,1157.23,4349.26,0,3231.12,-6423.15,-6864.16
2380852143177390592,2020-08,3640.48,147.91,1357.56,4267.49,582.64,-6281.52
2380852143177390592,2020-09,502.6,0,967.3,3015.54,-1545.64,-7827.16
2380852143177390592,2020-10,3730.98,2452.51,1876.65,3455.71,-300.59,-8127.75
2380852143177390592,2020-11,0,851.38,2171.85,1414.45,-93.98,-8221.73
2380852143177390592,2020-12,45.38,4135.41,575.84,4330.99,-7845.18,-16066.91
2381732398222395392,2020-01,1961.73,448.32,179.42,907.97,784.86,784.86
2381732398222395392,2020-02,0,1412.12,0,0,-1412.12,-627.26
2381732398222395392,2020-03,1352.22,4060.62,3829.38,1779.96,-658.98,-1286.24
2381732398222395392,2020-04,2523.22,478.09,2938.53,0,4983.66,3697.42
2381732398222395392,2020-05,1415.29,924.45,3224.03,1972.97,1741.9,5439.32
2381732398222395392,2020-06,1123.76,0,0,127.62,996.14,6435.46
2381732398222395392,2020-07,2843.32,3856.95,2296.61,321.91,961.07,7396.53
2381732398222395392,2020-08,1362.49,0,0,746.48,616.01,8012.54
2381732398222395392,2020-09,251.39,1591.47,0,0,-1340.08,6672.46
2381732398222395392,2020-10,1432.57,2930.01,0,5464.62,-6962.06,-289.6
2381732398222395392,2020-11,1631.66,0,0,208.22,1423.44,1133.84
2381732398222395392,2020-12,4244.47,0,1204.28,2345.79,3102.96,4236.8
2382513899347590656,2020-01,3146.41,0,2107.36,3473.97,1779.8,1779.8
2382513899347590656,2020-02,707.36,1486.56,0,4131.01,-4910.21,-3130.41
2382513899347590656,2020-03,891.28,2748.87,1323.51,2301.07,-2835.15,-5965.56
2382513899347590656,2020-05,2656.05,2266.62,3873.08,3080.91,1181.6,-4783.96
2382513899347590656,2020-06,5494.5,1031.27,2976.04,4040.89,3398.38,-1385.58
2382513899347590656,2020-07,4666.81,2185.54,2524.66,1277.63,3728.3,2342.72
2382513899347590656,2020-08,0,1776.55,3017.84,3731.77,-2490.48,-147.76
2382513899347590656,2020-09,5083.46,535.26,1750.87,0,6299.07,6151.31
2382513899347590656,2020-10,0,966.2,6548.49,2377.92,3204.37,9355.68
2382513899347590656,2020-11,8843.3,190.66,683.47,357.4,8978.71,18334.39
2382513899347590656,2020-12,4341.82,930.57,1860.71,1199.91,4072.05,22406.44
2383132883429978112,2020-01,844.56,0,0,0,844.56,844.56
2383132883429978112,2020-02,0,1119.02,0,860.5,-1979.52,-1134.96
2383132883429978112,2020-03,0,1986.58,958.17,1323.12,-2351.53,-3486.49
2383132883429978112,2020-04,1275.84,4240.22,1822.89,1890.38,-3031.87,-6518.36
2383132883429978112,2020-05,1095.45,0,1110.25,2559.31,-353.61,-6871.97
2383132883429978112,2020-06,1618.13,1521.68,1544.74,0,1641.19,-5230.78
2383132883429978112,2020-07,1298.21,0,1293.68,0,2591.89,-2638.89
2383132883429978112,2020-08,0,1383.31,904.06,917.64,-1396.89,-4035.78
2383132883429978112,2020-10,0,2481.25,0,1343.86,-3825.11,-7860.89
2383132883429978112,2020-12,1881.59,0,479.07,1807.46,553.2,-7307.69
2384232374733266432,2020-01,2494.63,6153.43,1510.9,1559.98,-3707.88,-3707.88
2384232374733266432,2020-02,2009.95,2313.61,19.25,786.22,-1070.63,-4778.51
2384232374733266432,2020-03,2794.65,5559.62,2372.78,4003.54,-4395.73,-9174.24
2384232374733266432,2020-04,4516.31,80.08,2938.16,2036.59,5337.8,-3836.44
2384232374733266432,2020-05,2752.34,0,1426.57,1745.8,2433.11,-1403.33
2384232374733266432,2020-06,4244.26,0,3360.2,2394.56,5209.9,3806.57
2384232374733266432,2020-08,1358.54,0,0,2342.67,-984.13,2822.44
2384232374733266432,2020-09,5.32,2110.22,2991.49,100.12,786.47,3608.91
2384232374733266432,2020-11,19.66,0,0,0,19.66,3628.57
2384232374733266432,2020-12,2170.41,475.82,897.5,48.95,2543.14,6171.71
2384768619476467712,2020-01,4728.68,3861.26,3504.56,3900.61,471.37,471.37
2384768619476467712,2020-02,3180.87,4533.7,527.35,1154.7,-1980.18,-1508.81
2384768619476467712,2020-03,11058.11,369.65,2897.5,2351.64,11234.32,9725.51
2384768619476467712,2020-04,4263.18,2801.22,18.04,4645.47,-3165.47,6560.04
2384768619476467712,2020-05,4567.42,365.33,5782.27,1710.17,8274.19,14834.23
2384768619476467712,2020-06,1571.65,2187.09,0,2761.52,-3376.96,11457.27
2384768619476467712,2020-07,1759.79,2543.7,1551.29,1801.65,-1034.27,10423
2384768619476467712,2020-08,4370.05,1323.33,681.18,2782.02,945.88,11368.88
2384768619476467712,2020-09,2666.87,4257.33,3781.11,3125.45,-934.8,10434.08
2384768619476467712,2020-10,3715.46,4703.28,1247.15,9.98,249.35,10683.43
2384768619476467712,2020-11,748.9,1202.47,1496.37,615.78,427.02,11110.45
2384768619476467712,2020-12,0,1633.64,2125.43,0,491.79,11602.24
2385133380184565760,2020-01,1656.44,436.91,1096.32,1771.24,544.61,544.61
2385133380184565760,2020-02,1324.92,1829.33,1188.67,514.55,169.71,714.32
2385133380184565760,2020-03,5372.44,0,2739.13,0,8111.57,8825.89
2385133380184565760,2020-04,0,893.37,1099.34,2485.83,-2279.86,6546.03
2385133380184565760,2020-05,0,2744.54,1879.75,580.93,-1445.72,5100.31
2385133380184565760,2020-06,1048.28,0,3337.99,0,4386.27,9486.58
2385133380184565760,2020-07,3227.64,4058.14,188.13,0,-642.37,8844.21
2385133380184565760,2020-08,2181.92,2334.6,1790.6,2503.58,-865.66,7978.55
2385133380184565760,2020-09,1776.62,0,0,1793.33,-16.71,7961.84
2385133380184565760,2020-10,2559.01,0,1312.57,783.54,3088.04,11049.88
2385133380184565760,2020-11,1907.01,2919.47,1362.5,977.8,-627.76,10422.12
2385133380184565760,2020-12,1339.21,0,3982.6,2345.76,2976.05,13398.17
2385333750693284864,2020-01,0,1611.95,930.15,0,-681.8,-681.8
2385333750693284864,2020-05,0,331.41,0,0,-331.41,-1013.21
2385333750693284864,2020-06,1454.32,0,1085.59,0,2539.91,1526.7
2385333750693284864,2020-08,0,84.43,3217.03,0,3132.6,4659.3
2385333750693284864,2020-10,1995.98,0,0,0,1995.98,6655.28
2385891860881815552,2020-01,5996.85,5402.09,551.92,10210.59,-9063.91,-9063.91
2385891860881815552,2020-02,7398.23,1251.91,7969.98,2426.71,11689.59,2625.68
2385891860881815552,2020-03,8842.32,6304.28,4546.8,5105.24,1979.6,4605.28
2385891860881815552,2020-04,3635.96,3552.36,1632.42,11328.01,-9611.99,-5006.71
2385891860881815552,2020-05,4348.79,3926.85,4541.08,3551,1412.02,-3594.69
2385891860881815552,2020-06,1629.33,4301.59,3534.26,7140.6,-6278.6,-9873.29
2385891860881815552,2020-07,3717.65,4238.7,2108.5,5646.83,-4059.38,-13932.67
2385891860881815552,2020-08,6857.17,4747.18,5318.85,256.73,7172.11,-6760.56
2385891860881815552,2020-09,0,1844.85,5076.08,5560.97,-2329.74,-9090.3
2385891860881815552,2020-10,1288.71,4268.61,1474.17,2652.28,-4158.01,-13248.31
2385891860881815552,2020-11,1574.92,2075.16,4909.78,7347.73,-2938.19,-16186.5
2385891860881815552,2020-12,3158.76,439.35,5806.51,5800.18,2725.74,-13460.76
2386404099650325504,2020-01,3554.84,1216.01,4166.74,4753.13,1752.44,1752.44
2386404099650325504,2020-02,2788.93,4354.56,5913.98,6500.17,-2151.82,-399.38
2386404099650325504,2020-03,1774.07,1207.27,3917.04,4254.62,229.22,-170.16
2386404099650325504,2020-04,350.35,4969.44,1222.11,3980.73,-7377.71,-7547.87
2386404099650325504,2020-05,2282.33,1370.54,2192.31,1822.07,1282.03,-6265.84
2386404099650325504,2020-06,4387.81,4638.77,3221.98,3993.02,-1022,-7287.84
2386404099650325504,2020-07,6177.3,2965.29,4676.11,2675.11,5213.01,-2074.83
2386404099650325504,2020-08,1829.81,3470.4,3073.71,3009.23,-1576.11,-3650.94
2386404099650325504,2020-09,2985.89,1065.44,3268.29,4015.23,1173.51,-2477.43
2386404099650325504,2020-10,1992.26,1686.49,6126.12,1631.77,4800.12,2322.69
2386404099650325504,2020-11,2504.43,1004.53,2371.65,2953.22,918.33,3241.02
2386404099650325504,2020-12,3661.45,4184.75,1034.85,3661.68,-3150.13,90.89
2387418697221875712,2020-01,3712.94,5685.29,1007.56,0,-964.79,-964.79
2387418697221875712,2020-02,2489.63,3128.81,2619.62,2214.59,-234.15,-1198.94
2387418697221875712,2020-03,1730.44,772.59,1810.29,0,2768.14,1569.2
2387418697221875712,2020-04,1358.41,1142.03,3496.63,669.8,3043.21,4612.41
2387418697221875712,2020-05,2148.8,0,3276.06,0,5424.86,10037.27
2387418697221875712,2020-06,1350.14,490.6,2566.04,4660.22,-1234.64,8802.63
2387418697221875712,2020-07,1894.18,2843.11,2087.01,7749.8,-6611.72,2190.91
2387418697221875712,2020-08,2780.48,0,576.42,713.82,2643.08,4833.99
2387418697221875712,2020-09,2663.97,2688.33,2900.02,1194.77,1680.89,6514.88
2387418697221875712,2020-10,5959.85,4589.5,1750.11,0,3120.46,9635.34
2387418697221875712,2020-11,3098.24,2939.34,1277.82,115.74,1320.98,10956.32
2387418697221875712,2020-12,2137.6,1231.04,1951.76,2619.7,238.62,11194.94
2387627290592962560,2020-01,3418.03,1405.31,5904.92,2468.04,5449.6,5449.6
2387627290592962560,2020-02,12.99,11044.62,4631.21,1722.21,-8122.63,-2673.03
2387627290592962560,2020-03,3361.37,3740.73,2751.37,6323.29,-3951.28,-6624.31
2387627290592962560,2020-04,3446.77,4862.03,7174.58,1513.94,4245.38,-2378.93
2387627290592962560,2020-05,2631.04,1931.38,3777.6,1672.03,2805.23,426.3
2387627290592962560,2020-06,3296.25,2665.03,4199.06,7632.47,-2802.19,-2375.89
2387627290592962560,2020-07,6949.39,4566.86,4555.4,471.73,6466.2,4090.31
2387627290592962560,2020-08,1737.83,3514.59,1840.65,6176.24,-6112.35,-2022.04
2387627290592962560,2020-09,8377.94,2605.12,4117.32,1932.05,7958.09,5936.05
2387627290592962560,2020-10,4652.88,308.45,2862.86,3308.9,3898.39,9834.44
2387627290592962560,2020-11,2945.24,1949.65,4223.83,4533.87,685.55,10519.99
2387627290592962560,2020-12,2384.68,3046.12,4994.16,1436.04,2896.68,13416.67
2391238189739306496,2020-01,1498.57,1345.21,2594.79,0,2748.15,2748.15
2391238189739306496,2020-02,6577.89,1443.79,1327.38,5105.82,1355.66,4103.81
2391238189739306496,2020-03,891.63,422.3,2151.91,5566.44,-2945.2,1158.61
2391238189739306496,2020-04,2317.67,5342.62,3320.33,3358.83,-3063.45,-1904.84
2391238189739306496,2020-05,3509.37,4959.12,4136.86,2194.21,492.9,-1411.94
2391238189739306496,2020-06,3024.7,1149.38,4276.57,2675.92,3475.97,2064.03
2391238189739306496,2020-07,2399.63,2060.56,2706.85,663.08,2382.84,4446.87
2391238189739306496,2020-08,0,5274.25,3186.21,4526.5,-6614.54,-2167.67
2391238189739306496,2020-09,2982.34,37.55,0,5693.38,-2748.59,-4916.26
2391238189739306496,2020-10,1188.6,3939.96,5676.69,2445.18,480.15,-4436.11
2391238189739306496,2020-11,3272.05,271.17,3676.18,3019.29,3657.77,-778.34
2391238189739306496,2020-12,5062.4,2294.95,0,3845.79,-1078.34,-1856.68
2391308015264220672,2020-01,5315.77,2493.48,2984.39,3962.88,1843.8,1843.8
2391308015264220672,2020-02,2124.79,3939.6,3228.86,1294.35,119.7,1963.5
2391308015264220672,2020-03,2481.2,3484.88,6107.28,2029.5,3074.1,5037.6
2391308015264220672,2020-04,2418.75,4304.18,5019.82,10624.49,-7490.1,-2452.5
2391308015264220672,2020-05,2517.14,7061.65,2934.16,12053.55,-13663.9,-16116.4
2391308015264220672,2020-06,1327.1,7807.03,7490.06,6212.39,-5202.26,-21318.66
2391308015264220672,2020-07,6101.11,1239.57,6333.15,539.14,10655.55,-10663.11
2391308015264220672,2020-08,7572.7,2421.6,3345.01,2908.46,5587.65,-5075.46
2391308015264220672,2020-09,3782.65,2698.42,3019.26,10237.63,-6134.14,-11209.6
2391308015264220672,2020-10,6238.99,6355.79,784.16,4844.81,-4177.45,-15387.05
2391308015264220672,2020-11,2886.49,5340.27,4254.95,1237.65,563.52,-14823.53
2391308015264220672,2020-12,6207.13,4721,4812.79,474.55,5824.37,-8999.16
2395183535512676864,2020-01,4961.8,7814.27,6696.83,3574.57,269.79,269.79
2395183535512676864,2020-02,5375.64,10199.18,4157.54,3927.63,-4593.63,-4323.84
2395183535512676864,2020-03,5751.21,2009.69,2429.55,1827.72,4343.35,19.51
2395183535512676864,2020-04,1222.56,5565.08,6438.53,4971.84,-2875.83,-2856.32
2395183535512676864,2020-05,1903.86,1139.47,4438.33,5456.74,-254.02,-3110.34
2395183535512676864,2020-06,356.03,5371.49,794.96,0,-4220.5,-7330.84
2395183535512676864,2020-07,5143.64,4160.25,7924.22,4629.12,4278.49,-3052.35
2395183535512676864,2020-08,4121.09,194.14,758.44,3577.59,1107.8,-1944.55
2395183535512676864,2020-09,2011.33,2623.99,6094.5,2549.53,2932.31,987.76
2395183535512676864,2020-10,2105.13,1565.07,5364,8942.51,-3038.45,-2050.69
2395183535512676864,2020-11,4589.34,6469.84,989.34,1188.16,-2079.32,-4130.01
2395183535512676864,2020-12,4085.82,6544.15,996.25,6051.22,-7513.3,-11643.31
2395548401983009792,2020-01,3062.74,3914.87,1648.99,2611.2,-1814.34,-1814.34
2395548401983009792,2020-02,1249.49,730.23,5629.72,1009.24,5139.74,3325.4
2395548401983009792,2020-03,3837.32,5290.38,2474.96,4871.88,-3849.98,-524.58
2395548401983009792,2020-04,1360.81,8214.81,1524.77,664.84,-5994.07,-6518.65
2395548401983009792,2020-05,7130.82,5198.13,2053.85,2012.9,1973.64,-4545.01
2395548401983009792,2020-06,1106.97,5964.84,4157.23,4059.36,-4760,-9305.01
2395548401983009792,2020-07,1998.38,5099.52,3321.78,1474.61,-1253.97,-10558.98
2395548401983009792,2020-08,3422.14,4177.76,3170.42,0,2414.8,-8144.18
2395548401983009792,2020-09,4776.92,2264.73,1364.1,2815.32,1060.97,-7083.21
2395548401983009792,2020-10,955.22,1467.73,2550.36,1166.24,871.61,-6211.6
2395548401983009792,2020-11,3033.81,0,1051.94,599.5,3486.25,-2725.35
2395548401983009792,2020-12,2867.88,0,2229.49,2613.72,2483.65,-241.7
2396150102693153792,2020-01,2927.83,2691.55,3932.41,6229.83,-2061.14,-2061.14
2396150102693153792,2020-02,6028.55,10354.97,1129.96,4770.98,-7967.44,-10028.58
2396150102693153792,2020-03,473.21,72.06,2346.98,5345.13,-2597,-12625.58
2396150102693153792,2020-04,1970.8,651,4725.86,0,6045.66,-6579.92
2396150102693153792,2020-05,5394.72,7369,4480.09,1721.38,784.43,-5795.49
2396150102693153792,2020-06,874.07,4168.99,2922.42,2895.46,-3267.96,-9063.45
2396150102693153792,2020-07,5379.43,1861.81,8184.33,540.76,11161.19,2097.74
2396150102693153792,2020-08,2068.34,1995.88,3615.71,4913.48,-1225.31,872.43
2396150102693153792,2020-09,213.35,5492.34,3743.44,7172.92,-8708.47,-7836.04
2396150102693153792,2020-10,1285.23,595.41,1180.42,1186.73,683.51,-7152.53
2396150102693153792,2020-11,1418.37,1957.85,1396.13,4673.22,-3816.57,-10969.1
2396150102693153792,2020-12,3680.16,3674.71,6125.66,4774.78,1356.33,-9612.77
2396269390305317888,2020-01,3223.72,1281.54,0,4251.61,-2309.43,-2309.43
2396269390305317888,2020-02,2043.42,3156.68,1317.69,3908.72,-3704.29,-6013.72
2396269390305317888,2020-03,3339.49,1111.75,3882.27,1314.05,4795.96,-1217.76
2396269390305317888,2020-04,2903.96,0,2026.34,1404.99,3525.31,2307.55
2396269390305317888,2020-05,1730.85,0,0,1144.39,586.46,2894.01
2396269390305317888,2020-06,2733.92,3119.58,4544.2,2703.68,1454.86,4348.87
2396269390305317888,2020-07,3857.78,2831.24,2813.59,1920.15,1919.98,6268.85
2396269390305317888,2020-08,0,4382.14,1237.05,6193.3,-9338.39,-3069.54
2396269390305317888,2020-09,422.84,2310.25,847.26,1977.76,-3017.91,-6087.45
2396269390305317888,2020-10,406.98,1391.8,0,34.42,-1019.24,-7106.69
2396269390305317888,2020-11,838.4,1563.87,1272.98,4937.43,-4389.92,-11496.61
2396269390305317888,2020-12,586.93,3859.2,4718.31,4529.83,-3083.79,-14580.4
2398205840510124032,2020-01,284.46,1374.95,1052.86,3566.56,-3604.19,-3604.19
2398205840510124032,2020-02,1758.84,383.59,865.84,2077.89,163.2,-3440.99
2398205840510124032,2020-03,0,820.12,0,1636.48,-2456.6,-5897.59
2398205840510124032,2020-04,2158.51,0,3241.86,995.58,4404.79,-1492.8
2398205840510124032,2020-05,1575.35,1393.49,3824.09,0,4005.95,2513.15
2398205840510124032,2020-06,1291.35,1015.84,1135.65,1826.48,-415.32,2097.83
2398205840510124032,2020-07,3384.31,654.97,2374.79,0,5104.13,7201.96
2398205840510124032,2020-08,1953.45,4465.2,975.47,1876.4,-3412.68,3789.28
2398205840510124032,2020-09,998.57,0,500.08,3691.48,-2192.83,1596.45
2398205840510124032,2020-10,1991.49,1898.34,3901.02,0,3994.17,5590.62
2398205840510124032,2020-11,2310.47,180.75,770.6,4310.58,-1410.26,4180.36
2398205840510124032,2020-12,1416.58,3777.06,7041.74,0,4681.26,8861.62
2399710096974452224,2020-01,4877.8,1600.71,1369.74,4786.29,-139.46,-139.46
2399710096974452224,2020-02,1612.9,2133.98,4313.28,2833.89,958.31,818.85
2399710096974452224,2020-03,4711.1,2028.17,6506.49,1755.73,7433.69,8252.54
2399710096974452224,2020-04,4759.33,4113.42,4594.87,3027.24,2213.54,10466.08
2399710096974452224,2020-05,1800.6,4454.55,0,1673.85,-4327.8,6138.28
2399710096974452224,2020-06,1031.78,4860.78,2714.59,5076.02,-6190.43,-52.15
2399710096974452224,2020-07,4102.56,3471.1,1471.75,65.38,2037.83,1985.68
2399710096974452224,2020-08,1402.82,1475.54,4428.39,5800.15,-1444.48,541.2
2399710096974452224,2020-09,4014.65,3485.81,1435.77,4565.86,-2601.25,-2060.05
2399710096974452224,2020-10,850.95,0,4202.56,6583.03,-1529.52,-3589.57
2399710096974452224,2020-11,6991.97,2841.43,2436.34,1971.47,4615.41,1025.84
2399710096974452224,2020-12,0,1469.89,2203.11,5721.5,-4988.28,-3962.44
2401023034540708352,2020-01,0,1019.69,2451.07,790.67,640.71,640.71
2401023034540708352,2020-02,1511.44,1404.09,0,985.57,-878.22,-237.51
2401023034540708352,2020-03,1137.38,0,0,862.06,275.32,37.81
2401023034540708352,2020-04,5007.29,1596.88,1991.63,1892.94,3509.1,3546.91
2401023034540708352,2020-05,2007.88,1431.6,0,0,576.28,4123.19
2401023034540708352,2020-07,556.1,1944.92,4179.7,2995.79,-204.91,3918.28
2401023034540708352,2020-08,1703.66,1193.83,0,589.28,-79.45,3838.83
2401023034540708352,2020-09,0,5150.29,2480.52,1447.82,-4117.59,-278.76
2401023034540708352,2020-10,3619.49,1722.94,3460.96,0,5357.51,5078.75
2401023034540708352,2020-11,954.96,3370.55,2896.82,0,481.23,5559.98
2401023034540708352,2020-12,0,1229.78,0,1587.28,-2817.06,2742.92
2401289382455005184,2020-01,0,1165.29,455.23,2315.11,-3025.17,-3025.17
2401289382455005184,2020-02,859.31,0,1750.85,1276.12,1334.04,-1691.13
2401289382455005184,2020-03,3895.72,2577.07,1840.73,1881.81,1277.57,-413.56
2401289382455005184,2020-04,3110.64,4871.13,0,2291.49,-4051.98,-4465.54
2401289382455005184,2020-05,3060.11,0,4187.15,2521.79,4725.47,259.93
2401289382455005184,2020-06,0,1851.03,1918.71,4604.3,-4536.62,-4276.69
2401289382455005184,2020-07,2866.83,0,1137.68,2499.19,1505.32,-2771.37
2401289382455005184,2020-08,2178.53,1679.79,0,1177.63,-678.89,-3450.26
2401289382455005184,2020-09,348.56,6621.49,160.3,0,-6112.63,-9562.89
2401289382455005184,2020-10,1814.79,0,2540.02,3064.78,1290.03,-8272.86
2401289382455005184,2020-11,5699.74,2714.19,0,0,2985.55,-5287.31
2401289382455005184,2020-12,939.92,2694.77,288.25,1049.25,-2515.85,-7803.16
2401349540693526528,2020-01,914.81,0,2250.92,1323.85,1841.88,1841.88
2401349540693526528,2020-02,2291.35,1564.86,3961.81,1041.95,3646.35,5488.23
2401349540693526528,2020-03,1015.54,1360.19,647.47,0,302.82,5791.05
2401349540693526528,2020-04,1445.09,3633.02,1714.53,1439.91,-1913.31,3877.74
2401349540693526528,2020-05,597.73,2336.36,1277.81,5152.24,-5613.06,-1735.32
2401349540693526528,2020-06,1760.42,1345.61,436.3,0,851.11,-884.21
2401349540693526528,2020-08,3256.65,1724.58,0,356.68,1175.39,291.18
2401349540693526528,2020-09,549.23,670.51,738.03,3728.18,-3111.43,-2820.25
2401349540693526528,2020-10,2807.3,1650.11,787.48,3190.42,-1245.75,-4066
2401349540693526528,2020-11,2638.89,1914.45,1833.93,4545.82,-1987.45,-6053.45
2401349540693526528,2020-12,1007.69,1448.33,3674.08,0,3233.44,-2820.01
2401397953910279680,2020-01,4276.44,4062.89,2063.12,5057.54,-2780.87,-2780.87
2401397953910279680,2020-02,2798.63,3070.54,3498.87,4275.26,-1048.3,-3829.17
2401397953910279680,2020-03,2750.19,801.89,0,3557.61,-1609.31,-5438.48
2401397953910279680,2020-04,3181.93,2729.91,2551.8,0,3003.82,-2434.66
2401397953910279680,2020-05,0,2938.39,2773.81,4344.13,-4508.71,-6943.37
2401397953910279680,2020-06,3023.33,0,1413.99,1626.42,2810.9,-4132.47
2401397953910279680,2020-07,1287.71,3355.71,4408.1,7329.1,-4989,-9121.47
2401397953910279680,2020-08,1517.48,5561,4915.37,2216.63,-1344.78,-10466.25
2401397953910279680,2020-09,989.53,3221.22,3472.98,3789.33,-2548.04,-13014.29
2401397953910279680,2020-10,5139.8,0,2046.58,1207.16,5979.22,-7035.07
2401397953910279680,2020-11,2549.54,1916.17,2392.5,1494.78,1531.09,-5503.98
2401397953910279680,2020-12,463.34,1023.26,1458.81,2617.35,-1718.46,-7222.44
2401522045076274688,2020-01,0,1672.64,1182.35,814.98,-1305.27,-1305.27
2401522045076274688,2020-02,1479.61,0,0,0,1479.61,174.34
2401522045076274688,2020-03,0,1686.29,0,791.67,-2477.96,-2303.62
2401522045076274688,2020-04,170.35,0,3904.86,2710.47,1364.74,-938.88
2401522045076274688,2020-05,3428.06,0,336.71,0,3764.77,2825.89
2401522045076274688,2020-06,531.01,85.4,0,1982.97,-1537.36,1288.53
2401522045076274688,2020-07,3551.16,1849.7,3234.77,1683.28,3252.95,4541.48
2401522045076274688,2020-08,1785.81,1803.08,1903.82,1961.84,-75.29,4466.19
2401522045076274688,2020-09,0,353.56,529.29,1144.14,-968.41,3497.78
2401522045076274688,2020-10,0,469.37,0,1809.78,-2279.15,1218.63
2401522045076274688,2020-11,1590.69,1871.65,1389.12,3259.92,-2151.76,-933.13
2401522045076274688,2020-12,1946.81,1947.98,2208.27,0,2207.1,1273.97
2407446585810824192,2020-01,1446.18,2581.74,6837.74,2452.57,3249.61,3249.61
2407446585810824192,2020-02,5696.58,3863.66,7162.73,5171.18,3824.47,7074.08
2407446585810824192,2020-03,1682.41,9281.73,5283.42,4658.7,-6974.6,99.48
2407446585810824192,2020-04,1055.62,0,9656.35,2031.58,8680.39,8779.87
2407446585810824192,2020-05,4142.05,3869.62,1771.47,6092.64,-4048.74,4731.13
2407446585810824192,2020-06,1073.46,3584.44,2954.12,776.89,-333.75,4397.38
2407446585810824192,2020-07,5965.37,2101.02,2530.28,4949.53,1445.1,5842.48
2407446585810824192,2020-08,3504.36,3949.02,3545.16,2439.65,660.85,6503.33
2407446585810824192,2020-09,5220.59,266.94,0,3633.45,1320.2,7823.53
2407446585810824192,2020-10,3921.48,7709.54,2560.85,6022.59,-7249.8,573.73
2407446585810824192,2020-11,5777.9,5003.15,6459.98,1324.13,5910.6,6484.33
2407446585810824192,2020-12,3324,4172.81,4214.83,2020.71,1345.31,7829.64
2407919194432215040,2020-01,1314.88,1766.05,2189.29,0,1738.12,1738.12
2407919194432215040,2020-02,2331.84,2288.02,40.55,439.21,-354.84,1383.28
2407919194432215040,2020-03,969.68,4212.27,2002.8,2116.81,-3356.6,-1973.32
2407919194432215040,2020-04,0,3991.44,3834.41,4366.92,-4523.95,-6497.27
2407919194432215040,2020-05,4646.77,1150.87,0,2715.12,780.78,-5716.49
2407919194432215040,2020-06,0,1683.21,2660.22,0,977.01,-4739.48
2407919194432215040,2020-07,278.6,294.42,2818.24,795.07,2007.35,-2732.13
2407919194432215040,2020-08,923.38,2052.61,470.42,1039.06,-1697.87,-4430
2407919194432215040,2020-09,1947.71,1157.21,4627.72,0,5418.22,988.22
2407919194432215040,2020-11,798.76,1796.35,2316.55,0,1318.96,2307.18
2407919194432215040,2020-12,0,3169.59,0,2263.05,-5432.64,-3125.46
2408910748984416768,2020-01,678.88,2016.87,1240.37,2520.6,-2618.22,-2618.22
2408910748984416768,2020-02,1358.12,4068.65,3164.68,4869.93,-4415.78,-7034
2408910748984416768,2020-03,548.63,4544.72,3488.79,880.75,-1388.05,-8422.05
2408910748984416768,2020-04,2641.49,0,1821.93,2358.01,2105.41,-6316.64
2408910748984416768,2020-05,3357.8,0,0,2198.97,1158.83,-5157.81
2408910748984416768,2020-06,0,5729.11,3374.79,606.89,-2961.21,-8119.02
2408910748984416768,2020-07,3652.13,2988.03,0,1290.15,-626.05,-8745.07
2408910748984416768,2020-08,3242.73,3181.46,2672.25,2149.12,584.4,-8160.67
2408910748984416768,2020-09,1047.2,3341.54,1245.15,3556.09,-4605.28,-12765.95
2408910748984416768,2020-10,1706.66,53.03,1107.47,1442.7,1318.4,-11447.55
2408910748984416768,2020-11,1801.98,3140.9,0,1180,-2518.92,-13966.47
2408910748984416768,2020-12,1204.93,859.26,1967.11,0,2312.78,-11653.69
2409958200181726720,2020-10,1172.22,0,0,0,1172.22,1172.22
2410490373981861376,2020-01,2551.1,0,65.92,210.13,2406.89,2406.89
2410490373981861376,2020-02,0,2279.48,1582.49,3399.71,-4096.7,-1689.81
2410490373981861376,2020-03,1112.67,0,1974.72,1129.35,1958.04,268.23
2410490373981861376,2020-04,0,5504.7,0,2201.75,-7706.45,-7438.22
2410490373981861376,2020-05,4442.38,4031.84,1561.55,2504.85,-532.76,-7970.98
2410490373981861376,2020-06,1728.05,5037.76,0,3660.54,-6970.25,-14941.23
2410490373981861376,2020-07,750.21,3662.14,3563.07,379.79,271.35,-14669.88
2410490373981861376,2020-08,1105.12,2483.33,0,2414.48,-3792.69,-18462.57
2410490373981861376,2020-09,487.48,1705.74,1862.13,0,643.87,-17818.7
2410490373981861376,2020-10,3150.72,0,2738.08,1816.57,4072.23,-13746.47
2410490373981861376,2020-11,3009.92,3222.07,2705.34,1511.61,981.58,-12764.89
2410490373981861376,2020-12,1191.28,605.43,4745.63,2299.14,3032.34,-9732.55
2410639409037228032,2020-01,358.27,0,1962.65,781.53,1539.39,1539.39
2410639409037228032,2020-09,417.57,0,0,0,417.57,1956.96
2410639409037228032,2020-10,1545.31,0,0,0,1545.31,3502.27
2410907920775945216,2020-01,3507.52,5432.4,2645.05,0,720.17,720.17
2410907920775945216,2020-02,1742.59,0,1475.09,4122.71,-905.03,-184.86
2410907920775945216,2020-03,4727.45,0,1948.1,978.76,5696.79,5511.93
2410907920775945216,2020-04,2232.98,474.18,2445.21,1814.23,2389.78,7901.71
2410907920775945216,2020-05,838.89,1532.5,2269.66,2388.93,-812.88,7088.83
2410907920775945216,2020-06,7580.49,0,5486.1,841.78,12224.81,19313.64
2410907920775945216,2020-07,156.92,1678.35,0,3131.27,-4652.7,14660.94
2410907920775945216,2020-08,0,2297.07,0,317.8,-2614.87,12046.07
2410907920775945216,2020-09,1121.95,0,3057.43,1217.77,2961.61,15007.68
2410907920775945216,2020-10,1537.78,1349.57,1975.01,869.32,1293.9,16301.58
2410907920775945216,2020-11,0,1227.59,0,1785.81,-3013.4,13288.18
2410907920775945216,2020-12,1306.37,929.25,539.68,0,916.8,14204.98
2411068658241079808,2020-01,1965.73,4280.9,1999.06,1785.04,-2101.15,-2101.15
2411068658241079808,2020-02,0,3335.68,502.51,153.8,-2986.97,-5088.12
2411068658241079808,2020-03,1977.83,4620.54,1059.41,0,-1583.3,-6671.42
2411068658241079808,2020-04,2577.35,350.34,3080.48,3228.1,2079.39,-4592.03
2411068658241079808,2020-05,1952.6,1242.79,4747.62,254.97,5202.46,610.43
2411068658241079808,2020-06,0,2517.2,2796.87,1833.51,-1553.84,-943.41
2411068658241079808,2020-07,4937.86,1100.96,1920.06,463,5293.96,4350.55
2411068658241079808,2020-08,301.84,1967.44,5099.98,5257.75,-1823.37,2527.18
2411068658241079808,2020-09,1630.44,1911.95,4189.85,1526.69,2381.65,4908.83
2411068658241079808,2020-10,1088.78,800.82,741.14,0,1029.1,5937.93
2411068658241079808,2020-11,649.48,774.63,4163.25,0,4038.1,9976.03
2411068658241079808,2020-12,2059.81,300.21,3793.85,476.48,5076.97,15053
2413095342474352128,2020-01,3933.22,211.14,1939.66,1901.02,3760.72,3760.72
2413095342474352128,2020-02,574.19,4095.67,1234.38,0,-2287.1,1473.62
2413095342474352128,2020-03,3995.72,1121.98,0,0,2873.74,4347.36
2413095342474352128,2020-04,1191.47,1649.63,1513.42,384.8,670.46,5017.82
2413095342474352128,2020-05,4213.07,1382.37,2515.77,1504.58,3841.89,8859.71
2413095342474352128,2020-07,1016.74,5514.93,2736.73,1364.89,-3126.35,5733.36
2413095342474352128,2020-08,4765.36,1384.1,1171.19,2775.56,1776.89,7510.25
2413095342474352128,2020-09,507.58,1921.1,0,2993.57,-4407.09,3103.16
2413095342474352128,2020-10,4285.97,2913.89,4819.7,0,6191.78,9294.94
2413095342474352128,2020-11,474.53,5545.34,1051.76,0,-4019.05,5275.89
2413095342474352128,2020-12,2830.65,2212.18,3015.03,1872.29,1761.21,7037.1
2414680610979247616,2020-01,7418.25,1779.85,2315.74,881.09,7073.05,7073.05
2414680610979247616,2020-02,5838.86,3299.55,172.11,1703.2,1008.22,8081.27
2414680610979247616,2020-03,0,424.34,6943.67,6554.67,-35.34,8045.93
2414680610979247616,2020-04,3327.26,603.04,5106.53,2681.99,5148.76,13194.69
2414680610979247616,2020-05,3249.67,2689.27,1777.25,4834.01,-2496.36,10698.33
2414680610979247616,2020-06,0,2155.97,0,7809.53,-9965.5,732.83
2414680610979247616,2020-07,2301.81,8356.6,1961.52,1183.18,-5276.45,-4543.62
2414680610979247616,2020-08,0,8868.76,2840.86,3151.27,-9179.17,-13722.79
2414680610979247616,2020-09,4819.82,8487.89,3737.23,2449.05,-2379.89,-16102.68
2414680610979247616,2020-10,1192.84,1777.7,3201.8,2366.41,250.53,-15852.15
2414680610979247616,2020-11,4254.41,5070.42,1760.33,2276.93,-1332.61,-17184.76
2414680610979247616,2020-12,1261.46,2733.27,4876.24,1989.17,1415.26,-15769.5
2415067679263659520,2020-01,1839.74,0,0,2616.23,-776.49,-776.49
2415067679263659520,2020-02,2702.55,0,0,157.26,2545.29,1768.8
2415067679263659520,2020-03,3041.16,0,1301.38,153.01,4189.53,5958.33
2415067679263659520,2020-04,3831.81,0,1627.23,477.25,4981.79,10940.12
2415067679263659520,2020-05,0,2189.58,319.09,1403.66,-3274.15,7665.97
2415067679263659520,2020-06,1455.22,0,1897.93,3694.8,-341.65,7324.32
2415067679263659520,2020-07,923.73,2981.13,3023.76,0,966.36,8290.68
2415067679263659520,2020-08,1350.12,0,1623.4,0,2973.52,11264.2
2415067679263659520,2020-10,0,3648.16,1382.42,0,-2265.74,8998.46
2415067679263659520,2020-11,3472.29,0,0,766.48,2705.81,11704.27
2415067679263659520,2020-12,0,2531.3,1920.35,202.09,-813.04,10891.23
2415263198175183872,2020-01,1910.27,2186.8,2124.05,4558.38,-2710.86,-2710.86
2415263198175183872,2020-02,6274.78,8587.8,401.17,2209.9,-4121.75,-6832.61
2415263198175183872,2020-03,1690.37,1637.29,5036.66,2232.12,2857.62,-3974.99
2415263198175183872,2020-04,1064.1,1727.54,823.11,3162.34,-3002.67,-6977.66
2415263198175183872,2020-05,1559.43,1356.18,1537.21,5213.16,-3472.7,-10450.36
2415263198175183872,2020-06,0,1992.53,4202.36,3940.38,-1730.55,-12180.91
2415263198175183872,2020-07,4799.78,1831.49,2524.02,2494.28,2998.03,-9182.88
2415263198175183872,2020-08,5723.7,3459.51,1117.99,1398.5,1983.68,-7199.2
2415263198175183872,2020-09,4669.76,3767.17,2419.14,0,3321.73,-3877.47
2415263198175183872,2020-10,6622.09,2978.79,0,1334.57,2308.73,-1568.74
2415263198175183872,2020-11,1977.61,2207.58,1200.07,1727.42,-757.32,-2326.06
2415263198175183872,2020-12,1580.18,3122.44,4219.33,2491.8,185.27,-2140.79
2415672511310092288,2020-01,0,246.76,3332.64,727.42,2358.46,2358.46
2415672511310092288,2020-02,2893.09,0,1908.17,3325.59,1475.67,3834.13
2415672511310092288,2020-04,924.76,1840.23,0,2056.2,-2971.67,862.46
2415672511310092288,2020-05,571.73,1700.51,0,1030.36,-2159.14,-1296.68
2415672511310092288,2020-06,0,1198.25,182.17,525.77,-1541.85,-2838.53
2415672511310092288,2020-07,38.21,0,0,1881.51,-1843.3,-4681.83
2415672511310092288,2020-08,595.46,509.04,3746.57,763.87,3069.12,-1612.71
2415672511310092288,2020-09,159.5,0,664.55,702.82,121.23,-1491.48
2415672511310092288,2020-10,2844.12,0,0,0,2844.12,1352.64
2415672511310092288,2020-12,2253.84,0,0,1625.53,628.31,1980.95
2415749686764510720,2020-02,1373.54,81.62,0,0,1291.92,1291.92
2415749686764510720,2020-03,340.04,0,857.71,0,1197.75,2489.67
2415749686764510720,2020-04,874.48,0,0,0,874.48,3364.15
2415749686764510720,2020-09,0,1351.46,0,0,-1351.46,2012.69
2415749686764510720,2020-10,465.98,0,0,0,465.98,2478.67
2415749686764510720,2020-11,0,1730,0,0,-1730,748.67
2415749686764510720,2020-12,3127.41,0,0,648.53,2478.88,3227.55
2415906080908179968,2020-01,3000.7,738.72,42.84,0,2304.82,2304.82
2415906080908179968,2020-03,907.68,2769.09,307.16,0,-1554.25,750.57
2415906080908179968,2020-04,970.15,0,0,478.66,491.49,1242.06
2415906080908179968,2020-05,329.05,2203.25,0,1033.1,-2907.3,-1665.24
2415906080908179968,2020-06,1663.95,0,574.26,0,2238.21,572.97
2415906080908179968,2020-07,2516.11,4090.14,819.67,0,-754.36,-181.39
2415906080908179968,2020-08,1490.76,0,0,1646.59,-155.83,-337.22
2415906080908179968,2020-09,2588.22,1828.89,1178.8,202.73,1735.4,1398.18
2415906080908179968,2020-10,2240.84,0,2303.42,0,4544.26,5942.44
2415906080908179968,2020-11,0,155.28,238.94,0,83.66,6026.1
2415906080908179968,2020-12,522.41,2545.22,1895.27,557.64,-685.18,5340.92
2416605611009102336,2020-01,92.63,3022.85,599.44,3348.36,-5679.14,-5679.14
2416605611009102336,2020-02,2526.53,2546.32,0,1420.15,-1439.94,-7119.08
2416605611009102336,2020-03,1903.79,2355.7,915.08,1275.29,-812.12,-7931.2
2416605611009102336,2020-04,985.75,539,2645.51,0,3092.26,-4838.94
2416605611009102336,2020-05,0,270.02,6479.36,2061.57,4147.77,-691.17
2416605611009102336,2020-07,0,1739.22,1513.06,2271.67,-2497.83,-3189
2416605611009102336,2020-08,1982.96,956.82,0,0,1026.14,-2162.86
2416605611009102336,2020-09,485.86,4074.57,0,2216.33,-5805.04,-7967.9
2416605611009102336,2020-10,0,4520.5,2844.66,1329.39,-3005.23,-10973.13
2416605611009102336,2020-11,636.37,0,0,3153.81,-2517.44,-13490.57
2416605611009102336,2020-12,535.19,996.75,1789.62,1021.85,306.21,-13184.36
2416715648146806784,2020-01,1977.28,2168.18,1403.98,2061.26,-848.18,-848.18
2416715648146806784,2020-02,0,640.57,1673.07,2247.11,-1214.61,-2062.79
2416715648146806784,2020-03,2189.43,3368.31,500.22,425.91,-1104.57,-3167.36
2416715648146806784,2020-04,1980,4210.13,1156.48,706.3,-1779.95,-4947.31
2416715648146806784,2020-05,2893.24,1532.26,4696.56,4665.29,1392.25,-3555.06
2416715648146806784,2020-06,1245.25,504.36,1332.97,2876.39,-802.53,-4357.59
2416715648146806784,2020-07,1970.47,6621.96,4134.51,5032.53,-5549.51,-9907.1
2416715648146806784,2020-08,601.48,350.1,919.4,2814.14,-1643.36,-11550.46
2416715648146806784,2020-09,3637.48,324.36,2086.37,784.31,4615.18,-6935.28
2416715648146806784,2020-10,1534.61,1649.88,1518.02,2718.9,-1316.15,-8251.43
2416715648146806784,2020-11,125.08,143.61,3332.52,2017.43,1296.56,-6954.87
2416715648146806784,2020-12,0,422.12,1679.53,4090.6,-2833.19,-9788.06
2417267114354775552,2020-01,1766.3,88.6,2030.65,1815.27,1893.08,1893.08
2417267114354775552,2020-02,2185.27,3777.99,3536.58,1854.05,89.81,1982.89
2417267114354775552,2020-03,6321.54,1019.55,2136.01,5536.73,1901.27,3884.16
2417267114354775552,2020-04,3716.57,2707,2224.18,8351.13,-5117.38,-1233.22
2417267114354775552,2020-05,11768.41,4693.45,5083.91,5227.09,6931.78,5698.56
2417267114354775552,2020-06,1144.26,4222.72,2659.26,2096.32,-2515.52,3183.04
2417267114354775552,2020-07,3014.44,5718.05,8827.81,3273.96,2850.24,6033.28
2417267114354775552,2020-08,3802.81,1384.2,8489.07,9345.45,1562.23,7595.51
2417267114354775552,2020-09,3318.1,4364.88,5568.66,9926.85,-5404.97,2190.54
2417267114354775552,2020-10,2790.71,865.07,4157.98,3272.42,2811.2,5001.74
2417267114354775552,2020-11,5423.06,5241.43,5286.94,1265.31,4203.26,9205
2417267114354775552,2020-12,3738.61,4260.34,7702.03,2752.3,4428,13633
2418514327681277440,2020-01,1981.59,5010.13,1018.49,6642.13,-8652.18,-8652.18
2418514327681277440,2020-02,3827.78,1950.98,2599.62,199.26,4277.16,-4375.02
2418514327681277440,2020-03,2301.97,1925.95,2040.09,3270.52,-854.41,-5229.43
2418514327681277440,2020-04,5568.13,3153.56,3860.29,0,6274.86,1045.43
2418514327681277440,2020-05,5760.99,4878.32,2966.09,536.28,3312.48,4357.91
2418514327681277440,2020-06,585.42,5106.38,1555,5836.82,-8802.78,-4444.87
2418514327681277440,2020-07,1822.52,1028.14,4796.53,4629.94,960.97,-3483.9
2418514327681277440,2020-08,699.43,2175.79,3830.5,3406.24,-1052.1,-4536
2418514327681277440,2020-10,1031.97,1541.47,8662.04,4362.96,3789.58,-746.42
2418514327681277440,2020-11,4771.22,2955.51,219.83,3440.4,-1404.86,-2151.28
2418514327681277440,2020-12,4445.94,7847.79,849.4,4174.33,-6726.78,-8878.06
2419552222265677824,2020-02,0,571.32,1795.75,5031.83,-3807.4,-3807.4
2419552222265677824,2020-03,983.58,1139.49,106.31,0,-49.6,-3857
2419552222265677824,2020-04,0,1304.52,990.04,3260.34,-3574.82,-7431.82
2419552222265677824,2020-07,2945.39,0,0,764.83,2180.56,-5251.26
2419552222265677824,2020-08,1933.79,1487.11,0,0,446.68,-4804.58
2419552222265677824,2020-09,2043.39,0,0,141.84,1901.55,-2903.03
2419552222265677824,2020-10,187.36,375.43,0,688.18,-876.25,-3779.28
2419552222265677824,2020-11,1336.86,795.53,1090.36,380.05,1251.64,-2527.64
2419552222265677824,2020-12,0,144.25,0,3952.71,-4096.96,-6624.6
2419946171254888960,2020-01,428.02,3217.77,983.2,1417.02,-3223.57,-3223.57
2419946171254888960,2020-02,0,2333.91,663.27,302.95,-1973.59,-5197.16
2419946171254888960,2020-03,2870.72,0,1870.43,0,4741.15,-456.01
2419946171254888960,2020-04,0,1331.56,3014.96,0,1683.4,1227.39
2419946171254888960,2020-05,1828.93,0,614.43,2031.72,411.64,1639.03
2419946171254888960,2020-06,0,1118.73,1549.98,1273.2,-841.95,797.08
2419946171254888960,2020-07,0,1840.96,3721.35,1979.99,-99.6,697.48
2419946171254888960,2020-08,1056.92,799.63,1627.39,0,1884.68,2582.16
2419946171254888960,2020-09,0,1903.2,0,0,-1903.2,678.96
2419946171254888960,2020-10,1444.09,1549.63,411.92,1601.01,-1294.63,-615.67
2419946171254888960,2020-11,0,491.86,0,0,-491.86,-1107.53
2419946171254888960,2020-12,0,1957.52,0,1350.45,-3307.97,-4415.5
2420457489152444928,2020-01,5452.02,3766.27,1668.8,2937.07,417.48,417.48
2420457489152444928,2020-02,3056.55,305.25,1182.54,1365.67,2568.17,2985.65
2420457489152444928,2020-03,0,3075.23,2334.48,6001.41,-6742.16,-3756.51
2420457489152444928,2020-04,3173.83,1875.96,2022.85,4480.28,-1159.56,-4916.07
2420457489152444928,2020-05,6500.24,1736.03,5321.52,0,10085.73,5169.66
2420457489152444928,2020-06,2815.86,4030.19,2962.02,2832.71,-1085.02,4084.64
2420457489152444928,2020-07,4071.53,4289.23,5737.79,3289.05,2231.04,6315.68
2420457489152444928,2020-08,4836.16,6864.3,1248.9,2771.19,-3550.43,2765.25
2420457489152444928,2020-09,2035.94,1103.79,544.89,5182.32,-3705.28,-940.03
2420457489152444928,2020-10,1775.27,5513.88,5063.27,7057.15,-5732.49,-6672.52
2420457489152444928,2020-11,5424.26,5997.68,4674.56,3861.35,239.79,-6432.73
2420457489152444928,2020-12,3168.1,1031.24,3398.88,3772.02,1763.72,-4669.01
2420658725619854336,2020-01,0,3094.06,1270.02,0,-1824.04,-1824.04
2420658725619854336,2020-02,0,1205.47,1561.89,2143.55,-1787.13,-3611.17
2420658725619854336,2020-03,0,1846.28,0,0,-1846.28,-5457.45
2420658725619854336,2020-04,0,1552.01,1425.22,1024.13,-1150.92,-6608.37
2420658725619854336,2020-05,578.09,723.92,0,1485.25,-1631.08,-8239.45
2420658725619854336,2020-06,1010.02,927.68,2483.25,5065.14,-2499.55,-10739
2420658725619854336,2020-07,2212.08,0,0,1763.09,448.99,-10290.01
2420658725619854336,2020-08,1021.49,1735.86,0,778.24,-1492.61,-11782.62
2420658725619854336,2020-09,0,371.16,307.73,0,-63.43,-11846.05
2420658725619854336,2020-10,330.12,932.71,44.38,1082.61,-1640.82,-13486.87
2420658725619854336,2020-11,1764.91,1532.78,1363.56,1463.13,132.56,-13354.31
2420658725619854336,2020-12,0,1271.93,5928.7,1911.8,2744.97,-10609.34
2420762049727410688,2020-01,1961.06,7017.17,1734.64,647.26,-3968.73,-3968.73
2420762049727410688,2020-02,2091.14,0,3624.19,319.17,5396.16,1427.43
2420762049727410688,2020-03,1912.51,0,4893.49,654.35,6151.65,7579.08
2420762049727410688,2020-04,1419.16,0,1188.37,366.9,2240.63,9819.71
2420762049727410688,2020-05,3925.21,991.09,3584.14,1970.95,4547.31,14367.02
2420762049727410688,2020-06,4148.54,2788.14,0,2289.13,-928.73,13438.29
2420762049727410688,2020-08,935.71,4884.05,1997.8,433.23,-2383.77,11054.52
2420762049727410688,2020-09,35.86,2678.25,1999.93,0,-642.46,10412.06
2420762049727410688,2020-10,1023.94,1388.13,2596.89,0,2232.7,12644.76
2420762049727410688,2020-11,2265.8,664.22,1452.98,1021.48,2033.08,14677.84
2420762049727410688,2020-12,4595,0,0,1934.94,2660.06,17337.9
2421471451521885696,2020-01,1363.5,1781.09,391.66,1701.64,-1727.57,-1727.57
2421471451521885696,2020-02,2865.85,3210.58,0,0,-344.73,-2072.3
2421471451521885696,2020-03,182.37,1598.45,2580.38,1428.7,-264.4,-2336.7
2421471451521885696,2020-04,912.15,651.59,3289.6,2801.91,748.25,-1588.45
2421471451521885696,2020-05,1799.41,0,2708.91,4028.45,479.87,-1108.58
2421471451521885696,2020-06,697.66,2966.7,2561,2426.63,-2134.67,-3243.25
2421471451521885696,2020-07,0,668.89,4060.3,0,3391.41,148.16
2421471451521885696,2020-08,4174.87,1251.6,701.19,0,3624.46,3772.62
2421471451521885696,2020-09,3083.01,1425.99,2015.66,0,3672.68,7445.3
2421471451521885696,2020-10,3822.33,1929.84,718.4,763.67,1847.22,9292.52
2421471451521885696,2020-11,2964.98,639.5,3848.68,3684.4,2489.76,11782.28
2421471451521885696,2020-12,894.59,1722.24,1844.48,4739.9,-3723.07,8059.21
2421696337313377280,2020-02,599.7,0,0,0,599.7,599.7
2421696337313377280,2020-03,571.96,0,621.46,0,1193.42,1793.12
2421696337313377280,2020-04,0,553.23,501.85,460.61,-511.99,1281.13
2421696337313377280,2020-07,1566.26,0,1948.07,1072.35,2441.98,3723.11
2421696337313377280,2020-08,921.3,0,0,700.18,221.12,3944.23
2421696337313377280,2020-09,430.68,0,0,0,430.68,4374.91
2421696337313377280,2020-12,0,1206.35,117.49,2519.69,-3608.55,766.36
2422341876333099008,2020-01,8179.37,3454.01,5505.33,3442.36,6788.33,6788.33
2422341876333099008,2020-02,661.64,3355.51,5285.96,3476.05,-883.96,5904.37
2422341876333099008,2020-03,3546.52,6868.51,3344.81,469.8,-446.98,5457.39
2422341876333099008,2020-04,2170.7,2568.29,3856.5,1686.58,1772.33,7229.72
2422341876333099008,2020-05,3909.91,3011.83,810.56,3163.33,-1454.69,5775.03
2422341876333099008,2020-06,2211.03,15186.25,4749.63,6674.18,-14899.77,-9124.74
2422341876333099008,2020-07,2810.18,3081.16,2944.73,3033.99,-360.24,-9484.98
2422341876333099008,2020-08,3341.4,1089.77,2331.68,3382.6,1200.71,-8284.27
2422341876333099008,2020-09,7198.55,6162.08,2224.93,3916.68,-655.28,-8939.55
2422341876333099008,2020-10,3125.54,2028.11,9746.77,5039.45,5804.75,-3134.8
2422341876333099008,2020-11,3395.02,2902.5,4589.92,2705.21,2377.23,-757.57
2422341876333099008,2020-12,7747.88,6262.85,1614.89,4556.46,-1456.54,-2214.11
2422935775278013952,2020-01,9406.82,0,8212.94,6312.07,11307.69,11307.69
2422935775278013952,2020-02,1551.78,14492.52,9011.14,2958.94,-6888.54,4419.15
2422935775278013952,2020-03,1895.86,5367.58,2610.73,4203.43,-5064.42,-645.27
2422935775278013952,2020-04,6187.4,3104.14,7273.06,8013.23,2343.09,1697.82
2422935775278013952,2020-05,7892.8,5990.47,4426.4,4863.56,1465.17,3162.99
2422935775278013952,2020-06,678.03,8238.5,3454.53,1620.87,-5726.81,-2563.82
2422935775278013952,2020-07,5935.53,1007.08,5884.91,4827.68,5985.68,3421.86
2422935775278013952,2020-08,5131.87,8586.9,2363.58,1420.1,-2511.55,910.31
2422935775278013952,2020-09,10137.35,10978.93,7126.91,2323.06,3962.27,4872.58
2422935775278013952,2020-10,3299.71,3678.48,3159.38,10092.44,-7311.83,-2439.25
2422935775278013952,2020-11,3515.61,1974.51,5017.45,4323.17,2235.38,-203.87
2422935775278013952,2020-12,4604.58,1127.91,9570.97,7237.66,5809.98,5606.11
2424035876592515584,2020-01,1229.53,0,0,4465.7,-3236.17,-3236.17
2424035876592515584,2020-03,1148.55,3018.66,4346.47,261.2,2215.16,-1021.01
2424035876592515584,2020-04,1699.79,245.14,1271.18,914.47,1811.36,790.35
2424035876592515584,2020-05,0,772.04,2343.07,3252.68,-1681.65,-891.3
2424035876592515584,2020-06,1779.55,0,3347.9,3497.24,1630.21,738.91
2424035876592515584,2020-07,273.76,681.27,3007.63,2349.58,250.54,989.45
2424035876592515584,2020-08,0,3256.31,4565.58,3471.24,-2161.97,-1172.52
2424035876592515584,2020-09,0,855.86,109.66,2613.53,-3359.73,-4532.25
2424035876592515584,2020-10,1760.72,1559.25,415.39,4270.89,-3654.03,-8186.28
2424035876592515584,2020-11,1999.82,1441.04,712.81,1746.19,-474.6,-8660.88
2424035876592515584,2020-12,1625.88,2270.57,0,1771.54,-2416.23,-11077.11
2425694487765250560,2020-01,1454.35,0,0.01,1676.05,-221.69,-221.69
2425694487765250560,2020-02,0,257.82,2085.07,1159.52,667.73,446.04
2425694487765250560,2020-03,3171.7,0,553.62,138.98,3586.34,4032.38
2425694487765250560,2020-04,1177.09,638.56,1730.33,0,2268.86,6301.24
2425694487765250560,2020-05,0,2448.65,3213.51,1309.79,-544.93,5756.31
2425694487765250560,2020-06,2425.6,2698.74,1391.66,0,1118.52,6874.83
2425694487765250560,2020-07,0,934.07,0,705.55,-1639.62,5235.21
2425694487765250560,2020-08,736.66,0,0,2978.61,-2241.95,2993.26
2425694487765250560,2020-10,1277.76,1414.71,1217.24,4424.76,-3344.47,-351.21
2425694487765250560,2020-11,1650.4,920.93,334.6,1855.34,-791.27,-1142.48
2425694487765250560,2020-12,1756.23,0,0,1860.61,-104.38,-1246.86
2427868941055056896,2020-01,3657.52,4254.7,2063.39,7105.19,-5638.98,-5638.98
2427868941055056896,2020-02,6081.03,1842.33,3575.73,3108.11,4706.32,-932.66
2427868941055056896,2020-03,6053.46,1410.51,3315.55,2811.91,5146.59,4213.93
2427868941055056896,2020-04,1807.68,5697.24,3727.07,5408.22,-5570.71,-1356.78
2427868941055056896,2020-05,7065.24,2290.22,4304.24,7115.92,1963.34,606.56
2427868941055056896,2020-06,6470.56,7955.52,9266.47,3162.84,4618.67,5225.23
2427868941055056896,2020-07,5483.45,7039.01,2824.55,2909.87,-1640.88,3584.35
2427868941055056896,2020-08,5068.61,3337.22,8296.86,1184.06,8844.19,12428.54
2427868941055056896,2020-09,1646.05,5431.42,5125.21,6621.4,-5281.56,7146.98
2427868941055056896,2020-10,4968.37,3580.39,6479.83,5338.87,2528.94,9675.92
2427868941055056896,2020-11,7533.77,5228.26,12789.32,6598.64,8496.19,18172.11
2427868941055056896,2020-12,2206.48,4477.3,904.26,1829.79,-3196.35,14975.76
2428028740350766080,2020-01,4467.11,2448.25,4488.12,4825.41,1681.57,1681.57
2428028740350766080,2020-02,2230.24,4042.64,3123.74,3065.86,-1754.52,-72.95
2428028740350766080,2020-03,2574.06,8782.67,5705.48,5721.99,-6225.12,-6298.07
2428028740350766080,2020-04,7217.95,4663.97,2844.98,6698.29,-1299.33,-7597.4
2428028740350766080,2020-05,5803.25,2204.47,3442.07,0,7040.85,-556.55
2428028740350766080,2020-06,751.4,4675.32,1992.95,2283.17,-4214.14,-4770.69
2428028740350766080,2020-07,5455.76,4164.34,2117.56,5661.65,-2252.67,-7023.36
2428028740350766080,2020-08,2720.31,5075.48,5338.56,1624.32,1359.07,-5664.29
2428028740350766080,2020-09,1061.82,3801.55,3382.89,3493.18,-2850.02,-8514.31
2428028740350766080,2020-10,8929.78,5117.47,4077.68,5757.07,2132.92,-6381.39
2428028740350766080,2020-11,5573.93,4461.88,8211.11,5176.2,4146.96,-2234.43
2428028740350766080,2020-12,4985.16,2231.35,6128.13,2837.08,6044.86,3810.43
2429134453534005760,2020-01,3287.65,3461.03,3459.56,4970.8,-1684.62,-1684.62
2429134453534005760,2020-02,6818.7,5210.5,1937.07,5886.27,-2341,-4025.62
2429134453534005760,2020-03,6180.72,4830.82,3043.01,5722.42,-1329.51,-5355.13
2429134453534005760,2020-04,6435.44,8611.65,3873.22,1460.15,236.86,-5118.27
2429134453534005760,2020-05,1777.26,4257.66,3966.48,919.75,566.33,-4551.94
2429134453534005760,2020-06,2427.99,2162.55,4052.14,3212.41,1105.17,-3446.77
2429134453534005760,2020-07,1394.7,6106.03,4170.43,4929.32,-5470.22,-8916.99
2429134453534005760,2020-08,6132.86,3245.74,3328.1,6670.66,-455.44,-9372.43
2429134453534005760,2020-09,3167.03,4666.93,5637,7043.18,-2906.08,-12278.51
2429134453534005760,2020-10,3946.54,3606.19,3821.32,3758.16,403.51,-11875
2429134453534005760,2020-11,3716.61,4408.28,3579.73,2589,299.06,-11575.94
2429134453534005760,2020-12,4106.13,6339.91,448.36,1874.71,-3660.13,-15236.07
2430134870409318400,2020-01,1304.94,7161.61,1312.69,2385.21,-6929.19,-6929.19
2430134870409318400,2020-02,8303.51,3729.52,4962.3,2701.71,6834.58,-94.61
2430134870409318400,2020-03,3187.24,1177.67,6311.11,5494.35,2826.33,2731.72
2430134870409318400,2020-04,1220.19,4169.77,2505.11,8276.66,-8721.13,-5989.41
2430134870409318400,2020-05,8138.99,1923.56,1004.97,3455.25,3765.15,-2224.26
2430134870409318400,2020-06,8972.16,5385.21,6912.34,2621.35,7877.94,5653.68
2430134870409318400,2020-07,3321.16,2379.2,1242.47,348.7,1835.73,7489.41
2430134870409318400,2020-08,3296.4,891.24,10179.39,2098.87,10485.68,17975.09
2430134870409318400,2020-09,2821.49,1544.17,5502.74,4953.74,1826.32,19801.41
2430134870409318400,2020-10,5285.54,860.26,6358.75,3895.49,6888.54,26689.95
2430134870409318400,2020-11,3690.01,7341.14,4135.39,2745.76,-2261.5,24428.45
2430134870409318400,2020-12,2399.68,3998.63,3284.07,7221.63,-5536.51,18891.94
2430227755557971968,2020-01,2670.93,6443.6,306.07,3152.04,-6618.64,-6618.64
2430227755557971968,2020-02,5241.56,2469.42,1794.04,4699.91,-133.73,-6752.37
2430227755557971968,2020-03,6093.87,1300.82,4207.28,4367.99,4632.34,-2120.03
2430227755557971968,2020-04,7736.35,2884.5,5555.86,3991.76,6415.95,4295.92
2430227755557971968,2020-05,2630.1,2542.52,2751.88,2088.43,751.03,5046.95
2430227755557971968,2020-06,4107.24,2579.53,3656.04,5504.54,-320.79,4726.16
2430227755557971968,2020-07,3822.59,3564.72,5469.09,7550.28,-1823.32,2902.84
2430227755557971968,2020-08,639.39,7006.47,3721.91,0,-2645.17,257.67
2430227755557971968,2020-09,3984.5,3470.23,6282.42,6687.28,109.41,367.08
2430227755557971968,2020-10,3707.62,2653.22,5657.57,2362.05,4349.92,4717
2430227755557971968,2020-11,1896.19,6537.85,1711.16,4471.61,-7402.11,-2685.11
2430227755557971968,2020-12,2149.67,5031,2984.53,3344.57,-3241.37,-5926.48
2431622172241977856,2020-01,6599.14,5544.17,3219.04,3830.87,443.14,443.14
2431622172241977856,2020-02,1752.27,2996.84,2467.63,842.97,380.09,823.23
2431622172241977856,2020-03,1281.69,1767.85,2673.26,3522.2,-1335.1,-511.87
2431622172241977856,2020-04,1897.19,560.01,1975.57,2032.6,1280.15,768.28
2431622172241977856,2020-05,1057.59,4071.36,5251.78,1145.99,1092.02,1860.3
2431622172241977856,2020-06,1739.43,6001.65,3895.05,1327.33,-1694.5,165.8
2431622172241977856,2020-07,3972.91,7366.5,5847.08,3215.17,-761.68,-595.88
2431622172241977856,2020-08,4557.62,459.29,1350.28,0,5448.61,4852.73
2431622172241977856,2020-09,1898.3,608.07,2232.73,2098.75,1424.21,6276.94
2431622172241977856,2020-10,1852.28,2746.05,1333.76,1160.86,-720.87,5556.07
2431622172241977856,2020-11,3256.82,1370.37,2380.11,3469.65,796.91,6352.98
2431622172241977856,2020-12,3337.68,422.96,2695.5,3586.45,2023.77,8376.75
2432646582794764288,2020-01,3990.49,3336.9,2589.6,3093.4,149.79,149.79
2432646582794764288,2020-02,2865.43,4928.24,2280.18,2518.13,-2300.76,-2150.97
2432646582794764288,2020-03,5591.99,3536.2,369.94,3585.55,-1159.82,-3310.79
2432646582794764288,2020-04,4690.51,440.84,3394.64,2935.12,4709.19,1398.4
2432646582794764288,2020-05,4840.12,2490.9,1589.76,63.86,3875.12,5273.52
2432646582794764288,2020-06,2886.83,1895.62,2216.93,1773.82,1434.32,6707.84
2432646582794764288,2020-07,3780.35,6811.39,91.17,2890.34,-5830.21,877.63
2432646582794764288,2020-08,4572.24,2764.97,3666.88,608.66,4865.49,5743.12
2432646582794764288,2020-09,3830.47,4300.61,9154.21,0,8684.07,14427.19
2432646582794764288,2020-10,6542.09,6927.2,5404.4,1460.63,3558.66,17985.85
2432646582794764288,2020-11,0,1881.29,1002.44,6067.87,-6946.72,11039.13
2432646582794764288,2020-12,1284.11,2336.93,3969.74,3742.81,-825.89,10213.24
2432961954951705088,2020-01,2055.66,209.88,0,0,1845.78,1845.78
2432961954951705088,2020-02,586.4,1050.98,882.24,1013.34,-595.68,1250.1
2432961954951705088,2020-03,384.38,683.96,1941.62,3595.49,-1953.45,-703.35
2432961954951705088,2020-04,1845.67,2145.72,0,1839.36,-2139.41,-2842.76
2432961954951705088,2020-05,2919.64,2067.32,1573.61,1320.02,1105.91,-1736.85
2432961954951705088,2020-06,2601.15,1409.37,1856.56,0,3048.34,1311.49
2432961954951705088,2020-07,5285.92,601.03,5982.82,348.84,10318.87,11630.36
2432961954951705088,2020-08,1056.81,4188.26,1832.42,3186.57,-4485.6,7144.76
2432961954951705088,2020-09,0,2782.01,3927.64,2233.99,-1088.36,6056.4
2432961954951705088,2020-10,3939.7,1767.23,3737.26,1590.66,4319.07,10375.47
2432961954951705088,2020-11,0,1635.08,1551.93,2889.84,-2972.99,7402.48
2432961954951705088,2020-12,40.29,3049.4,1022.42,1468.87,-3455.56,3946.92
2433911502061852672,2020-01,3372.9,1581.99,3524.97,5333.51,-17.63,-17.63
2433911502061852672,2020-02,1047.76,117.82,3152.65,4645.23,-562.64,-580.27
2433911502061852672,2020-03,1940.59,1905.67,6171.99,1441.74,4765.17,4184.9
2433911502061852672,2020-04,882.69,3433.82,2493.28,5941.48,-5999.33,-1814.43
2433911502061852672,2020-05,3194.25,1478.72,2738.94,1983.41,2471.06,656.63
2433911502061852672,2020-06,2621.37,846.6,3982.15,791.1,4965.82,5622.45
2433911502061852672,2020-07,4319,4230.87,4589.63,1049.1,3628.66,9251.11
2433911502061852672,2020-08,4442.14,5086.57,5675.48,3309.17,1721.88,10972.99
2433911502061852672,2020-09,707.11,4010.68,1780.93,2277.92,-3800.56,7172.43
2433911502061852672,2020-10,2549.95,1637.11,2794.73,4552.91,-845.34,6327.09
2433911502061852672,2020-11,5859.26,1759.25,6646.54,1294.21,9452.34,15779.43
2433911502061852672,2020-12,0,3970.25,400.28,6448.01,-10017.98,5761.45
2434518816809026560,2020-01,1674.77,1632.56,3116.97,5384.34,-2225.16,-2225.16
2434518816809026560,2020-02,7370.58,3118.39,1874.22,2560.92,3565.49,1340.33
2434518816809026560,2020-03,6187.15,3858.26,7178.19,2951.42,6555.66,7895.99
2434518816809026560,2020-04,3775.89,8718.38,7234.24,2131.42,160.33,8056.32
2434518816809026560,2020-05,5164.71,7435.46,1947.18,6345.3,-6668.87,1387.45
2434518816809026560,2020-06,4843.61,2178.32,4642.16,1410.97,5896.48,7283.93
2434518816809026560,2020-07,4729.45,4038.88,4408.42,4698.02,400.97,7684.9
2434518816809026560,2020-08,5744.81,2022.62,1578.06,1941.55,3358.7,11043.6
2434518816809026560,2020-09,13226.79,3200.37,4838.62,6591.4,8273.64,19317.24
2434518816809026560,2020-10,5451.23,7469.38,7455.93,5887.29,-449.51,18867.73
2434518816809026560,2020-11,4836.03,3351.16,3002.25,5261.2,-774.08,18093.65
2434518816809026560,2020-12,10012.88,8402.84,97.42,2556.94,-849.48,17244.17
2438505975766077440,2020-02,0,1828.58,0,0,-1828.58,-1828.58
2438505975766077440,2020-05,0,1264.09,0,0,-1264.09,-3092.67
2438505975766077440,2020-09,987.55,0,0,665.49,322.06,-2770.61
2438505975766077440,2020-10,1391.99,0,0,0,1391.99,-1378.62
2438505975766077440,2020-11,0,823.11,0,0,-823.11,-2201.73
2438764369795188736,2020-01,385.38,0,0,0,385.38,385.38
2438764369795188736,2020-02,1780.05,0,0,400.24,1379.81,1765.19
2438764369795188736,2020-04,2999.27,0,0,0,2999.27,4764.46
2438764369795188736,2020-05,1012.97,1542.3,1950.45,0,1421.12,6185.58
2438764369795188736,2020-07,1701.63,594.73,1537.77,0,2644.67,8830.25
2438764369795188736,2020-08,738,0,2224.83,0,2962.83,11793.08
2438764369795188736,2020-09,0,780.77,0,726.29,-1507.06,10286.02
2438764369795188736,2020-10,0,33.95,895.55,0,861.6,11147.62
2438764369795188736,2020-11,3332.57,0,0,0,3332.57,14480.19
2438764369795188736,2020-12,165.79,955.59,0,1787.91,-2577.71,11902.48
2438857635636335616,2020-01,542.93,6867.65,3578.81,1038.12,-3784.03,-3784.03
2438857635636335616,2020-02,964.94,0,0,3765.73,-2800.79,-6584.82
2438857635636335616,2020-03,0,3853.52,3879.79,1823.05,-1796.78,-8381.6
2438857635636335616,2020-04,2490.47,1831.77,5432.37,11692.34,-5601.27,-13982.87
2438857635636335616,2020-05,0,2681.07,104.42,0,-2576.65,-16559.52
2438857635636335616,2020-06,5654.94,3314.68,1019.44,3224.72,134.98,-16424.54
2438857635636335616,2020-07,4353.68,3399.46,0,795.07,159.15,-16265.39
2438857635636335616,2020-08,376.92,2628.27,1942.21,2774.58,-3083.72,-19349.11
2438857635636335616,2020-09,1513.59,438.1,1384.09,4116.18,-1656.6,-21005.71
2438857635636335616,2020-10,2353.24,1245.75,3027.8,2870.15,1265.14,-19740.57
2438857635636335616,2020-11,5371.5,1507.53,1695.45,0,5559.42,-14181.15
2438857635636335616,2020-12,594.1,6915.46,3227.2,0,-3094.16,-17275.31
2438956160448236544,2020-01,0,883.27,1343.8,2.88,457.65,457.65
2438956160448236544,2020-02,2199.85,1754.87,1160.4,990.17,615.21,1072.86
2438956160448236544,2020-03,3056.71,829.46,0,111.26,2115.99,3188.85
2438956160448236544,2020-04,2492.84,4609.56,0,1103.81,-3220.53,-31.68
2438956160448236544,2020-05,0,1862.23,0,1634.77,-3497,-3528.68
2438956160448236544,2020-06,0,4250.22,43.66,1775.49,-5982.05,-9510.73
2438956160448236544,2020-07,0,3120.53,204.57,0,-2915.96,-12426.69
2438956160448236544,2020-08,0,1560.01,2204.73,1878.97,-1234.25,-13660.94
2438956160448236544,2020-09,0,1066.21,3419.72,645.51,1708,-11952.94
2438956160448236544,2020-10,0,993.5,1788.26,95.46,699.3,-11253.64
2438956160448236544,2020-11,943.46,1684.22,1538.2,1198.24,-400.8,-11654.44
2438956160448236544,2020-12,2570.29,0,4922.71,2320.46,5172.54,-6481.9
2439489649889953280,2020-03,326.23,0,0,0,326.23,326.23
2439489649889953280,2020-06,0,654.76,0,0,-654.76,-328.53
2439489649889953280,2020-08,1328,489.52,0,0,838.48,509.95
2439489649889953280,2020-10,2071.49,0,0,0,2071.49,2581.44
2439489649889953280,2020-11,0,516.71,0,0,-516.71,2064.73
2439667109590728192,2020-01,3722.48,3094.1,4510.27,3289.22,1849.43,1849.43
2439667109590728192,2020-02,3433.54,3077.14,643.12,2461.86,-1462.34,387.09
2439667109590728192,2020-03,7693.16,4137.37,6349.46,3064.04,6841.21,7228.3
2439667109590728192,2020-04,5273.73,5485.35,3279.44,7017.02,-3949.2,3279.1
2439667109590728192,2020-05,6610.44,1810.93,1041.89,1799.41,4041.99,7321.09
2439667109590728192,2020-06,4510.74,1796.46,3765.53,4179.43,2300.38,9621.47
2439667109590728192,2020-07,9668.1,722.58,2405.22,3143.22,8207.52,17828.99
2439667109590728192,2020-08,1960.3,1965.77,4133.69,4206.03,-77.81,17751.18
2439667109590728192,2020-09,0,238.4,4419.55,7852.5,-3671.35,14079.83
2439667109590728192,2020-10,2998.95,6726.62,4050.07,4097.47,-3775.07,10304.76
2439667109590728192,2020-11,5219.48,2329.16,2807.26,3742.23,1955.35,12260.11
2439667109590728192,2020-12,1492.72,4625.14,3445.53,1982.96,-1669.85,10590.26
2440123256273428480,2020-01,1299.16,3775.68,1597.67,3556.77,-4435.62,-4435.62
2440123256273428480,2020-02,3650.11,5111.34,864.84,3297.33,-3893.72,-8329.34
2440123256273428480,2020-03,4358.7,1954.22,3301.6,4553.7,1152.38,-7176.96
2440123256273428480,2020-04,5547.18,4241.47,4600.68,3360.87,2545.52,-4631.44
2440123256273428480,2020-05,1148.48,3219.66,1251.52,0,-819.66,-5451.1
2440123256273428480,2020-06,3145.82,929.45,887.87,2135.12,969.12,-4481.98
2440123256273428480,2020-07,4520.89,1346.73,7593.85,3310.21,7457.8,2975.82
2440123256273428480,2020-08,6878.4,4845.22,219.94,1392.23,860.89,3836.71
2440123256273428480,2020-09,0,3811.48,4988.13,2480.63,-1303.98,2532.73
2440123256273428480,2020-10,4874.86,1986.56,2990.94,3772.82,2106.42,4639.15
2440123256273428480,2020-11,4691.45,4093.98,3705.86,6668.5,-2365.17,2273.98
2440123256273428480,2020-12,4411.39,1818.99,5243.21,1195.71,6639.9,8913.88
2440286574305995264,2020-01,2330.54,0,0,1567.35,763.19,763.19
2440286574305995264,2020-03,0,1324.74,872.58,991.62,-1443.78,-680.59
2440286574305995264,2020-04,0,858.62,3483.35,716.61,1908.12,1227.53
2440286574305995264,2020-08,330.45,0,814.43,76.68,1068.2,2295.73
2440286574305995264,2020-09,2367.93,1276.29,0,0,1091.64,3387.37
2440286574305995264,2020-10,1641.35,0,0,0,1641.35,5028.72
2440286574305995264,2020-11,2041.57,0,1000.46,117.23,2924.8,7953.52
2440286574305995264,2020-12,190.07,0,0,1096.54,-906.47,7047.05
2443537054824091136,2020-01,6509.33,2838.6,8031.49,3997.6,7704.62,7704.62
2443537054824091136,2020-02,2526.33,3854.38,2648.66,1888.8,-568.19,7136.43
2443537054824091136,2020-03,1901.67,3913.02,2965.47,8232.97,-7278.85,-142.42
2443537054824091136,2020-04,2871.35,4509.43,2732.63,7377.96,-6283.41,-6425.83
2443537054824091136,2020-05,2530.84,5351.59,6124.65,3281.77,22.13,-6403.7
2443537054824091136,2020-06,5069.66,2632.2,5240.04,2868,4809.5,-1594.2
2443537054824091136,2020-07,5626.34,4212.85,4479.06,0,5892.55,4298.35
2443537054824091136,2020-08,2411.9,2869.58,2695.36,6810.72,-4573.04,-274.69
2443537054824091136,2020-09,3614.55,3377.78,2783.85,10866.19,-7845.57,-8120.26
2443537054824091136,2020-10,3761.98,6175.39,1190.39,3504.24,-4727.26,-12847.52
2443537054824091136,2020-11,183.73,9092.1,1854.24,1947.28,-9001.41,-21848.93
2443537054824091136,2020-12,2736.67,4616.38,7465.6,5004.59,581.3,-21267.63
2443864586893059584,2020-01,6610.79,4286.71,2233.65,6667.29,-2109.56,-2109.56
2443864586893059584,2020-02,7822.96,1142.97,2044.26,5802.92,2921.33,811.77
2443864586893059584,2020-03,1458.55,4733.39,0,2467.2,-5742.04,-4930.27
2443864586893059584,2020-04,7753.5,6747.29,1481.17,5749.77,-3262.39,-8192.66
2443864586893059584,2020-05,637.3,1746.98,3384.85,3629.63,-1354.46,-9547.12
2443864586893059584,2020-06,7616.66,2641.72,2998.35,6765.03,1208.26,-8338.86
2443864586893059584,2020-07,3282.36,2758.32,3910.45,8111.58,-3677.09,-12015.95
2443864586893059584,2020-08,1852.95,2984.41,4490.43,2837.26,521.71,-11494.24
2443864586893059584,2020-09,4001.01,4365,1911.39,1773.47,-226.07,-11720.31
2443864586893059584,2020-10,3859.83,1092.77,5113.55,4446.7,3433.91,-8286.4
2443864586893059584,2020-11,1000.96,5030.81,3699.72,2974.63,-3304.76,-11591.16
2443864586893059584,2020-12,647.96,5203.58,3594.89,1852.73,-2813.46,-14404.62
2444429128914176512,2020-01,3055.63,908.95,6813.72,1553.03,7407.37,7407.37
2444429128914176512,2020-02,2794.44,329.63,0,2820.07,-355.26,7052.11
2444429128914176512,2020-03,0,2774.34,0,1877.92,-4652.26,2399.85
2444429128914176512,2020-04,1177.24,270.1,1123.09,4346.18,-2315.95,83.9
2444429128914176512,2020-05,904.98,169.16,0,4623.88,-3888.06,-3804.16
2444429128914176512,2020-06,546.16,0,251.36,890.6,-93.08,-3897.24
2444429128914176512,2020-07,2743.84,0,119.23,4889.38,-2026.31,-5923.55
2444429128914176512,2020-08,557.16,728.44,2310.09,2051.22,87.59,-5835.96
2444429128914176512,2020-10,2677.93,3452.19,1574.1,1676.34,-876.5,-6712.46
2444429128914176512,2020-11,16,2218.12,3334.44,1966.36,-834.04,-7546.5
2444429128914176512,2020-12,1621.1,1705.1,3252.8,2933.52,235.28,-7311.22
2445753135704350208,2020-01,4066.95,204.47,635.46,0,4497.94,4497.94
2445753135704350208,2020-02,6841.13,1396.75,1234.08,1775.99,4902.47,9400.41
2445753135704350208,2020-03,729.8,694.57,3271.7,2577.81,729.12,10129.53
2445753135704350208,2020-04,2814.4,1706.89,2504.44,0,3611.95,13741.48
2445753135704350208,2020-05,1007.91,1963.96,4145.46,1372.75,1816.66,15558.14
2445753135704350208,2020-06,1317.06,1854.22,3077.7,5652.24,-3111.7,12446.44
2445753135704350208,2020-07,307.27,3398.76,853.25,2196.21,-4434.45,8011.99
2445753135704350208,2020-08,2318.93,2511.53,2811.17,645.94,1972.63,9984.62
2445753135704350208,2020-09,2444.52,0,3521.92,2931.17,3035.27,13019.89
2445753135704350208,2020-10,2460.66,406.25,3104.96,584.29,4575.08,17594.97
2445753135704350208,2020-11,1526.44,2845.61,1276.69,4440.34,-4482.82,13112.15
2445753135704350208,2020-12,5244.14,1029.84,0,521.4,3692.9,16805.05
2446071462309766656,2020-01,5308.12,1769.26,5507.25,7116.82,1929.29,1929.29
2446071462309766656,2020-02,9390.59,9762.1,2567.77,5120.8,-2924.54,-995.25
2446071462309766656,2020-03,3510.14,7080.21,2256.18,4373.9,-5687.79,-6683.04
2446071462309766656,2020-04,3419.53,2919.2,5646.1,3707,2439.43,-4243.61
2446071462309766656,2020-05,4096.09,6142.7,11581.89,5882.59,3652.69,-590.92
2446071462309766656,2020-06,901.59,5457.01,7980.56,4183.68,-758.54,-1349.46
2446071462309766656,2020-07,2228.22,4754.8,8256.63,8072.25,-2342.2,-3691.66
2446071462309766656,2020-08,11543.96,2318.99,4706.66,2601.95,11329.68,7638.02
2446071462309766656,2020-09,3078.59,2183.57,1749.11,8891.91,-6247.78,1390.24
2446071462309766656,2020-10,9126.44,5495.1,3508.44,3736.99,3402.79,4793.03
2446071462309766656,2020-11,5002.52,1652.19,8483.78,5849.02,5985.09,10778.12
2446071462309766656,2020-12,1684.25,569.37,6422.19,3585.97,3951.1,14729.22
2447240902433615872,2020-01,1718.11,3453.13,2223.49,1482.87,-994.4,-994.4
2447240902433615872,2020-02,2678.59,7716.5,1822.61,2026.95,-5242.25,-6236.65
2447240902433615872,2020-03,4159.36,2354.33,6798.92,0,8603.95,2367.3
2447240902433615872,2020-04,4477.87,1494.78,1752.41,3088.92,1646.58,4013.88
2447240902433615872,2020-05,5898.12,9708.14,7242.18,2328.95,1103.21,5117.09
2447240902433615872,2020-06,3051.05,7436.84,4929.76,2136,-1592.03,3525.06
2447240902433615872,2020-07,6072.04,5092.75,3558.26,7067.34,-2529.79,995.27
2447240902433615872,2020-08,2209.59,713.67,3746.23,1211.77,4030.38,5025.65
2447240902433615872,2020-09,5088.98,3088.19,0,11133.6,-9132.81,-4107.16
2447240902433615872,2020-10,456.14,2777.99,2099.74,2171.34,-2393.45,-6500.61
2447240902433615872,2020-11,3998.83,3923.22,0,2460.03,-2384.42,-8885.03
2447240902433615872,2020-12,1709.11,7102.7,3872.74,3015.46,-4536.31,-13421.34
2448216857522249216,2020-01,16.02,3824.15,817.23,5257.85,-8248.75,-8248.75
2448216857522249216,2020-02,1134.01,1167.97,4492.08,2783.74,1674.38,-6574.37
2448216857522249216,2020-03,1483.61,4609.79,2127.83,582.7,-1581.05,-8155.42
2448216857522249216,2020-04,1938.86,2263.37,2521.66,3948.73,-1751.58,-9907
2448216857522249216,2020-05,3817.46,6681.91,1949.09,2522.9,-3438.26,-13345.26
2448216857522249216,2020-06,3176.59,1289.8,1691.15,2364.77,1213.17,-12132.09
2448216857522249216,2020-07,4338.72,1287.4,3553.65,1078.71,5526.26,-6605.83
2448216857522249216,2020-08,2908.6,1422.43,1960.01,5677.8,-2231.62,-8837.45
2448216857522249216,2020-09,4196.13,1396.43,3311.78,141.7,5969.78,-2867.67
2448216857522249216,2020-10,771.07,2530.83,4556.98,7260.44,-4463.22,-7330.89
2448216857522249216,2020-11,1231.5,8553.25,6113.59,2516.54,-3724.7,-11055.59
2448216857522249216,2020-12,4599.32,365.22,1048.89,3454.98,1828.01,-9227.58
2448617330691642880,2020-01,1664.56,0,0,757.85,906.71,906.71
2448617330691642880,2020-02,1768.81,25.59,3353.7,2400.12,2696.8,3603.51
2448617330691642880,2020-03,869.94,1400.22,4560.69,4411.15,-380.74,3222.77
2448617330691642880,2020-04,2203.2,1131.36,1137.45,0,2209.29,5432.06
2448617330691642880,2020-06,0,2468.62,0,1331.4,-3800.02,1632.04
2448617330691642880,2020-07,456.64,0,374.4,905.87,-74.83,1557.21
2448617330691642880,2020-08,0,531.49,1977.52,0,1446.03,3003.24
2448617330691642880,2020-09,884.01,2065.79,767.1,0,-414.68,2588.56
2448617330691642880,2020-10,0,481.35,607.95,241.66,-115.06,2473.5
2448617330691642880,2020-11,1513.42,2787.93,977.26,0,-297.25,2176.25
2448617330691642880,2020-12,535.89,491.15,647.45,3435.64,-2743.45,-567.2
2449631801509896704,2020-01,970.36,1093.24,3022.03,0,2899.15,2899.15
2449631801509896704,2020-02,1891.43,4457.58,1908.47,2143.88,-2801.56,97.59
2449631801509896704,2020-03,31.29,1853.26,134.81,935.08,-2622.24,-2524.65
2449631801509896704,2020-04,1841.83,1742.55,0,1592.88,-1493.6,-4018.25
2449631801509896704,2020-05,0,440.78,1611.14,1589.85,-419.49,-4437.74
2449631801509896704,2020-06,2892.73,409.97,1744.17,1667.84,2559.09,-1878.65
2449631801509896704,2020-07,2856.37,545.73,1899.56,1727.74,2482.46,603.81
2449631801509896704,2020-08,3202.25,1601.72,2829.46,54.44,4375.55,4979.36
2449631801509896704,2020-09,2755.03,1133.81,1858.22,0,3479.44,8458.8
2449631801509896704,2020-10,2223.48,704.8,0,2184.82,-666.14,7792.66
2449631801509896704,2020-11,2182.88,0,1212.51,254.88,3140.51,10933.17
2449631801509896704,2020-12,1288.32,369.91,1279.65,678.75,1519.31,12452.48
2449964319529063936,2020-01,2508.96,1374.2,2628.83,2091.55,1672.04,1672.04
2449964319529063936,2020-02,1347.23,1684.69,1380.17,2114.78,-1072.07,599.97
2449964319529063936,2020-03,0,3054.67,425.33,5370.78,-8000.12,-7400.15
2449964319529063936,2020-04,4916.75,2066.58,477.95,2916.95,411.17,-6988.98
2449964319529063936,2020-05,3397.6,1904.33,2054.47,578.54,2969.2,-4019.78
2449964319529063936,2020-06,0,830.5,1965.91,6961.88,-5826.47,-9846.25
2449964319529063936,2020-07,1392.26,0,2720.66,2950.63,1162.29,-8683.96
2449964319529063936,2020-08,1049.59,1219.27,3204.62,4557.87,-1522.93,-10206.89
2449964319529063936,2020-09,2736.87,929.12,7745.92,3376.64,6177.03,-4029.86
2449964319529063936,2020-10,4376.95,2664.99,2361.69,2892.38,1181.27,-2848.59
2449964319529063936,2020-11,1976.01,2860.43,1808.83,4814.08,-3889.67,-6738.26
2449964319529063936,2020-12,1052.91,4458.15,2120.24,3827.44,-5112.44,-11850.7
2451573179479930368,2020-01,3332.33,3354.77,3262.37,626.29,2613.64,2613.64
2451573179479930368,2020-02,822.89,1600.52,2265.21,905.66,581.92,3195.56
2451573179479930368,2020-03,4380.47,2174.12,2950.67,1768.56,3388.46,6584.02
2451573179479930368,2020-04,5246.67,2364.52,1147.01,0,4029.16,10613.18
2451573179479930368,2020-05,1867.71,3820.98,5100.4,6728.85,-3581.72,7031.46
2451573179479930368,2020-06,0,129.66,5204.87,4285.14,790.07,7821.53
2451573179479930368,2020-07,8829.17,2068.8,2876.52,5274.85,4362.04,12183.57
2451573179479930368,2020-08,2137.98,0,1614.52,0,3752.5,15936.07
2451573179479930368,2020-09,2430.37,1630.86,6346.69,4571.41,2574.79,18510.86
2451573179479930368,2020-10,6681.23,1056.18,2812.57,3590.7,4846.92,23357.78
2451573179479930368,2020-11,7385.61,1958.78,0,3501.88,1924.95,25282.73
2451573179479930368,2020-12,2954.86,5582.29,312.9,5595.7,-7910.23,17372.5
2452542950164127744,2020-01,8241.4,2869.01,3421.38,8540.61,253.16,253.16
2452542950164127744,2020-02,3370.86,2952.52,1270.45,2309.77,-620.98,-367.82
2452542950164127744,2020-03,4775,3148.19,1505.51,83.26,3049.06,2681.24
2452542950164127744,2020-04,6102.29,4238.18,351.4,1298.05,917.46,3598.7
2452542950164127744,2020-05,5776.58,4878.6,4170.61,60.34,5008.25,8606.95
2452542950164127744,2020-06,0,1610.23,1401.55,2244.42,-2453.1,6153.85
2452542950164127744,2020-07,4554.9,5119.67,2936.21,4822.67,-2451.23,3702.62
2452542950164127744,2020-08,3679.83,3054.55,1712.99,4001.03,-1662.76,2039.86
2452542950164127744,2020-09,247.94,2206.29,5212.05,5646.59,-2392.89,-353.03
2452542950164127744,2020-10,2894.3,7955.83,2690.44,1465.32,-3836.41,-4189.44
2452542950164127744,2020-11,8978.75,4477.24,1698.51,3147.62,3052.4,-1137.04
2452542950164127744,2020-12,3560.48,5297.31,2919.67,2849.55,-1666.71,-2803.75
2453721962201389568,2020-01,274.77,1026.93,1588.95,2526.55,-1689.76,-1689.76
2453721962201389568,2020-02,526.42,4300.9,4486.56,2323.39,-1611.31,-3301.07
2453721962201389568,2020-03,2381.1,9767.83,3749.59,1730.39,-5367.53,-8668.6
2453721962201389568,2020-04,765.41,3639.69,1588.34,831.51,-2117.45,-10786.05
2453721962201389568,2020-05,768.42,638.56,2317.8,190.48,2257.18,-8528.87
2453721962201389568,2020-06,1894.98,4312.26,2846.29,6715.61,-6286.6,-14815.47
2453721962201389568,2020-07,1071.82,5906.85,1694.07,2886.39,-6027.35,-20842.82
2453721962201389568,2020-08,3435.47,2295.89,0,3212.11,-2072.53,-22915.35
2453721962201389568,2020-09,7023.25,1653.46,1406.31,4518.79,2257.31,-20658.04
2453721962201389568,2020-10,3304.55,3277.18,3562.43,5005.54,-1415.74,-22073.78
2453721962201389568,2020-11,2716.98,0,3891.07,1983.12,4624.93,-17448.85
2453721962201389568,2020-12,3464.27,712.09,1902.62,2014.13,2640.67,-14808.18
2455754279210200576,2020-01,3446.98,1197.53,0,1120.52,1128.93,1128.93
2455754279210200576,2020-02,0,1103.12,1405.28,0,302.16,1431.09
2455754279210200576,2020-03,406.44,0,0,4590.53,-4184.09,-2753
2455754279210200576,2020-05,4139.17,1229.63,0,122.84,2786.7,33.7
2455754279210200576,2020-07,1927,1346.15,4618.16,0,5199.01,5232.71
2455754279210200576,2020-08,1035.48,1610.2,2551.48,2680.82,-704.06,4528.65
2455754279210200576,2020-09,926.51,1673.94,1583.54,1542.52,-706.41,3822.24
2455754279210200576,2020-10,341.33,0,1584.54,1661.39,264.48,4086.72
2455754279210200576,2020-11,1220.51,2606.4,1891.91,926.34,-420.32,3666.4
2455754279210200576,2020-12,4583.44,0,0,3076.9,1506.54,5172.94
2456179963177216512,2020-01,0,1141.31,1721.73,1952,-1371.58,-1371.58
2456179963177216512,2020-02,246.04,0,0,0,246.04,-1125.54
2456179963177216512,2020-03,5539.19,0,2503.77,0,8042.96,6917.42
2456179963177216512,2020-04,5477.79,1220.06,1928.48,935.02,5251.19,12168.61
2456179963177216512,2020-05,588.33,2628.58,862.19,0,-1178.06,10990.55
2456179963177216512,2020-06,0,1533.31,2020.24,0,486.93,11477.48
2456179963177216512,2020-07,0,2259,1823.78,876.96,-1312.18,10165.3
2456179963177216512,2020-08,1916.8,1162.3,1460.64,407.7,1807.44,11972.74
2456179963177216512,2020-09,1862.52,2717.47,1709.39,1161.5,-307.06,11665.68
2456179963177216512,2020-11,1751.56,0,1464.76,0,3216.32,14882
2456179963177216512,2020-12,195.89,1962.91,0,0,-1767.02,13114.98
2458189260299062784,2020-01,2624.6,4777.18,5118.75,1182.81,1783.36,1783.36
2458189260299062784,2020-02,0,7419.51,2866.8,1746.01,-6298.72,-4515.36
2458189260299062784,2020-03,2854.54,4130.22,764.15,3527.79,-4039.32,-8554.68
2458189260299062784,2020-04,1979.57,5693.1,6696.35,8082.82,-5100,-13654.68
2458189260299062784,2020-05,2076.03,3750.42,2074.96,3374.67,-2974.1,-16628.78
2458189260299062784,2020-06,7537.21,5848.75,6596.4,513.96,7770.9,-8857.88
2458189260299062784,2020-07,1380.13,12994.06,6190.22,2180.37,-7604.08,-16461.96
2458189260299062784,2020-08,1646.51,2017.8,1763.93,2105.86,-713.22,-17175.18
2458189260299062784,2020-09,4631.04,5760.98,3711.05,9131.46,-6550.35,-23725.53
2458189260299062784,2020-10,2380.39,4762.95,6039.17,3686.6,-29.99,-23755.52
2458189260299062784,2020-11,7060.28,7198.77,4256.16,2694.85,1422.82,-22332.7
2458189260299062784,2020-12,5415.53,483.33,3723.41,5182.5,3473.11,-18859.59
2458398993874955264,2020-01,135.3,3040.25,3554.45,5616.84,-4967.34,-4967.34
2458398993874955264,2020-02,2356.44,2343.28,2574.41,1608.04,979.53,-3987.81
2458398993874955264,2020-03,1980.59,2108.91,633.18,122.25,382.61,-3605.2
2458398993874955264,2020-04,3108.66,2940.24,2030.32,2055.71,143.03,-3462.17
2458398993874955264,2020-05,2596.78,1216.42,0,2404.5,-1024.14,-4486.31
2458398993874955264,2020-06,0,1308.21,1789.89,0,481.68,-4004.63
2458398993874955264,2020-07,1991.86,758.24,0,1574.45,-340.83,-4345.46
2458398993874955264,2020-08,2243.85,1134.87,1791.75,1063.68,1837.05,-2508.41
2458398993874955264,2020-09,787.9,0,2285.39,0,3073.29,564.88
2458398993874955264,2020-11,1597.33,0,0,3348.42,-1751.09,-1186.21
2458398993874955264,2020-12,1211.42,0,2519.65,1922.61,1808.46,622.25
2459312784770413568,2020-01,802.39,4113.57,5065.17,6787.64,-5033.65,-5033.65
2459312784770413568,2020-02,348.78,3540.52,2698.4,864.01,-1357.35,-6391
2459312784770413568,2020-03,1659.86,1974.92,1858.06,4565.27,-3022.27,-9413.27
2459312784770413568,2020-04,1424.83,2175.29,1756.6,4216.19,-3210.05,-12623.32
2459312784770413568,2020-05,2797.73,7755.83,4555.96,3505.08,-3907.22,-16530.54
2459312784770413568,2020-06,2650.19,4241.59,2105,3624.16,-3110.56,-19641.1
2459312784770413568,2020-07,1944.1,17.3,4394.31,1636.38,4684.73,-14956.37
2459312784770413568,2020-08,5474.81,4211.76,1929.4,292.83,2899.62,-12056.75
2459312784770413568,2020-09,1174.2,2984.79,1858.23,4509.16,-4461.52,-16518.27
2459312784770413568,2020-10,3356.93,2698.86,8827.1,4956.09,4529.08,-11989.19
2459312784770413568,2020-11,1262.38,2816.51,4253.26,2854.5,-155.37,-12144.56
2459312784770413568,2020-12,3359.98,3145.39,519.86,3649.71,-2915.26,-15059.82
2460081654671506944,2020-01,1185.18,937.71,3157.68,2583.12,822.03,822.03
2460081654671506944,2020-02,1143.15,5092.07,2309.22,1567.51,-3207.21,-2385.18
2460081654671506944,2020-03,1673.4,4465.9,5473,9790.44,-7109.94,-9495.12
2460081654671506944,2020-04,2886.58,2800.82,3073.75,4879.18,-1719.67,-11214.79
2460081654671506944,2020-05,4740.22,8479.34,9041.29,0,5302.17,-5912.62
2460081654671506944,2020-06,5224.91,0,4320.55,4757.02,4788.44,-1124.18
2460081654671506944,2020-07,8180.94,1193.96,8138.51,6134.07,8991.42,7867.24
2460081654671506944,2020-08,4125.69,1342.5,6590.75,5305.96,4067.98,11935.22
2460081654671506944,2020-09,2707.03,2209.84,418.49,807.07,108.61,12043.83
2460081654671506944,2020-10,7359.3,8423.92,3751.57,524.71,2162.24,14206.07
2460081654671506944,2020-11,5873.94,1436.37,8460.13,2826.41,10071.29,24277.36
2460081654671506944,2020-12,2862.88,1471.07,6546.85,3706.23,4232.43,28509.79
2460237543256058880,2020-01,6536.62,4321.67,1382.11,2937.2,659.86,659.86
2460237543256058880,2020-02,5628.49,0,0,2889.86,2738.63,3398.49
2460237543256058880,2020-03,664.17,1159.44,835.71,452.67,-112.23,3286.26
2460237543256058880,2020-04,0,2402.13,1273.8,2268.51,-3396.84,-110.58
2460237543256058880,2020-05,236.37,4792.32,639.85,858.98,-4775.08,-4885.66
2460237543256058880,2020-06,0,2386.88,2469.42,4124.96,-4042.42,-8928.08
2460237543256058880,2020-07,18.09,221.65,2823.16,95.77,2523.83,-6404.25
2460237543256058880,2020-08,2183.46,6365.18,1433.33,1322.53,-4070.92,-10475.17
2460237543256058880,2020-09,2026.65,253.96,0,5417.46,-3644.77,-14119.94
2460237543256058880,2020-10,966.82,1347.76,5127.56,3684.27,1062.35,-13057.59
2460237543256058880,2020-11,1437.17,1829.51,2075.97,2093.88,-410.25,-13467.84
2460237543256058880,2020-12,5049.01,3313.06,0,1016.73,719.22,-12748.62
2463943513657600000,2020-01,6205.93,4046.65,1914.18,484.4,3589.06,3589.06
2463943513657600000,2020-02,4238.32,3214.49,1288.77,480.42,1832.18,5421.24
2463943513657600000,2020-03,1478.82,2252.85,1867.26,2919.52,-1826.29,3594.95
2463943513657600000,2020-04,1413.25,3183.81,0,2706.14,-4476.7,-881.75
2463943513657600000,2020-05,2726.78,2344.17,1042.42,302.77,1122.26,240.51
2463943513657600000,2020-06,1645.89,3277.41,3089.66,0,1458.14,1698.65
2463943513657600000,2020-07,0,3827.56,828.21,2089.56,-5088.91,-3390.26
2463943513657600000,2020-08,1866.82,2682.37,6405.26,977.38,4612.33,1222.07
2463943513657600000,2020-09,3016.75,976.3,0,1993.07,47.38,1269.45
2463943513657600000,2020-10,0,44.95,5105.54,0,5060.59,6330.04
2463943513657600000,2020-11,0,391.71,3094.75,5125.07,-2422.03,3908.01
2463943513657600000,2020-12,0,2349.36,0,2382.93,-4732.29,-824.28
2464779381264489472,2020-01,2549.63,4758.69,1265.96,4095.69,-5038.79,-5038.79
2464779381264489472,2020-02,3111.44,200.28,3016.13,641.16,5286.13,247.34
2464779381264489472,2020-03,479.22,0,1649.24,849.04,1279.42,1526.76
2464779381264489472,2020-04,0,27.78,164.87,1696.09,-1559,-32.24
2464779381264489472,2020-05,1718.87,2331.3,1657.23,539.36,505.44,473.2
2464779381264489472,2020-06,0,4602.62,2932.88,4747.21,-6416.95,-5943.75
2464779381264489472,2020-07,1924.89,6013.81,0,2411.11,-6500.03,-12443.78
2464779381264489472,2020-08,1737.34,703.64,5412.58,1487.41,4958.87,-7484.91
2464779381264489472,2020-10,4061.4,3183.6,5344.04,1383.58,4838.26,-2646.65
2464779381264489472,2020-11,5860.16,0,4760.31,1623.7,8996.77,6350.12
2464779381264489472,2020-12,0,1711.96,0,2751.46,-4463.42,1886.7
2464968064048081408,2020-01,1673.33,1514.92,1232.16,1874.12,-483.55,-483.55
2464968064048081408,2020-02,8093.27,2242.32,5014.54,3773.12,7092.37,6608.82
2464968064048081408,2020-03,0,8188.45,2931.89,4699.31,-9955.87,-3347.05
2464968064048081408,2020-04,4893.87,1276.29,3769.88,2560.58,4826.88,1479.83
2464968064048081408,2020-05,8268.38,2888.04,9089.56,6411.75,8058.15,9537.98
2464968064048081408,2020-06,6097.59,6811.09,4960.33,4412.86,-166.03,9371.95
2464968064048081408,2020-07,5146.08,9067.62,2282.73,5175.53,-6814.34,2557.61
2464968064048081408,2020-08,6632.54,6769.77,4283.77,4144.98,1.56,2559.17
2464968064048081408,2020-09,4839.93,1828.18,6168.25,2953.49,6226.51,8785.68
2464968064048081408,2020-10,1243.75,1605.1,9344.68,4314.92,4668.41,13454.09
2464968064048081408,2020-11,5882.07,5180.3,3970.02,4828.37,-156.58,13297.51
2464968064048081408,2020-12,6330.31,2822.5,3604.6,5507.95,1604.46,14901.97
2465574559843324416,2020-01,275.63,0,936.77,0,1212.4,1212.4
2465574559843324416,2020-02,157.34,0,0,0,157.34,1369.74
2465574559843324416,2020-03,979.71,0,0,0,979.71,2349.45
2465574559843324416,2020-06,0,1329.76,0,648.34,-1978.1,371.35
2465574559843324416,2020-07,1729.65,0,0,1687.43,42.22,413.57
2465574559843324416,2020-09,875.06,0,0,0,875.06,1288.63
2466013925772088320,2020-01,1284.1,0,0,0,1284.1,1284.1
2466013925772088320,2020-02,1883.35,0,220.91,0,2104.26,3388.36
2466013925772088320,2020-03,536.36,913.04,1382.94,0,1006.26,4394.62
2466013925772088320,2020-06,1249.02,0,0,308.11,940.91,5335.53
2466013925772088320,2020-09,544.56,0,0,0,544.56,5880.09
2467735674802272768,2020-01,4346.14,6597.92,2708.31,0,456.53,456.53
2467735674802272768,2020-02,2974.99,2145.79,1645.16,4259.89,-1785.53,-1329
2467735674802272768,2020-03,65.91,3564.71,6373.08,1222.12,1652.16,323.16
2467735674802272768,2020-04,3915.6,5025.53,816.8,5646.24,-5939.37,-5616.21
2467735674802272768,2020-05,530.25,6882.24,1728.12,1655.64,-6279.51,-11895.72
2467735674802272768,2020-06,7588.48,4956.9,3203.23,1562.9,4271.91,-7623.81
2467735674802272768,2020-07,1104.36,3327.36,4113.47,3330.69,-1440.22,-9064.03
2467735674802272768,2020-08,3925.76,2392.97,1702.16,2899.96,334.99,-8729.04
2467735674802272768,2020-09,3587.01,2966.66,4967.6,4720.38,867.57,-7861.47
2467735674802272768,2020-10,4595.01,1536.62,4550.85,5290.39,2318.85,-5542.62
2467735674802272768,2020-11,2838.76,4178.67,2849.71,2665.51,-1155.71,-6698.33
2467735674802272768,2020-12,589.88,2470.09,4458.83,911.71,1666.91,-5031.42
2468326689938762752,2020-01,4568.32,6676.29,5172.57,5650.69,-2586.09,-2586.09
2468326689938762752,2020-02,1279.27,3818.62,4240.66,570.3,1131.01,-1455.08
2468326689938762752,2020-03,1373.93,4542.63,2408.35,13338.75,-14099.1,-15554.18
2468326689938762752,2020-04,6445.96,8144.31,0,3472.31,-5170.66,-20724.84
2468326689938762752,2020-05,3474.44,9384.21,2517.88,5936.36,-9328.25,-30053.09
2468326689938762752,2020-06,3653.98,4237.91,1953.88,5126.31,-3756.36,-33809.45
2468326689938762752,2020-07,8902.75,2086.09,3837.65,5802.83,4851.48,-28957.97
2468326689938762752,2020-08,4854.05,3905.26,2950.06,8945.39,-5046.54,-34004.51
2468326689938762752,2020-09,5371.36,1977.46,4636.38,6539.61,1490.67,-32513.84
2468326689938762752,2020-10,3594.75,8100.92,1360.59,3842.61,-6988.19,-39502.03
2468326689938762752,2020-11,1496.74,1733.16,5089.3,1220.72,3632.16,-35869.87
2468326689938762752,2020-12,2893.57,2443.03,5092.8,14279.85,-8736.51,-44606.38
2468393078570165248,2020-01,0,6431.16,2103.63,1314.25,-5641.78,-5641.78
2468393078570165248,2020-02,1317.66,1903.73,4858.32,2869.46,1402.79,-4238.99
2468393078570165248,2020-03,2631.3,3108.91,7086.54,445.66,6163.27,1924.28
2468393078570165248,2020-04,3233.18,2514.16,592.66,1690.62,-378.94,1545.34
2468393078570165248,2020-05,390.96,1388.46,1255.52,3004.32,-2746.3,-1200.96
2468393078570165248,2020-06,992.94,760.16,6325.84,2724.32,3834.3,2633.34
2468393078570165248,2020-07,1355.63,3334.5,5498.36,4671.41,-1151.92,1481.42
2468393078570165248,2020-08,2773.35,0,6127.63,4409.63,4491.35,5972.77
2468393078570165248,2020-09,1013.43,2456.9,3099.55,3253.95,-1597.87,4374.9
2468393078570165248,2020-10,1685.75,2585.78,1972.64,3471.97,-2399.36,1975.54
2468393078570165248,2020-11,1826.61,1348.21,5258.15,4425.07,1311.48,3287.02
2468393078570165248,2020-12,3711.49,7550.56,5.34,4903.33,-8737.06,-5450.04
2469439696965061632,2020-01,4618.85,6157.86,1534.01,4783.93,-4788.93,-4788.93
2469439696965061632,2020-02,5438.93,1771.39,5842.63,4394.88,5115.29,326.36
2469439696965061632,2020-03,222.26,2990.3,6255.63,2948.08,539.51,865.87
2469439696965061632,2020-04,9073.05,1198.16,4973.3,6414.92,6433.27,7299.14
2469439696965061632,2020-05,4225.65,5559.17,2239.03,4948.24,-4042.73,3256.41
2469439696965061632,2020-06,5810.86,3103.94,754.92,2218,1243.84,4500.25
2469439696965061632,2020-07,3493.87,4194.46,6901.36,4872.08,1328.69,5828.94
2469439696965061632,2020-08,7844.64,7167.63,1812.11,2666.1,-176.98,5651.96
2469439696965061632,2020-09,2370.9,2269.32,7845.73,4787.96,3159.35,8811.31
2469439696965061632,2020-10,4698.25,8211.94,6151.36,8734.07,-6096.4,2714.91
2469439696965061632,2020-11,6246.09,5040.9,7877.88,3783.12,5299.95,8014.86
2469439696965061632,2020-12,1992.65,3507.59,958.86,1865.15,-2421.23,5593.63
2469684252373578752,2020-01,0,1406.58,1342.68,37.24,-101.14,-101.14
2469684252373578752,2020-02,2217.04,0,3067.6,0,5284.64,5183.5
2469684252373578752,2020-03,2784.59,15.51,3983.91,2932.16,3820.83,9004.33
2469684252373578752,2020-04,1225.62,0,2591.63,3407.86,409.39,9413.72
2469684252373578752,2020-05,4164.72,0,670.68,2072,2763.4,12177.12
2469684252373578752,2020-06,1530.87,2122.75,1050.19,1203.99,-745.68,11431.44
2469684252373578752,2020-07,1914.95,2127.52,5253.45,1156.65,3884.23,15315.67
2469684252373578752,2020-08,536.55,5381.23,805.24,819.12,-4858.56,10457.11
2469684252373578752,2020-09,0,3532.58,1541.9,0,-1990.68,8466.43
2469684252373578752,2020-10,632.22,3282.63,4190.6,1177.02,363.17,8829.6
2469684252373578752,2020-11,865.7,4003.27,0,5639.06,-8776.63,52.97
2469684252373578752,2020-12,1290.47,0,1699.94,0,2990.41,3043.38
2469808895683208192,2020-01,8123.03,7981.92,2694.64,3212.54,-376.79,-376.79
2469808895683208192,2020-02,1979.91,2021.52,3589.82,4279.61,-731.4,-1108.19
2469808895683208192,2020-03,369.15,4936.38,2948.13,7453.72,-9072.82,-10181.01
2469808895683208192,2020-04,1031.45,7553.01,1476.69,5239.85,-10284.72,-20465.73
2469808895683208192,2020-05,7632.98,3897.26,3886.53,3185.88,4436.37,-16029.36
2469808895683208192,2020-06,4703.24,5213.31,5522.57,1344.68,3667.82,-12361.54
2469808895683208192,2020-07,2529.13,699.62,7455.93,5489.08,3796.36,-8565.18
2469808895683208192,2020-08,3037.1,2652.62,5528.12,4082.56,1830.04,-6735.14
2469808895683208192,2020-09,5351.36,6247.27,622.21,4159.57,-4433.27,-11168.41
2469808895683208192,2020-10,2505.29,1301.77,5883.64,5144.49,1942.67,-9225.74
2469808895683208192,2020-11,6595.07,3201.75,5790.61,7692.34,1491.59,-7734.15
2469808895683208192,2020-12,3535.86,7672.96,1283.78,3775.69,-6629.01,-14363.16
2470141018431494144,2020-01,976.06,1599.82,1265.68,1505.37,-863.45,-863.45
2470141018431494144,2020-02,0,700.69,2590.24,1848.76,40.79,-822.66
2470141018431494144,2020-03,3138.58,581.06,1531.92,0,4089.44,3266.78
2470141018431494144,2020-05,1850.08,0,592.94,246.4,2196.62,5463.4
2470141018431494144,2020-06,447.38,1270.65,1204.16,1449.91,-1069.02,4394.38
2470141018431494144,2020-07,0,78.93,0,332.67,-411.6,3982.78
2470141018431494144,2020-08,1486.16,0,2580.46,1450.24,2616.38,6599.16
2470141018431494144,2020-09,4220.27,1056.14,2742.94,0,5907.07,12506.23
2470141018431494144,2020-10,3968.04,494.83,1757.7,3238.27,1992.64,14498.87
2470141018431494144,2020-12,4243.59,0,0,637.34,3606.25,18105.12
2472338699499826688,2020-01,4485.88,6037.24,3131.04,5109.66,-3529.98,-3529.98
2472338699499826688,2020-02,1756.92,3017.24,1095.22,6401.58,-6566.68,-10096.66
2472338699499826688,2020-03,1136.09,1372.8,5584.28,1662.4,3685.17,-6411.49
2472338699499826688,2020-04,5144.18,4534.32,3703.71,2767.68,1545.89,-4865.6
2472338699499826688,2020-05,1248.46,2497.15,5097.98,4141.14,-291.85,-5157.45
2472338699499826688,2020-06,3330.05,2694.92,4975.61,2863.19,2747.55,-2409.9
2472338699499826688,2020-07,3972.73,7763.22,3856.65,3436.74,-3370.58,-5780.48
2472338699499826688,2020-08,2638.95,3066.82,578.68,3556.44,-3405.63,-9186.11
2472338699499826688,2020-09,4760.5,2512.04,2535.15,6602.29,-1818.68,-11004.79
2472338699499826688,2020-10,3230.32,7465.86,861.19,2456.85,-5831.2,-16835.99
2472338699499826688,2020-11,2603.42,1410.52,1731.78,4667.79,-1743.11,-18579.1
2472338699499826688,2020-12,1383.88,324.28,2448.64,713.01,2795.23,-15783.87
2473121968534603264,2020-01,1640.49,95.82,1516.55,0,3061.22,3061.22
2473121968534603264,2020-02,2201.82,3723.9,0,3415.27,-4937.35,-1876.13
2473121968534603264,2020-03,625.71,2771.05,3188.24,529.72,513.18,-1362.95
2473121968534603264,2020-04,49.47,2699.55,2698.62,4090.15,-4041.61,-5404.56
2473121968534603264,2020-05,3109.95,2548,1887.42,2642.1,-192.73,-5597.29
2473121968534603264,2020-06,2394.07,1628.77,2607.78,4732.13,-1359.05,-6956.34
2473121968534603264,2020-07,3156.86,385.65,1720.58,1916.99,2574.8,-4381.54
2473121968534603264,2020-08,4285.64,3241.86,0,0,1043.78,-3337.76
2473121968534603264,2020-09,4778.31,4061.83,1461.32,4275.97,-2098.17,-5435.93
2473121968534603264,2020-10,0,5063.33,3315.88,2584.75,-4332.2,-9768.13
2473121968534603264,2020-11,2567.12,0,999.69,2695.37,871.44,-8896.69
2473121968534603264,2020-12,648.75,5021.53,6275.01,2007.23,-105,-9001.69
2473439956315480064,2020-01,2458.96,980.8,6852.41,4507.55,3823.02,3823.02
2473439956315480064,2020-02,2227.24,6811.74,736.45,2161.92,-6009.97,-2186.95
2473439956315480064,2020-03,881.18,9168.23,1340.49,4346.64,-11293.2,-13480.15
2473439956315480064,2020-04,4233.54,2155.22,193.96,1114.23,1158.05,-12322.1
2473439956315480064,2020-05,4917.77,0,4070.26,2525.08,6462.95,-5859.15
2473439956315480064,2020-06,569.69,2577.68,280.25,5004.63,-6732.37,-12591.52
2473439956315480064,2020-07,3170.17,1788.16,2598.46,865.39,3115.08,-9476.44
2473439956315480064,2020-08,1196.98,3679.71,1926.96,1945.49,-2501.26,-11977.7
2473439956315480064,2020-09,1361.32,2793.12,2946.39,6189.92,-4675.33,-16653.03
2473439956315480064,2020-10,5655.12,4416.94,1549.62,1940.09,847.71,-15805.32
2473439956315480064,2020-11,3118.8,3114.62,872.97,2438.9,-1561.75,-17367.07
2473439956315480064,2020-12,5310.37,1765.72,1256.16,6543.06,-1742.25,-19109.32
2474006587302687744,2020-01,1439.3,276.84,1721.03,2428.27,455.22,455.22
2474006587302687744,2020-02,2141.92,2563.72,0,2522.51,-2944.31,-2489.09
2474006587302687744,2020-03,246.51,2384.5,3422.91,1428.13,-143.21,-2632.3
2474006587302687744,2020-04,1887.1,3787.82,4431.85,2810.57,-279.44,-2911.74
2474006587302687744,2020-05,382.44,1956.55,853.72,1909.72,-2630.11,-5541.85
2474006587302687744,2020-06,1219.77,3361.94,778.75,805.41,-2168.83,-7710.68
2474006587302687744,2020-07,2882.41,967.61,707.73,4750.67,-2128.14,-9838.82
2474006587302687744,2020-08,1287.62,0,4935.39,21.12,6201.89,-3636.93
2474006587302687744,2020-09,2848.98,2670.84,2489.76,2302.01,365.89,-3271.04
2474006587302687744,2020-10,656.76,2350.28,1848.49,0,154.97,-3116.07
2474006587302687744,2020-11,0,3308.57,1169.02,3845.8,-5985.35,-9101.42
2474006587302687744,2020-12,2288.76,0,3681.55,3012.68,2957.63,-6143.79
2474401469558791168,2020-01,0,1074.2,4887.66,0,3813.46,3813.46
2474401469558791168,2020-03,1540.57,2777.61,0,3465.02,-4702.06,-888.6
2474401469558791168,2020-04,0,1445.46,2317.01,3190.2,-2318.65,-3207.25
2474401469558791168,2020-05,1769.95,0,1197.91,0,2967.86,-239.39
2474401469558791168,2020-06,911.02,0,0,0,911.02,671.63
2474401469558791168,2020-07,0,1866.8,0,1931.2,-3798,-3126.37
2474401469558791168,2020-08,0,266.9,2083.44,0,1816.54,-1309.83
2474401469558791168,2020-09,1883.39,845.34,0,0,1038.05,-271.78
2474401469558791168,2020-10,1751.77,1261.52,0,616.95,-126.7,-398.48
2474401469558791168,2020-11,520.43,195.96,1977.62,0,2302.09,1903.61
2474401469558791168,2020-12,2887.58,608.44,0,110.86,2168.28,4071.89
2475730417130189312,2020-01,3671.07,2870.43,3186.66,4025.56,-38.26,-38.26
2475730417130189312,2020-02,4124.45,5304.91,5252.26,195.96,3875.84,3837.58
2475730417130189312,2020-03,3093.63,2357.58,5297.68,6093.48,-59.75,3777.83
2475730417130189312,2020-04,6625.85,1933.46,2867.1,5917.11,1642.38,5420.21
2475730417130189312,2020-05,3120.81,4565.65,2529.88,4663.99,-3578.95,1841.26
2475730417130189312,2020-06,0,1566.85,2275.15,3269.69,-2561.39,-720.13
2475730417130189312,2020-07,5045.21,1336.54,2117.71,2770.51,3055.87,2335.74
2475730417130189312,2020-08,4011.34,3673.48,3293.08,5949.88,-2318.94,16.8
2475730417130189312,2020-09,5996.18,505.1,5641.71,3383.48,7749.31,7766.11
2475730417130189312,2020-10,1259.23,4707.98,6866.69,4511.18,-1093.24,6672.87
2475730417130189312,2020-11,5408.83,2598.07,5291.09,4404.97,3696.88,10369.75
2475730417130189312,2020-12,2650.22,1861.84,6809.7,5219.63,2378.45,12748.2
2475946014123909632,2020-01,1511.83,5527.96,7036.39,2359.71,660.55,660.55
2475946014123909632,2020-02,6022.81,311.21,3821.32,3606.78,5926.14,6586.69
2475946014123909632,2020-03,1510.07,7379.39,5494.04,5017.83,-5393.11,1193.58
2475946014123909632,2020-04,1850.4,4838.64,8912.65,3784.1,2140.31,3333.89
2475946014123909632,2020-05,2768.43,3764.12,2309.86,3325.91,-2011.74,1322.15
2475946014123909632,2020-06,1504.9,6003.31,2019.43,1933.59,-4412.57,-3090.42
2475946014123909632,2020-07,5152.56,3319.73,5772.54,2758.37,4847,1756.58
2475946014123909632,2020-08,1526,2352.69,2625.65,3438.33,-1639.37,117.21
2475946014123909632,2020-09,2052.23,4989.98,2947.05,5003.34,-4994.04,-4876.83
2475946014123909632,2020-10,3882.43,4496.18,3702.48,1548.48,1540.25,-3336.58
2475946014123909632,2020-11,3549.21,10742.12,1077.68,3346.56,-9461.79,-12798.37
2475946014123909632,2020-12,5595.75,1487.45,2767.22,2385.76,4489.76,-8308.61
2477919054002095616,2020-01,94.23,1830.14,1404.91,1074.68,-1405.68,-1405.68
2477919054002095616,2020-02,595.44,3375.34,0,713.1,-3493,-4898.68
2477919054002095616,2020-04,1517.22,0,1399.89,1441.85,1475.26,-3423.42
2477919054002095616,2020-05,1524.61,2544.17,203.27,2035.18,-2851.47,-6274.89
2477919054002095616,2020-07,2497.21,1834.8,4466.65,1846.91,3282.15,-2992.74
2477919054002095616,2020-08,2096.07,1906.56,1917.73,0,2107.24,-885.5
2477919054002095616,2020-09,1451,1943.1,344.98,1015.85,-1162.97,-2048.47
2477919054002095616,2020-10,5653.2,1715.16,1387.1,638.07,4687.07,2638.6
2477919054002095616,2020-11,1710.66,620.59,1654.01,832.8,1911.28,4549.88
2477919054002095616,2020-12,1188.83,4405.39,1423.84,0,-1792.72,2757.16
2478372299468782080,2020-01,1870.43,0,0,0,1870.43,1870.43
2478372299468782080,2020-07,656.13,0,0,1500.67,-844.54,1025.89
2478372299468782080,2020-08,1899.46,0,0,1763.52,135.94,1161.83
2478372299468782080,2020-11,0,238.93,1574.97,0,1336.04,2497.87
2478705804897043968,2020-01,3524.59,2941.79,2104.9,2289.99,397.71,397.71
2478705804897043968,2020-02,3672.78,5071.82,9396.25,1483.74,6513.47,6911.18
2478705804897043968,2020-03,1642.64,2715.08,2480.51,7419.93,-6011.86,899.32
2478705804897043968,2020-04,3619.94,1328.8,3290.94,7553.21,-1971.13,-1071.81
2478705804897043968,2020-05,1461.53,6690.09,4953.78,8294.62,-8569.4,-9641.21
2478705804897043968,2020-06,8908.96,7928.8,1661.63,3223.27,-581.48,-10222.69
2478705804897043968,2020-07,4952.88,5767.77,5141.48,3303.63,1022.96,-9199.73
2478705804897043968,2020-08,2920.75,3099.86,11267.21,907.63,10180.47,980.74
2478705804897043968,2020-09,7919.34,5389.66,1199.07,10260.17,-6531.42,-5550.68
2478705804897043968,2020-10,7092.35,4840.06,6568.01,575.97,8244.33,2693.65
2478705804897043968,2020-11,4651.74,6238.32,3795.8,5846.4,-3637.18,-943.53
2478705804897043968,2020-12,12513.42,4382.22,3121.03,479.32,10772.91,9829.38
2478720287061022208,2020-01,6999.9,2251.24,6063.04,6536.23,4275.47,4275.47
2478720287061022208,2020-02,6799.94,5587.87,2695.98,1900.17,2007.88,6283.35
2478720287061022208,2020-03,90.11,1777.03,3973.1,2179.37,106.81,6390.16
2478720287061022208,2020-04,1743.64,1669.85,8133.65,5930.36,2277.08,8667.24
2478720287061022208,2020-05,5764.84,2999.32,5690.37,3027.71,5428.18,14095.42
2478720287061022208,2020-06,127,1891.45,1220.91,3822.57,-4366.11,9729.31
2478720287061022208,2020-07,6243.82,7284.49,3254.59,3005.83,-791.91,8937.4
2478720287061022208,2020-08,1897.39,0,8961.81,3424.72,7434.48,16371.88
2478720287061022208,2020-09,5711.71,4590.18,3946.82,8062.47,-2994.12,13377.76
2478720287061022208,2020-10,9474.08,2606.72,7473.45,1185.15,13155.66,26533.42
2478720287061022208,2020-11,8423.92,2683.32,5897.68,1826.05,9812.23,36345.65
2478720287061022208,2020-12,817.16,4077.25,4455.71,3003.04,-1807.42,34538.23
2480186290317768192,2020-01,24.83,1973.38,0,1669.81,-3618.36,-3618.36
2480186290317768192,2020-02,1493.42,0,4246.03,0,5739.45,2121.09
2480186290317768192,2020-03,1904.42,1161.58,2896.72,2565.06,1074.5,3195.59
2480186290317768192,2020-04,448.59,4493.07,831.75,2437.15,-5649.88,-2454.29
2480186290317768192,2020-05,0,1125.41,1147.41,736.85,-714.85,-3169.14
2480186290317768192,2020-06,0,3588.14,0,0,-3588.14,-6757.28
2480186290317768192,2020-07,2437.81,50.72,3844.58,0,6231.67,-525.61
2480186290317768192,2020-08,2501.75,0,1851.08,2769.13,1583.7,1058.09
2480186290317768192,2020-09,1716.68,0,0.37,540.57,1176.48,2234.57
2480186290317768192,2020-10,1817.29,121.07,1725.47,0,3421.69,5656.26
2480186290317768192,2020-11,1974.04,1052.21,1662.73,0,2584.56,8240.82
2480186290317768192,2020-12,1163.06,795.4,126.86,0,494.52,8735.34
2480873341794441216,2020-01,3382.48,580.72,513.4,2071.14,1244.02,1244.02
2480873341794441216,2020-02,786.74,160.69,4503.38,953.47,4175.96,5419.98
2480873341794441216,2020-03,181.42,3348.37,2588.45,4453.13,-5031.63,388.35
2480873341794441216,2020-04,4358.69,1474.79,3174.68,1562.42,4496.16,4884.51
2480873341794441216,2020-05,1147.22,1792.03,0,0,-644.81,4239.7
2480873341794441216,2020-06,1154.05,0,2020.11,2065.6,1108.56,5348.26
2480873341794441216,2020-07,1535.05,1499.75,7196.56,3530.55,3701.31,9049.57
2480873341794441216,2020-08,0,784.93,1553.28,1713.39,-945.04,8104.53
2480873341794441216,2020-09,2381.2,4789.55,1268.82,1953.2,-3092.73,5011.8
2480873341794441216,2020-10,0,3152.85,1739.83,87.79,-1500.81,3510.99
2480873341794441216,2020-11,0,989.8,153.42,937.54,-1773.92,1737.07
2480873341794441216,2020-12,0,6536.94,0,726.4,-7263.34,-5526.27
2481007105267219456,2020-01,3226.91,0,0,2766.51,460.4,460.4
2481007105267219456,2020-02,0,1999.76,61.77,1424.25,-3362.24,-2901.84
2481007105267219456,2020-03,0,1029.6,1172.67,2277.25,-2134.18,-5036.02
2481007105267219456,2020-04,1530.71,2570.27,0,37.24,-1076.8,-6112.82
2481007105267219456,2020-05,2784.64,2169.57,1415.61,3834.46,-1803.78,-7916.6
2481007105267219456,2020-06,3750.59,647.19,2976.51,1227.46,4852.45,-3064.15
2481007105267219456,2020-07,45.22,4624.75,0,1544.89,-6124.42,-9188.57
2481007105267219456,2020-08,411.36,1579.96,1553.05,0,384.45,-8804.12
2481007105267219456,2020-09,1314.37,1031.39,0,2967.96,-2684.98,-11489.1
2481007105267219456,2020-10,0,1355.99,1762.2,1364.98,-958.77,-12447.87
2481007105267219456,2020-11,3628.65,0,1728.48,4372.93,984.2,-11463.67
2481007105267219456,2020-12,1819.98,0,2017.12,19.52,3817.58,-7646.09
2481861278853952512,2020-01,0,1931.6,2106.53,384.4,-209.47,-209.47
2481861278853952512,2020-03,3287.23,0,1030.05,4033.16,284.12,74.65
2481861278853952512,2020-04,1984.06,4033.13,68.3,194.74,-2175.51,-2100.86
2481861278853952512,2020-06,641.66,1901.63,0,5371.71,-6631.68,-8732.54
2481861278853952512,2020-07,607.01,0,1069.52,445.5,1231.03,-7501.51
2481861278853952512,2020-08,665.89,1492.38,3617.93,0,2791.44,-4710.07
2481861278853952512,2020-09,0,1296.64,1049.73,1799.7,-2046.61,-6756.68
2481861278853952512,2020-10,1946.32,2980.38,304.61,564.72,-1294.17,-8050.85
2481861278853952512,2020-11,0,1689.71,5327.35,0,3637.64,-4413.21
2481861278853952512,2020-12,1463.97,404.95,1497.74,1646.6,910.16,-3503.05
2482077421293471232,2020-01,1269.09,0,0,0,1269.09,1269.09
2482077421293471232,2020-02,1112.6,280.02,1492.35,3508.62,-1183.69,85.4
2482077421293471232,2020-03,1967.59,0,2662.04,1611.48,3018.15,3103.55
2482077421293471232,2020-04,2050.15,3047.98,1826.01,0,828.18,3931.73
2482077421293471232,2020-05,0,1696.03,2602.55,1903.07,-996.55,2935.18
2482077421293471232,2020-06,2525.82,0,4186.5,0,6712.32,9647.5
2482077421293471232,2020-07,0,2824.89,1954.97,0,-869.92,8777.58
2482077421293471232,2020-08,721.72,0,1452.31,916.61,1257.42,10035
2482077421293471232,2020-09,0,2404.04,1688.25,0,-715.79,9319.21
2482077421293471232,2020-10,520.28,996.6,0,1693.43,-2169.75,7149.46
2482077421293471232,2020-12,1226.01,1675.47,0,2376.22,-2825.68,4323.78
2482240869406734848,2020-01,0,1688.65,210.08,47.67,-1526.24,-1526.24
2482240869406734848,2020-02,1920.6,5051.91,2241.05,2310.06,-3200.32,-4726.56
2482240869406734848,2020-03,3548.61,3310.72,8547.15,2371.14,6413.9,1687.34
2482240869406734848,2020-04,4301.69,0,3001.39,178.92,7124.16,8811.5
2482240869406734848,2020-05,2816.33,1516.15,1058.14,1198.72,1159.6,9971.1
2482240869406734848,2020-06,3953.49,3920.48,697.26,0,730.27,10701.37
2482240869406734848,2020-07,1410.54,5408.15,7183.65,4382.81,-1196.77,9504.6
2482240869406734848,2020-08,1694.54,376.97,5649.58,1677.76,5289.39,14793.99
2482240869406734848,2020-09,3508.89,1669.36,0,6224.75,-4385.22,10408.77
2482240869406734848,2020-10,3773.29,5165.06,2720.95,3290.39,-1961.21,8447.56
2482240869406734848,2020-11,3201.05,3608.1,937.59,4821.71,-4291.17,4156.39
2482240869406734848,2020-12,3122.26,4482.99,1419.35,7970.68,-7912.06,-3755.67
2482567403738742272,2020-02,1175.76,2106.3,217.14,2887.29,-3600.69,-3600.69
2482567403738742272,2020-04,2979.26,3765.71,0,3704.12,-4490.57,-8091.26
2482567403738742272,2020-06,612.6,0,0,0,612.6,-7478.66
2482567403738742272,2020-07,3030.85,1578.46,0,2151.49,-699.1,-8177.76
2482567403738742272,2020-08,0,1408.56,204.15,432.4,-1636.81,-9814.57
2482567403738742272,2020-10,0,2337.83,0,3702.12,-6039.95,-15854.52
2482567403738742272,2020-11,2042.22,0,0,0,2042.22,-13812.3
2482567403738742272,2020-12,0,461.13,0,780.23,-1241.36,-15053.66
2483758828144264192,2020-01,5759.64,3541.01,4006.62,5135.31,1089.94,1089.94
2483758828144264192,2020-02,11752.19,6774.46,4527.61,6132.18,3373.16,4463.1
2483758828144264192,2020-03,3187.55,4740.16,6788.09,4693.71,541.77,5004.87
2483758828144264192,2020-04,7155.65,6546.87,9510.8,7821.91,2297.67,7302.54
2483758828144264192,2020-05,4655.86,4279.2,6084.74,6977.8,-516.4,6786.14
2483758828144264192,2020-06,9461.52,5534.83,2998.25,8552.87,-1627.93,5158.21
2483758828144264192,2020-07,8370.09,4488.87,844.85,3430.03,1296.04,6454.25
2483758828144264192,2020-08,3892.32,6696.28,9503.84,1796.22,4903.66,11357.91
2483758828144264192,2020-09,3416.14,8068.48,8107.86,4350.47,-894.95,10462.96
2483758828144264192,2020-10,2033.52,4947.89,1627.57,2269.81,-3556.61,6906.35
2483758828144264192,2020-11,1572.71,2269.02,6545.8,3890.85,1958.64,8864.99
2483758828144264192,2020-12,5726.46,1134.51,3275.05,2929.71,4937.29,13802.28
2487467222957680640,2020-01,1609.21,944.42,2039.23,3469.25,-765.23,-765.23
2487467222957680640,2020-02,1328.5,15.24,1813.86,5737.58,-2610.46,-3375.69
2487467222957680640,2020-03,1642.77,2628.76,0,1959.05,-2945.04,-6320.73
2487467222957680640,2020-04,2606.45,2178.86,748.1,1047.41,128.28,-6192.45
2487467222957680640,2020-05,2338.89,3804.13,2819,2493.69,-1139.93,-7332.38
2487467222957680640,2020-06,3302.88,3032.95,1885.49,368.08,1787.34,-5545.04
2487467222957680640,2020-07,0,2979.13,1836.94,0,-1142.19,-6687.23
2487467222957680640,2020-08,1948.82,3701.47,3024.45,1966.86,-695.06,-7382.29
2487467222957680640,2020-09,205.39,3173.67,2823.12,1814.62,-1959.78,-9342.07
2487467222957680640,2020-10,1265.05,430.36,6034.15,1708.01,5160.83,-4181.24
2487467222957680640,2020-11,818.87,2819.24,265.24,1306.55,-3041.68,-7222.92
2487467222957680640,2020-12,1255.9,1982.58,1307.38,2995.24,-2414.54,-9637.46
2487524826916933120,2020-01,0,1834.16,661.06,0,-1173.1,-1173.1
2487524826916933120,2020-02,121.11,0,0,0,121.11,-1051.99
2487524826916933120,2020-04,0,993.58,0,4780.07,-5773.65,-6825.64
2487524826916933120,2020-05,0,781.69,0,0,-781.69,-7607.33
2487524826916933120,2020-07,2414.01,557.37,910.2,0,2766.84,-4840.49
2487524826916933120,2020-08,0,972.05,0,0,-972.05,-5812.54
2487524826916933120,2020-09,317.37,930.83,0,0,-613.46,-6426
2487524826916933120,2020-10,0,1521.24,72.48,0,-1448.76,-7874.76
2487524826916933120,2020-11,2658.15,1436.98,0,0,1221.17,-6653.59
2487524826916933120,2020-12,1307.03,0,0,0,1307.03,-5346.56
2487731668578069504,2020-01,4171.77,9378.95,6724.19,6846.13,-5329.12,-5329.12
2487731668578069504,2020-02,4683.1,3969.62,8060.11,6060.06,2713.53,-2615.59
2487731668578069504,2020-03,7115.2,2914.9,6378.03,5620.6,4957.73,2342.14
2487731668578069504,2020-04,2421.15,3045.95,4315.51,3992.75,-302.04,2040.1
2487731668578069504,2020-05,5916.81,6676.06,5262.23,3112.15,1390.83,3430.93
2487731668578069504,2020-06,5620.81,2218.56,6947.3,4331.14,6018.41,9449.34
2487731668578069504,2020-07,4176.34,8139.33,5844.26,2265.18,-383.91,9065.43
2487731668578069504,2020-08,5134.46,5513.57,4484.1,5208.34,-1103.35,7962.08
2487731668578069504,2020-09,5423.06,3649.89,2075.47,4536.48,-687.84,7274.24
2487731668578069504,2020-10,3946.44,5730.78,782.89,2837.2,-3838.65,3435.59
2487731668578069504,2020-11,5738.6,3985.31,1481.6,5711.61,-2476.72,958.87
2487731668578069504,2020-12,4840.17,3579.94,4830.93,1806.02,4285.14,5244.01
2490072617901655552,2020-01,4654.06,6555.84,5219.26,10722.27,-7404.79,-7404.79
2490072617901655552,2020-02,5361.68,5953.77,8338.92,4466.8,3280.03,-4124.76
2490072617901655552,2020-03,4369.32,3036.82,6224.56,2957.85,4599.21,474.45
2490072617901655552,2020-04,3488.24,8710.79,6059.29,5519.82,-4683.08,-4208.63
2490072617901655552,2020-05,3268.57,7865.24,1924.83,1939.04,-4610.88,-8819.51
2490072617901655552,2020-06,7154.98,2150.2,5555.92,3559.87,7000.83,-1818.68
2490072617901655552,2020-07,2199.49,3336.45,2448.4,7417.91,-6106.47,-7925.15
2490072617901655552,2020-08,3795.45,3119.21,7936.88,6474.14,2138.98,-5786.17
2490072617901655552,2020-09,4705.61,3779.27,1038.9,3158.71,-1193.47,-6979.64
2490072617901655552,2020-10,1016.62,3119.12,0,2881.42,-4983.92,-11963.56
2490072617901655552,2020-11,8491.27,7978.13,4354.66,10608.64,-5740.84,-17704.4
2490072617901655552,2020-12,3445.38,1616.38,7242.15,16.74,9054.41,-8649.99
2490096561452301824,2020-01,1658.78,3625.02,2547.48,3174.42,-2593.18,-2593.18
2490096561452301824,2020-02,3476.07,2466.05,3105.47,1093.21,3022.28,429.1
2490096561452301824,2020-03,1448.24,2625.82,6668.51,920.35,4570.58,4999.68
2490096561452301824,2020-04,7344.7,2317.63,774.35,0,5801.42,10801.1
2490096561452301824,2020-05,4558.64,2477.41,2217.62,2886.69,1412.16,12213.26
2490096561452301824,2020-06,356.76,4245.25,0,1990.39,-5878.88,6334.38
2490096561452301824,2020-07,3181.75,1891.82,6769.05,4421.83,3637.15,9971.53
2490096561452301824,2020-08,1773.03,4725.27,5244.72,1751.71,540.77,10512.3
2490096561452301824,2020-09,3670.06,583.74,5794.25,3631.03,5249.54,15761.84
2490096561452301824,2020-10,1505.24,7147.62,5611.72,7649.34,-7680,8081.84
2490096561452301824,2020-11,4207.35,3377.9,4315.1,3971.67,1172.88,9254.72
2490096561452301824,2020-12,5593.02,5518.03,3302.45,125.51,3251.93,12506.65
2491519743964167680,2020-01,5153.2,12069.13,10404.02,4424.22,-936.13,-936.13
2491519743964167680,2020-02,3201.88,5388.44,6013.48,1668.47,2158.45,1222.32
2491519743964167680,2020-03,6707.95,3295.63,2498.7,2571.52,3339.5,4561.82
2491519743964167680,2020-04,7023.78,5401.8,323.53,3329.41,-1383.9,3177.92
2491519743964167680,2020-05,4648,3983.89,6698.92,1943.43,5419.6,8597.52
2491519743964167680,2020-06,3123.02,1921.14,7079.42,3797.26,4484.04,13081.56
2491519743964167680,2020-07,11386.35,633.23,4036.76,7939.39,6850.49,19932.05
2491519743964167680,2020-08,5259.34,5110.38,6100.51,3883.62,2365.85,22297.9
2491519743964167680,2020-09,9237.64,4188.19,6014.35,938.2,10125.6,32423.5
2491519743964167680,2020-10,3850.18,5934.8,5525.63,2291.48,1149.53,33573.03
2491519743964167680,2020-11,1204.57,5392.26,2154.37,5921.61,-7954.93,25618.1
2491519743964167680,2020-12,6434.59,7061.87,8047.03,6980.38,439.37,26057.47
2492420154834317312,2020-01,3446.32,2606.84,1120.04,1466.41,493.11,493.11
2492420154834317312,2020-02,3090.49,269.17,386.84,1201.81,2006.35,2499.46
2492420154834317312,2020-03,0,2989.57,1919.6,0,-1069.97,1429.49
2492420154834317312,2020-04,2880.38,3269.97,123.93,1667.54,-1933.2,-503.71
2492420154834317312,2020-05,178.9,878.66,76.22,636.82,-1260.36,-1764.07
2492420154834317312,2020-06,2804.71,0,3588.47,0,6393.18,4629.11
2492420154834317312,2020-08,0,680.05,1594.72,1281.8,-367.13,4261.98
2492420154834317312,2020-09,0,1265.47,2047.96,1683.94,-901.45,3360.53
2492420154834317312,2020-10,265.69,2834.6,0,0,-2568.91,791.62
2492420154834317312,2020-11,1824.42,3398.65,432.83,0,-1141.4,-349.78
2493893237046748672,2020-01,0,358.16,221.74,385.13,-521.55,-521.55
2493893237046748672,2020-02,229.58,957.75,0,0,-728.17,-1249.72
2493893237046748672,2020-03,0,741.31,0,212.85,-954.16,-2203.88
2493893237046748672,2020-07,0,1541.98,0,0,-1541.98,-3745.86
2493893237046748672,2020-08,1572.53,163.13,0,0,1409.4,-2336.46
2493893237046748672,2020-09,1083.23,0,0,0,1083.23,-1253.23
2493893237046748672,2020-10,0,324.56,1440.44,0,1115.88,-137.35
2494111648573008384,2020-01,2712.63,900.21,0,3195.72,-1383.3,-1383.3
2494111648573008384,2020-02,1376.32,300.07,434.65,1144.12,366.78,-1016.52
2494111648573008384,2020-03,2676.46,2121.82,1497.09,1913.41,138.32,-878.2
2494111648573008384,2020-04,0,1376.26,1562.4,567.96,-381.82,-1260.02
2494111648573008384,2020-05,1765.22,1695.41,3425.2,0,3495.01,2234.99
2494111648573008384,2020-06,3931.15,220.38,0,1309.88,2400.89,4635.88
2494111648573008384,2020-07,0,3000.36,2678.16,3393.79,-3715.99,919.89
2494111648573008384,2020-08,1790.9,3827.73,985.94,4580.37,-5631.26,-4711.37
2494111648573008384,2020-09,4426.16,3944.05,4201.99,3274.55,1409.55,-3301.82
2494111648573008384,2020-10,3546.93,4639.24,414.29,1781.69,-2459.71,-5761.53
2494111648573008384,2020-11,1415.21,658.53,676.74,2432.88,-999.46,-6760.99
2494111648573008384,2020-12,2965.55,4254.03,1841.64,1202.71,-649.55,-7410.54
2494207371562749952,2020-01,2292.48,2685.37,6766.15,2580.33,3792.93,3792.93
2494207371562749952,2020-02,3671.51,2781.35,946.43,3867.5,-2030.91,1762.02
2494207371562749952,2020-03,2210.62,2616.63,2115.19,1043.86,665.32,2427.34
2494207371562749952,2020-04,3031.24,9879.61,3001.16,1011.86,-4859.07,-2431.73
2494207371562749952,2020-05,2484.87,1903.34,104.6,2013.23,-1327.1,-3758.83
2494207371562749952,2020-06,4096.36,1055.38,2574.52,1280.95,4334.55,575.72
2494207371562749952,2020-07,2852.27,1088.54,1778.49,0,3542.22,4117.94
2494207371562749952,2020-08,1917.62,3992.73,3123.67,1241.4,-192.84,3925.1
2494207371562749952,2020-09,3351.47,1403.94,1990.23,2054.71,1883.05,5808.15
2494207371562749952,2020-10,568.83,1143.43,0,2368.06,-2942.66,2865.49
2494207371562749952,2020-11,3253.65,5801.2,5526.63,0,2979.08,5844.57
2494207371562749952,2020-12,0,5199.24,1728.79,2168.36,-5638.81,205.76
2494637683717784064,2020-02,0,475.68,0,549.11,-1024.79,-1024.79
2494637683717784064,2020-03,1492.74,0,0,0,1492.74,467.95
2494637683717784064,2020-04,747.9,0,0,246.72,501.18,969.13
2494637683717784064,2020-06,1059.46,0,0,0,1059.46,2028.59
2494637683717784064,2020-07,0,1308.64,0,0,-1308.64,719.95
2494637683717784064,2020-08,3033.44,0,0,321.33,2712.11,3432.06
2494637683717784064,2020-09,694.56,0,1268.09,0,1962.65,5394.71
2494637683717784064,2020-10,0,1091.25,0,1556.91,-2648.16,2746.55
2495660682553779712,2020-01,1258.22,4281.48,4979.04,1003.15,952.63,952.63
2495660682553779712,2020-02,348.92,2730.1,3149.88,5186.23,-4417.53,-3464.9
2495660682553779712,2020-03,3912.71,6185.7,2212.75,1778.76,-1839,-5303.9
2495660682553779712,2020-04,3041.87,904,475.1,6261.95,-3648.98,-8952.88
2495660682553779712,2020-05,1976.94,2589.47,3446.6,3410.3,-576.23,-9529.11
2495660682553779712,2020-06,3629.07,3150.61,0,4721.09,-4242.63,-13771.74
2495660682553779712,2020-07,5151.53,1056.63,3153.07,4757.26,2490.71,-11281.03
2495660682553779712,2020-08,1499.21,1294.99,1429.71,5240.69,-3606.76,-14887.79
2495660682553779712,2020-09,1386.96,2483.87,2297.14,2965.25,-1765.02,-16652.81
2495660682553779712,2020-10,2728.53,3328.86,3626.69,1899.36,1127,-15525.81
2495660682553779712,2020-11,342.82,2370.89,1388.36,2140.68,-2780.39,-18306.2
2495660682553779712,2020-12,1796.99,495.92,4452.21,5033.93,719.35,-17586.85
2495706809555454464,2020-01,4235.93,8280.44,10464.69,6302.26,117.92,117.92
2495706809555454464,2020-02,6884.91,3724.41,3082,5198.74,1043.76,1161.68
2495706809555454464,2020-03,2810.3,7478.31,4603.57,4691.68,-4756.12,-3594.44
2495706809555454464,2020-04,5755.87,9797.49,5178.83,2183.47,-1046.26,-4640.7
2495706809555454464,2020-05,2268.35,5037.71,7281.46,4534.57,-22.47,-4663.17
2495706809555454464,2020-06,4268.22,4753.8,6238.91,6006.12,-252.79,-4915.96
2495706809555454464,2020-07,3345.38,2861.27,4204.21,6598.63,-1910.31,-6826.27
2495706809555454464,2020-08,2085.12,5764.74,3123.07,4411.79,-4968.34,-11794.61
2495706809555454464,2020-09,9466.39,3960.19,2764.06,3146.26,5124,-6670.61
2495706809555454464,2020-10,3172.85,4488.02,6468.51,4317.57,835.77,-5834.84
2495706809555454464,2020-11,5905.89,5419.75,4115.66,1261.32,3340.48,-2494.36
2495706809555454464,2020-12,4306.81,5969.7,4852.34,5406.5,-2217.05,-4711.41
2496235397536089600,2020-10,1487.18,0,0,0,1487.18,1487.18
2496235397536089600,2020-11,0,1189.82,261.92,0,-927.9,559.28
2497871227268828672,2020-01,5457.6,3536.81,3800.67,3228.25,2493.21,2493.21
2497871227268828672,2020-02,5008.89,517.21,635.83,2208.17,2919.34,5412.55
2497871227268828672,2020-03,4546.03,371.86,7063.78,10352.16,885.79,6298.34
2497871227268828672,2020-04,6090.16,4302.68,5125.47,7268.43,-355.48,5942.86
2497871227268828672,2020-05,6610.62,2730.37,2718.57,4841.5,1757.32,7700.18
2497871227268828672,2020-06,1393.84,5391.53,5864.46,1948.29,-81.52,7618.66
2497871227268828672,2020-07,1990.48,4237.42,2460.22,3097.68,-2884.4,4734.26
2497871227268828672,2020-08,4606.96,4725.42,5942.5,8511.24,-2687.2,2047.06
2497871227268828672,2020-09,3234.61,2120.95,5075.39,4103.37,2085.68,4132.74
2497871227268828672,2020-10,0,6340.66,3787.12,4183.56,-6737.1,-2604.36
2497871227268828672,2020-11,4340.48,7037.45,3830.38,3756.14,-2622.73,-5227.09
2497871227268828672,2020-12,970.88,4376.78,2359.91,1332.97,-2378.96,-7606.05
2497927370217774592,2020-01,1728.23,6171.65,2322.58,3864.22,-5985.06,-5985.06
2497927370217774592,2020-02,4679,5393.58,5728.21,2146.31,2867.32,-3117.74
2497927370217774592,2020-03,1712.02,0,1099.58,4722.63,-1911.03,-5028.77
2497927370217774592,2020-04,3278.58,4551.3,4889.61,2947.99,668.9,-4359.87
2497927370217774592,2020-05,6334.14,5014.99,1693.77,7046.33,-4033.41,-8393.28
2497927370217774592,2020-06,3889.28,6520.34,2097.27,2641.84,-3175.63,-11568.91
2497927370217774592,2020-07,4678.52,9725.58,554.78,3405.77,-7898.05,-19466.96
2497927370217774592,2020-08,3853.21,6224.79,3013.45,4190.74,-3548.87,-23015.83
2497927370217774592,2020-09,8516.01,5356.59,5767.47,7448.11,1478.78,-21537.05
2497927370217774592,2020-10,6444.04,4748.94,3276.71,3703.14,1268.67,-20268.38
2497927370217774592,2020-11,7869.29,6778.52,7651.64,7751.01,991.4,-19276.98
2497927370217774592,2020-12,3340.76,4665.39,2813.23,1634.89,-146.29,-19423.27
2498045472837332992,2020-01,2219.82,3340.53,3863.06,0,2742.35,2742.35
2498045472837332992,2020-02,1840.38,2440.61,0,1847.97,-2448.2,294.15
2498045472837332992,2020-03,1535.35,0,0,2378.95,-843.6,-549.45
2498045472837332992,2020-04,1154.97,0,432.64,2840.07,-1252.46,-1801.91
2498045472837332992,2020-05,992.83,608.65,770.77,0,1154.95,-646.96
2498045472837332992,2020-06,759.71,0,0,3308.59,-2548.88,-3195.84
2498045472837332992,2020-07,1037.99,0,0,228.37,809.62,-2386.22
2498045472837332992,2020-08,259.85,717.82,0,332.92,-790.89,-3177.11
2498045472837332992,2020-09,758.91,392.63,0,0,366.28,-2810.83
2498045472837332992,2020-10,3431.87,3647.05,427.47,0,212.29,-2598.54
2498045472837332992,2020-11,374.81,0,0,0,374.81,-2223.73
2498045472837332992,2020-12,5464.89,2617.13,0,1850.73,997.03,-1226.7
2498256617742617088,2020-01,1522.13,0,3228.25,1007.4,3742.98,3742.98
2498256617742617088,2020-02,1072.76,0,0,0,1072.76,4815.74
2498256617742617088,2020-03,1470.28,3564.22,426.23,1512.23,-3179.94,1635.8
2498256617742617088,2020-04,547.06,152.23,286.99,1039.98,-358.16,1277.64
2498256617742617088,2020-05,0,5062.63,1852.39,2678.46,-5888.7,-4611.06
2498256617742617088,2020-06,0,1286.78,0,0,-1286.78,-5897.84
2498256617742617088,2020-07,3312.5,1821.99,3017.35,1480.23,3027.63,-2870.21
2498256617742617088,2020-08,0,1654.49,81.13,659.81,-2233.17,-5103.38
2498256617742617088,2020-09,179.62,3821.22,2392.48,1936.56,-3185.68,-8289.06
2498256617742617088,2020-10,1897.91,344.83,4751.35,6370.13,-65.7,-8354.76
2498256617742617088,2020-11,0,1894.22,1966.22,2124.98,-2052.98,-10407.74
2498256617742617088,2020-12,1301,4524.54,0,0,-3223.54,-13631.28
2499438733042070016,2020-01,6696.84,2785.12,3601.38,1633.86,5879.24,5879.24
2499438733042070016,2020-02,3226.96,3190.13,4676.86,858.8,3854.89,9734.13
2499438733042070016,2020-03,3952.67,2627.03,1988.29,1300.79,2013.14,11747.27
2499438733042070016,2020-04,3989.54,3135.36,0,3987.71,-3133.53,8613.74
2499438733042070016,2020-05,4207.11,3190.26,2684.65,1651.2,2050.3,10664.04
2499438733042070016,2020-06,0,4315.64,10739.43,3694.06,2729.73,13393.77
2499438733042070016,2020-07,578.73,3527.33,2691.53,2772.99,-3030.06,10363.71
2499438733042070016,2020-08,4474.93,4718.23,3740.65,3282.43,214.92,10578.63
2499438733042070016,2020-09,7374.94,2815.67,3764.91,3782.82,4541.36,15119.99
2499438733042070016,2020-10,6182.1,1878.1,928.56,2795.64,2436.92,17556.91
2499438733042070016,2020-11,4230.54,4420.55,1888.86,4314.4,-2615.55,14941.36
2499438733042070016,2020-12,2282.83,5835.6,5909.42,843.06,1513.59,16454.95
2502213148701882368,2020-01,4153.89,5497.36,9057.82,3834.48,3879.87,3879.87
2502213148701882368,2020-02,7616.49,3496.09,995.34,8324.69,-3208.95,670.92
2502213148701882368,2020-03,1592.41,3723.93,2237.05,5766.06,-5660.53,-4989.61
2502213148701882368,2020-04,3582.68,4503.63,8023.3,8272.27,-1169.92,-6159.53
2502213148701882368,2020-05,2292.82,4905.83,5472.95,10194.41,-7334.47,-13494
2502213148701882368,2020-06,1057.81,3706.76,1981.12,3737.64,-4405.47,-17899.47
2502213148701882368,2020-07,11456.46,3623.37,4997.63,4071.07,8759.65,-9139.82
2502213148701882368,2020-08,6891.44,2592.2,6198.67,8404.47,2093.44,-7046.38
2502213148701882368,2020-09,3048.68,2500.26,3402.06,4662.13,-711.65,-7758.03
2502213148701882368,2020-10,2545.76,778.67,4160.77,3665.88,2261.98,-5496.05
2502213148701882368,2020-11,4610.31,3786.87,5090.09,5927.54,-14.01,-5510.06
2502213148701882368,2020-12,5648.12,7560.77,2359.77,3635.84,-3188.72,-8698.78
2503059792963657216,2020-01,1646.38,0,3208.63,3990.67,864.34,864.34
2503059792963657216,2020-02,2758.43,99.95,2881.41,2982,2557.89,3422.23
2503059792963657216,2020-03,1828.67,1963.6,798.26,3930.51,-3267.18,155.05
2503059792963657216,2020-04,1243.53,3162.28,1480.97,2987.41,-3425.19,-3270.14
2503059792963657216,2020-05,3857.09,0,4115.71,1546.52,6426.28,3156.14
2503059792963657216,2020-06,1294.99,2528.51,1512.61,645.99,-366.9,2789.24
2503059792963657216,2020-07,3847.2,3965.37,5389.45,2391.76,2879.52,5668.76
2503059792963657216,2020-08,2951.04,0,3165.99,2881.81,3235.22,8903.98
2503059792963657216,2020-09,0,2192.15,1918.68,2301.98,-2575.45,6328.53
2503059792963657216,2020-10,1761.46,3805.18,3168.9,2011.65,-886.47,5442.06
2503059792963657216,2020-11,1625.68,1786.15,0,0,-160.47,5281.59
2503059792963657216,2020-12,1820.18,4264.97,2573.62,2585.93,-2457.1,2824.49
2505040563256064512,2020-01,1575.57,0,687.72,1903.88,359.41,359.41
2505040563256064512,2020-02,3328.68,778.83,2817.95,174.78,5193.02,5552.43
2505040563256064512,2020-03,1877.56,3523.23,7414.69,5915.15,-146.13,5406.3
2505040563256064512,2020-04,876.17,3112.78,2249.76,3192.71,-3179.56,2226.74
2505040563256064512,2020-05,972.93,2618.38,0,4374.59,-6020.04,-3793.3
2505040563256064512,2020-06,3391.16,759.47,1550.09,2852.18,1329.6,-2463.7
2505040563256064512,2020-07,1680.25,3258.98,1330.28,2855.42,-3103.87,-5567.57
2505040563256064512,2020-08,3793.73,4589.86,4036.4,2664.58,575.69,-4991.88
2505040563256064512,2020-09,0,4272.48,2728.78,0,-1543.7,-6535.58
2505040563256064512,2020-10,5846.46,1270.89,2855.57,1321.73,6109.41,-426.17
2505040563256064512,2020-11,1111.54,1737.84,3074.05,2886.78,-439.03,-865.2
2505040563256064512,2020-12,1900.12,1038.79,2801.97,0,3663.3,2798.1
2505071035958950912,2020-01,9089.44,4738.3,9517.71,1876.79,11992.06,11992.06
2505071035958950912,2020-02,5653.32,1210.06,0,0,4443.26,16435.32
2505071035958950912,2020-03,3725.46,1665.75,956.66,2335.8,680.57,17115.89
2505071035958950912,2020-04,1121.68,1111.77,859.77,4018.12,-3148.44,13967.45
2505071035958950912,2020-05,1819.44,761.51,0,4063.1,-3005.17,10962.28
2505071035958950912,2020-06,5067.82,1334.88,5223.47,151.92,8804.49,19766.77
2505071035958950912,2020-07,1984.06,3568.44,1572.51,2113.46,-2125.33,17641.44
2505071035958950912,2020-08,2404.01,3631.68,2768.71,1051.51,489.53,18130.97
2505071035958950912,2020-09,2784.71,3119.84,2961.62,370.57,2255.92,20386.89
2505071035958950912,2020-10,2107.67,3454.45,484.78,870.19,-1732.19,18654.7
2505071035958950912,2020-11,325.27,6644.8,2959.22,5677.73,-9038.04,9616.66
2505071035958950912,2020-12,1318.8,0,7799.67,1849.16,7269.31,16885.97
2508123703158604800,2020-01,5527.3,3153.96,5926.19,4865.35,3434.18,3434.18
2508123703158604800,2020-02,2797.98,4665.69,1179.01,6992.01,-7680.71,-4246.53
2508123703158604800,2020-03,2180.63,1869,4437.8,4631.36,118.07,-4128.46
2508123703158604800,2020-04,6205.37,6998.7,1590.17,3974.32,-3177.48,-7305.94
2508123703158604800,2020-05,3206.64,5279.93,1416.56,0,-656.73,-7962.67
2508123703158604800,2020-06,1816.59,4311.05,1049.88,2344.87,-3789.45,-11752.12
2508123703158604800,2020-07,3201.31,3182.41,4400.28,3136.65,1282.53,-10469.59
2508123703158604800,2020-08,790.79,3827.45,1841.53,6771.86,-7966.99,-18436.58
2508123703158604800,2020-09,4368.12,5504.69,3683.22,2425.32,121.33,-18315.25
2508123703158604800,2020-10,3427.06,1641.66,637.01,8434.82,-6012.41,-24327.66
2508123703158604800,2020-11,2789.72,3418.13,3321.98,1421.16,1272.41,-23055.25
2508123703158604800,2020-12,1444.62,3220.83,3673.71,4954.3,-3056.8,-26112.05
2508177670293161472,2020-01,1957.49,0,1446.46,0,3403.95,3403.95
2508177670293161472,2020-03,0,1356.83,0,0,-1356.83,2047.12
2508177670293161472,2020-04,212.02,0,0,0,212.02,2259.14
2508177670293161472,2020-06,1186.19,1803.55,1677.09,0,1059.73,3318.87
2508177670293161472,2020-07,0,1489.3,0,1836.62,-3325.92,-7.05
2508177670293161472,2020-08,0,413.83,0,0,-413.83,-420.88
2508177670293161472,2020-09,439.1,3113.73,1162.29,3185.61,-4697.95,-5118.83
2508177670293161472,2020-10,1403.74,486.46,0,599.1,318.18,-4800.65
2508177670293161472,2020-11,0,2177.64,1918.89,0,-258.75,-5059.4
2508177670293161472,2020-12,0,2505.49,0,523.06,-3028.55,-8087.95
2508452975988294656,2020-01,1195.41,0,989.13,1502.8,681.74,681.74
2508452975988294656,2020-02,253.37,0,2632.96,0,2886.33,3568.07
2508452975988294656,2020-03,0,1985,0,0,-1985,1583.07
2508452975988294656,2020-06,0,1874.58,342.46,0,-1532.12,50.95
2508452975988294656,2020-09,1728.77,0,1990.93,0,3719.7,3770.65
2508452975988294656,2020-11,0,2244.95,155.7,1963.24,-4052.49,-281.84
2508452975988294656,2020-12,1441.06,0,0,0,1441.06,1159.22
2509044017768216064,2020-01,3098.69,4270.24,4436.35,538.36,2726.44,2726.44
2509044017768216064,2020-02,7081.59,4861.26,3243.89,2388.45,3075.77,5802.21
2509044017768216064,2020-03,2214.44,5219.83,1232.95,6004.55,-7776.99,-1974.78
2509044017768216064,2020-04,7879.41,1642.19,1706.1,5908.41,2034.91,60.13
2509044017768216064,2020-05,1287.77,1830.33,4015.83,4339.45,-866.18,-806.05
2509044017768216064,2020-06,3384.91,5015.44,6935.4,6110.13,-805.26,-1611.31
2509044017768216064,2020-07,8928.07,7533.06,2042.65,3432.4,5.26,-1606.05
2509044017768216064,2020-08,4876.64,5446.98,6405.67,5789.71,45.62,-1560.43
2509044017768216064,2020-09,7200.4,2680.02,7204.05,2676.33,9048.1,7487.67
2509044017768216064,2020-10,13136.11,3931.53,6132.29,2916.95,12419.92,19907.59
2509044017768216064,2020-11,3918.47,1251.02,3194.21,7545.77,-1684.11,18223.48
2509044017768216064,2020-12,937.58,3355.92,1156.85,6226.89,-7488.38,10735.1
2509625348641090560,2020-01,569.13,296,933.67,1992.06,-785.26,-785.26
2509625348641090560,2020-02,2875.36,1529.88,1322.36,0,2667.84,1882.58
2509625348641090560,2020-05,0,501.59,661.99,600.97,-440.57,1442.01
2509625348641090560,2020-06,64.37,1869.03,0,0,-1804.66,-362.65
2509625348641090560,2020-07,2149.84,0,459.05,715.56,1893.33,1530.68
2509625348641090560,2020-08,103.74,1267.87,3553.36,0,2389.23,3919.91
2509625348641090560,2020-09,1493.6,0,0,0,1493.6,5413.51
2509625348641090560,2020-10,26.75,1238.38,1487.35,548.55,-272.83,5140.68
2512295669710043648,2020-01,4291.59,1660.47,0,1626.41,1004.71,1004.71
2512295669710043648,2020-02,6975.02,1481.32,3491.83,2828.43,6157.1,7161.81
2512295669710043648,2020-03,1112.05,3629.04,4078.08,3490.06,-1928.97,5232.84
2512295669710043648,2020-04,3891.94,2875.05,2126.51,2081.1,1062.3,6295.14
2512295669710043648,2020-05,2058.55,4823.08,1035.23,0,-1729.3,4565.84
2512295669710043648,2020-06,0,3676.81,1850.31,1243.82,-3070.32,1495.52
2512295669710043648,2020-07,2265.94,1692.2,2388.15,4021.54,-1059.65,435.87
2512295669710043648,2020-09,361.42,2178.92,169.64,5483.82,-7131.68,-6695.81
2512295669710043648,2020-10,5002.01,2572.62,4514.11,0,6943.5,247.69
2512295669710043648,2020-11,3467.53,6197.27,2479.33,3117.95,-3368.36,-3120.67
2512295669710043648,2020-12,5795.11,2742.38,2213.25,2035.83,3230.15,109.48
2512424601511661568,2020-01,3775.68,12835.4,2913.79,2708.42,-8854.35,-8854.35
2512424601511661568,2020-02,6316.3,6177.42,5069.95,1203.26,4005.57,-4848.78
2512424601511661568,2020-03,2539.65,3175.86,1650.17,6538.14,-5524.18,-10372.96
2512424601511661568,2020-04,5106.33,2723.94,1595.43,729.87,3247.95,-7125.01
2512424601511661568,2020-05,1613.88,5945.22,67.33,5002.85,-9266.86,-16391.87
2512424601511661568,2020-06,8092.35,7456.81,1512.7,447.81,1700.43,-14691.44
2512424601511661568,2020-07,5033.55,889.76,2879.5,3541.86,3481.43,-11210.01
2512424601511661568,2020-08,3771.47,1749.12,4198.57,2381.13,3839.79,-7370.22
2512424601511661568,2020-09,501.9,1466.04,1693.13,1304.87,-575.88,-7946.1
2512424601511661568,2020-10,2244.56,1544.53,3166.97,2119.77,1747.23,-6198.87
2512424601511661568,2020-11,8624.36,436.29,4842.15,4552.22,8478,2279.13
2512424601511661568,2020-12,4732.82,1828.2,5169.75,5847.65,2226.72,4505.85
2512523023886599680,2020-01,0,8886.51,2505.08,884.24,-7265.67,-7265.67
2512523023886599680,2020-02,763.93,1324.92,1683.66,3057.48,-1934.81,-9200.48
2512523023886599680,2020-03,2161.98,2319.56,0,2386.38,-2543.96,-11744.44
2512523023886599680,2020-04,2807.86,3130.95,5486.28,4939.29,223.9,-11520.54
2512523023886599680,2020-05,359.67,0,0,1127.32,-767.65,-12288.19
2512523023886599680,2020-06,1962.75,0,1759.04,0,3721.79,-8566.4
2512523023886599680,2020-07,3424.27,2445.69,2005.97,7374.49,-4389.94,-12956.34
2512523023886599680,2020-09,1704.49,943.34,615.66,1303.08,73.73,-12882.61
2512523023886599680,2020-10,1992.24,748.48,2437.33,1971.39,1709.7,-11172.91
2512523023886599680,2020-11,2437.54,3414.14,1294.82,3913.09,-3594.87,-14767.78
2512523023886599680,2020-12,5628.21,0,753.97,1217.3,5164.88,-9602.9
2512689003952169984,2020-01,5641.55,5624.89,4149.67,5121.35,-955.02,-955.02
2512689003952169984,2020-02,5450.96,4182.8,5385.34,1628.97,5024.53,4069.51
2512689003952169984,2020-03,524.96,999.34,4900.26,7824.86,-3398.98,670.53
2512689003952169984,2020-04,4384.97,4669.5,0,6675.49,-6960.02,-6289.49
2512689003952169984,2020-05,3851.99,7083.1,1296.97,2620.13,-4554.27,-10843.76
2512689003952169984,2020-06,7082.73,379.96,6124.55,3772.68,9054.64,-1789.12
2512689003952169984,2020-07,1268.97,2101.49,3408.23,5028.63,-2452.92,-4242.04
2512689003952169984,2020-08,4328.33,0,6129.43,4080.26,6377.5,2135.46
2512689003952169984,2020-09,5282.63,5118.7,8776.6,5020.63,3919.9,6055.36
2512689003952169984,2020-10,1568.89,6924.42,4011.73,2380.98,-3724.78,2330.58
2512689003952169984,2020-11,550.47,3731.44,2185.52,4701.5,-5696.95,-3366.37
2512689003952169984,2020-12,2051.31,2199.89,772.46,2677.42,-2053.54,-5419.91
2514662167952148480,2020-01,309.26,0,119.5,2233.08,-1804.32,-1804.32
2514662167952148480,2020-02,0,2665.42,3689.05,987.28,36.35,-1767.97
2514662167952148480,2020-03,1701.85,2431.82,1023.89,1927.39,-1633.47,-3401.44
2514662167952148480,2020-06,0,1666.42,2713.51,3059.37,-2012.28,-5413.72
2514662167952148480,2020-07,0,273.09,3813.63,0,3540.54,-1873.18
2514662167952148480,2020-08,264.34,735.2,0,1975.63,-2446.49,-4319.67
2514662167952148480,2020-09,0,1005.14,129.25,0,-875.89,-5195.56
2514662167952148480,2020-10,983.29,0,747.94,0,1731.23,-3464.33
2514662167952148480,2020-11,1186.34,5350.99,1521.3,0,-2643.35,-6107.68
2514662167952148480,2020-12,4460.12,0,0,0,4460.12,-1647.56
2518140210842141696,2020-01,3070.73,0,0,850.03,2220.7,2220.7
2518140210842141696,2020-02,0,111.99,0,215.62,-327.61,1893.09
2518140210842141696,2020-03,0,3422.5,0,0,-3422.5,-1529.41
2518140210842141696,2020-04,1390.31,0,1169.11,0,2559.42,1030.01
2518140210842141696,2020-05,0,1037.61,278,0,-759.61,270.4
2518140210842141696,2020-06,1777.65,156.89,0,1758.69,-137.93,132.47
2518140210842141696,2020-07,2525.12,0,0,0,2525.12,2657.59
2518140210842141696,2020-08,957.43,0,0,879.81,77.62,2735.21
2518140210842141696,2020-09,584.87,0,0,0,584.87,3320.08
2518140210842141696,2020-11,0,462.64,0,0,-462.64,2857.44
2518140210842141696,2020-12,0,900.08,135.7,2949.35,-3713.73,-856.29
2520475293467082240,2020-01,491.84,3688.57,1860.89,6846.31,-8182.15,-8182.15
2520475293467082240,2020-02,3067.59,2055.6,5557,5420.26,1148.73,-7033.42
2520475293467082240,2020-03,2429.06,3919.66,4378.09,8396.59,-5509.1,-12542.52
2520475293467082240,2020-04,2753.01,4313.76,4097,827.92,1708.33,-10834.19
2520475293467082240,2020-05,7015.19,1922.48,3471.64,3172.55,5391.8,-5442.39
2520475293467082240,2020-06,1284.77,2202.47,1033.56,4400.65,-4284.79,-9727.18
2520475293467082240,2020-07,6798.64,4722.36,1522.71,2492.36,1106.63,-8620.55
2520475293467082240,2020-08,6068.87,3056.39,1656.52,5761,-1092,-9712.55
2520475293467082240,2020-09,1325.26,3408.36,6094.92,3928.08,83.74,-9628.81
2520475293467082240,2020-10,9475.33,7499.71,1832.6,3455.01,353.21,-9275.6
2520475293467082240,2020-11,5528.48,3640.76,2818.77,4979.81,-273.32,-9548.92
2520475293467082240,2020-12,3603.93,1756.71,5080.91,2176.06,4752.07,-4796.85
2521077763586844672,2020-01,4163.93,1559.81,9696.83,6243.13,6057.82,6057.82
2521077763586844672,2020-02,5981.29,6900.14,2251.94,4540.03,-3206.94,2850.88
2521077763586844672,2020-03,812.23,2167.47,4392.27,8540.35,-5503.32,-2652.44
2521077763586844672,2020-04,3173.55,0,4475.77,9941.77,-2292.45,-4944.89
2521077763586844672,2020-05,9333.2,2529.62,3798.03,5100.31,5501.3,556.41
2521077763586844672,2020-06,3221.17,3569.36,2086.25,2708.2,-970.14,-413.73
2521077763586844672,2020-07,1567.88,2313.48,4401.65,3275.04,381.01,-32.72
2521077763586844672,2020-08,4755.4,5235.88,3849.77,5910.16,-2540.87,-2573.59
2521077763586844672,2020-09,5676.18,3001.84,3622.09,835.01,5461.42,2887.83
2521077763586844672,2020-10,4156.5,5666.18,2112.15,6855.2,-6252.73,-3364.9
2521077763586844672,2020-11,1077.09,3672.53,2978.94,5176.89,-4793.39,-8158.29
2521077763586844672,2020-12,8760.42,7576.36,1899.21,7146.4,-4063.13,-12221.42
2521372665041312256,2020-01,2962.68,1635.58,2488.11,5176.33,-1361.12,-1361.12
2521372665041312256,2020-02,2145.35,4439.02,5687.38,1450.6,1943.11,581.99
2521372665041312256,2020-03,1840.16,2311.06,3119.4,2685.19,-36.69,545.3
2521372665041312256,2020-04,4426.03,1646.04,4744.71,7338,186.7,732
2521372665041312256,2020-05,3813.22,5415.36,2329.61,621.91,105.56,837.56
2521372665041312256,2020-06,3550.26,2257.62,3186.84,2831.16,1648.32,2485.88
2521372665041312256,2020-07,3869.37,3220.7,2394.66,4091.87,-1048.54,1437.34
2521372665041312256,2020-08,2303.03,2473.07,2528.71,5908.95,-3550.28,-2112.94
2521372665041312256,2020-09,5517.61,3959.52,362.97,1145.51,775.55,-1337.39
2521372665041312256,2020-10,4797.9,1118.12,2248.51,1176.23,4752.06,3414.67
2521372665041312256,2020-11,3222.74,2609.58,2834.91,2957.17,490.9,3905.57
2521372665041312256,2020-12,2954.89,5496.86,97.95,6072.15,-8516.17,-4610.6
2522306679096314880,2020-01,2926.74,3640.49,523.66,3912.29,-4102.38,-4102.38
2522306679096314880,2020-02,2639.21,2718.37,5076.41,3874.85,1122.4,-2979.98
2522306679096314880,2020-03,5480.84,7208.49,3469.97,1481.23,261.09,-2718.89
2522306679096314880,2020-04,7909.57,4127.3,166.83,2031.08,1918.02,-800.87
2522306679096314880,2020-05,6250.36,2224.4,2750.2,3392.28,3383.88,2583.01
2522306679096314880,2020-06,0,5756.34,2569.8,4388.95,-7575.49,-4992.48
2522306679096314880,2020-07,2864.76,6998.6,5023.62,4834.31,-3944.53,-8937.01
2522306679096314880,2020-08,10615.96,4906.44,1185.38,11312.67,-4417.77,-13354.78
2522306679096314880,2020-09,8213.6,4289.47,7131.97,3282.66,7773.44,-5581.34
2522306679096314880,2020-10,7489.19,5185.38,7342.1,2785.99,6859.92,1278.58
2522306679096314880,2020-11,1028.98,4203.18,7753.58,3641.37,938.01,2216.59
2522306679096314880,2020-12,2740.26,1356.29,2312.39,4940.17,-1243.81,972.78
2525992995438121472,2020-01,604.63,2723.62,288.14,1962.06,-3792.91,-3792.91
2525992995438121472,2020-02,0,1213.62,2455.87,3014.37,-1772.12,-5565.03
2525992995438121472,2020-03,2202.34,1713.67,169.19,0,657.86,-4907.17
2525992995438121472,2020-04,1446.75,379.54,1699.73,1526.33,1240.61,-3666.56
2525992995438121472,2020-05,2905.25,0,1737.28,241.48,4401.05,734.49
2525992995438121472,2020-06,1268.14,1913.83,0,665.16,-1310.85,-576.36
2525992995438121472,2020-07,1059.89,523.01,2924.74,0,3461.62,2885.26
2525992995438121472,2020-09,1777.13,1102.87,1308.11,0,1982.37,4867.63
2525992995438121472,2020-11,2305.05,516.04,298.32,1181.63,905.7,5773.33
2525992995438121472,2020-12,0,37.21,1434.19,1128.9,268.08,6041.41
2526734408635340288,2020-01,1542.9,3170.46,0,0,-1627.56,-1627.56
2526734408635340288,2020-02,0,1661.73,0,595.57,-2257.3,-3884.86
2526734408635340288,2020-04,0,55.12,0,0,-55.12,-3939.98
2526734408635340288,2020-06,1494.96,1216.03,0,0,278.93,-3661.05
2526734408635340288,2020-10,0,992.73,0,0,-992.73,-4653.78
2526734408635340288,2020-11,0,1676.07,0,0,-1676.07,-6329.85
2529502073160810496,2020-01,2069.5,4419.25,0,876.98,-3226.73,-3226.73
2529502073160810496,2020-02,0,728.72,1365.78,0,637.06,-2589.67
2529502073160810496,2020-03,776.93,1203.5,2197.28,2151.83,-381.12,-2970.79
2529502073160810496,2020-04,1005.53,0,3394.18,0,4399.71,1428.92
2529502073160810496,2020-05,1746.13,0,600.99,263.79,2083.33,3512.25
2529502073160810496,2020-06,2153.04,929.17,0,0,1223.87,4736.12
2529502073160810496,2020-07,1624.04,1477.71,0,0,146.33,4882.45
2529502073160810496,2020-08,1679.2,0,140.33,0,1819.53,6701.98
2529502073160810496,2020-10,1860.34,1105.54,158.56,0,913.36,7615.34
2530309509177738752,2020-01,7419.02,0,1289.58,4714.43,3994.17,3994.17
2530309509177738752,2020-02,847.03,0,6010.1,1234.52,5622.61,9616.78
2530309509177738752,2020-03,1653.65,833.08,0,2026.77,-1206.2,8410.58
2530309509177738752,2020-04,1970.26,2006.93,1591.42,49.93,1504.82,9915.4
2530309509177738752,2020-05,1490.17,201.28,3418.59,4303.24,404.24,10319.64
2530309509177738752,2020-06,4076.99,1353.02,5087.31,376.31,7434.97,17754.61
2530309509177738752,2020-07,1839.26,3265.28,6924.3,1702.75,3795.53,21550.14
2530309509177738752,2020-08,2062.1,4964.91,3057.56,3524.2,-3369.45,18180.69
2530309509177738752,2020-09,4427.52,5236.28,2099.51,4721.06,-3430.31,14750.38
2530309509177738752,2020-10,7773.94,4559.77,2424,1187.51,4450.66,19201.04
2530309509177738752,2020-11,1646.19,3285.08,300.49,0,-1338.4,17862.64
2530309509177738752,2020-12,926.92,2894.37,1961.43,2503.13,-2509.15,15353.49
2532237085204018176,2020-01,3450.59,0,1360.4,2907.68,1903.31,1903.31
2532237085204018176,2020-02,1573.33,2581.52,988.52,3635.03,-3654.7,-1751.39
2532237085204018176,2020-03,2664.36,183.61,0,1459.11,1021.64,-729.75
2532237085204018176,2020-05,1938.92,1035.56,4011.47,5005.13,-90.3,-820.05
2532237085204018176,2020-06,1894.8,1685.31,3727.85,228.66,3708.68,2888.63
2532237085204018176,2020-07,0,2633.88,0,0,-2633.88,254.75
2532237085204018176,2020-08,1187.69,745.72,2187.58,1866.53,763.02,1017.77
2532237085204018176,2020-09,2185.41,2253.83,0,0,-68.42,949.35
2532237085204018176,2020-10,1701.96,0,1320.93,5450.17,-2427.28,-1477.93
2532237085204018176,2020-11,281.93,912.98,2385.32,162.49,1591.78,113.85
2532237085204018176,2020-12,5342.04,515.97,2844.4,1703.87,5966.6,6080.45
2532493380479925760,2020-01,3010.4,11428.95,6450.18,6720,-8688.37,-8688.37
2532493380479925760,2020-02,1865.59,4857.54,2595.29,6296.3,-6692.96,-15381.33
2532493380479925760,2020-03,4569.77,8088.5,10067.45,3451.72,3097,-12284.33
2532493380479925760,2020-04,3128.6,9720.96,3338.87,574.51,-3828,-16112.33
2532493380479925760,2020-05,6748.9,6389.38,2751.56,6055.5,-2944.42,-19056.75
2532493380479925760,2020-06,2436.53,5720.92,2417.58,1424.68,-2291.49,-21348.24
2532493380479925760,2020-07,5848.05,5135.19,3687.11,1788.11,2611.86,-18736.38
2532493380479925760,2020-08,3011.82,7877.18,2523.5,5540.71,-7882.57,-26618.95
2532493380479925760,2020-09,5098.77,1699.39,1551.85,4081.5,869.73,-25749.22
2532493380479925760,2020-10,3857.5,1529.88,1790.78,1990.01,2128.39,-23620.83
2532493380479925760,2020-11,3353.31,2764.65,1794.47,3160.42,-777.29,-24398.12
2532493380479925760,2020-12,3662.08,3411.19,4679.99,1716.74,3214.14,-21183.98
2533002906288659968,2020-01,4551.65,1757.87,6884.48,3298,6380.26,6380.26
2533002906288659968,2020-02,5266.51,904.01,4330.5,3352.48,5340.52,11720.78
2533002906288659968,2020-03,7622.51,3014.06,3189.03,3407.8,4389.68,16110.46
2533002906288659968,2020-04,4438.92,7039.25,4858.51,1238.46,1019.72,17130.18
2533002906288659968,2020-05,2821.76,2697.34,3179.97,6576.87,-3272.48,13857.7
2533002906288659968,2020-06,3830.05,1503.88,2456.77,6231.76,-1448.82,12408.88
2533002906288659968,2020-07,618.84,3925.87,5921.73,3875.01,-1260.31,11148.57
2533002906288659968,2020-08,4484.33,6470.79,2005.63,1824.68,-1805.51,9343.06
2533002906288659968,2020-09,3685.04,610.05,974.45,2524.65,1524.79,10867.85
2533002906288659968,2020-10,4279.83,10835.74,3947.4,574.21,-3182.72,7685.13
2533002906288659968,2020-11,5085.32,3868.41,409.11,2243.41,-617.39,7067.74
2533002906288659968,2020-12,1338.77,1352.51,3835.21,3544.29,277.18,7344.92
2533407761803280896,2020-01,8048.85,7443.35,1564.03,7965.2,-5795.67,-5795.67
2533407761803280896,2020-02,8635.52,7393.66,2056.14,3841.86,-543.86,-6339.53
2533407761803280896,2020-03,3617.98,2719.91,6792.2,4974.58,2715.69,-3623.84
2533407761803280896,2020-04,2947.56,4367.99,6805.24,4342.57,1042.24,-2581.6
2533407761803280896,2020-05,923.68,3492.68,4956.56,2900.9,-513.34,-3094.94
2533407761803280896,2020-06,2190.33,2183.52,6143.28,7271.79,-1121.7,-4216.64
2533407761803280896,2020-07,9003.82,2158.67,1966.7,3698.87,5112.98,896.34
2533407761803280896,2020-08,2839.38,4480.79,5073.96,5146.9,-1714.35,-818.01
2533407761803280896,2020-09,2720.08,1772.71,2161.06,5000.9,-1892.47,-2710.48
2533407761803280896,2020-10,4381.72,6918.87,1816.68,4602.66,-5323.13,-8033.61
2533407761803280896,2020-11,3824.8,3833.55,2486.51,6393.28,-3915.52,-11949.13
2533407761803280896,2020-12,7541.44,4189.89,6147.47,3723.3,5775.72,-6173.41
2533591798107540992,2020-01,2310.18,7132.97,4342.21,7407.93,-7888.51,-7888.51
2533591798107540992,2020-02,10231.68,1810.57,5662.67,3062,11021.78,3133.27
2533591798107540992,2020-03,8682.51,8499.07,2822.09,1131.42,1874.11,5007.38
2533591798107540992,2020-04,5599.9,4929.83,3992.52,1626.95,3035.64,8043.02
2533591798107540992,2020-05,335.63,3401.41,6093.96,9250.51,-6222.33,1820.69
2533591798107540992,2020-06,6063.11,3597.27,5432.77,1756.09,6142.52,7963.21
2533591798107540992,2020-07,3027.36,4033.19,7493.16,5215.38,1271.95,9235.16
2533591798107540992,2020-08,586.91,4284.61,5494.91,7742.11,-5944.9,3290.26
2533591798107540992,2020-09,5116.66,3006.43,2244.36,3570.84,783.75,4074.01
2533591798107540992,2020-10,5094.75,11811.54,5300.32,4584.25,-6000.72,-1926.71
2533591798107540992,2020-11,5603.7,8495.06,2498.62,6663.79,-7056.53,-8983.24
2533591798107540992,2020-12,3147.91,4871,4924.59,45.98,3155.52,-5827.72
2536372921345161728,2020-01,5002.18,2976.51,2812.22,6881.68,-2043.79,-2043.79
2536372921345161728,2020-02,2654.87,2049.27,5557.76,5801.72,361.64,-1682.15
2536372921345161728,2020-03,6054.5,1328.46,3605.41,6404.7,1926.75,244.6
2536372921345161728,2020-04,0,1384.69,377.86,2696.92,-3703.75,-3459.15
2536372921345161728,2020-05,8185.83,567.01,5137.83,4691.93,8064.72,4605.57
2536372921345161728,2020-06,4736.94,112.86,3882.24,9262.41,-756.09,3849.48
2536372921345161728,2020-07,3101.1,1405.64,1544.12,3745.44,-505.86,3343.62
2536372921345161728,2020-08,134.29,3684.75,4988.88,3911,-2472.58,871.04
2536372921345161728,2020-09,3912.97,4422.81,1617.18,2872.96,-1765.62,-894.58
2536372921345161728,2020-10,3122.98,4380.35,6036.2,6963.08,-2184.25,-3078.83
2536372921345161728,2020-11,7896.25,2808.1,8100.85,1250.89,11938.11,8859.28
2536372921345161728,2020-12,4857.69,3614.94,3096.97,5841.39,-1501.67,7357.61
2536604708106940416,2020-01,6381.7,3530.49,4300.22,4372.26,2779.17,2779.17
2536604708106940416,2020-02,4482.5,4636.6,3452.83,3149.41,149.32,2928.49
2536604708106940416,2020-03,5753.56,1642.9,8529.75,3452.56,9187.85,12116.34
2536604708106940416,2020-04,5959.08,11739.77,4321.41,3161.55,-4620.83,7495.51
2536604708106940416,2020-05,4397.29,1084.76,5204.18,1823.2,6693.51,14189.02
2536604708106940416,2020-06,0,2963.34,5781.95,3941.94,-1123.33,13065.69
2536604708106940416,2020-07,4113.55,4306.98,2822.64,6231.61,-3602.4,9463.29
2536604708106940416,2020-08,4747.06,1502.24,3131.5,3535.94,2840.38,12303.67
2536604708106940416,2020-09,4424.43,10335.8,5395.48,6538.68,-7054.57,5249.1
2536604708106940416,2020-10,5663.99,2403.41,5371.39,5364.74,3267.23,8516.33
2536604708106940416,2020-11,0,9766.22,0,7307.55,-17073.77,-8557.44
2536604708106940416,2020-12,2564.42,1855.03,6652.82,3122.27,4239.94,-4317.5
2539326553507295232,2020-01,3898.68,1025.56,5273.53,5427.85,2718.8,2718.8
2539326553507295232,2020-02,1796.96,526.85,4064.82,7201.78,-1866.85,851.95
2539326553507295232,2020-03,3124.2,2249.79,2472.3,2221.9,1124.81,1976.76
2539326553507295232,2020-04,0,5155.87,4395.07,4283.02,-5043.82,-3067.06
2539326553507295232,2020-05,505.18,0,5194.74,4820.51,879.41,-2187.65
2539326553507295232,2020-06,3433.41,5880.32,1808.93,4108.42,-4746.4,-6934.05
2539326553507295232,2020-07,2818.08,3767.68,2281.43,4457.29,-3125.46,-10059.51
2539326553507295232,2020-08,1920.95,1810.5,2977.4,607.8,2480.05,-7579.46
2539326553507295232,2020-09,3971.68,0,439.56,9813.11,-5401.87,-12981.33
2539326553507295232,2020-10,6916.63,9298.19,717.13,2615.35,-4279.78,-17261.11
2539326553507295232,2020-11,2972.98,2612.87,3116.69,1446.42,2030.38,-15230.73
2539326553507295232,2020-12,1350.63,2276.28,5749.92,2190.96,2633.31,-12597.42
2539458545614439424,2020-01,1112.68,2141.93,4032.36,3356.09,-352.98,-352.98
2539458545614439424,2020-02,7607.58,2659.32,2494.29,369.32,7073.23,6720.25
2539458545614439424,2020-03,1919.09,7910.59,4989.95,5122.2,-6123.75,596.5
2539458545614439424,2020-04,4904.57,7217.04,6211.56,3540.04,359.05,955.55
2539458545614439424,2020-05,1701.18,7867.61,1715.32,688.88,-5139.99,-4184.44
2539458545614439424,2020-06,2916.79,1944.92,1584.87,4132.11,-1575.37,-5759.81
2539458545614439424,2020-07,5597.24,2421.89,13533.17,1038.46,15670.06,9910.25
2539458545614439424,2020-08,1960.53,3508.31,3974.5,4441.71,-2014.99,7895.26
2539458545614439424,2020-09,11318.5,3516.9,351.69,6043.43,2109.86,10005.12
2539458545614439424,2020-10,2631.17,4579.36,3052.66,5039.7,-3935.23,6069.89
2539458545614439424,2020-11,4747.27,22.9,2825.7,3569.17,3980.9,10050.79
2539458545614439424,2020-12,3512.27,1131.54,2844.77,6165.49,-939.99,9110.8
2539512768612523520,2020-01,3755.09,0,9065.56,5767.75,7052.9,7052.9
2539512768612523520,2020-02,4814.6,0,1622.51,3199.22,3237.89,10290.79
2539512768612523520,2020-03,1043.12,1385.49,3113.15,4493.42,-1722.64,8568.15
2539512768612523520,2020-04,664.95,0,1307.38,1335.52,636.81,9204.96
2539512768612523520,2020-05,1376.96,4419.06,2387.44,331.53,-986.19,8218.77
2539512768612523520,2020-06,195.78,5449.27,610.15,0,-4643.34,3575.43
2539512768612523520,2020-07,0,2002.96,5958.83,2210.22,1745.65,5321.08
2539512768612523520,2020-08,2301.18,2381.49,3603.62,5881.56,-2358.25,2962.83
2539512768612523520,2020-09,1759.48,0,1796.68,1643.1,1913.06,4875.89
2539512768612523520,2020-10,1850.81,1154.5,3691.86,5626.89,-1238.72,3637.17
2539512768612523520,2020-11,1316.32,6691.28,1928.64,4215.64,-7661.96,-4024.79
2539512768612523520,2020-12,371.33,399.16,1553.11,642.85,882.43,-3142.36
2540114430441328128,2020-01,3869.15,2815.49,1818.45,1929.26,942.85,942.85
2540114430441328128,2020-02,5805.01,6678.81,2537.69,3127.2,-1463.31,-520.46
2540114430441328128,2020-03,5880.5,0,1872.15,2652.6,5100.05,4579.59
2540114430441328128,2020-04,3225.13,1421.99,5417.58,2968.07,4252.65,8832.24
2540114430441328128,2020-05,5270.57,2347.22,3235.17,1997.31,4161.21,12993.45
2540114430441328128,2020-06,5940.65,0,5291.53,7539.69,3692.49,16685.94
2540114430441328128,2020-07,1948.8,2818.84,3259.33,0,2389.29,19075.23
2540114430441328128,2020-08,469.16,1090.27,1963.46,6138.31,-4795.96,14279.27
2540114430441328128,2020-09,1787.29,4523.08,1585.98,2270.08,-3419.89,10859.38
2540114430441328128,2020-10,3275.3,8341.75,5041.89,2256.36,-2280.92,8578.46
2540114430441328128,2020-11,3560.81,3786.13,1602.64,5274.11,-3896.79,4681.67
2540114430441328128,2020-12,3985.9,9307.96,1051.37,212.01,-4482.7,198.97
2545044381531892736,2020-11,1222.15,0,0,0,1222.15,1222.15
2546899552964107776,2020-01,174.92,2326.33,1186.72,3127.79,-4092.48,-4092.48
2546899552964107776,2020-02,1490.6,1611.78,2226.47,1846.71,258.58,-3833.9
2546899552964107776,2020-03,0,148.65,1491.27,4976.94,-3634.32,-7468.22
2546899552964107776,2020-04,2010.56,2879.02,0,677.21,-1545.67,-9013.89
2546899552964107776,2020-06,256.35,193.56,0,1798.78,-1735.99,-10749.88
2546899552964107776,2020-07,160.55,1477.91,3011.45,2408.76,-714.67,-11464.55
2546899552964107776,2020-08,538.24,3488.54,4623.52,628.57,1044.65,-10419.9
2546899552964107776,2020-09,5078.47,3142.51,0,2039.51,-103.55,-10523.45
2546899552964107776,2020-10,3414.98,6318.11,2713.6,0,-189.53,-10712.98
2546899552964107776,2020-11,1365.23,4384.95,1048.14,3222.46,-5194.04,-15907.02
2546899552964107776,2020-12,2717.76,876.84,1721.85,1109.45,2453.32,-13453.7
2547370175620444672,2020-02,0,800.8,0,0,-800.8,-800.8
2548578637980212224,2020-01,1157.23,0,0,0,1157.23,1157.23
2548578637980212224,2020-03,483.85,0,0,2625.33,-2141.48,-984.25
2548578637980212224,2020-04,0,2041.8,1150.68,0,-891.12,-1875.37
2548578637980212224,2020-07,612.68,0,308.12,0,920.8,-954.57
2548578637980212224,2020-10,1540.67,0,0,1091.53,449.14,-505.43
2548578637980212224,2020-11,821.4,0,0,0,821.4,315.97
2548578637980212224,2020-12,432.42,0,0,0,432.42,748.39
2549535531111093248,2020-01,5690.56,1560.73,2887.25,2160.91,4856.17,4856.17
2549535531111093248,2020-02,1904.16,2752.44,0,4595.45,-5443.73,-587.56
2549535531111093248,2020-03,891.55,1811.13,2930.76,2692.39,-681.21,-1268.77
2549535531111093248,2020-04,3765.01,4198.47,2018.33,3588.29,-2003.42,-3272.19
2549535531111093248,2020-05,2664.34,3535.35,5680.43,3201.21,1608.21,-1663.98
2549535531111093248,2020-06,3006.28,4184.21,2092.28,4527.66,-3613.31,-5277.29
2549535531111093248,2020-07,5085.89,2763.12,2415.69,2471.81,2266.65,-3010.64
2549535531111093248,2020-08,1778.38,4335.71,3306.53,4813.4,-4064.2,-7074.84
2549535531111093248,2020-09,2801.83,7356.21,1233.43,6211.22,-9532.17,-16607.01
2549535531111093248,2020-10,1877.49,3395.1,2192.56,5495.77,-4820.82,-21427.83
2549535531111093248,2020-11,1972.95,3672.05,3200.4,3029.76,-1528.46,-22956.29
2549535531111093248,2020-12,4245.91,6562.04,4391.3,1783.05,292.12,-22664.17
2549823375783220224,2020-01,2107.3,0,0,398.42,1708.88,1708.88
2549823375783220224,2020-02,0,2044.79,4635.85,964.54,1626.52,3335.4
2549823375783220224,2020-03,3340.26,2742.4,1325.07,1881.29,41.64,3377.04
2549823375783220224,2020-04,2837.42,0,2036.41,0,4873.83,8250.87
2549823375783220224,2020-05,1282.44,2716.38,1016.25,6004.66,-6422.35,1828.52
2549823375783220224,2020-06,1698.37,2060.37,4150.96,5091.43,-1302.47,526.05
2549823375783220224,2020-07,2310.86,1390.77,1136.37,716.36,1340.1,1866.15
2549823375783220224,2020-08,1375.23,3649.58,280.03,397.78,-2392.1,-525.95
2549823375783220224,2020-09,3028.14,670.05,3095.46,2604.04,2849.51,2323.56
2549823375783220224,2020-10,3425.92,2169.54,1539.46,0,2795.84,5119.4
2549823375783220224,2020-11,3084.14,5726.93,2716.48,5224.88,-5151.19,-31.79
2549823375783220224,2020-12,3957.61,935.2,1242.45,1903.81,2361.05,2329.26
2550013300483613184,2020-01,694.39,1510.31,1031.21,1752.52,-1537.23,-1537.23
2550013300483613184,2020-02,637.27,0,1488.81,0,2126.08,588.85
2550013300483613184,2020-03,348.69,168.07,1187.72,2239.01,-870.67,-281.82
2550013300483613184,2020-04,1660.39,6269.89,4921.41,3230.62,-2918.71,-3200.53
2550013300483613184,2020-05,73.1,3177.26,2246.96,770.01,-1627.21,-4827.74
2550013300483613184,2020-06,0,2127.39,2200.76,128.43,-55.06,-4882.8
2550013300483613184,2020-07,4649.92,4305.42,3619.24,2948.54,1015.2,-3867.6
2550013300483613184,2020-08,0,497.41,5260.95,2197.21,2566.33,-1301.27
2550013300483613184,2020-09,1979.87,2087.41,2119.73,1542.45,469.74,-831.53
2550013300483613184,2020-10,0,561.69,2389.65,3907.11,-2079.15,-2910.68
2550013300483613184,2020-11,0,1207.54,3406.92,1896.51,302.87,-2607.81
2550013300483613184,2020-12,933.51,5139.72,3335.67,3830.05,-4700.59,-7308.4
2550560199879143936,2020-01,5969.14,359.17,696.47,1398.81,4907.63,4907.63
2550560199879143936,2020-02,5319.77,1618.02,4477.23,7687.45,491.53,5399.16
2550560199879143936,2020-03,3577.72,985.58,3841.92,1415.66,5018.4,10417.56
2550560199879143936,2020-04,1385.25,3116.72,3520.41,2184.28,-395.34,10022.22
2550560199879143936,2020-05,777.2,1937.39,3614.49,3989.73,-1535.43,8486.79
2550560199879143936,2020-06,0,2441.4,3508.99,0,1067.59,9554.38
2550560199879143936,2020-07,408.85,3689.4,0,2788.52,-6069.07,3485.31
2550560199879143936,2020-08,1810.72,2156.45,4786.48,4663.5,-222.75,3262.56
2550560199879143936,2020-09,1780.29,653.81,517.34,1683.23,-39.41,3223.15
2550560199879143936,2020-10,5941.25,213.27,1341.65,3913.23,3156.4,6379.55
2550560199879143936,2020-11,4384.1,2599.66,1538.12,3313.14,9.42,6388.97
2550560199879143936,2020-12,3474.22,3434.57,3558.22,1152.22,2445.65,8834.62
2551588286099921408,2020-02,222.01,1461.28,0,0,-1239.27,-1239.27
2551588286099921408,2020-06,0,2474.87,0,0,-2474.87,-3714.14
2551588286099921408,2020-07,1876.58,336.26,0,0,1540.32,-2173.82
2551588286099921408,2020-08,0,1243.76,346.1,0,-897.66,-3071.48
2552152200454308864,2020-01,1577.61,872.62,1589.95,0,2294.94,2294.94
2552152200454308864,2020-04,811.14,990.26,64.09,0,-115.03,2179.91
2552152200454308864,2020-06,0,1471.35,0,0,-1471.35,708.56
2552152200454308864,2020-07,387.91,0,0,0,387.91,1096.47
2552152200454308864,2020-11,1.91,3235.31,0,0,-3233.4,-2136.93
2552879319461780992,2020-01,6087.36,5780.37,1701.55,1055.9,952.64,952.64
2552879319461780992,2020-02,7406.29,0,0,3085.51,4320.78,5273.42
2552879319461780992,2020-03,6084.36,2179.72,3673.96,912.01,6666.59,11940.01
2552879319461780992,2020-04,5035.62,0,6256.59,7590.02,3702.19,15642.2
2552879319461780992,2020-05,7931.4,3279.68,4302.73,3704.25,5250.2,20892.4
2552879319461780992,2020-06,4583.43,3116.29,978.27,2021.79,423.62,21316.02
2552879319461780992,2020-07,2602.78,3663.96,169.32,5687.58,-6579.44,14736.58
2552879319461780992,2020-08,7793.87,601.51,3277.89,1954.69,8515.56,23252.14
2552879319461780992,2020-09,3758.27,4692.36,2512.88,5682.97,-4104.18,19147.96
2552879319461780992,2020-10,0,1655.32,7135.29,5899.41,-419.44,18728.52
2552879319461780992,2020-11,3983.71,5207.11,3584.53,886.33,1474.8,20203.32
2552879319461780992,2020-12,3894.5,3971.96,435.21,3802.1,-3444.35,16758.97
2556195365618138624,2020-01,6306.98,2790.5,2780.91,5697.7,599.69,599.69
2556195365618138624,2020-02,3015.31,3736.07,2286.87,390.73,1175.38,1775.07
2556195365618138624,2020-03,2473.11,6750.2,7364.64,6461.97,-3374.42,-1599.35
2556195365618138624,2020-04,1880.12,3722.46,5555.5,5313.58,-1600.42,-3199.77
2556195365618138624,2020-05,3525.44,5145.93,4480.95,1136.42,1724.04,-1475.73
2556195365618138624,2020-06,1626.68,4424.06,6192.39,9075.43,-5680.42,-7156.15
2556195365618138624,2020-07,4973.33,8151.68,6734.09,4058.48,-502.74,-7658.89
2556195365618138624,2020-08,5923.03,3955.24,4887.47,98.71,6756.55,-902.34
2556195365618138624,2020-09,2964.06,1552.99,1930.43,2327.93,1013.57,111.23
2556195365618138624,2020-10,5149.69,3304.31,1448.79,1020.23,2273.94,2385.17
2556195365618138624,2020-11,6191.21,555.01,4435.75,5443.51,4628.44,7013.61
2556195365618138624,2020-12,6830.86,2225.51,3148.48,4616.11,3137.72,10151.33
2559195124226977280,2020-01,1309.67,4046.5,2319.51,8986.56,-9403.88,-9403.88
2559195124226977280,2020-02,8676.72,1747.86,6009.8,4528.12,8410.54,-993.34
2559195124226977280,2020-03,4105.15,4752.2,7553.29,5040.55,1865.69,872.35
2559195124226977280,2020-04,10250.9,4905.32,2344.77,3708.93,3981.42,4853.77
2559195124226977280,2020-05,3726.62,7969.42,5325.82,4845.27,-3762.25,1091.52
2559195124226977280,2020-06,3295.74,6804.92,1581.56,7293.88,-9221.5,-8129.98
2559195124226977280,2020-07,6627.85,4485.59,7367.86,6852.17,2657.95,-5472.03
2559195124226977280,2020-08,5108.59,7004.47,1017.32,11034.34,-11912.9,-17384.93
2559195124226977280,2020-09,4252.36,11663.37,2961.82,5433.4,-9882.59,-27267.52
2559195124226977280,2020-10,3640.79,3753.86,8997.13,3404.87,5479.19,-21788.33
2559195124226977280,2020-11,8675.19,4767.56,7566.39,3735.61,7738.41,-14049.92
2559195124226977280,2020-12,1617.24,2269.29,3621.23,3519.73,-550.55,-14600.47
2560832569025229312,2020-01,3992.78,2990.37,546.37,1504.84,43.94,43.94
2560832569025229312,2020-02,8252.3,9785.62,5769.89,2381.26,1855.31,1899.25
2560832569025229312,2020-03,8011.9,284.15,6667.55,2490.03,11905.27,13804.52
2560832569025229312,2020-04,3854.01,2692.72,2506.99,5858.42,-2190.14,11614.38
2560832569025229312,2020-05,5698.36,1278.87,3224.84,821.4,6822.93,18437.31
2560832569025229312,2020-06,2301.31,9696.65,4268.71,4205.23,-7331.86,11105.45
2560832569025229312,2020-07,5735.52,2495.45,1933.16,2835.77,2337.46,13442.91
2560832569025229312,2020-08,1473.47,7283.45,2810.89,7427.77,-10426.86,3016.05
2560832569025229312,2020-09,1881.61,8180.4,2327.91,6415.57,-10386.45,-7370.4
2560832569025229312,2020-10,5603.71,8330.21,5211.71,1807.87,677.34,-6693.06
2560832569025229312,2020-11,1966.78,3206.7,2729.83,4104.42,-2614.51,-9307.57
2560832569025229312,2020-12,6786.94,4797.8,3899.7,4049.64,1839.2,-7468.37
2560869694582820864,2020-01,7991.07,7788.81,5397.28,7366.24,-1766.7,-1766.7
2560869694582820864,2020-02,4046.24,6729.19,4770.9,5456.78,-3368.83,-5135.53
2560869694582820864,2020-03,6164.37,3778.46,4075.27,1449.88,5011.3,-124.23
2560869694582820864,2020-04,1970.09,4003.76,202.62,6728.94,-8559.99,-8684.22
2560869694582820864,2020-05,0,9050.75,5434.21,4667.87,-8284.41,-16968.63
2560869694582820864,2020-06,6699.81,1250.8,1768.42,2561.77,4655.66,-12312.97
2560869694582820864,2020-07,9124.91,4972.12,2501.74,3729.33,2925.2,-9387.77
2560869694582820864,2020-08,8765.48,2148.13,4643.26,3989.92,7270.69,-2117.08
2560869694582820864,2020-09,4434.07,4297.71,2015.21,7466.45,-5314.88,-7431.96
2560869694582820864,2020-10,3110.04,6527.52,4763.52,1510.53,-164.49,-7596.45
2560869694582820864,2020-11,2814.66,3999.58,8744.73,5180.17,2379.64,-5216.81
2560869694582820864,2020-12,1203.18,5216.88,9949.5,533.26,5402.54,185.73
2561447480028680192,2020-01,1423.76,3535.52,2930.57,1828.93,-1010.12,-1010.12
2561447480028680192,2020-02,119.61,0,2446.7,349.79,2216.52,1206.4
2561447480028680192,2020-03,0,2332.53,4869.91,4436.39,-1899.01,-692.61
2561447480028680192,2020-04,1283.8,1538.9,1175.47,4032.7,-3112.33,-3804.94
2561447480028680192,2020-05,2511.3,0,390.54,1975.41,926.43,-2878.51
2561447480028680192,2020-06,465.41,0,785.54,2288.43,-1037.48,-3915.99
2561447480028680192,2020-07,2585.2,3410.7,0,1011.31,-1836.81,-5752.8
2561447480028680192,2020-08,1371.5,1547.52,1925.28,506.62,1242.64,-4510.16
2561447480028680192,2020-09,1773.31,4025.84,1037.35,3750.51,-4965.69,-9475.85
2561447480028680192,2020-10,1793.19,1892.93,2695.39,955.01,1640.64,-7835.21
2561447480028680192,2020-11,61.61,2848.18,1046.87,5520.1,-7259.8,-15095.01
2561447480028680192,2020-12,6580.26,0,0,1029.2,5551.06,-9543.95
2562779546561440256,2020-01,1140.59,187.09,203.28,2458.4,-1301.62,-1301.62
2562779546561440256,2020-02,0,1620.71,0,0,-1620.71,-2922.33
2562779546561440256,2020-03,4728.66,3038.49,116.43,1780.82,25.78,-2896.55
2562779546561440256,2020-04,2206.59,1924.14,0,0,282.45,-2614.1
2562779546561440256,2020-05,2174.25,1460.69,1666.48,2501.36,-121.32,-2735.42
2562779546561440256,2020-06,2532.46,0,1658.79,810.77,3380.48,645.06
2562779546561440256,2020-07,480.18,2506.98,1050.3,48.48,-1024.98,-379.92
2562779546561440256,2020-08,1547.5,1088.5,0,2151.78,-1692.78,-2072.7
2562779546561440256,2020-09,267.86,0,753.07,2364.69,-1343.76,-3416.46
2562779546561440256,2020-10,1882.84,0,1035.09,2334.53,583.4,-2833.06
2562779546561440256,2020-11,1280.81,1175.42,502.39,1483.82,-876.04,-3709.1
2562779546561440256,2020-12,1760.84,2913.45,3359.8,1383.75,823.44,-2885.66
2563953117121337344,2020-01,0,1519.18,4449.92,3333.32,-402.58,-402.58
2563953117121337344,2020-02,0,2216.12,718.07,0,-1498.05,-1900.63
2563953117121337344,2020-03,1400.05,1826.91,558.26,675.97,-544.57,-2445.2
2563953117121337344,2020-04,606.35,1239.58,1464.7,1805.33,-973.86,-3419.06
2563953117121337344,2020-05,0,423.53,0,0,-423.53,-3842.59
2563953117121337344,2020-07,3514.33,4130.62,403.79,161.03,-373.53,-4216.12
2563953117121337344,2020-08,1737.6,0,0,3150.9,-1413.3,-5629.42
2563953117121337344,2020-09,1542.07,2663.99,0,0,-1121.92,-6751.34
2563953117121337344,2020-10,3350.06,2025.11,3803.96,3567.38,1561.53,-5189.81
2563953117121337344,2020-11,1021.32,0,1628.71,3092.8,-442.77,-5632.58
2563953117121337344,2020-12,1811.4,840.31,2762.63,0,3733.72,-1898.86
2564207793132371968,2020-01,9597.29,10085.59,3425.17,2157.16,779.71,779.71
2564207793132371968,2020-02,4835,4368.25,7591.27,2067.74,5990.28,6769.99
2564207793132371968,2020-03,8238.93,251.5,9620.24,2043.08,15564.59,22334.58
2564207793132371968,2020-04,1779.64,4120.26,5740.3,2634.75,764.93,23099.51
2564207793132371968,2020-05,3512.23,3855.87,2019.11,494.75,1180.72,24280.23
2564207793132371968,2020-06,8993,4385.91,7914.05,4161.4,8359.74,32639.97
2564207793132371968,2020-07,2155.53,3817.56,0,3588.84,-5250.87,27389.1
2564207793132371968,2020-08,2872.17,7777.61,1995.08,5175.08,-8085.44,19303.66
2564207793132371968,2020-09,6580.77,4530.81,7737.14,5132.31,4654.79,23958.45
2564207793132371968,2020-10,7276.23,7957.65,1886.43,3822.56,-2617.55,21340.9
2564207793132371968,2020-11,7586.85,2457.98,4230.9,7244.36,2115.41,23456.31
2564207793132371968,2020-12,3464.39,2537.06,3645.49,1805.09,2767.73,26224.04
2564556380667662336,2020-01,0,1047.15,1813.37,1698.57,-932.35,-932.35
2564556380667662336,2020-02,0,1006.16,2224.96,1576.69,-357.89,-1290.24
2564556380667662336,2020-03,0.26,0,3723.64,11532.74,-7808.84,-9099.08
2564556380667662336,2020-04,436.85,1061.96,1685.72,3437.19,-2376.58,-11475.66
2564556380667662336,2020-05,1930.68,2144.3,594.88,0,381.26,-11094.4
2564556380667662336,2020-06,0,6574.61,0,5240.41,-11815.02,-22909.42
2564556380667662336,2020-07,1236.89,0,2214.69,2919.69,531.89,-22377.53
2564556380667662336,2020-08,704.45,982.02,2253.72,630.78,1345.37,-21032.16
2564556380667662336,2020-09,1608.44,2818.96,5259.07,4502.98,-454.43,-21486.59
2564556380667662336,2020-10,3484.13,1394.22,967.21,0,3057.12,-18429.47
2564556380667662336,2020-11,2048.04,1202.09,5096.11,0,5942.06,-12487.41
2564556380667662336,2020-12,3088.9,1068.65,1551.92,1486.23,2085.94,-10401.47
2564732589506044416,2020-01,9354.67,7160.71,7451.17,2905.11,6740.02,6740.02
2564732589506044416,2020-02,3175.57,762.89,5228.35,1387.79,6253.24,12993.26
2564732589506044416,2020-03,2767.57,10958.33,3157.05,2511.52,-7545.23,5448.03
2564732589506044416,2020-04,4354.01,3180.14,12554.36,3466.73,10261.5,15709.53
2564732589506044416,2020-05,1828.9,10961.79,8110.2,5948.21,-6970.9,8738.63
2564732589506044416,2020-06,5317.08,1784.11,2660.17,2297.96,3895.18,12633.81
2564732589506044416,2020-07,5104.85,2685.78,4409.6,4047.97,2780.7,15414.51
2564732589506044416,2020-08,5605.39,2202.29,3253.01,1868.52,4787.59,20202.1
2564732589506044416,2020-09,5943.97,5551.33,3263.84,2568.94,1087.54,21289.64
2564732589506044416,2020-10,4001.77,5686.07,4811.35,0,3127.05,24416.69
2564732589506044416,2020-11,6161.37,4255.45,8689.83,5811.52,4784.23,29200.92
2564732589506044416,2020-12,4571.89,1307.97,3542.08,5305.37,1500.63,30701.55
2564989623377068032,2020-01,1948.01,0,0,4627.73,-2679.72,-2679.72
2564989623377068032,2020-03,949.45,0,0,0,949.45,-1730.27
2564989623377068032,2020-05,1758.72,2918.45,1761.72,0,601.99,-1128.28
2564989623377068032,2020-06,0,793.37,0,821.73,-1615.1,-2743.38
2564989623377068032,2020-07,3924.09,1852.91,491.6,0,2562.78,-180.6
2564989623377068032,2020-08,0,1959.14,1977.01,239.33,-221.46,-402.06
2564989623377068032,2020-09,0,2525.49,54.65,17.24,-2488.08,-2890.14
2564989623377068032,2020-10,280.92,654.73,0,830.41,-1204.22,-4094.36
2564989623377068032,2020-12,347.33,0,1825.39,0,2172.72,-1921.64
2565142372847597568,2020-01,4388.86,59.21,5473.13,8669.4,1133.38,1133.38
2565142372847597568,2020-02,5317.14,3470.05,5406.31,3756.38,3497.02,4630.4
2565142372847597568,2020-03,4034.01,2672.41,2638.33,2745.82,1254.11,5884.51
2565142372847597568,2020-04,3693.14,6391.34,3852.72,4534.44,-3379.92,2504.59
2565142372847597568,2020-05,3969.13,3789.31,2068.37,3875.83,-1627.64,876.95
2565142372847597568,2020-06,2396.31,1809.23,4574.94,1844.5,3317.52,4194.47
2565142372847597568,2020-07,1229.79,3424.42,3620.74,2890.77,-1464.66,2729.81
2565142372847597568,2020-08,1093.96,1707.05,5646.57,1922.85,3110.63,5840.44
2565142372847597568,2020-09,1823.86,5666.63,3127.33,4268,-4983.44,857
2565142372847597568,2020-10,4067.41,5471.9,2209.26,956.78,-152.01,704.99
2565142372847597568,2020-11,1223.71,3416.75,3081.82,1113.67,-224.89,480.1
2565142372847597568,2020-12,3924.31,3593.59,1256.54,3119.53,-1532.27,-1052.17
2565165780537280000,2020-01,1708.3,529.65,2129.43,2814.46,493.62,493.62
2565165780537280000,2020-02,463.2,3833.59,3311.74,3546.4,-3605.05,-3111.43
2565165780537280000,2020-03,418.01,7005.73,3125.66,1486.01,-4948.07,-8059.5
2565165780537280000,2020-04,5119.37,2728.53,2613.02,4068.1,935.76,-7123.74
2565165780537280000,2020-05,9295.13,5922.84,1060.71,0,4433,-2690.74
2565165780537280000,2020-06,0,1842.31,3096.91,2391.86,-1137.26,-3828
2565165780537280000,2020-07,2207.83,5151.59,1216.39,4586.73,-6314.1,-10142.1
2565165780537280000,2020-08,1608.49,1723.55,1668.41,604.63,948.72,-9193.38
2565165780537280000,2020-09,1295.5,2780.44,1556.59,0,71.65,-9121.73
2565165780537280000,2020-10,3919.33,2471.14,3768.8,2919.02,2297.97,-6823.76
2565165780537280000,2020-11,1028.4,5398.24,1309.1,2738.88,-5799.62,-12623.38
2565165780537280000,2020-12,221.76,3489.56,3668.98,2022.56,-1621.38,-14244.76
2565205962938397696,2020-01,5838.56,7664.05,6747.65,1840.15,3082.01,3082.01
2565205962938397696,2020-02,3039.34,888.44,1710.6,3015.59,845.91,3927.92
2565205962938397696,2020-03,2994.11,1676.46,4836.21,1165.84,4988.02,8915.94
2565205962938397696,2020-04,628.37,2116.54,812.85,4311.15,-4986.47,3929.47
2565205962938397696,2020-05,2369.05,4012.13,2078.57,7116.62,-6681.13,-2751.66
2565205962938397696,2020-06,1754.69,7187.16,3350.93,0,-2081.54,-4833.2
2565205962938397696,2020-07,5865.68,4377.23,4346.94,1132.07,4703.32,-129.88
2565205962938397696,2020-08,5254.13,1541.85,3645.02,678.13,6679.17,6549.29
2565205962938397696,2020-09,6608.07,4121.9,257.57,3319.42,-575.68,5973.61
2565205962938397696,2020-10,2413.15,5340.36,6451.79,2277.53,1247.05,7220.66
2565205962938397696,2020-11,4901.35,6006.61,2789.27,4972.54,-3288.53,3932.13
2565205962938397696,2020-12,1952.04,3509.68,3432.26,3831,-1956.38,1975.75
2565422015403164672,2020-01,618.64,6627.93,5685.46,5752.28,-6076.11,-6076.11
2565422015403164672,2020-02,1789.35,2683.1,6634.38,2156.38,3584.25,-2491.86
2565422015403164672,2020-03,4404.15,1902.24,11475.39,9500.08,4477.22,1985.36
2565422015403164672,2020-04,3541.53,2321.09,6617.16,2187.14,5650.46,7635.82
2565422015403164672,2020-05,3749.31,3555.46,5539.88,0,5733.73,13369.55
2565422015403164672,2020-06,940.76,2761.33,4174.87,2059.47,294.83,13664.38
2565422015403164672,2020-07,2981.14,6596.7,3501.88,3124.36,-3238.04,10426.34
2565422015403164672,2020-08,6644.97,1330.07,1212.44,4471.45,2055.89,12482.23
2565422015403164672,2020-09,1612.44,2992.76,2697.41,2626.05,-1308.96,11173.27
2565422015403164672,2020-10,5729.39,4868.34,4636.27,4363.78,1133.54,12306.81
2565422015403164672,2020-11,5523.95,6730.83,4631.3,8617.93,-5193.51,7113.3
2565422015403164672,2020-12,2509.93,515.41,3912.13,6076.16,-169.51,6943.79
2566014392152346624,2020-01,5986.93,944.12,3560.09,2280.4,6322.5,6322.5
2566014392152346624,2020-02,1145.18,0,1150.89,4240.96,-1944.89,4377.61
2566014392152346624,2020-03,1975.76,869.59,1211.09,1742.24,575.02,4952.63
2566014392152346624,2020-04,2297.11,3575.73,1993.92,8416.32,-7701.02,-2748.39
2566014392152346624,2020-05,3814.09,1388.23,2663.86,2498.49,2591.23,-157.16
2566014392152346624,2020-06,0,2222.25,935.71,4675.05,-5961.59,-6118.75
2566014392152346624,2020-07,4856.03,4095.8,2230.1,4084.06,-1093.73,-7212.48
2566014392152346624,2020-08,1271,4493.76,43.84,2029.98,-5208.9,-12421.38
2566014392152346624,2020-09,3262.92,7807.62,4555.3,1856.03,-1845.43,-14266.81
2566014392152346624,2020-10,2630.54,3007.39,0,2754.17,-3131.02,-17397.83
2566014392152346624,2020-11,955.42,4001.42,2236.06,1603.29,-2413.23,-19811.06
2566014392152346624,2020-12,2691.2,1358.64,859.54,1738.28,453.82,-19357.24
2566490291969177600,2020-01,8004.24,5430.82,5432.21,5373.82,2631.81,2631.81
2566490291969177600,2020-02,4768.1,6615.93,7526.32,6878.03,-1199.54,1432.27
2566490291969177600,2020-03,7385.94,4296.83,9515.12,3270.18,9334.05,10766.32
2566490291969177600,2020-04,4445.34,2647.38,5694.1,3335.87,4156.19,14922.51
2566490291969177600,2020-05,6970.95,5938.34,5983.3,3960.68,3055.23,17977.74
2566490291969177600,2020-06,3576.4,3610.79,4245.85,3041.86,1169.6,19147.34
2566490291969177600,2020-07,5192.84,3046.13,6848.45,940.68,8054.48,27201.82
2566490291969177600,2020-08,3656.09,5155.42,843.74,3939.23,-4594.82,22607
2566490291969177600,2020-09,4207.96,6153.09,6621.81,4431.46,245.22,22852.22
2566490291969177600,2020-10,4559.3,7833.01,3119.96,4090.61,-4244.36,18607.86
2566490291969177600,2020-11,2230.43,8150.36,5075.64,0,-844.29,17763.57
2566490291969177600,2020-12,6018.74,4924.52,7265.92,3336.54,5023.6,22787.17
2566495738064916992,2020-01,1908.36,0,1083.68,991.2,2000.84,2000.84
2566495738064916992,2020-02,478.59,7023.25,279.98,1155.34,-7420.02,-5419.18
2566495738064916992,2020-03,3274.3,2734.97,1736.06,902.19,1373.2,-4045.98
2566495738064916992,2020-04,0,4030.71,485.96,765.14,-4309.89,-8355.87
2566495738064916992,2020-05,0,1172.31,3778.67,0,2606.36,-5749.51
2566495738064916992,2020-06,3918.03,1300.13,1782.11,1976.13,2423.88,-3325.63
2566495738064916992,2020-07,200.85,0,1502.8,1289.93,413.72,-2911.91
2566495738064916992,2020-08,2203.08,1288.16,3428.36,0,4343.28,1431.37
2566495738064916992,2020-09,370.2,0,1057.59,0,1427.79,2859.16
2566495738064916992,2020-10,1936.11,1997.9,2326.94,1655.79,609.36,3468.52
2566495738064916992,2020-11,1731.43,1368.42,1669.25,0,2032.26,5500.78
2566495738064916992,2020-12,0,2508.12,898.36,1252.38,-2862.14,2638.64
2568708337558359040,2020-01,2613.88,4055.67,4489.95,7103.49,-4055.33,-4055.33
2568708337558359040,2020-02,3345.52,6079.59,1990.16,3901.67,-4645.58,-8700.91
2568708337558359040,2020-03,2868.54,1689.64,7544.01,5464.55,3258.36,-5442.55
2568708337558359040,2020-04,1082.17,3816.11,1253.79,0,-1480.15,-6922.7
2568708337558359040,2020-05,0,4499.84,5291.51,6181.5,-5389.83,-12312.53
2568708337558359040,2020-06,6481.33,3862.66,1398.23,60.81,3956.09,-8356.44
2568708337558359040,2020-07,1908.59,2300.28,4930.31,983.76,3554.86,-4801.58
2568708337558359040,2020-08,4034.4,1932.41,1317.63,3134.2,285.42,-4516.16
2568708337558359040,2020-09,4324.02,1685.07,5400.4,2492.46,5546.89,1030.73
2568708337558359040,2020-10,4195.46,7852.51,4732.5,4218.55,-3143.1,-2112.37
2568708337558359040,2020-11,1591.55,1675.07,5112.67,6339.14,-1309.99,-3422.36
2568708337558359040,2020-12,683.53,5325.65,2253.3,1777.22,-4166.04,-7588.4
2569093538912119808,2020-01,1836.95,997.85,1336.34,2462.76,-287.32,-287.32
2569093538912119808,2020-02,2889.58,1053.22,659.11,0,2495.47,2208.15
2569093538912119808,2020-04,1564.11,1704.47,1780.07,816.7,823.01,3031.16
2569093538912119808,2020-05,455.6,2618.67,1316.32,5070.15,-5916.9,-2885.74
2569093538912119808,2020-06,0,1782.85,0,478.03,-2260.88,-5146.62
2569093538912119808,2020-08,0,1512.99,0,3498.49,-5011.48,-10158.1
2569093538912119808,2020-09,0,1440.31,2919.93,0,1479.62,-8678.48
2569093538912119808,2020-10,2357.19,925.27,1926.98,2353.97,1004.93,-7673.55
2569093538912119808,2020-11,3745.68,0,0,1651.04,2094.64,-5578.91
2569093538912119808,2020-12,0,878.6,287.21,1923.14,-2514.53,-8093.44
2571016899143157760,2020-01,4200.74,3851.3,4893.06,5507.73,-265.23,-265.23
2571016899143157760,2020-02,3750.83,6928.35,3038.89,4902.62,-5041.25,-5306.48
2571016899143157760,2020-03,8432.13,5373.5,10024.52,2721.75,10361.4,5054.92
2571016899143157760,2020-04,40.2,434.06,2746.32,4203.83,-1851.37,3203.55
2571016899143157760,2020-05,4327.63,7203.37,0,1311.69,-4187.43,-983.88
2571016899143157760,2020-06,9243.41,2628.07,484.19,2214.57,4884.96,3901.08
2571016899143157760,2020-07,1726.39,8161.75,2243.36,6386.37,-10578.37,-6677.29
2571016899143157760,2020-08,5656.28,4575.05,1629.85,1056.74,1654.34,-5022.95
2571016899143157760,2020-09,990.52,6903.74,4601.62,4706.1,-6017.7,-11040.65
2571016899143157760,2020-10,5344.95,2993.86,5889.55,6274.25,1966.39,-9074.26
2571016899143157760,2020-11,5584.84,4180.03,6448.1,1070.97,6781.94,-2292.32
2571016899143157760,2020-12,5924.3,3875.26,2032.35,9613.49,-5532.1,-7824.42
2571048313192768512,2020-01,1011.34,0,1306.59,0,2317.93,2317.93
2571048313192768512,2020-02,0,891.3,0,0,-891.3,1426.63
2571048313192768512,2020-03,1639.52,3939.21,0,278.52,-2578.21,-1151.58
2571048313192768512,2020-04,0,692.56,0,726.51,-1419.07,-2570.65
2571048313192768512,2020-05,532.92,1953.27,927.99,0,-492.36,-3063.01
2571048313192768512,2020-06,1323.63,0,0,125.16,1198.47,-1864.54
2571048313192768512,2020-09,1987.37,1855.15,0,107.74,24.48,-1840.06
2571048313192768512,2020-11,3364.99,0,3489.43,1982.81,4871.61,3031.55
2571048313192768512,2020-12,1997.49,1659.85,365.98,0,703.62,3735.17
2571322912490301952,2020-01,1245.29,1175.25,1072.91,777.3,365.65,365.65
2571322912490301952,2020-02,0,1523.41,258.51,1130.58,-2395.48,-2029.83
2571322912490301952,2020-03,1340.24,1850.77,0,768.53,-1279.06,-3308.89
2571322912490301952,2020-04,3068.35,3258.82,1736.5,1229.73,316.3,-2992.59
2571322912490301952,2020-06,2970.15,942.21,294.78,1021.13,1301.59,-1691
2571322912490301952,2020-07,1718.58,0,621.7,1884.94,455.34,-1235.66
2571322912490301952,2020-08,1182.3,652.9,1728.98,1992.23,266.15,-969.51
2571322912490301952,2020-09,1926.71,2931.54,1999.14,1149.41,-155.1,-1124.61
2571322912490301952,2020-10,449.97,0,0,3065.83,-2615.86,-3740.47
2571322912490301952,2020-11,2462.09,1575.88,1495.46,1734.34,647.33,-3093.14
2571322912490301952,2020-12,0,3681.96,1461.49,1334.55,-3555.02,-6648.16
2572435834096320512,2020-01,0,1426.62,1288.83,0,-137.79,-137.79
2572435834096320512,2020-03,0,18.83,0,0,-18.83,-156.62
2572435834096320512,2020-10,0,1389.33,1484,0,94.67,-61.95
2572435834096320512,2020-11,889.82,0,0,420.97,468.85,406.9
2575773698565916672,2020-02,0,2568.33,0,661.14,-3229.47,-3229.47
2575773698565916672,2020-04,0,4170.41,0,2857.69,-7028.1,-10257.57
2575773698565916672,2020-05,1182.54,463.93,1548.87,0,2267.48,-7990.09
2575773698565916672,2020-06,0,907.45,0,0,-907.45,-8897.54
2575773698565916672,2020-07,0,1358.45,0,962.06,-2320.51,-11218.05
2575773698565916672,2020-09,0,524.97,0,0,-524.97,-11743.02
2575773698565916672,2020-12,0,1996.18,0,0,-1996.18,-13739.2
2576709408245584896,2020-01,5616.37,2069.12,3220.16,6211.33,556.08,556.08
2576709408245584896,2020-02,2792.07,4297.95,2280.85,2701.05,-1926.08,-1370
2576709408245584896,2020-03,3882.67,318.16,0,252.87,3311.64,1941.64
2576709408245584896,2020-04,597.9,3247.55,3209,885.6,-326.25,1615.39
2576709408245584896,2020-05,447.94,4151.35,594.29,1817.58,-4926.7,-3311.31
2576709408245584896,2020-06,2248.78,981.35,4380.86,6810.31,-1162.02,-4473.33
2576709408245584896,2020-07,2651.07,3546.38,2478.26,11504.82,-9921.87,-14395.2
2576709408245584896,2020-08,1822.76,2026.43,5150.09,2296.05,2650.37,-11744.83
2576709408245584896,2020-09,3558.72,1918.36,4253.52,2588.86,3305.02,-8439.81
2576709408245584896,2020-10,3447.92,387.28,0,0,3060.64,-5379.17
2576709408245584896,2020-11,1669.07,2914.01,0,1674.3,-2919.24,-8298.41
2576709408245584896,2020-12,31.05,2671.74,879.04,2342.74,-4104.39,-12402.8
2578019295293609472,2020-01,8083.38,7158.36,4036.38,0,4961.4,4961.4
2578019295293609472,2020-02,5237.41,2660.12,2535.25,3318.99,1793.55,6754.95
2578019295293609472,2020-03,3156.35,3196.68,5563.31,5491.9,31.08,6786.03
2578019295293609472,2020-04,3770.15,2056.41,1338.28,4951.24,-1899.22,4886.81
2578019295293609472,2020-05,8848.02,7607.24,4266.53,4892.99,614.32,5501.13
2578019295293609472,2020-06,6016.5,2909.92,7543.53,5430.55,5219.56,10720.69
2578019295293609472,2020-07,5434.68,3027.44,4789.44,5830.71,1365.97,12086.66
2578019295293609472,2020-08,7217.74,1960.54,5286.55,1859.02,8684.73,20771.39
2578019295293609472,2020-09,2825.7,3786.04,7552.34,10751.02,-4159.02,16612.37
2578019295293609472,2020-10,2207.19,3984.14,4738.83,3605.88,-644,15968.37
2578019295293609472,2020-11,1971.93,32.1,1096.52,1903.98,1132.37,17100.74
2578019295293609472,2020-12,5980.41,6321.45,469.77,1856.65,-1727.92,15372.82
2578703701104116736,2020-01,7662.04,2294.41,3013.5,3264.21,5116.92,5116.92
2578703701104116736,2020-02,2768.31,7402.37,4672.04,2887.81,-2849.83,2267.09
2578703701104116736,2020-03,2670.8,3098.33,5653.84,3071.76,2154.55,4421.64
2578703701104116736,2020-04,573.16,3353.85,2798.62,2901.36,-2883.43,1538.21
2578703701104116736,2020-05,5269.01,6205.27,6119.24,5444.84,-261.86,1276.35
2578703701104116736,2020-06,5061.83,4594.47,2283.25,2992.5,-241.89,1034.46
2578703701104116736,2020-07,6630.33,7278.08,4352.1,2090.02,1614.33,2648.79
2578703701104116736,2020-08,4681.09,3397.23,326.3,8009.17,-6399.01,-3750.22
2578703701104116736,2020-09,3115.94,5679.82,1749.91,1965.71,-2779.68,-6529.9
2578703701104116736,2020-10,1239.1,8809.22,0,3910.24,-11480.36,-18010.26
2578703701104116736,2020-11,624.35,459.6,5465.26,3631.94,1998.07,-16012.19
2578703701104116736,2020-12,3989.79,2575.34,4821.44,2621.57,3614.32,-12397.87
2579703769389719552,2020-01,0,641.01,0,0,-641.01,-641.01
2579703769389719552,2020-02,0,292.26,0,1679.62,-1971.88,-2612.89
2579703769389719552,2020-04,2693.98,0,0,0,2693.98,81.09
2579703769389719552,2020-08,1597.89,619.04,0,0,978.85,1059.94
2579703769389719552,2020-09,0,1172.04,0,0,-1172.04,-112.1
2579703769389719552,2020-10,1299.06,0,0,0,1299.06,1186.96
2579703769389719552,2020-11,0,315.01,0,0,-315.01,871.95
2580604964062608896,2020-01,1446.27,2415.85,4522.15,3032.72,519.85,519.85
2580604964062608896,2020-02,2203.88,14355.41,3836.76,1230.43,-9545.2,-9025.35
2580604964062608896,2020-03,0,11024.3,3588.65,9932.12,-17367.77,-26393.12
2580604964062608896,2020-04,1922.77,3031.38,1744.87,2158.07,-1521.81,-27914.93
2580604964062608896,2020-05,8639.64,3990.11,5031.82,3900.44,5780.91,-22134.02
2580604964062608896,2020-06,5269.99,7223.07,7689.6,8632.53,-2896.01,-25030.03
2580604964062608896,2020-07,9886.34,3797.55,9298.06,2212.13,13174.72,-11855.31
2580604964062608896,2020-08,4742.57,1843.48,1452.68,3333.73,1018.04,-10837.27
2580604964062608896,2020-09,3644.04,10051.51,3521.49,7786.29,-10672.27,-21509.54
2580604964062608896,2020-10,1825.25,3178.26,4542.02,7116.5,-3927.49,-25437.03
2580604964062608896,2020-11,6176.89,8415.53,947.29,5265.08,-6556.43,-31993.46
2580604964062608896,2020-12,5186.59,5328.59,1090.02,7857.5,-6909.48,-38902.94
2580628306825528320,2020-01,5317.08,7361.81,5026.57,1471.84,1510,1510
2580628306825528320,2020-02,4269.78,7792.52,4124.69,3620.02,-3018.07,-1508.07
2580628306825528320,2020-03,3047.54,5931.4,1969.04,7460.52,-8375.34,-9883.41
2580628306825528320,2020-04,8415.87,4906.94,2520.44,4602.61,1426.76,-8456.65
2580628306825528320,2020-05,646.71,2237.52,4897.08,2426.08,880.19,-7576.46
2580628306825528320,2020-06,3945.81,5914.19,9234.16,8191.6,-925.82,-8502.28
2580628306825528320,2020-07,3575.78,1680.13,2787.95,5013.51,-329.91,-8832.19
2580628306825528320,2020-08,5752.93,4032.84,5280,2121.04,4879.05,-3953.14
2580628306825528320,2020-09,2576.99,1656,3210.95,5702.84,-1570.9,-5524.04
2580628306825528320,2020-10,3039.94,1675.81,4530.6,73.73,5821,296.96
2580628306825528320,2020-11,7191.49,6482.83,7619.38,5644.28,2683.76,2980.72
2580628306825528320,2020-12,2443.74,8735.64,2752.64,2020.49,-5559.75,-2579.03
2581043264455072256,2020-01,781.99,0,0,923.93,-141.94,-141.94
2581043264455072256,2020-06,1255.37,0,0,0,1255.37,1113.43
2581043264455072256,2020-07,0,1561.85,0,0,-1561.85,-448.42
2581043264455072256,2020-08,178.69,0,0,1171.91,-993.22,-1441.64
2581043264455072256,2020-09,702.39,0,1274.55,0,1976.94,535.3
2581043264455072256,2020-11,0,1144.8,0,0,-1144.8,-609.5
2581043264455072256,2020-12,0,1424.21,0,0,-1424.21,-2033.71
2581619563453145600,2020-01,8634.57,3364.78,8052.12,3324.31,9997.6,9997.6
2581619563453145600,2020-02,8040.86,1978.87,0,5484.12,577.87,10575.47
2581619563453145600,2020-03,5317.33,8557.53,5791.65,2880.49,-329.04,10246.43
2581619563453145600,2020-04,9475.28,8224.36,1736.2,5855.12,-2868,7378.43
2581619563453145600,2020-05,6381.01,3062.96,6533.14,5084.99,4766.2,12144.63
2581619563453145600,2020-06,5543.1,298.73,2910.97,4879.31,3276.03,15420.66
2581619563453145600,2020-07,3945.95,3285.05,5152.22,3665.06,2148.06,17568.72
2581619563453145600,2020-08,1507.36,4443.29,3996.22,9757.95,-8697.66,8871.06
2581619563453145600,2020-09,3565.41,7803.17,6685.39,3611.62,-1163.99,7707.07
2581619563453145600,2020-10,6816.81,10876.69,4205.86,5035.96,-4889.98,2817.09
2581619563453145600,2020-11,8229.38,5593.81,4997.62,11938.03,-4304.84,-1487.75
2581619563453145600,2020-12,2851.28,2282.09,1991.52,7629.37,-5068.66,-6556.41
2582312454490957824,2020-01,0,2389.15,1553.75,4605.93,-5441.33,-5441.33
2582312454490957824,2020-02,3994.63,308.51,8000.95,1957,9730.07,4288.74
2582312454490957824,2020-03,3366.31,0,4347.46,1568.74,6145.03,10433.77
2582312454490957824,2020-04,1512.9,0,3567.18,2134.65,2945.43,13379.2
2582312454490957824,2020-05,2904.19,1763.34,2197.88,1000.05,2338.68,15717.88
2582312454490957824,2020-06,3237.16,1243,4533.01,3052.98,3474.19,19192.07
2582312454490957824,2020-07,7451.48,5689.01,580.13,4451.62,-2109.02,17083.05
2582312454490957824,2020-08,0,393.86,2566.32,633.98,1538.48,18621.53
2582312454490957824,2020-09,2400.71,430.95,145.52,4620.52,-2505.24,16116.29
2582312454490957824,2020-10,2363.02,5382.87,0,0,-3019.85,13096.44
2582312454490957824,2020-11,2128.3,3292.8,4394.53,604.03,2626,15722.44
2582312454490957824,2020-12,170.22,3326.55,2115.52,5569.3,-6610.11,9112.33
2584190978058143744,2020-01,1986.98,2597.38,0,5238.62,-5849.02,-5849.02
2584190978058143744,2020-02,778.66,0,1229.26,3185.29,-1177.37,-7026.39
2584190978058143744,2020-03,1037.64,925.32,938.18,905.56,144.94,-6881.45
2584190978058143744,2020-04,3293.65,251.93,3046.29,5408.29,679.72,-6201.73
2584190978058143744,2020-05,4499.37,3276.27,950.23,3677.93,-1504.6,-7706.33
2584190978058143744,2020-06,565.31,0,985.34,0,1550.65,-6155.68
2584190978058143744,2020-07,1097.53,1256.4,667.97,0,509.1,-5646.58
2584190978058143744,2020-08,1448.57,1633.96,3202.88,2722.79,294.7,-5351.88
2584190978058143744,2020-09,1747.93,424.6,0,2123.93,-800.6,-6152.48
2584190978058143744,2020-10,24.63,835.28,308.68,3369.89,-3871.86,-10024.34
2584190978058143744,2020-11,558.36,0,2566.34,7281.14,-4156.44,-14180.78
2584190978058143744,2020-12,1835.49,560.11,0,569.95,705.43,-13475.35
2584929773583613952,2020-01,3853.29,6539.79,3738.93,5616.64,-4564.21,-4564.21
2584929773583613952,2020-02,6516.95,2200.86,2795.68,6387.49,724.28,-3839.93
2584929773583613952,2020-03,1465.03,1454.93,4483.42,3655.33,838.19,-3001.74
2584929773583613952,2020-04,5130.41,3425.97,1457,3053.33,108.11,-2893.63
2584929773583613952,2020-05,1339.66,2055.6,1693.15,1183.57,-206.36,-3099.99
2584929773583613952,2020-06,3028.83,3361.33,3196.07,2510.34,353.23,-2746.76
2584929773583613952,2020-07,4466.05,4089.82,2101.44,4887.29,-2409.62,-5156.38
2584929773583613952,2020-08,2123.35,5775.16,1229.61,1185.81,-3608.01,-8764.39
2584929773583613952,2020-09,0,1794.83,1165.83,4601.8,-5230.8,-13995.19
2584929773583613952,2020-10,4490.76,1948.13,1088.18,5322.07,-1691.26,-15686.45
2584929773583613952,2020-11,4246.79,2260.5,3373.48,10015.27,-4655.5,-20341.95
2584929773583613952,2020-12,4764.6,3288.71,2125.11,1055.65,2545.35,-17796.6
2585912559743459840,2020-01,2886.92,0,6388.21,1922.25,7352.88,7352.88
2585912559743459840,2020-02,2469.24,2058.32,3777.04,7992.67,-3804.71,3548.17
2585912559743459840,2020-03,2829.25,8571.52,2066.45,2824.96,-6500.78,-2952.61
2585912559743459840,2020-04,0,3768.32,1656.86,6037.88,-8149.34,-11101.95
2585912559743459840,2020-05,4030.46,2330.87,2118.71,2797.47,1020.83,-10081.12
2585912559743459840,2020-06,1710.7,0,4002,4513.14,1199.56,-8881.56
2585912559743459840,2020-07,2883.99,4026.8,2549.18,3357.85,-1951.48,-10833.04
2585912559743459840,2020-08,3509.72,6824.85,6172.43,3498.87,-641.57,-11474.61
2585912559743459840,2020-09,6481.02,3999.81,6582.36,2837.2,6226.37,-5248.24
2585912559743459840,2020-10,43.54,3444.09,3391.54,3694.86,-3703.87,-8952.11
2585912559743459840,2020-11,817.3,3659.06,0,3911.55,-6753.31,-15705.42
2585912559743459840,2020-12,10527.84,4526.59,1877.75,2263.36,5615.64,-10089.78
2586841573165230080,2020-01,1897.21,476.3,0,673.2,747.71,747.71
2586841573165230080,2020-02,1512.63,925.29,257.47,1530.23,-685.42,62.29
2586841573165230080,2020-03,1531.6,0,2710.14,881.93,3359.81,3422.1
2586841573165230080,2020-04,0,30.65,4043.85,1817.79,2195.41,5617.51
2586841573165230080,2020-05,1756.45,3108.77,4566.64,1837.38,1376.94,6994.45
2586841573165230080,2020-06,4363.06,736.31,1544.82,0,5171.57,12166.02
2586841573165230080,2020-07,2262.75,646.35,5291.2,1739.79,5167.81,17333.83
2586841573165230080,2020-08,108.56,3354.02,4595.75,1359.83,-9.54,17324.29
2586841573165230080,2020-09,1047.21,0,980.64,4165.54,-2137.69,15186.6
2586841573165230080,2020-11,603,3724.9,1306.72,5398.53,-7213.71,7972.89
2587775779155146752,2020-01,2664.57,3512.92,1466.41,2786.22,-2168.16,-2168.16
2587775779155146752,2020-02,4975.3,3293.54,1914.79,4129.71,-533.16,-2701.32
2587775779155146752,2020-03,3414.87,1604.86,6402.83,2139.32,6073.52,3372.2
2587775779155146752,2020-04,5814.09,1501.44,1796.75,1260.31,4849.09,8221.29
2587775779155146752,2020-05,1763.93,5571.32,3470.24,3811.19,-4148.34,4072.95
2587775779155146752,2020-06,0,4803.53,1859.23,5969.04,-8913.34,-4840.39
2587775779155146752,2020-07,1820.49,3070.72,2103.49,1920.84,-1067.58,-5907.97
2587775779155146752,2020-08,1316.64,2145.77,1469.45,4155.15,-3514.83,-9422.8
2587775779155146752,2020-09,0,1083.14,2484.51,6170.8,-4769.43,-14192.23
2587775779155146752,2020-10,5746.39,0,3583.9,4061.21,5269.08,-8923.15
2587775779155146752,2020-11,8265.46,1539.64,1651.68,1899.52,6477.98,-2445.17
2587775779155146752,2020-12,2440.28,1446.63,3194.32,2573.33,1614.64,-830.53
2588879110549101568,2020-01,4010,3857.75,0,131.22,21.03,21.03
2588879110549101568,2020-02,6595.06,0,2704.24,885.09,8414.21,8435.24
2588879110549101568,2020-03,337.61,1175.37,7486.09,3771.34,2876.99,11312.23
2588879110549101568,2020-04,0,3979.9,3241.64,5065.02,-5803.28,5508.95
2588879110549101568,2020-05,213.78,2733.28,2484.33,354.22,-389.39,5119.56
2588879110549101568,2020-06,1577.81,1644.16,2650.76,4626.59,-2042.18,3077.38
2588879110549101568,2020-07,1831.06,3640.82,2313.7,0,503.94,3581.32
2588879110549101568,2020-08,5091,3197.18,1460.24,2701.03,653.03,4234.35
2588879110549101568,2020-09,2297.49,1248.07,4369.59,3557.97,1861.04,6095.39
2588879110549101568,2020-10,1961.64,3517.67,950.62,4060.23,-4665.64,1429.75
2588879110549101568,2020-11,4416.74,814.56,4303.42,0,7905.6,9335.35
2588879110549101568,2020-12,2453.15,0,9479.14,3491.68,8440.61,17775.96
2591620136873173504,2020-01,3205.76,1877.44,514.53,0,1842.85,1842.85
2591620136873173504,2020-04,0,1462.75,0,47.66,-1510.41,332.44
2591620136873173504,2020-05,2182.17,612.92,0,0,1569.25,1901.69
2591620136873173504,2020-06,0,1797.79,0,0,-1797.79,103.9
2591620136873173504,2020-08,0,1446.5,0,0,-1446.5,-1342.6
2591620136873173504,2020-09,0,815.26,0,0,-815.26,-2157.86
2591620136873173504,2020-10,1124.88,0,0,0,1124.88,-1032.98
2591620136873173504,2020-11,914.38,0,0,0,914.38,-118.6
2591735782049036800,2020-01,7209.23,2879.06,4918.92,1984.7,7264.39,7264.39
2591735782049036800,2020-02,5932.67,998.03,6672.05,2453.97,9152.72,16417.11
2591735782049036800,2020-03,8128.06,4248.03,6617.24,9568.31,928.96,17346.07
2591735782049036800,2020-04,1558.72,8572.36,5862.89,3416.05,-4566.8,12779.27
2591735782049036800,2020-05,3276.42,12295.53,1792.18,392.68,-7619.61,5159.66
2591735782049036800,2020-06,4188.5,4893.24,4787.21,3969.78,112.69,5272.35
2591735782049036800,2020-07,2691.5,5015.57,6733.5,11601.88,-7192.45,-1920.1
2591735782049036800,2020-08,7243.12,5343.58,2434.2,6255.66,-1921.92,-3842.02
2591735782049036800,2020-09,9711.37,4881,6257.61,4652.46,6435.52,2593.5
2591735782049036800,2020-10,6113.33,2570.72,3376.08,1110.21,5808.48,8401.98
2591735782049036800,2020-11,1961.74,4144.86,2258.61,3430.36,-3354.87,5047.11
2591735782049036800,2020-12,3962.56,5837.01,6185.33,5089.67,-778.79,4268.32
2592293856540852736,2020-02,1426.95,0,0,0,1426.95,1426.95
2592293856540852736,2020-03,1455.41,0,0,0,1455.41,2882.36
2592293856540852736,2020-07,1999.75,0,0,1118.11,881.64,3764
2592293856540852736,2020-09,993.16,0,801.05,0,1794.21,5558.21
2592293856540852736,2020-10,0,1519.19,0,1934.47,-3453.66,2104.55
2592293856540852736,2020-11,0,1814.01,0,0,-1814.01,290.54
2592429008068141056,2020-01,4126.29,3270.7,1449.72,953.19,1352.12,1352.12
2592429008068141056,2020-02,483.29,597.65,1668.33,479.03,1074.94,2427.06
2592429008068141056,2020-03,1043.51,1999.14,1349.62,367.68,26.31,2453.37
2592429008068141056,2020-04,0,4361,1874.46,4751.98,-7238.52,-4785.15
2592429008068141056,2020-05,92.61,4049.71,2981.82,1177.09,-2152.37,-6937.52
2592429008068141056,2020-06,4192.2,2686.99,5612.04,10584.48,-3467.23,-10404.75
2592429008068141056,2020-07,3113.67,7378.69,2859.17,2192,-3597.85,-14002.6
2592429008068141056,2020-08,1455.43,3321.46,1239.58,3354.54,-3980.99,-17983.59
2592429008068141056,2020-09,2583.91,0,3650.88,2081.18,4153.61,-13829.98
2592429008068141056,2020-10,1923.06,3300.74,1106.04,7595.99,-7867.63,-21697.61
2592429008068141056,2020-11,3964.71,0,2536.44,119.17,6381.98,-15315.63
2592429008068141056,2020-12,3776.8,3072.04,565.3,1958.85,-688.79,-16004.42
2592527305844619776,2020-01,2556.65,116.12,2288.96,0,4729.49,4729.49
2592527305844619776,2020-03,0,1052.53,0,798.75,-1851.28,2878.21
2592527305844619776,2020-04,0,3421.35,243.21,1092.45,-4270.59,-1392.38
2592527305844619776,2020-05,1118.78,2713.01,4810.74,4427.76,-1211.25,-2603.63
2592527305844619776,2020-06,1187.51,755.34,1176.31,2091.2,-482.72,-3086.35
2592527305844619776,2020-07,0,2216.6,824.71,564.54,-1956.43,-5042.78
2592527305844619776,2020-08,1003.16,2522.02,1955.67,1774.6,-1337.79,-6380.57
2592527305844619776,2020-09,3332.19,0,1703.16,1453.71,3581.64,-2798.93
2592527305844619776,2020-10,3174.82,816.19,771.33,0,3129.96,331.03
2592527305844619776,2020-11,2434.52,548.34,4412.28,977.17,5321.29,5652.32
2592527305844619776,2020-12,1443.22,1637.2,613.59,2841.52,-2421.91,3230.41
2593913335457863680,2020-01,3882.2,2524.34,6514.19,4861.64,3010.41,3010.41
2593913335457863680,2020-02,8842.58,3555.65,0,1281.25,4005.68,7016.09
2593913335457863680,2020-03,3052.16,4663.91,6212.58,5357.28,-756.45,6259.64
2593913335457863680,2020-04,0,1994.63,5589.04,1736.27,1858.14,8117.78
2593913335457863680,2020-05,3271.19,7679.37,680.9,0,-3727.28,4390.5
2593913335457863680,2020-06,2874.23,855.48,3193.17,4862.3,349.62,4740.12
2593913335457863680,2020-07,2333.85,1382.42,1616.99,334.72,2233.7,6973.82
2593913335457863680,2020-08,1662.6,2532.52,3273.72,4095.1,-1691.3,5282.52
2593913335457863680,2020-09,2088.36,0,3176.74,3450.3,1814.8,7097.32
2593913335457863680,2020-10,2212.24,1891.25,662.38,330.43,652.94,7750.26
2593913335457863680,2020-11,688.86,5127.65,4150.67,2143.4,-2431.52,5318.74
2593913335457863680,2020-12,3388.99,1148.03,319.69,1494.61,1066.04,6384.78
2594093690928985600,2020-02,0,738.63,2284.97,498.31,1048.03,1048.03
2594093690928985600,2020-03,445.98,0,135.7,0,581.68,1629.71
2594093690928985600,2020-04,1753.84,1916.49,1426.4,1668.23,-404.48,1225.23
2594093690928985600,2020-05,1719.14,0,0,0,1719.14,2944.37
2594093690928985600,2020-06,0,1939.69,2476.87,573.14,-35.96,2908.41
2594093690928985600,2020-07,212.62,0,0,1657.11,-1444.49,1463.92
2594093690928985600,2020-08,833.71,1962.47,1094.95,0,-33.81,1430.11
2594093690928985600,2020-09,0,725.88,0,436.93,-1162.81,267.3
2594093690928985600,2020-11,0,1025.17,0,0,-1025.17,-757.87
2594129326984344064,2020-01,3733.72,1220.45,1793.22,5834.44,-1527.95,-1527.95
2594129326984344064,2020-02,2160.72,3626.88,3201.01,7357.52,-5622.67,-7150.62
2594129326984344064,2020-03,1564.98,3370.69,1572.68,4206.82,-4439.85,-11590.47
2594129326984344064,2020-04,9012.45,2136.25,1666.44,350.85,8191.79,-3398.68
2594129326984344064,2020-05,0,4158.24,4853.43,3545.61,-2850.42,-6249.1
2594129326984344064,2020-06,3755.13,3119.54,8410.68,5215.38,3830.89,-2418.21
2594129326984344064,2020-07,378.93,2255.39,1683.42,3680.4,-3873.44,-6291.65
2594129326984344064,2020-08,3803.29,1399.38,5407.83,450.18,7361.56,1069.91
2594129326984344064,2020-09,1691.86,6198.14,792.01,1596.78,-5311.05,-4241.14
2594129326984344064,2020-10,13777.7,3494.86,8096.56,5836.25,12543.15,8302.01
2594129326984344064,2020-11,3400.52,2134.15,4221.25,3350.43,2137.19,10439.2
2594129326984344064,2020-12,1341.92,2823.75,4623.24,3060.8,80.61,10519.81
2594751276533586432,2020-05,0,1840.54,0,0,-1840.54,-1840.54
2594751276533586432,2020-08,0,277.62,0,0,-277.62,-2118.16
2596422852420166656,2020-01,2384.27,4266.47,2378.93,2866.88,-2370.15,-2370.15
2596422852420166656,2020-02,2834.73,4741.12,837.77,4952.12,-6020.74,-8390.89
2596422852420166656,2020-03,6039.23,2377.32,2373.02,3910.18,2124.75,-6266.14
2596422852420166656,2020-04,2597.28,4588.93,8996.71,2339.32,4665.74,-1600.4
2596422852420166656,2020-05,818.31,536.67,4010.51,1238.43,3053.72,1453.32
2596422852420166656,2020-06,3580.54,4291.63,3914.47,5402.8,-2199.42,-746.1
2596422852420166656,2020-07,5856.21,905.08,5061.27,3444.21,6568.19,5822.09
2596422852420166656,2020-08,2094.69,3525.44,1676.35,2505.46,-2259.86,3562.23
2596422852420166656,2020-09,3009.38,6698.34,6426.44,2585.36,152.12,3714.35
2596422852420166656,2020-10,1728.49,5891.37,2779.17,4528.48,-5912.19,-2197.84
2596422852420166656,2020-11,1432.82,4113.63,1948.9,2960.2,-3692.11,-5889.95
2596422852420166656,2020-12,5384.53,5299.5,5328.77,2249.35,3164.45,-2725.5
2596999122683644928,2020-01,2987.84,2756.37,3231.45,0,3462.92,3462.92
2596999122683644928,2020-02,649.78,2848.32,1111.38,411.76,-1498.92,1964
2596999122683644928,2020-03,3229.03,2990.61,2772.48,4986.29,-1975.39,-11.39
2596999122683644928,2020-04,4970.44,2768.15,3507.6,2126.65,3583.24,3571.85
2596999122683644928,2020-05,1940.89,3604.15,2444.86,1436.71,-655.11,2916.74
2596999122683644928,2020-06,424.13,898.47,5225.6,4923.03,-171.77,2744.97
2596999122683644928,2020-07,5321,928.89,11563.34,856.14,15099.31,17844.28
2596999122683644928,2020-08,9522.86,907.98,3047.82,3693.27,7969.43,25813.71
2596999122683644928,2020-09,5030.69,1874.08,4518.93,4058.17,3617.37,29431.08
2596999122683644928,2020-10,6010.61,3231.12,3920.98,8251.13,-1550.66,27880.42
2596999122683644928,2020-11,4859.08,3286.69,3674.37,5395.18,-148.42,27732
2596999122683644928,2020-12,6203.39,0,215.92,5581.95,837.36,28569.36
2597798025668714496,2020-02,0,1476.15,0,0,-1476.15,-1476.15
2597798025668714496,2020-06,0,1951.95,0,0,-1951.95,-3428.1
2597798025668714496,2020-08,497.77,1687.41,0,1629,-2818.64,-6246.74
2597798025668714496,2020-10,1126.17,0,0,1247.77,-121.6,-6368.34
2597863872346541568,2020-01,2392.38,6119.86,0,6759.59,-10487.07,-10487.07
2597863872346541568,2020-02,1488.78,0,2662.82,4983.25,-831.65,-11318.72
2597863872346541568,2020-03,1436.19,6263.31,2097.95,2956.28,-5685.45,-17004.17
2597863872346541568,2020-04,2826.06,4939.97,4583.98,4230.97,-1760.9,-18765.07
2597863872346541568,2020-05,0,3120.99,3282.64,1982.33,-1820.68,-20585.75
2597863872346541568,2020-06,2401.01,1981.22,0,1127.09,-707.3,-21293.05
2597863872346541568,2020-07,2399.88,1725.99,3229.41,219.42,3683.88,-17609.17
2597863872346541568,2020-08,1761.91,1025.5,1340.72,2912,-834.87,-18444.04
2597863872346541568,2020-09,1366.68,712.2,1187.01,3479.77,-1638.28,-20082.32
2597863872346541568,2020-10,1594.16,6286.91,3611.7,2683.67,-3764.72,-23847.04
2597863872346541568,2020-11,2311.89,983.07,0,922.74,406.08,-23440.96
2597863872346541568,2020-12,0,1287.8,2971.09,3429.54,-1746.25,-25187.21
2598182919589495296,2020-01,5190.36,13959.16,1947.3,6090.05,-12911.55,-12911.55
2598182919589495296,2020-02,6901.53,1553.47,2938.44,1977.26,6309.24,-6602.31
2598182919589495296,2020-03,9255.85,3880.47,6798.29,3386.9,8786.77,2184.46
2598182919589495296,2020-04,4762.18,6855.28,4778.67,4330.46,-1644.89,539.57
2598182919589495296,2020-05,5181.41,3271.53,7473.32,4797.26,4585.94,5125.51
2598182919589495296,2020-06,5926.83,2908.2,3426.07,1848.75,4595.95,9721.46
2598182919589495296,2020-07,1584.35,1862.74,3547.74,6096.95,-2827.6,6893.86
2598182919589495296,2020-08,6706.14,8576.72,7673.59,4811.61,991.4,7885.26
2598182919589495296,2020-09,2404.38,4342.48,7509.83,2633.12,2938.61,10823.87
2598182919589495296,2020-10,5946.93,5893.96,129.62,2365.81,-2183.22,8640.65
2598182919589495296,2020-11,252.38,4536.69,1168.81,6646.52,-9762.02,-1121.37
2598182919589495296,2020-12,117.44,5649.85,8543.15,4167.7,-1156.96,-2278.33
2599634215174645760,2020-01,2488.41,787.68,5748.4,479.02,6970.11,6970.11
2599634215174645760,2020-02,4353.43,5700.21,2263.92,3864.17,-2947.03,4023.08
2599634215174645760,2020-03,6483.5,4531.55,2813,3017.13,1747.82,5770.9
2599634215174645760,2020-04,6387.9,2723.52,3882.63,5083.73,2463.28,8234.18
2599634215174645760,2020-05,2516.43,2349.99,3745.57,0,3912.01,12146.19
2599634215174645760,2020-06,5559.13,2275.58,2796.17,895.02,5184.7,17330.89
2599634215174645760,2020-07,1444.97,6432.08,2853.52,6503.84,-8637.43,8693.46
2599634215174645760,2020-08,1552.44,917.96,1475.65,2686.65,-576.52,8116.94
2599634215174645760,2020-09,0,3925.63,4812.16,1112.82,-226.29,7890.65
2599634215174645760,2020-10,3289.9,4445.51,10655.33,2751.14,6748.58,14639.23
2599634215174645760,2020-11,5703.87,3986.2,4148.57,2392.5,3473.74,18112.97
2599634215174645760,2020-12,3626.95,4619.11,1443.3,6346.37,-5895.23,12217.74
2602046199033155072,2020-01,4288.21,2534.6,1293.03,3385.18,-338.54,-338.54
2602046199033155072,2020-02,2609.14,413.74,5493.42,1966.86,5721.96,5383.42
2602046199033155072,2020-03,1638.22,1436.46,4680.07,3042.82,1839.01,7222.43
2602046199033155072,2020-04,3433.4,3324.44,1452.49,3573.63,-2012.18,5210.25
2602046199033155072,2020-05,4134,1772.01,692.25,2016.36,1037.88,6248.13
2602046199033155072,2020-06,5475.03,1402.52,2869.95,0,6942.46,13190.59
2602046199033155072,2020-07,0,4457.24,734.26,1191.75,-4914.73,8275.86
2602046199033155072,2020-08,4909.32,2789.1,2789.38,1840.75,3068.85,11344.71
2602046199033155072,2020-09,3310.78,7997.93,1890.5,0,-2796.65,8548.06
2602046199033155072,2020-10,348.3,1030.84,5730.68,1031.79,4016.35,12564.41
2602046199033155072,2020-11,1459.2,1821.56,2390.45,796.62,1231.47,13795.88
2602046199033155072,2020-12,1473.31,2384.51,5183.65,5482.49,-1210.04,12585.84
2602859610314620416,2020-01,673.32,1119.37,482.78,2049.39,-2012.66,-2012.66
2602859610314620416,2020-02,2132.01,3505.06,1683.84,0,310.79,-1701.87
2602859610314620416,2020-03,2735.42,2094.11,1437.25,0,2078.56,376.69
2602859610314620416,2020-04,4412.64,1997.26,1141.16,0,3556.54,3933.23
2602859610314620416,2020-05,0,1749.55,0,1134.54,-2884.09,1049.14
2602859610314620416,2020-06,886.66,1948.98,1171.88,1561.62,-1452.06,-402.92
2602859610314620416,2020-07,3963.89,0,0,1817.39,2146.5,1743.58
2602859610314620416,2020-08,2890.7,0,1038.42,283.2,3645.92,5389.5
2602859610314620416,2020-09,0,931.38,2698.21,1394.63,372.2,5761.7
2602859610314620416,2020-10,1531.96,2926.75,794.87,2712.9,-3312.82,2448.88
2602859610314620416,2020-11,711.88,4251.73,0,978.83,-4518.68,-2069.8
2602859610314620416,2020-12,2104.88,3148.74,1673.63,893.58,-263.81,-2333.61
2603997955443121152,2020-01,1327.17,4382.52,1410.61,1941.28,-3586.02,-3586.02
2603997955443121152,2020-03,1876.41,3593.05,1860.27,1908.95,-1765.32,-5351.34
2603997955443121152,2020-04,1721.83,3370.06,0,2173.21,-3821.44,-9172.78
2603997955443121152,2020-05,3114.79,1741.61,2309.95,2358.93,1324.2,-7848.58
2603997955443121152,2020-06,1069.55,4380.98,5204.16,5425.06,-3532.33,-11380.91
2603997955443121152,2020-07,2333.44,1714.57,3181.67,544.86,3255.68,-8125.23
2603997955443121152,2020-08,4672.56,2787.66,2183.68,0,4068.58,-4056.65
2603997955443121152,2020-09,1221.72,1627.98,4127.77,3770.57,-49.06,-4105.71
2603997955443121152,2020-10,4891.97,6149.2,2364.4,4135.51,-3028.34,-7134.05
2603997955443121152,2020-11,728.56,1551.82,0,5106.06,-5929.32,-13063.37
2603997955443121152,2020-12,852.59,3596.7,227.52,4096.46,-6613.05,-19676.42
2604277422079043072,2020-01,83.67,0,0,2634.07,-2550.4,-2550.4
2604277422079043072,2020-03,0,2381.69,0,1729.73,-4111.42,-6661.82
2604277422079043072,2020-05,1434.53,0,381.46,0,1815.99,-4845.83
2604277422079043072,2020-07,3262.98,0,1812.67,0,5075.65,229.82
2604277422079043072,2020-08,882.45,0,0,1347.95,-465.5,-235.68
2604277422079043072,2020-09,1073.24,0,633.08,0,1706.32,1470.64
2604277422079043072,2020-11,1892.55,1690.39,0,0,202.16,1672.8
2607567766191219200,2020-01,3564.18,6389,2607.39,6901.78,-7119.21,-7119.21
2607567766191219200,2020-02,2995.99,1787.11,2561.57,2829.94,940.51,-6178.7
2607567766191219200,2020-03,4957.63,7206.32,3131.2,2225.72,-1343.21,-7521.91
2607567766191219200,2020-04,3665.44,2575.88,8902.56,6164.44,3827.68,-3694.23
2607567766191219200,2020-05,5405.98,7503.43,7399.03,3193.57,2108.01,-1586.22
2607567766191219200,2020-06,6360.58,3148.06,5739.6,10375.25,-1423.13,-3009.35
2607567766191219200,2020-07,4710.15,1607.55,1915.84,491.82,4526.62,1517.27
2607567766191219200,2020-08,5185.96,4434.85,1007.56,3318.34,-1559.67,-42.4
2607567766191219200,2020-09,2658.8,3497.3,4898.46,1968.78,2091.18,2048.78
2607567766191219200,2020-10,393.21,6482.02,5941.98,2299.07,-2445.9,-397.12
2607567766191219200,2020-11,3273.65,4307.49,3779.92,4842.31,-2096.23,-2493.35
2607567766191219200,2020-12,2652.55,8238.6,4535.49,5508.04,-6558.6,-9051.95
2607829308351379968,2020-01,1857,329,5479.43,6256.95,750.48,750.48
2607829308351379968,2020-02,1235.14,1748.3,6255.19,3540.54,2201.49,2951.97
2607829308351379968,2020-03,4290.1,9033.02,1598.7,5777.35,-8921.57,-5969.6
2607829308351379968,2020-04,4142.84,385.83,5591.02,6884.07,2463.96,-3505.64
2607829308351379968,2020-05,2283.44,4375.27,3573.74,2232.82,-750.91,-4256.55
2607829308351379968,2020-06,6390.47,1486.66,2002.07,1960.98,4944.9,688.35
2607829308351379968,2020-07,177.03,1221.39,3761.89,4374.83,-1657.3,-968.95
2607829308351379968,2020-08,6052.41,6845.59,504.25,1482.67,-1771.6,-2740.55
2607829308351379968,2020-09,5091.71,6108.68,4377.01,2609.64,750.4,-1990.15
2607829308351379968,2020-10,4228.24,0,4675.96,5531.77,3372.43,1382.28
2607829308351379968,2020-11,4816.72,3247.14,814.43,238.05,2145.96,3528.24
2607829308351379968,2020-12,1879.86,1553.7,5301.09,5735.08,-107.83,3420.41
2609167186961946624,2020-01,3037.19,1997.12,769.16,3861.13,-2051.9,-2051.9
2609167186961946624,2020-02,2512.33,0,1978.39,0,4490.72,2438.82
2609167186961946624,2020-03,726.64,156.45,6079.7,6785.38,-135.49,2303.33
2609167186961946624,2020-04,685.62,4156.83,451.97,4283.1,-7302.34,-4999.01
2609167186961946624,2020-05,917.39,904.63,6512.6,1785.98,4739.38,-259.63
2609167186961946624,2020-06,0,4794.37,3811.74,1136.13,-2118.76,-2378.39
2609167186961946624,2020-07,1924.66,972.7,3022.89,1806.97,2167.88,-210.51
2609167186961946624,2020-08,3440.58,947.28,2847.42,4920.39,420.33,209.82
2609167186961946624,2020-09,58.45,1530.22,5438.15,1150.95,2815.43,3025.25
2609167186961946624,2020-10,2974.67,4817.78,1946.89,2592.88,-2489.1,536.15
2609167186961946624,2020-11,0,3564.39,1089.43,3432.75,-5907.71,-5371.56
2609167186961946624,2020-12,2411.6,3262.74,3093.06,3025.34,-783.42,-6154.98
2609651783432978944,2020-01,2838.92,1466.7,2030.15,0,3402.37,3402.37
2609651783432978944,2020-02,350.64,0,2272.86,2062.71,560.79,3963.16
2609651783432978944,2020-03,4502.17,1600.87,725.45,0,3626.75,7589.91
2609651783432978944,2020-04,0,2529.88,1678.27,1367.42,-2219.03,5370.88
2609651783432978944,2020-05,1735.78,2414.68,0,557.25,-1236.15,4134.73
2609651783432978944,2020-06,1779.96,3878.9,0,3913.29,-6012.23,-1877.5
2609651783432978944,2020-07,3197.95,1980.61,920.36,1718.81,418.89,-1458.61
2609651783432978944,2020-09,3614.66,2217.68,619.97,2501.44,-484.49,-1943.1
2609651783432978944,2020-10,3133.47,0,655.32,2976.3,812.49,-1130.61
2609651783432978944,2020-11,3382.77,0,0,0,3382.77,2252.16
2609651783432978944,2020-12,1971.78,1820.17,1301.51,0,1453.12,3705.28
2610169757516870656,2020-01,7427,2416.82,1968.24,1839.6,5138.82,5138.82
2610169757516870656,2020-02,4805.87,1681.75,2136.75,5458.42,-197.55,4941.27
2610169757516870656,2020-03,2441.21,2887.66,1896.72,1018.29,431.98,5373.25
2610169757516870656,2020-04,8702.53,3467.03,6829.48,860.29,11204.69,16577.94
2610169757516870656,2020-05,4681.21,2156.49,0,6030.4,-3505.68,13072.26
2610169757516870656,2020-06,5683.47,4812.39,3827.77,6449.12,-1750.27,11321.99
2610169757516870656,2020-07,11072.85,4798.22,4107.21,5535.52,4846.32,16168.31
2610169757516870656,2020-08,4043.53,4418.84,1069.33,4944.95,-4250.93,11917.38
2610169757516870656,2020-09,6883.97,6170.35,4091.72,1099.04,3706.3,15623.68
2610169757516870656,2020-10,5306.91,5283.38,2994.3,2836.52,181.31,15804.99
2610169757516870656,2020-11,5325.58,6587.63,1107.76,1050.23,-1204.52,14600.47
2610169757516870656,2020-12,3191.05,805.14,6678.35,2417.94,6646.32,21246.79
2610264128850235392,2020-01,340.25,1968.08,483.28,0,-1144.55,-1144.55
2610264128850235392,2020-02,0,1715.95,1248.69,4617.62,-5084.88,-6229.43
2610264128850235392,2020-04,1687.15,0,1512.83,2688.07,511.91,-5717.52
2610264128850235392,2020-05,0,2267.63,557.25,586.92,-2297.3,-8014.82
2610264128850235392,2020-06,1390.36,1958,1748.77,3455.85,-2274.72,-10289.54
2610264128850235392,2020-07,202.26,1796.47,3397.15,2231.94,-429,-10718.54
2610264128850235392,2020-08,0,1777.68,1458.86,4560.15,-4878.97,-15597.51
2610264128850235392,2020-09,4914.21,0,1844.52,3301.33,3457.4,-12140.11
2610264128850235392,2020-10,5259.41,4227.1,0,3771.96,-2739.65,-14879.76
2610264128850235392,2020-11,3190.79,1907.58,4068.96,2650.09,2702.08,-12177.68
2610264128850235392,2020-12,0,4273.05,2128.92,3592.98,-5737.11,-17914.79
2612505419006441984,2020-01,1161.92,0,1052.07,682.64,1531.35,1531.35
2612505419006441984,2020-02,0,476.96,0,0,-476.96,1054.39
2612505419006441984,2020-03,1901.24,1879.13,2329.71,0,2351.82,3406.21
2612505419006441984,2020-04,1393.57,684.81,384.99,0,1093.75,4499.96
2612505419006441984,2020-05,0,1486.96,314.86,1228.74,-2400.84,2099.12
2612505419006441984,2020-06,0,216.1,0,0,-216.1,1883.02
2612505419006441984,2020-07,2680.2,1012.88,122.85,0,1790.17,3673.19
2612505419006441984,2020-08,0,1394.32,0,0,-1394.32,2278.87
2612505419006441984,2020-09,411.09,1725.66,32.13,0,-1282.44,996.43
2612505419006441984,2020-10,918.29,0,0,885.85,32.44,1028.87
2613299489752445952,2020-01,4043.38,0,0,2188.12,1855.26,1855.26
2613299489752445952,2020-02,1353.85,4874.31,1897.67,1329.24,-2952.03,-1096.77
2613299489752445952,2020-03,0,1246.21,1276.89,20.57,10.11,-1086.66
2613299489752445952,2020-04,939.92,1457.72,3198.49,2459.07,221.62,-865.04
2613299489752445952,2020-05,407.72,4514.64,1642.01,1765.19,-4230.1,-5095.14
2613299489752445952,2020-06,726.4,2663.94,3456.33,1442.5,76.29,-5018.85
2613299489752445952,2020-07,3010.33,889.98,2249.01,3000.65,1368.71,-3650.14
2613299489752445952,2020-08,728,3519.93,6653.23,392.23,3469.07,-181.07
2613299489752445952,2020-09,943.82,1182.73,1114.17,3626.57,-2751.31,-2932.38
2613299489752445952,2020-10,2338.61,3572.89,3529.23,8531.41,-6236.46,-9168.84
2613299489752445952,2020-11,0,5262.61,3408.25,511.92,-2366.28,-11535.12
2613299489752445952,2020-12,3664.31,1750.1,1411.8,1367.15,1958.86,-9576.26
2613546309764546560,2020-01,3188.85,6052.99,646.42,5059.27,-7276.99,-7276.99
2613546309764546560,2020-03,2319.1,1207.31,1374.38,0,2486.17,-4790.82
2613546309764546560,2020-04,2382.79,4201.12,2424.36,1540.21,-934.18,-5725
2613546309764546560,2020-05,2413.31,0,6359.76,2312.25,6460.82,735.82
2613546309764546560,2020-06,3355.49,1729.47,1193.69,2668.45,151.26,887.08
2613546309764546560,2020-07,5214.27,3445.53,1385.9,2795.16,359.48,1246.56
2613546309764546560,2020-08,2220.03,3281.23,0,0,-1061.2,185.36
2613546309764546560,2020-09,794.56,106.52,5226.12,2706.92,3207.24,3392.6
2613546309764546560,2020-10,1693.83,0,1559.21,0,3253.04,6645.64
2613546309764546560,2020-11,2641.1,4495.32,1183.69,2295.86,-2966.39,3679.25
2613546309764546560,2020-12,4405.82,1890.38,1188.37,1169.97,2533.84,6213.09
2614161516695870976,2020-01,769.69,6924.6,815.94,1689.47,-7028.44,-7028.44
2614161516695870976,2020-02,527.46,1639.03,1983.9,0,872.33,-6156.11
2614161516695870976,2020-03,1564.58,0,1783.22,566.59,2781.21,-3374.9
2614161516695870976,2020-05,0,2387.83,2359.73,0,-28.1,-3403
2614161516695870976,2020-06,3381.15,1416.47,1330.64,0,3295.32,-107.68
2614161516695870976,2020-07,1938.89,0,0,0,1938.89,1831.21
2614161516695870976,2020-08,0,957.2,1876.22,5581.56,-4662.54,-2831.33
2614161516695870976,2020-09,3041.03,1594.56,2374.83,2725.68,1095.62,-1735.71
2614161516695870976,2020-10,658.28,1225.05,1468.59,456.77,445.05,-1290.66
2614161516695870976,2020-11,457.35,0,1905.7,1859.55,503.5,-787.16
2614161516695870976,2020-12,0,1842.21,2915.1,305.83,767.06,-20.1
2614286504441269760,2020-01,1584.09,2095.05,1788.53,6638.89,-5361.32,-5361.32
2614286504441269760,2020-02,0,1506.5,1955.92,3493.41,-3043.99,-8405.31
2614286504441269760,2020-03,7266.29,2857.21,0,1825.93,2583.15,-5822.16
2614286504441269760,2020-04,0,661.08,920.51,620.8,-361.37,-6183.53
2614286504441269760,2020-05,250.15,3627.36,0,585.74,-3962.95,-10146.48
2614286504441269760,2020-06,1132.83,3293.83,3864.53,1475.31,228.22,-9918.26
2614286504441269760,2020-07,4213.02,28.68,1923.52,1933.04,4174.82,-5743.44
2614286504441269760,2020-08,817.39,1638.64,2046.29,138.66,1086.38,-4657.06
2614286504441269760,2020-09,2462.08,3084.2,1922.91,4409.75,-3108.96,-7766.02
2614286504441269760,2020-10,1042.66,0,0,2516.48,-1473.82,-9239.84
2614286504441269760,2020-11,2032.49,7642.27,2074.44,589.32,-4124.66,-13364.5
2614286504441269760,2020-12,0,3213.55,2724.57,3962.01,-4450.99,-17815.49
2615426726566059008,2020-01,6900.55,1437.44,1109.38,632.87,5939.62,5939.62
2615426726566059008,2020-02,1708.92,1119.76,0,0,589.16,6528.78
2615426726566059008,2020-03,1263.21,1743.92,1400.86,486.6,433.55,6962.33
2615426726566059008,2020-04,1871.93,0,1788.75,2973.67,687.01,7649.34
2615426726566059008,2020-06,62.81,0,188.96,1336.35,-1084.58,6564.76
2615426726566059008,2020-07,4011.21,2475.45,926.24,0,2462,9026.76
2615426726566059008,2020-08,2508.42,0,1121.7,2136.83,1493.29,10520.05
2615426726566059008,2020-09,1120.85,794.49,1959.4,1570.82,714.94,11234.99
2615426726566059008,2020-10,2091.95,0,148.15,1915.97,324.13,11559.12
2615426726566059008,2020-11,0,1928.93,0,2839.13,-4768.06,6791.06
2615426726566059008,2020-12,2463.54,4613.32,2976.76,2553.58,-1726.6,5064.46
2615490999058176512,2020-01,5711.15,1235.49,3292.68,2825.13,4943.21,4943.21
2615490999058176512,2020-02,2169.45,1582.82,1984.75,1328.19,1243.19,6186.4
2615490999058176512,2020-03,1196.47,507.27,1067.08,3605.42,-1849.14,4337.26
2615490999058176512,2020-04,5236.11,1887.12,2002.69,0,5351.68,9688.94
2615490999058176512,2020-05,1929.8,0,0,0,1929.8,11618.74
2615490999058176512,2020-06,0,3100.86,2701.07,2217.97,-2617.76,9000.98
2615490999058176512,2020-07,1747.93,949.5,128.79,1808.92,-881.7,8119.28
2615490999058176512,2020-08,3392.57,1585.36,2152.69,0,3959.9,12079.18
2615490999058176512,2020-09,3111.16,1434.98,1787.4,2235.29,1228.29,13307.47
2615490999058176512,2020-10,2676.02,4333.21,1491.59,113.8,-279.4,13028.07
2615490999058176512,2020-11,3166.79,4064.78,2380.76,1721.19,-238.42,12789.65
2615490999058176512,2020-12,5410.13,2967.88,938.7,822.62,2558.33,15347.98
2616955668354499584,2020-01,4792.81,1646.99,1946.87,1353.67,3739.02,3739.02
2616955668354499584,2020-02,2617.01,1919.15,2086.78,3391.73,-607.09,3131.93
2616955668354499584,2020-03,3842.45,2814.64,2528.21,1560.29,1995.73,5127.66
2616955668354499584,2020-04,8026.47,5469.16,4280.32,2521.86,4315.77,9443.43
2616955668354499584,2020-05,3522.2,1655.39,6554.29,2977.9,5443.2,14886.63
2616955668354499584,2020-06,198.76,5280.98,2928.03,3253.81,-5408,9478.63
2616955668354499584,2020-07,4868.67,6448.19,1933.34,189.58,164.24,9642.87
2616955668354499584,2020-08,6092.69,4391.96,1881.34,645.73,2936.34,12579.21
2616955668354499584,2020-09,1605.46,0,2734.16,5076.15,-736.53,11842.68
2616955668354499584,2020-10,1146.06,5876.86,1113.9,4576.36,-8193.26,3649.42
2616955668354499584,2020-11,2548.99,3639.15,1359.62,1891.58,-1622.12,2027.3
2616955668354499584,2020-12,5930.22,1835.81,1954.18,2616.14,3432.45,5459.75
2618244491524084736,2020-01,0,990.66,1139.14,0,148.48,148.48
2618244491524084736,2020-02,2869.5,3105.36,1164.2,1370.17,-441.83,-293.35
2618244491524084736,2020-03,581.26,1624.2,691,0,-351.94,-645.29
2618244491524084736,2020-04,2388.87,0,2251.88,1811.79,2828.96,2183.67
2618244491524084736,2020-05,1855.74,311.29,3069.67,2492.24,2121.88,4305.55
2618244491524084736,2020-06,0,3787.7,637.55,1603.81,-4753.96,-448.41
2618244491524084736,2020-07,0,3781.82,0,175.49,-3957.31,-4405.72
2618244491524084736,2020-08,2927.33,2016.91,4405.33,890.69,4425.06,19.34
2618244491524084736,2020-10,2591.1,1810.46,3911.78,0,4692.42,4711.76
2618244491524084736,2020-11,2581.1,935.43,942.13,2675.29,-87.49,4624.27
2618244491524084736,2020-12,1017.4,2488.34,0,1517.56,-2988.5,1635.77
2618266425658075648,2020-03,925.33,565.79,0,0,359.54,359.54
2620505955526663680,2020-01,4949.64,3341.44,4402.33,3609.04,2401.49,2401.49
2620505955526663680,2020-02,3422.22,1597.23,2370.26,2573.9,1621.35,4022.84
2620505955526663680,2020-03,1929.26,291.74,5984.58,3090.73,4531.37,8554.21
2620505955526663680,2020-04,4773.49,8790.56,3459.07,7964.83,-8522.83,31.38
2620505955526663680,2020-05,4431.62,3439.04,1352.3,5253.98,-2909.1,-2877.72
2620505955526663680,2020-06,5862.24,4970.78,12811.01,6751.75,6950.72,4073
2620505955526663680,2020-07,3574.21,4627.24,3720.23,7260.78,-4593.58,-520.58
2620505955526663680,2020-08,9025.25,1114.79,0,2300.18,5610.28,5089.7
2620505955526663680,2020-09,4157.44,2782.17,3095.53,4411.42,59.38,5149.08
2620505955526663680,2020-10,5710.31,2653.5,3860.39,3461.11,3456.09,8605.17
2620505955526663680,2020-11,6504.76,3286.03,1463.4,2108.37,2573.76,11178.93
2620505955526663680,2020-12,6948.66,4374.65,2081.99,1862.43,2793.57,13972.5
2620699401776964608,2020-01,349.89,3247.99,2260.66,3284.24,-3921.68,-3921.68
2620699401776964608,2020-02,3530.52,1552.03,4349.23,3371.48,2956.24,-965.44
2620699401776964608,2020-03,4410.43,3812.63,4723.85,1943.34,3378.31,2412.87
2620699401776964608,2020-04,1662.55,1318.41,1581.42,2122.54,-196.98,2215.89
2620699401776964608,2020-05,2146.97,2188.07,1893.41,2531.54,-679.23,1536.66
2620699401776964608,2020-06,3164.87,2954.8,4458.95,1133.22,3535.8,5072.46
2620699401776964608,2020-07,4613.61,2777.33,1543.15,636.21,2743.22,7815.68
2620699401776964608,2020-08,650.94,1835.67,1903.92,1365.95,-646.76,7168.92
2620699401776964608,2020-09,2679.84,3247.53,5389.41,0,4821.72,11990.64
2620699401776964608,2020-10,1779.03,4658.62,2811.08,9291.52,-9360.03,2630.61
2620699401776964608,2020-11,3525.22,4355.05,174.62,6563.14,-7218.35,-4587.74
2620699401776964608,2020-12,3596.42,1713.33,2157.95,676.25,3364.79,-1222.95
2621732630575826432,2020-01,1764.66,1446.15,2687.63,8834.36,-5828.22,-5828.22
2621732630575826432,2020-02,127.31,3024.62,6277.36,2631.42,748.63,-5079.59
2621732630575826432,2020-03,1942.81,5082.01,6181.85,4937.61,-1894.96,-6974.55
2621732630575826432,2020-04,5918.15,217.09,3261.99,3798.81,5164.24,-1810.31
2621732630575826432,2020-05,3812.98,2100.21,100.12,899.27,913.62,-896.69
2621732630575826432,2020-06,3564.65,3120.46,536.54,6097.51,-5116.78,-6013.47
2621732630575826432,2020-07,1920.56,2054.56,4539.81,180.61,4225.2,-1788.27
2621732630575826432,2020-08,2332.23,3445.59,3959.37,4969.38,-2123.37,-3911.64
2621732630575826432,2020-09,2169.58,3254.5,5915.02,2169.63,2660.47,-1251.17
2621732630575826432,2020-10,669.25,1461.5,5628.94,1762.05,3074.64,1823.47
2621732630575826432,2020-11,3853.64,690.32,5021.61,4370.82,3814.11,5637.58
2621732630575826432,2020-12,1990.41,3402.46,1309.39,2860.97,-2963.63,2673.95
2622103965489639424,2020-01,961.34,3240.17,2148.04,2555.78,-2686.57,-2686.57
2622103965489639424,2020-02,2417.31,0,2328.59,793.29,3952.61,1266.04
2622103965489639424,2020-03,1042.42,2259.55,0,2476.13,-3693.26,-2427.22
2622103965489639424,2020-04,5666.15,1285.57,2118.7,644.31,5854.97,3427.75
2622103965489639424,2020-05,1436.96,160.46,848.6,2024.01,101.09,3528.84
2622103965489639424,2020-06,1117.19,0,2741.31,2560.25,1298.25,4827.09
2622103965489639424,2020-07,2894.02,0,948,0,3842.02,8669.11
2622103965489639424,2020-08,991.55,1029.07,610.7,635.53,-62.35,8606.76
2622103965489639424,2020-09,1804.99,0,0,2981.56,-1176.57,7430.19
2622103965489639424,2020-10,3658.93,979.53,1590.03,4719.9,-450.47,6979.72
2622103965489639424,2020-11,0,1338.75,747.65,0,-591.1,6388.62
2622103965489639424,2020-12,3022.01,5591.47,0,0,-2569.46,3819.16
2622339360017297408,2020-01,499.11,2777.06,1771.28,4236.66,-4743.33,-4743.33
2622339360017297408,2020-02,5374.51,6366.46,1028.06,2954.7,-2918.59,-7661.92
2622339360017297408,2020-03,2194.54,6225.21,1629.01,4973.3,-7374.96,-15036.88
2622339360017297408,2020-04,1178.53,0,6077.75,5087.5,2168.78,-12868.1
2622339360017297408,2020-05,1959.79,4975.19,2002.85,2675.76,-3688.31,-16556.41
2622339360017297408,2020-06,4799.79,4773.81,5590.33,1032.75,4583.56,-11972.85
2622339360017297408,2020-07,8473.8,5526.09,6329.65,3283.28,5994.08,-5978.77
2622339360017297408,2020-08,1750.25,6697.33,497.39,560.66,-5010.35,-10989.12
2622339360017297408,2020-09,4522.31,5527.58,5639.43,1896.11,2738.05,-8251.07
2622339360017297408,2020-10,2581.45,3541.51,4221.11,1303.82,1957.23,-6293.84
2622339360017297408,2020-11,4646.47,2443.71,2449.41,2925.22,1726.95,-4566.89
2622339360017297408,2020-12,2168.8,1409.29,888.76,648.15,1000.12,-3566.77
2622677493109980672,2020-01,985.98,0,0,644.14,341.84,341.84
2622677493109980672,2020-02,893.87,0,299.89,0,1193.76,1535.6
2622677493109980672,2020-03,1923.87,0,2369.44,1082.12,3211.19,4746.79
2622677493109980672,2020-05,0,514.51,2332.28,2820.83,-1003.06,3743.73
2622677493109980672,2020-06,1289.93,3473.55,911.7,2291.01,-3562.93,180.8
2622677493109980672,2020-07,172.09,3819.87,2559.7,0,-1088.08,-907.28
2622677493109980672,2020-08,381.72,5244.88,5418.08,0,554.92,-352.36
2622677493109980672,2020-09,2915.22,1166.07,1678.48,2555.23,872.4,520.04
2622677493109980672,2020-10,3502.14,0,90.04,3651.86,-59.68,460.36
2622677493109980672,2020-11,1450.67,0,647.17,364.82,1733.02,2193.38
2622677493109980672,2020-12,3235.84,1957.73,0,0,1278.11,3471.49
2625891806053430784,2020-01,1933.94,2311.04,2608.85,4589.84,-2358.09,-2358.09
2625891806053430784,2020-02,1572.73,0,7067.61,4831.54,3808.8,1450.71
2625891806053430784,2020-03,1358.3,6952.12,5163.38,4020.08,-4450.52,-2999.81
2625891806053430784,2020-04,3232.27,2717.33,4408.67,5909.54,-985.93,-3985.74
2625891806053430784,2020-05,12112.71,1601.23,3778.36,507.75,13782.09,9796.35
2625891806053430784,2020-06,3853.32,1774.06,4199.51,2937.07,3341.7,13138.05
2625891806053430784,2020-07,2967.61,6433.69,201.42,894.38,-4159.04,8979.01
2625891806053430784,2020-08,6278.99,3767.89,7286.42,4016.9,5780.62,14759.63
2625891806053430784,2020-09,3674.11,1198.7,1346.97,6826.71,-3004.33,11755.3
2625891806053430784,2020-10,4796.18,2474.79,6.44,6215.46,-3887.63,7867.67
2625891806053430784,2020-11,6373.44,7832.55,2946.88,2766.05,-1278.28,6589.39
2625891806053430784,2020-12,2813.49,4304.5,4269.36,3021.34,-242.99,6346.4
2626984267042284032,2020-01,2657.49,1338.26,3968.06,3642.94,1644.35,1644.35
2626984267042284032,2020-02,957.08,3778.32,4395.69,5124.15,-3549.7,-1905.35
2626984267042284032,2020-03,2329.79,168.85,902.26,1967.91,1095.29,-810.06
2626984267042284032,2020-04,2199.63,5925.05,678.67,7713.73,-10760.48,-11570.54
2626984267042284032,2020-05,387.33,4634,3430.66,4179.33,-4995.34,-16565.88
2626984267042284032,2020-06,2804.25,6413.81,4645.34,2524.87,-1489.09,-18054.97
2626984267042284032,2020-07,1438.89,6602.76,8294.99,5530.36,-2399.24,-20454.21
2626984267042284032,2020-08,945.06,6.06,5948.8,0,6887.8,-13566.41
2626984267042284032,2020-09,3647.33,681.68,4017.14,3368.01,3614.78,-9951.63
2626984267042284032,2020-10,3010.67,2726.86,2320.1,3375.89,-771.98,-10723.61
2626984267042284032,2020-11,1448.03,2726.39,1517.77,4908.39,-4668.98,-15392.59
2626984267042284032,2020-12,2197.2,7406.54,1177.51,2204.83,-6236.66,-21629.25
2627940527087473664,2020-01,1409.64,2333.3,4834.29,7732.13,-3821.5,-3821.5
2627940527087473664,2020-02,3369.74,1925.73,3131.41,1849.87,2725.55,-1095.95
2627940527087473664,2020-03,0,4306.12,5125.59,7280.82,-6461.35,-7557.3
2627940527087473664,2020-04,1097.14,2850.77,1969.25,695.82,-480.2,-8037.5
2627940527087473664,2020-05,2346.68,5377.04,3349.33,3305.55,-2986.58,-11024.08
2627940527087473664,2020-06,3688.11,1191.29,4418.89,7428.24,-512.53,-11536.61
2627940527087473664,2020-07,0,4695.1,5463.41,4307.57,-3539.26,-15075.87
2627940527087473664,2020-08,4912.53,0,4341.82,2277.69,6976.66,-8099.21
2627940527087473664,2020-09,2192.41,1628.44,540.34,3465.28,-2360.97,-10460.18
2627940527087473664,2020-10,3248.76,8150.12,3849.11,7112.17,-8164.42,-18624.6
2627940527087473664,2020-11,573.22,3853.42,4260.19,2207.85,-1227.86,-19852.46
2627940527087473664,2020-12,372.62,6375.78,2776.89,2760.44,-5986.71,-25839.17
2627962088698975744,2020-01,8274.96,5387.32,6696.35,9076.92,507.07,507.07
2627962088698975744,2020-02,5601.42,3725.76,1951.97,2469.35,1358.28,1865.35
2627962088698975744,2020-03,7164.3,6024.49,5051.79,6376.74,-185.14,1680.21
2627962088698975744,2020-04,5529.97,7079.69,8149.19,975.71,5623.76,7303.97
2627962088698975744,2020-05,8236.49,3780.05,4245.67,8058.72,643.39,7947.36
2627962088698975744,2020-06,13080.25,4801.43,5659,3183.78,10754.04,18701.4
2627962088698975744,2020-07,1220.56,4678.66,3458.94,8071.92,-8071.08,10630.32
2627962088698975744,2020-08,2885.26,7351.16,4328.65,4943.42,-5080.67,5549.65
2627962088698975744,2020-09,71.19,3335.7,3238.36,4238.93,-4265.08,1284.57
2627962088698975744,2020-10,5442.5,8372.77,1946.35,616.75,-1600.67,-316.1
2627962088698975744,2020-11,6207.25,572.98,2548.83,5412.4,2770.7,2454.6
2627962088698975744,2020-12,3257.54,12549.49,1592.82,497.09,-8196.22,-5741.62
2628495063082174976,2020-01,315.85,235.86,2372.62,1780.1,672.51,672.51
2628495063082174976,2020-02,1912.75,0,1413.06,307.21,3018.6,3691.11
2628495063082174976,2020-03,3366.77,1278.78,3788.03,2659.96,3216.06,6907.17
2628495063082174976,2020-04,2297.62,2756.85,3768.47,4737.67,-1428.43,5478.74
2628495063082174976,2020-05,1396.5,4276.06,4079.04,0,1199.48,6678.22
2628495063082174976,2020-06,4977.24,1830.58,1676.75,941.12,3882.29,10560.51
2628495063082174976,2020-07,1195.99,2344.52,4913.51,3583.09,181.89,10742.4
2628495063082174976,2020-08,1530.22,1069.79,846.1,677.56,628.97,11371.37
2628495063082174976,2020-09,0,3354.96,2030.46,705.96,-2030.46,9340.91
2628495063082174976,2020-10,2821.81,3367.24,321.74,2338.67,-2562.36,6778.55
2628495063082174976,2020-11,2443.33,1374.56,119.5,0,1188.27,7966.82
2628495063082174976,2020-12,1007.43,2131.51,487.32,1078.82,-1715.58,6251.24
2628828024208234496,2020-01,3034.53,694.89,1406.21,1963.96,1781.89,1781.89
2628828024208234496,2020-02,878.51,0,1267.08,4528.8,-2383.21,-601.32
2628828024208234496,2020-03,679.14,1634.4,0,850.36,-1805.62,-2406.94
2628828024208234496,2020-04,3540.95,2469.66,3516.12,1391.02,3196.39,789.45
2628828024208234496,2020-05,4432.93,1377.7,1197.18,0,4252.41,5041.86
2628828024208234496,2020-06,0,148.25,1392.79,83.09,1161.45,6203.31
2628828024208234496,2020-07,78.47,0,0,1747.4,-1668.93,4534.38
2628828024208234496,2020-08,2950.32,0,1004.49,1841.89,2112.92,6647.3
2628828024208234496,2020-09,1951.4,2727.66,3974.96,643.85,2554.85,9202.15
2628828024208234496,2020-10,174.1,1681.71,1092.7,2747.52,-3162.43,6039.72
2628828024208234496,2020-11,0,3529.77,2995.95,1049.62,-1583.44,4456.28
2628828024208234496,2020-12,4538.57,2702.33,2417.13,956.06,3297.31,7753.59
2630546899631622144,2020-02,0,1333.72,1417.48,0,83.76,83.76
2630546899631622144,2020-03,1310.36,0,1728.25,1819.29,1219.32,1303.08
2630546899631622144,2020-04,0,971.64,0,465.47,-1437.11,-134.03
2630546899631622144,2020-11,0,1238.89,0,0,-1238.89,-1372.92
2631555412936298496,2020-03,1957.17,0,0,0,1957.17,1957.17
2631555412936298496,2020-10,1226.49,0,0,0,1226.49,3183.66
2631555412936298496,2020-12,0,725.99,0,0,-725.99,2457.67
2631584320447677440,2020-01,2558.72,2039.23,4499.37,1820.74,3198.12,3198.12
2631584320447677440,2020-02,8615.16,458.07,5041.81,6859.14,6339.76,9537.88
2631584320447677440,2020-03,6464.82,3879.52,5978.93,2766.78,5797.45,15335.33
2631584320447677440,2020-04,4053.19,8134.21,2918.54,3679.56,-4842.04,10493.29
2631584320447677440,2020-05,4619.31,5764.45,3577.52,7014.64,-4582.26,5911.03
2631584320447677440,2020-06,8254.58,3947.72,6195.5,1563.51,8938.85,14849.88
2631584320447677440,2020-07,1109.2,713.16,3639.79,9464.1,-5428.27,9421.61
2631584320447677440,2020-08,4053.81,2556.34,559.92,6565.88,-4508.49,4913.12
2631584320447677440,2020-09,6262.65,3186.62,7266.76,7307.29,3035.5,7948.62
2631584320447677440,2020-10,7180.12,5687.99,10677.69,7104.86,5064.96,13013.58
2631584320447677440,2020-11,4151.88,6602.47,6549.01,2506.06,1592.36,14605.94
2631584320447677440,2020-12,6652.5,4290.82,1795.21,5377.44,-1220.55,13385.39
2631743578048847872,2020-01,5911.02,2012.09,1506.42,4305.61,1099.74,1099.74
2631743578048847872,2020-02,4833.22,2035.24,2048.77,565.28,4281.47,5381.21
2631743578048847872,2020-03,3627.54,2791.99,2581.67,2697.18,720.04,6101.25
2631743578048847872,2020-04,1892.39,3611.93,1869.84,2053.55,-1903.25,4198
2631743578048847872,2020-05,2009.38,2473.07,4154.17,2383.07,1307.41,5505.41
2631743578048847872,2020-06,5723.05,1191.53,2765.64,3600.47,3696.69,9202.1
2631743578048847872,2020-07,6369.8,763.85,1860.89,0,7466.84,16668.94
2631743578048847872,2020-08,0,2013.6,5336.08,836.87,2485.61,19154.55
2631743578048847872,2020-09,1575.88,7506.95,4476.73,1172.46,-2626.8,16527.75
2631743578048847872,2020-10,4366.42,6525.45,2762.3,4052.06,-3448.79,13078.96
2631743578048847872,2020-11,3370.06,2277.32,2085.62,1383.51,1794.85,14873.81
2631743578048847872,2020-12,7743.06,1249.33,4139.86,3049.69,7583.9,22457.71
2632693832165278208,2020-01,1758.9,1690.66,0,0,68.24,68.24
2632693832165278208,2020-02,0,1155.24,0,200.45,-1355.69,-1287.45
2632693832165278208,2020-03,0,1636.18,404.31,0,-1231.87,-2519.32
2632693832165278208,2020-04,1267.86,0,0,0,1267.86,-1251.46
2632693832165278208,2020-05,0,758.02,2154.92,0,1396.9,145.44
2632693832165278208,2020-06,1402.12,0,1976.66,2679.38,699.4,844.84
2632693832165278208,2020-07,755.4,743.77,1994.62,0,2006.25,2851.09
2632693832165278208,2020-08,1647.54,2795.18,1869.23,2476.89,-1755.3,1095.79
2632693832165278208,2020-09,4002.64,0,580.76,0,4583.4,5679.19
2632693832165278208,2020-10,0,1534,859.73,88.39,-762.66,4916.53
2632693832165278208,2020-11,0,1175.24,0,0,-1175.24,3741.29
2632693832165278208,2020-12,1367.24,886.84,0,1783.56,-1303.16,2438.13
2635421896403020800,2020-01,2984.11,2586.89,538.07,0,935.29,935.29
2635421896403020800,2020-02,1213.37,2689.3,0,1228.03,-2703.96,-1768.67
2635421896403020800,2020-03,1364.33,0,0,367.15,997.18,-771.49
2635421896403020800,2020-04,1049.69,406.93,2074.15,56.01,2660.9,1889.41
2635421896403020800,2020-06,1397.88,605.58,0,0,792.3,2681.71
2635421896403020800,2020-07,809.7,0,0,0,809.7,3491.41
2635421896403020800,2020-08,0,1694.16,1653.37,0,-40.79,3450.62
2635421896403020800,2020-09,0,49.78,599.22,1336.95,-787.51,2663.11
2635421896403020800,2020-10,1216.67,1354.66,0,0,-137.99,2525.12
2635421896403020800,2020-11,2087.15,58.34,779.58,895.91,1912.48,4437.6
2635421896403020800,2020-12,0,1130.75,578.4,727.2,-1279.55,3158.05
2636020295355460608,2020-01,1659.58,2055.33,5198.11,3135.9,1666.46,1666.46
2636020295355460608,2020-02,3628.7,1779.2,5200.15,1954.66,5094.99,6761.45
2636020295355460608,2020-03,4369.74,3504.75,1844.13,1763.84,945.28,7706.73
2636020295355460608,2020-04,2389.74,6516.64,1666.72,0,-2460.18,5246.55
2636020295355460608,2020-05,6884.9,3010.4,0,4671.99,-797.49,4449.06
2636020295355460608,2020-06,640.05,7397.43,0,4261.36,-11018.74,-6569.68
2636020295355460608,2020-07,6952.33,1844.58,6122.26,1980.88,9249.13,2679.45
2636020295355460608,2020-08,1826.61,126.73,6030.52,2654.59,5075.81,7755.26
2636020295355460608,2020-09,3799.07,3565.4,7315.03,1164.36,6384.34,14139.6
2636020295355460608,2020-10,2605.45,2512.25,0,1921.8,-1828.6,12311
2636020295355460608,2020-11,2314.06,6046.34,10473.39,3602.21,3138.9,15449.9
2636020295355460608,2020-12,1938.07,3716.33,3822.73,3287.86,-1243.39,14206.51
2637406138806737408,2020-10,0,1128.9,0,0,-1128.9,-1128.9
2637406138806737408,2020-11,0,762.44,1353.42,0,590.98,-537.92
2638489057289999872,2020-01,1656.65,2217.73,5170.1,1804.86,2804.16,2804.16
2638489057289999872,2020-02,0,1639.78,0,2186.15,-3825.93,-1021.77
2638489057289999872,2020-03,2305.95,1633.18,3384.03,4354.5,-297.7,-1319.47
2638489057289999872,2020-04,2975.03,806.29,0,3454.96,-1286.22,-2605.69
2638489057289999872,2020-05,1730.81,4232.47,1880.74,2268.46,-2889.38,-5495.07
2638489057289999872,2020-06,84.36,0,89.77,1145.51,-971.38,-6466.45
2638489057289999872,2020-07,2526.21,4293.91,3000.97,5669.59,-4436.32,-10902.77
2638489057289999872,2020-08,1480.69,3599.22,297.94,2881.61,-4702.2,-15604.97
2638489057289999872,2020-09,0,1214.43,660.29,1850.36,-2404.5,-18009.47
2638489057289999872,2020-10,2035.81,766.02,1473,1662.23,1080.56,-16928.91
2638489057289999872,2020-11,5286.32,3906.89,0,0,1379.43,-15549.48
2638489057289999872,2020-12,2328.25,2225.29,3469.73,1678.85,1893.84,-13655.64
2638650198726993408,2020-01,0,149.74,0,0,-149.74,-149.74
2638650198726993408,2020-02,1903.66,0,0,1483,420.66,270.92
2638650198726993408,2020-04,855.83,193.42,0,0,662.41,933.33
2638650198726993408,2020-05,0,1554.82,0,0,-1554.82,-621.49
2638650198726993408,2020-07,292.95,0,76.4,0,369.35,-252.14
2638650198726993408,2020-08,0,418.29,0,640.37,-1058.66,-1310.8
2638650198726993408,2020-09,1986.04,122.45,1811.2,0,3674.79,2363.99
2638650198726993408,2020-10,0,150.7,0,1273.7,-1424.4,939.59
2638650198726993408,2020-12,0,320.57,0,0,-320.57,619.02
2639262233026621952,2020-01,1711.22,0,7255.65,3317.57,5649.3,5649.3
2639262233026621952,2020-02,1994.31,509.3,4877.82,874.89,5487.94,11137.24
2639262233026621952,2020-03,3285.44,5002.65,1334.75,728.49,-1110.95,10026.29
2639262233026621952,2020-04,3297.49,1621.04,0,2785.66,-1109.21,8917.08
2639262233026621952,2020-05,1347.73,3810.22,2827.52,4628.2,-4263.17,4653.91
2639262233026621952,2020-06,1025.77,2371.27,754.25,862.86,-1454.11,3199.8
2639262233026621952,2020-07,6890.03,0,1100.68,0,7990.71,11190.51
2639262233026621952,2020-08,1668.59,1587.26,3206.08,2078.62,1208.79,12399.3
2639262233026621952,2020-09,1969.68,2091.49,3581.14,3725.29,-265.96,12133.34
2639262233026621952,2020-10,4243.5,418.58,3480.88,6317.61,988.19,13121.53
2639262233026621952,2020-11,2609.09,2024.56,421.36,3323.76,-2317.87,10803.66
2639262233026621952,2020-12,0,1733.19,1495.14,1787.15,-2025.2,8778.46
2642667715248969728,2020-01,1916.09,3978.68,3355.49,3103.75,-1810.85,-1810.85
2642667715248969728,2020-02,3317.23,3083.24,710.65,3891.39,-2946.75,-4757.6
2642667715248969728,2020-03,1625.95,1016.7,1856.42,3087.27,-621.6,-5379.2
2642667715248969728,2020-04,2346,491.88,1762.23,0,3616.35,-1762.85
2642667715248969728,2020-05,2471.98,3642.53,1416.43,0,245.88,-1516.97
2642667715248969728,2020-06,0,2013.76,992.65,2762.8,-3783.91,-5300.88
2642667715248969728,2020-07,692.48,2306.22,5963.07,2849.94,1499.39,-3801.49
2642667715248969728,2020-08,2241.98,3142.05,2772.44,3779.93,-1907.56,-5709.05
2642667715248969728,2020-09,5692.97,1361.86,3677.56,3754.5,4254.17,-1454.88
2642667715248969728,2020-10,1410.07,4933.85,3838.47,388.37,-73.68,-1528.56
2642667715248969728,2020-11,2996.64,2254.19,4997.22,4992.14,747.53,-781.03
2642667715248969728,2020-12,1064.38,4429.76,5169.61,0,1804.23,1023.2
2644113871722194944,2020-01,1767.17,0,0,0,1767.17,1767.17
2644113871722194944,2020-02,0,2217.39,0,0,-2217.39,-450.22
2644113871722194944,2020-03,275.21,0,1538.4,0,1813.61,1363.39
2644113871722194944,2020-04,492,0,0,0,492,1855.39
2644113871722194944,2020-06,1895.5,0,1306.83,0,3202.33,5057.72
2644113871722194944,2020-07,1306.78,592.28,502.32,1487.9,-271.08,4786.64
2644113871722194944,2020-08,3484.29,0,1737.03,0,5221.32,10007.96
2644113871722194944,2020-09,0,1368.34,0,1275.82,-2644.16,7363.8
2644113871722194944,2020-10,0,1237.39,322.49,0,-914.9,6448.9
2644113871722194944,2020-12,617,0,0,1959.71,-1342.71,5106.19
2645413083503904256,2020-01,626.52,2238.99,3802.63,8446.23,-6256.07,-6256.07
2645413083503904256,2020-02,4319.09,8077.86,5090.53,4879.56,-3547.8,-9803.87
2645413083503904256,2020-03,4682.01,3138.86,2340.61,5032.51,-1148.75,-10952.62
2645413083503904256,2020-04,1785,6836.04,3932.21,7304.87,-8423.7,-19376.32
2645413083503904256,2020-05,2280.65,2779.87,3585.85,1084.58,2002.05,-17374.27
2645413083503904256,2020-06,5349.53,8198.12,1862.11,3476.79,-4463.27,-21837.54
2645413083503904256,2020-07,3635.03,5056.41,2151.56,1728.48,-998.3,-22835.84
2645413083503904256,2020-08,4876.62,1008.6,7733.68,6365.67,5236.03,-17599.81
2645413083503904256,2020-09,7655.56,7274.95,688.81,5184.39,-4114.97,-21714.78
2645413083503904256,2020-10,5575.29,2885.54,7861.6,4728.5,5822.85,-15891.93
2645413083503904256,2020-11,4332.28,5882.67,10128.55,5944.3,2633.86,-13258.07
2645413083503904256,2020-12,7179.89,5126.79,6902.4,8814.46,141.04,-13117.03
2648176911800016384,2020-02,0,875.89,0,0,-875.89,-875.89
2648176911800016384,2020-03,983.81,0,0,0,983.81,107.92
2648176911800016384,2020-04,1425.63,69.13,0,0,1356.5,1464.42
2648176911800016384,2020-08,1262.82,688.88,0,0,573.94,2038.36
2648176911800016384,2020-09,0,427.73,0,604.46,-1032.19,1006.17
2648176911800016384,2020-10,667.88,0,1745.33,0,2413.21,3419.38
2648223594158565888,2020-01,3476.98,3988.25,2865.29,1528.4,825.62,825.62
2648223594158565888,2020-02,3161.23,397.34,1879.27,4926.63,-283.47,542.15
2648223594158565888,2020-03,3535.36,6138,162.85,4542.23,-6982.02,-6439.87
2648223594158565888,2020-04,2422.93,7437.97,4783.27,2429.13,-2660.9,-9100.77
2648223594158565888,2020-05,1662.62,5134.1,4002.38,4212.64,-3681.74,-12782.51
2648223594158565888,2020-06,1445.73,1943.9,6206.41,1775.61,3932.63,-8849.88
2648223594158565888,2020-07,4170.89,2062.45,6206.23,4599.11,3715.56,-5134.32
2648223594158565888,2020-08,277.27,3346.26,3334.83,4968.34,-4702.5,-9836.82
2648223594158565888,2020-09,790.26,1234.19,1380.69,6387.66,-5450.9,-15287.72
2648223594158565888,2020-10,8987.4,1783.85,1824.28,2237.91,6789.92,-8497.8
2648223594158565888,2020-11,2167.91,6601.74,1374,5984.37,-9044.2,-17542
2648223594158565888,2020-12,566.27,1562.31,3744.89,3404.16,-655.31,-18197.31
2648806172590853632,2020-01,808.94,5399.14,3718.82,5584.76,-6456.14,-6456.14
2648806172590853632,2020-02,5519.18,4485.07,3915.48,2264.78,2684.81,-3771.33
2648806172590853632,2020-03,3076.83,4366.42,4645.3,5657.35,-2301.64,-6072.97
2648806172590853632,2020-04,8509.49,6448.95,850.32,5839.98,-2929.12,-9002.09
2648806172590853632,2020-05,4244.95,5389.21,4671.43,9775.31,-6248.14,-15250.23
2648806172590853632,2020-06,3703.07,2790.69,2304.9,9453.29,-6236.01,-21486.24
2648806172590853632,2020-07,2984.1,6013.82,5954.68,8476.8,-5551.84,-27038.08
2648806172590853632,2020-08,7723.52,6400.09,5679.85,3375.41,3627.87,-23410.21
2648806172590853632,2020-09,3855.38,7065.42,4368.77,3435.19,-2276.46,-25686.67
2648806172590853632,2020-10,8860.85,4761.35,4452.26,7844.82,706.94,-24979.73
2648806172590853632,2020-11,3523.15,7363.38,7119.5,3628.53,-349.26,-25328.99
2648806172590853632,2020-12,326.5,8466.18,2135.21,3954.92,-9959.39,-35288.38
2648828207218422272,2020-01,2305.43,3730.41,1233.6,4517.5,-4708.88,-4708.88
2648828207218422272,2020-02,1312.92,4152.32,881.27,772.11,-2730.24,-7439.12
2648828207218422272,2020-03,2206.39,2979.68,0,921.81,-1695.1,-9134.22
2648828207218422272,2020-04,4730.21,782.01,7788.49,3460.67,8276.02,-858.2
2648828207218422272,2020-05,6472.73,0,4999.88,5422.87,6049.74,5191.54
2648828207218422272,2020-06,2210.1,2681.7,694.57,2275.74,-2052.77,3138.77
2648828207218422272,2020-07,3653.64,3316.81,770.42,1826.29,-719.04,2419.73
2648828207218422272,2020-08,1170.04,5022.56,1456.05,3938.98,-6335.45,-3915.72
2648828207218422272,2020-09,1447.55,1473.36,2685.2,1246.26,1413.13,-2502.59
2648828207218422272,2020-10,249.94,985.09,1313.09,2776.93,-2198.99,-4701.58
2648828207218422272,2020-11,1304.3,1990.5,2012.51,2774.31,-1448,-6149.58
2648828207218422272,2020-12,2962.5,1503.64,3094.8,445.11,4108.55,-2041.03
2649906874161179136,2020-01,55.28,1181,132.16,0,-993.56,-993.56
2649906874161179136,2020-02,176.64,381.88,185.45,352.69,-372.48,-1366.04
2649906874161179136,2020-03,1498.89,1719.5,49.77,0,-170.84,-1536.88
2649906874161179136,2020-04,1011.7,1775.62,0,0,-763.92,-2300.8
2649906874161179136,2020-05,1956.38,1386.85,2531.23,2798.25,302.51,-1998.29
2649906874161179136,2020-06,2725.71,172.42,0,2959.65,-406.36,-2404.65
2649906874161179136,2020-07,1507.85,0,0,2279.7,-771.85,-3176.5
2649906874161179136,2020-08,0,1308.25,1533.18,0,224.93,-2951.57
2649906874161179136,2020-09,1934.26,0,1864.63,1513.02,2285.87,-665.7
2649906874161179136,2020-10,0,45.32,695.51,763.92,-113.73,-779.43
2649906874161179136,2020-12,2371.71,0,1592.99,2307.13,1657.57,878.14
2650665625744744960,2020-01,11776.4,6490.74,3002.81,6919.49,1368.98,1368.98
2650665625744744960,2020-02,4687.52,5337.92,3726.66,2151.48,924.78,2293.76
2650665625744744960,2020-03,4406.15,4960.06,4242.01,10870.58,-7182.48,-4888.72
2650665625744744960,2020-04,6972.53,1498.21,4697.64,6439.46,3732.5,-1156.22
2650665625744744960,2020-05,8511.34,1353.24,3959.17,7417.57,3699.7,2543.48
2650665625744744960,2020-06,3697.53,4730.27,6904.76,4639.91,1232.11,3775.59
2650665625744744960,2020-07,4178,1887.61,6391.98,6285.79,2396.58,6172.17
2650665625744744960,2020-08,6449.3,3652.21,2551.01,6320.73,-972.63,5199.54
2650665625744744960,2020-09,4379.31,5421.44,5000.25,3719.29,238.83,5438.37
2650665625744744960,2020-10,941.39,6337.98,4986.45,5877.73,-6287.87,-849.5
2650665625744744960,2020-11,3856.42,5715.86,3314.95,2047.75,-592.24,-1441.74
2650665625744744960,2020-12,3357.08,3510.21,6992.32,1633.09,5206.1,3764.36
2650727288443031552,2020-01,293.89,0,0,0,293.89,293.89
2650727288443031552,2020-03,1776.86,1320.33,1977.29,0,2433.82,2727.71
2650727288443031552,2020-06,494.46,2951.52,0,0,-2457.06,270.65
2650727288443031552,2020-07,0,4944.91,154.36,929.81,-5720.36,-5449.71
2650727288443031552,2020-08,1196.47,0,775.31,0,1971.78,-3477.93
2650727288443031552,2020-09,0,1248.33,1636.26,0,387.93,-3090
2650727288443031552,2020-10,0,769.98,288.65,0,-481.33,-3571.33
2650727288443031552,2020-11,388.82,605.12,1580.37,831.7,532.37,-3038.96
2651528631017120768,2020-01,0,4741.13,3229.07,4635.16,-6147.22,-6147.22
2651528631017120768,2020-02,1834.81,192.24,4537.33,6968.44,-788.54,-6935.76
2651528631017120768,2020-03,6104.08,922.93,2034.09,2027.5,5187.74,-1748.02
2651528631017120768,2020-04,538.76,0,1129.75,2673.35,-1004.84,-2752.86
2651528631017120768,2020-05,1529.93,0,1184,2204.39,509.54,-2243.32
2651528631017120768,2020-06,5255.63,6384.25,8351.61,1449.39,5773.6,3530.28
2651528631017120768,2020-07,2294.48,3757.57,1993.91,1709.4,-1178.58,2351.7
2651528631017120768,2020-08,445.82,2731.88,1931.75,2313.76,-2668.07,-316.37
2651528631017120768,2020-09,5162.23,1372.92,1749.64,2389.09,3149.86,2833.49
2651528631017120768,2020-10,1946.91,1517.79,1463.35,6909.46,-5016.99,-2183.5
2651528631017120768,2020-11,2308.27,4718.26,844.32,5182.1,-6747.77,-8931.27
2651528631017120768,2020-12,6053.72,630.34,1255.5,1633.04,5045.84,-3885.43
2652229259915991040,2020-01,4452.58,1660.35,1587.69,4180.51,199.41,199.41
2652229259915991040,2020-02,124.8,34.13,1942.23,2101.53,-68.63,130.78
2652229259915991040,2020-03,4852.78,1797.65,0,1014.46,2040.67,2171.45
2652229259915991040,2020-04,1526.06,234.8,3317.65,1667.56,2941.35,5112.8
2652229259915991040,2020-05,1189.11,1366.44,2873.78,275.34,2421.11,7533.91
2652229259915991040,2020-06,905.59,1254.27,2189.75,0,1841.07,9374.98
2652229259915991040,2020-07,2774.17,1709.49,2721.99,2305.31,1481.36,10856.34
2652229259915991040,2020-08,4833.73,4946.09,605.22,1130.3,-637.44,10218.9
2652229259915991040,2020-09,429.28,1061.69,0,2930.33,-3562.74,6656.16
2652229259915991040,2020-10,0,61.35,596.04,0,534.69,7190.85
2652229259915991040,2020-11,2925.55,1885.39,2757.77,63.38,3734.55,10925.4
2652229259915991040,2020-12,1166.52,3389.62,4489.01,629.13,1636.78,12562.18
2652877647116973056,2020-01,3984.51,5612.08,2103.22,2805.47,-2329.82,-2329.82
2652877647116973056,2020-02,4110.62,0,3513.39,4282.71,3341.3,1011.48
2652877647116973056,2020-03,9705.14,3633.27,5148.96,7435.19,3785.64,4797.12
2652877647116973056,2020-04,392.92,4952.08,1318.63,10039.25,-13279.78,-8482.66
2652877647116973056,2020-05,2232.77,1980.12,2352.74,11335.82,-8730.43,-17213.09
2652877647116973056,2020-06,5766.11,6837.23,5719.31,2732.57,1915.62,-15297.47
2652877647116973056,2020-07,1878.05,4082.21,3790.51,5559.86,-3973.51,-19270.98
2652877647116973056,2020-08,7363.23,5386.86,5040.42,4358.82,2657.97,-16613.01
2652877647116973056,2020-09,3907.7,6397.43,3537.28,1691.28,-643.73,-17256.74
2652877647116973056,2020-10,2465.5,3044.58,2406.89,3874.48,-2046.67,-19303.41
2652877647116973056,2020-11,4442.43,5308.09,4797.66,1195.52,2736.48,-16566.93
2652877647116973056,2020-12,4191.58,6412.28,10078.22,11387.62,-3530.1,-20097.03
2653840381989955584,2020-01,2238.98,89.39,639.68,4298.74,-1509.47,-1509.47
2653840381989955584,2020-02,4482.68,2197.95,3893.76,300.54,5877.95,4368.48
2653840381989955584,2020-03,2652.94,3793.29,1159.24,1728.03,-1709.14,2659.34
2653840381989955584,2020-04,3416.81,763.18,6334.2,2233.97,6753.86,9413.2
2653840381989955584,2020-05,2437.34,0,2667.3,4649.18,455.46,9868.66
2653840381989955584,2020-06,3331.3,3005.99,861.53,1533.75,-346.91,9521.75
2653840381989955584,2020-07,1678.51,229.75,3874.49,8370.9,-3047.65,6474.1
2653840381989955584,2020-08,4590.36,1748.74,2934.09,5177.41,598.3,7072.4
2653840381989955584,2020-09,338.45,6545.38,2248.44,6244.92,-10203.41,-3131.01
2653840381989955584,2020-10,2508.72,0,2688.95,1849.51,3348.16,217.15
2653840381989955584,2020-11,3683.85,2702.25,1377.64,2784.13,-424.89,-207.74
2653840381989955584,2020-12,5287.87,518.92,925.56,1159.96,4534.55,4326.81
2654983840832216064,2020-01,1005.81,4848.15,7082.04,6003.24,-2763.54,-2763.54
2654983840832216064,2020-02,8096.38,4748.65,2850.29,5901.68,296.34,-2467.2
2654983840832216064,2020-03,4461.49,6805.51,1180.36,2520.74,-3684.4,-6151.6
2654983840832216064,2020-04,905.21,5324.45,3807.18,6658.19,-7270.25,-13421.85
2654983840832216064,2020-05,2069.62,3397.94,5387.36,2314.94,1744.1,-11677.75
2654983840832216064,2020-06,3267.94,9434.63,3812.23,11589.82,-13944.28,-25622.03
2654983840832216064,2020-07,300.95,2696.34,6185.44,1657.91,2132.14,-23489.89
2654983840832216064,2020-08,1498.96,3139.37,2897.03,2636.83,-1380.21,-24870.1
2654983840832216064,2020-09,2778.39,4659.11,4427.77,7919.2,-5372.15,-30242.25
2654983840832216064,2020-10,4402.17,5557.14,6107.11,5753.09,-800.95,-31043.2
2654983840832216064,2020-11,5767.86,6352.32,5307.14,4728.22,-5.54,-31048.74
2654983840832216064,2020-12,8957.66,3338.95,6358.64,6682.42,5294.93,-25753.81
2655747263048243712,2020-01,172.05,1269.79,758.92,0,-338.82,-338.82
2655747263048243712,2020-02,1929.48,1129.83,1534.61,0,2334.26,1995.44
2655747263048243712,2020-03,1754.92,1342.23,0,0,412.69,2408.13
2655747263048243712,2020-04,1486.49,353.23,1928.91,0,3062.17,5470.3
2655747263048243712,2020-05,1729.17,1914.06,0,421.18,-606.07,4864.23
2655747263048243712,2020-06,3029.42,792.39,3130.3,1482.9,3884.43,8748.66
2655747263048243712,2020-07,0,641.32,0,0,-641.32,8107.34
2655747263048243712,2020-08,1395.1,0,2607.69,1856.99,2145.8,10253.14
2655747263048243712,2020-09,1981.83,0,334.94,0,2316.77,12569.91
2655747263048243712,2020-10,4275.65,1599.09,4665.49,669.82,6672.23,19242.14
2655747263048243712,2020-11,0,890.54,3279.05,1137.42,1251.09,20493.23
2655747263048243712,2020-12,517.55,0,1305.9,3521.04,-1697.59,18795.64
2655874270176222720,2020-04,1340.17,0,0,0,1340.17,1340.17
2655874270176222720,2020-05,0,2404.57,0,0,-2404.57,-1064.4
2655874270176222720,2020-07,1975.99,1422.6,0,0,553.39,-511.01
2655874270176222720,2020-09,820.06,0,0,0,820.06,309.05
2656213396702935552,2020-01,2598.1,6935.75,4366.86,6447.23,-6418.02,-6418.02
2656213396702935552,2020-02,1613.41,0,0,1550.36,63.05,-6354.97
2656213396702935552,2020-03,1676.29,18.06,4910.32,2549.65,4018.9,-2336.07
2656213396702935552,2020-04,1023.63,645.46,1933.44,1596.49,715.12,-1620.95
2656213396702935552,2020-05,727.63,2781.46,1104.98,11.95,-960.8,-2581.75
2656213396702935552,2020-06,309.5,1646.8,875.02,1587.57,-2049.85,-4631.6
2656213396702935552,2020-07,1954.13,3732.02,0,3145.33,-4923.22,-9554.82
2656213396702935552,2020-08,1062.18,0,1750.9,4531.17,-1718.09,-11272.91
2656213396702935552,2020-09,0,5595.74,2543.69,96.3,-3148.35,-14421.26
2656213396702935552,2020-10,0,1684.63,4795.52,1588.89,1522,-12899.26
2656213396702935552,2020-11,3033.01,4150.59,1021.87,517.46,-613.17,-13512.43
2656213396702935552,2020-12,3531.44,946.11,0,1230.76,1354.57,-12157.86
2657012967310373888,2020-01,0,1487.47,0,0,-1487.47,-1487.47
2657012967310373888,2020-05,0,1971.91,1152.77,1987.59,-2806.73,-4294.2
2657012967310373888,2020-06,0,1490.35,0,0,-1490.35,-5784.55
2657012967310373888,2020-07,0,27.63,2786.27,0,2758.64,-3025.91
2657012967310373888,2020-08,1568.54,0,0,0,1568.54,-1457.37
2657012967310373888,2020-10,0,728.78,0,0,-728.78,-2186.15
2657012967310373888,2020-12,0,1947.35,0,0,-1947.35,-4133.5
2657620145787417600,2020-01,705.44,1608,0,0,-902.56,-902.56
2657620145787417600,2020-02,838.51,0,0,1980.77,-1142.26,-2044.82
2657620145787417600,2020-10,0,1332.12,155.78,0,-1176.34,-3221.16
2657620145787417600,2020-11,0,2024.09,0,0,-2024.09,-5245.25
2658314563941461504,2020-01,6508.57,4177.21,2423.35,3294.81,1459.9,1459.9
2658314563941461504,2020-02,10055.14,6156.92,1039.65,2609.34,2328.53,3788.43
2658314563941461504,2020-03,9523.86,2390.52,7312.45,6312.06,8133.73,11922.16
2658314563941461504,2020-04,2538.44,4482.4,2315.2,2847.81,-2476.57,9445.59
2658314563941461504,2020-05,5271.17,3237.69,3243.33,8603.7,-3326.89,6118.7
2658314563941461504,2020-06,3654.74,2430.61,5659.8,2901.56,3982.37,10101.07
2658314563941461504,2020-07,6109.84,9146.17,5625.02,6113.49,-3524.8,6576.27
2658314563941461504,2020-08,3141.07,9230.6,8463.79,3193.51,-819.25,5757.02
2658314563941461504,2020-09,8551.77,2925.94,2923.4,1897.32,6651.91,12408.93
2658314563941461504,2020-10,11479.71,2753.02,2849.41,6506.66,5069.44,17478.37
2658314563941461504,2020-11,4813.07,10511.23,4607.55,2647.85,-3738.46,13739.91
2658314563941461504,2020-12,2173.64,3200.04,2941.69,8291.92,-6376.63,7363.28
2659035683531739648,2020-01,349.34,0,1529.02,1534.02,344.34,344.34
2659035683531739648,2020-03,2549.92,1911.99,0,407.82,230.11,574.45
2659035683531739648,2020-04,1079.01,1116.52,1576.25,1994.91,-456.17,118.28
2659035683531739648,2020-05,0,198.84,0,0,-198.84,-80.56
2659035683531739648,2020-06,964.49,306.67,1992.64,305.36,2345.1,2264.54
2659035683531739648,2020-07,2062.69,501.03,0,0,1561.66,3826.2
2659035683531739648,2020-08,120.25,0,0,930.28,-810.03,3016.17
2659035683531739648,2020-10,441.41,1003.79,3953.92,0,3391.54,6407.71
2659035683531739648,2020-11,0,690.5,0,952.39,-1642.89,4764.82
2659035683531739648,2020-12,197.87,0,0,0,197.87,4962.69
2659310683554706432,2020-01,1777.84,2937.8,827.81,3864.46,-4196.61,-4196.61
2659310683554706432,2020-03,2313.72,1670.49,3109.18,1100.37,2652.04,-1544.57
2659310683554706432,2020-04,2024.66,4210.54,1433.88,1560.65,-2312.65,-3857.22
2659310683554706432,2020-05,1698.76,953.55,2224.25,3148.12,-178.66,-4035.88
2659310683554706432,2020-06,2944.23,2032.72,2909.05,37.24,3783.32,-252.56
2659310683554706432,2020-07,4279.97,3137.97,480.63,0,1622.63,1370.07
2659310683554706432,2020-08,0,1468.27,2089.82,5353.82,-4732.27,-3362.2
2659310683554706432,2020-09,1780.73,1393.07,3844.33,0,4231.99,869.79
2659310683554706432,2020-10,2959.83,1694.68,1749.54,1868.16,1146.53,2016.32
2659310683554706432,2020-11,4747.86,1406,3271.84,4369.22,2244.48,4260.8
2659310683554706432,2020-12,3332.99,796.2,6086.55,2983.85,5639.49,9900.29
2659530639821317120,2020-01,0,2799.46,1607.03,2755.47,-3947.9,-3947.9
2659530639821317120,2020-02,5106.7,623.1,3826.76,3871.89,4438.47,490.57
2659530639821317120,2020-03,4577.88,2201.02,3365.72,0,5742.58,6233.15
2659530639821317120,2020-04,270.11,1197.52,2343.94,1185.72,230.81,6463.96
2659530639821317120,2020-05,2997.85,2690.35,496.49,1582.62,-778.63,5685.33
2659530639821317120,2020-06,4193.54,537.35,0,3532.94,123.25,5808.58
2659530639821317120,2020-07,445.78,3007.21,809.71,1579.89,-3331.61,2476.97
2659530639821317120,2020-08,521.16,2455.63,4936.65,0,3002.18,5479.15
2659530639821317120,2020-09,2366.47,2311.08,4907.1,3614.52,1347.97,6827.12
2659530639821317120,2020-10,3638.89,1555.97,3595.65,3903.48,1775.09,8602.21
2659530639821317120,2020-11,2711.81,1166.46,805.48,2160.57,190.26,8792.47
2659530639821317120,2020-12,2332.99,1119.44,3243.82,1510.97,2946.4,11738.87
2660431624894492160,2020-01,3022.47,0,1382.59,0,4405.06,4405.06
2660431624894492160,2020-02,25.08,1497.24,0,2646.51,-4118.67,286.39
2660431624894492160,2020-03,0,797.4,0,0,-797.4,-511.01
2660431624894492160,2020-04,3171.68,1801.45,925.18,0,2295.41,1784.4
2660431624894492160,2020-05,557.36,1916.11,0,866.45,-2225.2,-440.8
2660431624894492160,2020-06,215.07,1452.76,0,934.97,-2172.66,-2613.46
2660431624894492160,2020-07,1343.75,1247.81,661.35,0,757.29,-1856.17
2660431624894492160,2020-08,1991.44,369.42,0,0,1622.02,-234.15
2660431624894492160,2020-09,0,1965.85,2564.52,0,598.67,364.52
2660431624894492160,2020-10,287.08,2029.87,1308.62,0,-434.17,-69.65
2660431624894492160,2020-11,1948.17,2742.99,0,35.61,-830.43,-900.08
2660939917335598080,2020-01,1980.11,1902.52,3181.34,1070.37,2188.56,2188.56
2660939917335598080,2020-02,2917.13,2037.42,1485.74,1801.37,564.08,2752.64
2660939917335598080,2020-03,1841.63,1194.4,1262.1,4592.28,-2682.95,69.69
2660939917335598080,2020-04,1026.93,3442.54,860.09,2145.3,-3700.82,-3631.13
2660939917335598080,2020-05,2825.89,3980.36,5599.73,3928.82,516.44,-3114.69
2660939917335598080,2020-06,3165.17,1657.53,1813.32,367.41,2953.55,-161.14
2660939917335598080,2020-07,3915.62,1436.83,1548.87,2357.31,1670.35,1509.21
2660939917335598080,2020-08,1476.48,4661.61,1567.32,2360.46,-3978.27,-2469.06
2660939917335598080,2020-09,5957.02,3210.94,2843.38,3110.78,2478.68,9.62
2660939917335598080,2020-10,801.59,0,590.1,4910.29,-3518.6,-3508.98
2660939917335598080,2020-11,153.35,3373.95,4690.46,1807.36,-337.5,-3846.48
2660939917335598080,2020-12,3526.88,5162.6,1409.6,3829.12,-4055.24,-7901.72
2661931465608288768,2020-01,23.6,3276.84,3946.56,2263.52,-1570.2,-1570.2
2661931465608288768,2020-02,474.27,2685.02,4171.32,3397.69,-1437.12,-3007.32
2661931465608288768,2020-03,4611.8,4807.66,8494.89,4630.54,3668.49,661.17
2661931465608288768,2020-04,4568.53,1944.65,5966.66,3503.24,5087.3,5748.47
2661931465608288768,2020-05,3403.63,4119.3,5042.31,10518.53,-6191.89,-443.42
2661931465608288768,2020-06,4051.51,8505.18,3390.79,924.57,-1987.45,-2430.87
2661931465608288768,2020-07,11760.63,8195.44,6584.93,10460.51,-310.39,-2741.26
2661931465608288768,2020-08,1039.4,4526.29,4488.73,7832.87,-6831.03,-9572.29
2661931465608288768,2020-09,6141.32,6928.72,75.16,6510.06,-7222.3,-16794.59
2661931465608288768,2020-10,7606.78,3114.74,4946.28,3344.05,6094.27,-10700.32
2661931465608288768,2020-11,1794.12,5867.6,4094.19,5285.4,-5264.69,-15965.01
2661931465608288768,2020-12,2265.56,4657.34,4425.58,1357.34,676.46,-15288.55
2662624053670854144,2020-01,3782.03,619.67,2383.13,608.37,4937.12,4937.12
2662624053670854144,2020-02,0,1617.87,2868.89,2096.05,-845.03,4092.09
2662624053670854144,2020-03,5390.86,3627.65,10515.69,603.96,11674.94,15767.03
2662624053670854144,2020-04,6943.12,2196.15,3386.41,2316.66,5816.72,21583.75
2662624053670854144,2020-05,3540.76,1791.03,1876.08,2751.36,874.45,22458.2
2662624053670854144,2020-06,4627.91,0,3115.29,7255.02,488.18,22946.38
2662624053670854144,2020-07,1124.17,4226.31,1882.44,2069.69,-3289.39,19656.99
2662624053670854144,2020-08,0,1587.03,3730.55,3214.63,-1071.11,18585.88
2662624053670854144,2020-09,4694.69,0,7239.48,3583.14,8351.03,26936.91
2662624053670854144,2020-10,0,2918.1,1876.35,3841.05,-4882.8,22054.11
2662624053670854144,2020-11,1685.11,2126.68,1901.43,1753.51,-293.65,21760.46
2662624053670854144,2020-12,6641.12,1130.28,0,3389.17,2121.67,23882.13
2662944240587158528,2020-01,583.76,3628.18,1488.52,940.28,-2496.18,-2496.18
2662944240587158528,2020-02,3075.7,2829.7,332.66,1026.06,-447.4,-2943.58
2662944240587158528,2020-03,1189.78,1620.48,898.32,2035.75,-1568.13,-4511.71
2662944240587158528,2020-04,3025.56,1636.67,2858.62,1302.32,2945.19,-1566.52
2662944240587158528,2020-05,0,855.1,1524.37,5657.7,-4988.43,-6554.95
2662944240587158528,2020-06,1857.52,289.21,762.45,1560.98,769.78,-5785.17
2662944240587158528,2020-07,5799.09,5745.43,187.31,0,240.97,-5544.2
2662944240587158528,2020-08,2891.11,6197.53,2717.64,3696.02,-4284.8,-9829
2662944240587158528,2020-09,2134.19,1796.83,2679.47,0,3016.83,-6812.17
2662944240587158528,2020-10,575.85,1866.44,4407.92,2406.52,710.81,-6101.36
2662944240587158528,2020-11,0,1011,1921.2,1887.17,-976.97,-7078.33
2662944240587158528,2020-12,1318.35,0,1722.62,547.28,2493.69,-4584.64
2663309969228992000,2020-10,1054.5,0,926.8,0,1981.3,1981.3
2663378750488618496,2020-01,3042.83,4280.54,3825.6,5710.09,-3122.2,-3122.2
2663378750488618496,2020-02,1324.78,464.44,4752.58,2952.31,2660.61,-461.59
2663378750488618496,2020-03,4837.19,4327.76,866.33,3200.84,-1825.08,-2286.67
2663378750488618496,2020-04,990.55,1079.42,0,3727.69,-3816.56,-6103.23
2663378750488618496,2020-05,7244.31,3361.68,1218.27,2207.92,2892.98,-3210.25
2663378750488618496,2020-06,900.87,3183.65,0,1747.72,-4030.5,-7240.75
2663378750488618496,2020-07,3579.29,4799.16,1939.13,4862.55,-4143.29,-11384.04
2663378750488618496,2020-08,2724.06,4401.4,719.53,713.4,-1671.21,-13055.25
2663378750488618496,2020-09,9427.1,1832.69,2299.13,4271.01,5622.53,-7432.72
2663378750488618496,2020-10,1705.04,6069.36,4181.09,3891.13,-4074.36,-11507.08
2663378750488618496,2020-11,6845.81,6470.29,2566.51,6463.16,-3521.13,-15028.21
2663378750488618496,2020-12,927.47,1693.83,4945.96,4914.14,-734.54,-15762.75
2664232533639591936,2020-01,2572.77,4352.01,3551.29,3927.77,-2155.72,-2155.72
2664232533639591936,2020-02,3818.15,2476.53,2434.64,3582.62,193.64,-1962.08
2664232533639591936,2020-03,2753.96,9276.2,5165.79,963.18,-2319.63,-4281.71
2664232533639591936,2020-04,2653.29,5881.44,8367.25,7635.58,-2496.48,-6778.19
2664232533639591936,2020-05,6048.79,6403.47,3190.92,1815.12,1021.12,-5757.07
2664232533639591936,2020-06,4890.21,4505.03,2839.26,4960.09,-1735.65,-7492.72
2664232533639591936,2020-07,7316.47,3535.29,5560,6512.87,2828.31,-4664.41
2664232533639591936,2020-08,3076.8,4097.2,1349.65,7073.45,-6744.2,-11408.61
2664232533639591936,2020-09,3570.45,5351.2,4619.46,3408.64,-569.93,-11978.54
2664232533639591936,2020-10,2788.17,3101.25,198.68,4546.98,-4661.38,-16639.92
2664232533639591936,2020-11,12836.12,3822.25,5611.85,3004.77,11620.95,-5018.97
2664232533639591936,2020-12,4395.26,3844.54,3948.7,4679.98,-180.56,-5199.53
2666394854556459008,2020-01,5463.88,0,1547.17,5991.09,1019.96,1019.96
2666394854556459008,2020-02,2137.12,2851.54,1118.38,4889.74,-4485.78,-3465.82
2666394854556459008,2020-03,1572.87,4753.88,518.05,2959.54,-5622.5,-9088.32
2666394854556459008,2020-04,4872.35,2422.09,7927.44,4612.43,5765.27,-3323.05
2666394854556459008,2020-05,3474.65,2366.49,4313.72,3066.56,2355.32,-967.73
2666394854556459008,2020-06,1991.97,4133.25,4421.92,9188.18,-6907.54,-7875.27
2666394854556459008,2020-07,6202.98,3555.82,6031.06,2959.55,5718.67,-2156.6
2666394854556459008,2020-08,1122.12,2668.81,6657.91,0,5111.22,2954.62
2666394854556459008,2020-09,6601.91,5313.61,5147.14,4341.69,2093.75,5048.37
2666394854556459008,2020-10,2487.98,4075.16,6255.94,4566.98,101.78,5150.15
2666394854556459008,2020-11,1045.72,5225.61,4342.82,1633.87,-1470.94,3679.21
2666394854556459008,2020-12,2683.26,2697.95,1240.76,3161.8,-1935.73,1743.48
2666472183670329856,2020-01,0,1138.47,3254.56,3227.96,-1111.87,-1111.87
2666472183670329856,2020-02,1791.6,4011.46,4020.38,1370.15,430.37,-681.5
2666472183670329856,2020-03,0,1255.15,3909.74,0,2654.59,1973.09
2666472183670329856,2020-05,0,121.79,0,1601.95,-1723.74,249.35
2666472183670329856,2020-06,5276.95,2990.68,0,599.39,1686.88,1936.23
2666472183670329856,2020-07,1652.66,2807.9,1748.41,0,593.17,2529.4
2666472183670329856,2020-08,1962.01,0,1150,584.14,2527.87,5057.27
2666472183670329856,2020-09,370.81,1208.33,277.3,1587.86,-2148.08,2909.19
2666472183670329856,2020-10,410.28,0,3150.85,2109.89,1451.24,4360.43
2666472183670329856,2020-11,1127.04,155.13,0,0,971.91,5332.34
2666472183670329856,2020-12,386.87,1698.75,1377.31,0,65.43,5397.77
2666609718618712064,2020-01,8167.09,1678.58,2033.59,6774.05,1748.05,1748.05
2666609718618712064,2020-02,5312.54,3444.85,1544.93,8525.69,-5113.07,-3365.02
2666609718618712064,2020-03,2678.73,2849.76,4334.58,3484.37,679.18,-2685.84
2666609718618712064,2020-04,417.03,4529.71,1800.01,6618.33,-8931,-11616.84
2666609718618712064,2020-05,6090.19,4518.89,2507.01,3569.8,508.51,-11108.33
2666609718618712064,2020-06,1822.04,5858.83,4807.51,975.76,-205.04,-11313.37
2666609718618712064,2020-07,5228.26,583.86,2089.89,3321.42,3412.87,-7900.5
2666609718618712064,2020-08,6153.2,8195.74,4798.24,5583.25,-2827.55,-10728.05
2666609718618712064,2020-09,2193.67,934.56,5885.96,803.09,6341.98,-4386.07
2666609718618712064,2020-10,5187.85,5257.24,7514.71,1212.94,6232.38,1846.31
2666609718618712064,2020-11,2525.69,2725.94,6029.33,5845.48,-16.4,1829.91
2666609718618712064,2020-12,2287.33,4546.01,4451.64,9087.75,-6894.79,-5064.88
2666679887070643200,2020-01,506.75,514.25,0,0,-7.5,-7.5
2666679887070643200,2020-02,718.92,0,179.29,0,898.21,890.71
2666679887070643200,2020-03,3534.5,712.65,0,1827.4,994.45,1885.16
2666679887070643200,2020-05,0,200.97,1950.78,0,1749.81,3634.97
2666679887070643200,2020-06,0,2426.38,1873.25,1618.9,-2172.03,1462.94
2666679887070643200,2020-07,1941.14,1834.72,1258.67,362.94,1002.15,2465.09
2666679887070643200,2020-08,0,1902.41,0,1263.57,-3165.98,-700.89
2666679887070643200,2020-09,0,751.5,0,0,-751.5,-1452.39
2666679887070643200,2020-12,22.11,1788.75,0,10.77,-1777.41,-3229.8
2667084456098471936,2020-01,1479.97,1540.93,8495.86,999.66,7435.24,7435.24
2667084456098471936,2020-02,2945.03,0,2159.7,4126.16,978.57,8413.81
2667084456098471936,2020-03,0,1558.27,6015.37,7081.39,-2624.29,5789.52
2667084456098471936,2020-04,4232.5,1373.62,2575.8,0,5434.68,11224.2
2667084456098471936,2020-05,4893.34,2592.3,2185.36,2235.13,2251.27,13475.47
2667084456098471936,2020-06,4460.49,1085.17,1689.03,3890.24,1174.11,14649.58
2667084456098471936,2020-07,3976.45,3200.35,3535.15,2043.32,2267.93,16917.51
2667084456098471936,2020-08,3023.11,589.9,263.93,661.27,2035.87,18953.38
2667084456098471936,2020-09,5504.89,1344.72,8735.07,1089,11806.24,30759.62
2667084456098471936,2020-10,3294.88,5327.73,3352.63,5077.09,-3757.31,27002.31
2667084456098471936,2020-11,4056.58,2951.35,5018.79,3188.06,2935.96,29938.27
2667084456098471936,2020-12,3148.87,1463.49,2232.45,2941.2,976.63,30914.9
2668232146114368000,2020-01,3576.32,3993.72,3613.67,5661.63,-2465.36,-2465.36
2668232146114368000,2020-02,3913.04,6552.53,4353.84,468.66,1245.69,-1219.67
2668232146114368000,2020-03,9725.04,4342.4,2707.77,6601.21,1489.2,269.53
2668232146114368000,2020-04,4389.54,2334.47,917.47,3807.04,-834.5,-564.97
2668232146114368000,2020-05,6762.17,793.9,3417.84,4468.2,4917.91,4352.94
2668232146114368000,2020-06,967.56,2476.86,3160.14,357.48,1293.36,5646.3
2668232146114368000,2020-07,3894.86,4162.04,544.44,7605.24,-7327.98,-1681.68
2668232146114368000,2020-08,934.76,639.1,3645.29,4131.39,-190.44,-1872.12
2668232146114368000,2020-09,1520.82,4900.09,7096.71,4340.79,-623.35,-2495.47
2668232146114368000,2020-10,5256.8,0,963.84,4102.71,2117.93,-377.54
2668232146114368000,2020-11,1306.56,9438.92,4364.84,4485.42,-8252.94,-8630.48
2668232146114368000,2020-12,1597.86,2966.96,942.18,3957.69,-4384.61,-13015.09
2669566964026446848,2020-01,1486.02,1785.92,6977.67,3324.1,3353.67,3353.67
2669566964026446848,2020-02,1574.13,3198.37,4459.73,121.97,2713.52,6067.19
2669566964026446848,2020-03,8408.52,5309.49,6110.72,2288.47,6921.28,12988.47
2669566964026446848,2020-04,3505.57,0,8337.61,6653.72,5189.46,18177.93
2669566964026446848,2020-05,7020.96,2537.08,751.94,3319.88,1915.94,20093.87
2669566964026446848,2020-06,3580.17,4043.31,3815.49,3020.08,332.27,20426.14
2669566964026446848,2020-07,2617.07,1206.67,9000.62,3582.12,6828.9,27255.04
2669566964026446848,2020-08,3553.89,5674.55,5126.98,2091.52,914.8,28169.84
2669566964026446848,2020-09,3220.21,3407.21,4390.59,6016.98,-1813.39,26356.45
2669566964026446848,2020-10,3478.38,3210.47,5037,1882.8,3422.11,29778.56
2669566964026446848,2020-11,0,10556.1,5297.37,832.63,-6091.36,23687.2
2669566964026446848,2020-12,0,2370.39,4035.36,2309.22,-644.25,23042.95
2671407007307783168,2020-01,2526.51,5023.2,6004,1547.1,1960.21,1960.21
2671407007307783168,2020-02,955.37,152.45,3171.65,2829.14,1145.43,3105.64
2671407007307783168,2020-03,3388.35,1746.36,4960.16,0,6602.15,9707.79
2671407007307783168,2020-04,7006.91,4673.25,1572.15,5431.44,-1525.63,8182.16
2671407007307783168,2020-05,3014.24,10179.15,3068.7,4238.37,-8334.58,-152.42
2671407007307783168,2020-06,0,914.64,5279.73,3454.18,910.91,758.49
2671407007307783168,2020-07,1270.02,6559.49,2317.73,524.37,-3496.11,-2737.62
2671407007307783168,2020-08,1223.41,1636.53,3907.82,1472.41,2022.29,-715.33
2671407007307783168,2020-09,1844.75,2932.62,6946.55,3491.34,2367.34,1652.01
2671407007307783168,2020-10,3970.78,4513.75,3043.67,2352.9,147.8,1799.81
2671407007307783168,2020-11,4364.73,0,0,2291.61,2073.12,3872.93
2671407007307783168,2020-12,1965.85,8997.95,804.21,3642.71,-9870.6,-5997.67
2671595374857391616,2020-01,8000.5,7211.75,7996.83,4343.43,4442.15,4442.15
2671595374857391616,2020-02,1964.4,6836.26,3955.08,2007.51,-2924.29,1517.86
2671595374857391616,2020-03,7781.28,5495.22,6982.05,2051.14,7216.97,8734.83
2671595374857391616,2020-04,1903.99,6008.4,5102,5156.9,-4159.31,4575.52
2671595374857391616,2020-05,5774.54,3830.14,3840.84,731.15,5054.09,9629.61
2671595374857391616,2020-06,0,3680.65,5991.1,3474.84,-1164.39,8465.22
2671595374857391616,2020-07,1730.46,7632.54,1936.72,3640.73,-7606.09,859.13
2671595374857391616,2020-08,8845.05,6874.1,3286.8,2915.94,2341.81,3200.94
2671595374857391616,2020-09,7760.5,3834.47,1479.44,3510.07,1895.4,5096.34
2671595374857391616,2020-10,4139.91,14946.63,3138.58,9695.71,-17363.85,-12267.51
2671595374857391616,2020-11,2035.42,5989.82,3647.36,4309.09,-4616.13,-16883.64
2671595374857391616,2020-12,3151.4,3155.28,6450.41,5294.8,1151.73,-15731.91
2672365251713287168,2020-09,0,715.12,1006.87,0,291.75,291.75
2672365251713287168,2020-10,1838.57,0,0,1127.1,711.47,1003.22
2672396808312370688,2020-01,2751.49,2054.44,0,3086.23,-2389.18,-2389.18
2672396808312370688,2020-02,2554.14,3255.34,8033.69,5402.7,1929.79,-459.39
2672396808312370688,2020-03,4943.03,1860.7,1050.46,2071.33,2061.46,1602.07
2672396808312370688,2020-04,4634.2,3860.55,1507.22,3904.51,-1623.64,-21.57
2672396808312370688,2020-05,0,226.51,2517.61,3427.41,-1136.31,-1157.88
2672396808312370688,2020-06,1798.82,3375.99,0,1555.56,-3132.73,-4290.61
2672396808312370688,2020-07,3051.2,801.95,14.58,5366.24,-3102.41,-7393.02
2672396808312370688,2020-08,0,935.16,1626,1716,-1025.16,-8418.18
2672396808312370688,2020-09,2255.31,1569.96,5590.87,1653.57,4622.65,-3795.53
2672396808312370688,2020-10,3432.5,1845.83,0,4008.16,-2421.49,-6217.02
2672396808312370688,2020-11,6144.92,1120.52,256.92,1423.9,3857.42,-2359.6
2672396808312370688,2020-12,661.76,3384.42,4152.41,3412.69,-1982.94,-4342.54
2673237789241110016,2020-01,0,3145.46,2731.33,4120.52,-4534.65,-4534.65
2673237789241110016,2020-02,2763.08,2449.02,0,839.08,-525.02,-5059.67
2673237789241110016,2020-03,1509.27,2668.69,1776.45,3487.96,-2870.93,-7930.6
2673237789241110016,2020-04,659.18,0,0,1909.34,-1250.16,-9180.76
2673237789241110016,2020-06,1283.14,870.01,1566,0,1979.13,-7201.63
2673237789241110016,2020-07,1812.56,3908.27,0,0,-2095.71,-9297.34
2673237789241110016,2020-08,3797.26,2553.44,1177.87,680.21,1741.48,-7555.86
2673237789241110016,2020-09,0,1653.54,0,3991.17,-5644.71,-13200.57
2673237789241110016,2020-10,1186.9,0,4203.24,491.62,4898.52,-8302.05
2673237789241110016,2020-11,4183.48,0,1214.75,0,5398.23,-2903.82
2673237789241110016,2020-12,2127.96,1909.97,905.02,517.9,605.11,-2298.71
2673387237276380160,2020-01,6237.78,807.83,5149.86,2999.6,7580.21,7580.21
2673387237276380160,2020-02,12327.35,1003.25,0,6764.59,4559.51,12139.72
2673387237276380160,2020-03,3025.55,1425.9,5696.05,9361.93,-2066.23,10073.49
2673387237276380160,2020-04,2230.68,2853.11,6727.07,5577.47,527.17,10600.66
2673387237276380160,2020-05,7813.76,5040.89,5923.16,3845.19,4850.84,15451.5
2673387237276380160,2020-06,4168.5,7871.74,2898.66,2868.4,-3672.98,11778.52
2673387237276380160,2020-07,4735.75,1930.16,2204.3,986.67,4023.22,15801.74
2673387237276380160,2020-08,5672.9,3569.37,3132.69,1783.27,3452.95,19254.69
2673387237276380160,2020-09,4483.49,2285.15,5739.54,1023.96,6913.92,26168.61
2673387237276380160,2020-10,4792.21,4519.28,2375.29,515.89,2132.33,28300.94
2673387237276380160,2020-11,3052.36,8555.89,1478.15,4803.1,-8828.48,19472.46
2673387237276380160,2020-12,3977.45,3909.06,1351.72,3136.74,-1716.63,17755.83
2675216141114081280,2020-01,1679.92,4026.18,3218.57,1710.55,-838.24,-838.24
2675216141114081280,2020-02,3583.01,4186.39,4945.71,4289.53,52.8,-785.44
2675216141114081280,2020-03,2762.36,2902.35,1808.16,1258.96,409.21,-376.23
2675216141114081280,2020-04,4372.36,4298.38,808.85,2233.55,-1350.72,-1726.95
2675216141114081280,2020-05,8198.98,6889.15,7939.18,3258.85,5990.16,4263.21
2675216141114081280,2020-06,4886.39,7092.51,3882.87,3375.16,-1698.41,2564.8
2675216141114081280,2020-07,8265.18,9552.76,3978.44,0,2690.86,5255.66
2675216141114081280,2020-08,1848.36,8435.02,9797.33,2543.25,667.42,5923.08
2675216141114081280,2020-09,3917.58,5698.73,2810.46,4855.2,-3825.89,2097.19
2675216141114081280,2020-10,7719.22,2361.9,7079.2,5061.88,7374.64,9471.83
2675216141114081280,2020-11,0,2862.74,8465.62,1589.08,4013.8,13485.63
2675216141114081280,2020-12,3066.99,4661.66,4826.51,4483.18,-1251.34,12234.29
2675885123035686400,2020-01,1842.82,299.62,1623.79,2780.39,386.6,386.6
2675885123035686400,2020-02,4532.09,737.56,4907.65,3337.77,5364.41,5751.01
2675885123035686400,2020-03,1824.23,5170.62,2975.98,8199.96,-8570.37,-2819.36
2675885123035686400,2020-04,3034.23,1263.33,1771.73,1544.71,1997.92,-821.44
2675885123035686400,2020-05,1570.21,799.75,4351.28,2006.32,3115.42,2293.98
2675885123035686400,2020-06,0,1618.87,1253.24,1410.49,-1776.12,517.86
2675885123035686400,2020-07,5206.56,1964.53,239.31,988.08,2493.26,3011.12
2675885123035686400,2020-08,0,47.62,1207.49,3720.64,-2560.77,450.35
2675885123035686400,2020-09,1652.6,1024.19,1410.5,6120.26,-4081.35,-3631
2675885123035686400,2020-10,1788.9,1531.89,1402.26,1970.24,-310.97,-3941.97
2675885123035686400,2020-11,2509.8,0,1940.71,3126.33,1324.18,-2617.79
2675885123035686400,2020-12,473.32,1030.18,608.96,296.49,-244.39,-2862.18
2676204029295935488,2020-01,0,5942.82,2414.68,4901.78,-8429.92,-8429.92
2676204029295935488,2020-02,1952.81,3859.49,3738.82,1725.41,106.73,-8323.19
2676204029295935488,2020-03,1774.39,4251.11,3931.55,552.98,901.85,-7421.34
2676204029295935488,2020-04,6393.96,3198.71,5980.64,5796.68,3379.21,-4042.13
2676204029295935488,2020-05,1766.63,4324.17,6079.84,6409.25,-2886.95,-6929.08
2676204029295935488,2020-06,313.57,6989.83,1954.46,1803.28,-6525.08,-13454.16
2676204029295935488,2020-07,4793.22,1183.15,8447.88,3933.26,8124.69,-5329.47
2676204029295935488,2020-08,1166.28,7543.47,9761.29,3460.09,-75.99,-5405.46
2676204029295935488,2020-09,110.48,2198.05,219.28,4215.21,-6083.5,-11488.96
2676204029295935488,2020-10,3071.07,5655.11,1506.89,3004.41,-4081.56,-15570.52
2676204029295935488,2020-11,0,3014.7,7804.47,5246.57,-456.8,-16027.32
2676204029295935488,2020-12,6202,4658.52,5268.79,3746.04,3066.23,-12961.09
2676687990081312256,2020-01,381.08,4430.25,2266.6,708.29,-2490.86,-2490.86
2676687990081312256,2020-02,1796.42,1679.81,3147.32,894.58,2369.35,-121.51
2676687990081312256,2020-03,4599.18,5668.11,3256.46,1813.14,374.39,252.88
2676687990081312256,2020-04,1867.79,9395.26,3521.86,2254.86,-6260.47,-6007.59
2676687990081312256,2020-05,0,6265.92,1712.95,3795.37,-8348.34,-14355.93
2676687990081312256,2020-06,2794.37,4679.6,1973.02,4518.28,-4430.49,-18786.42
2676687990081312256,2020-07,2426.93,182.69,2531.24,2229.21,2546.27,-16240.15
2676687990081312256,2020-08,4925.63,1877.87,1140.98,2034.68,2154.06,-14086.09
2676687990081312256,2020-09,1773.74,2001.66,533.65,3479.37,-3173.64,-17259.73
2676687990081312256,2020-10,459.29,1997.5,2277.11,6751.06,-6012.16,-23271.89
2676687990081312256,2020-11,6968.83,1742.47,205.69,3752.12,1679.93,-21591.96
2676687990081312256,2020-12,3396.5,3072.23,3285.22,2163.5,1445.99,-20145.97
2677325150562278400,2020-01,2621.49,346.97,0,74.28,2200.24,2200.24
2677325150562278400,2020-02,6.24,48.18,0,0,-41.94,2158.3
2677325150562278400,2020-03,2693.15,0,40.37,971.15,1762.37,3920.67
2677325150562278400,2020-06,1381.73,4271.85,0,1041.34,-3931.46,-10.79
2677325150562278400,2020-07,1198.9,246.33,504.61,369.34,1087.84,1077.05
2677325150562278400,2020-08,1654.57,0,0,0,1654.57,2731.62
2677325150562278400,2020-09,2129.5,1304.57,1720.76,1046.06,1499.63,4231.25
2677325150562278400,2020-10,1405.48,0,0,1729.69,-324.21,3907.04
2677325150562278400,2020-11,1738.45,774.84,1357.86,1134.12,1187.35,5094.39
2678020919080188928,2020-02,420.46,869.75,0,0,-449.29,-449.29
2678020919080188928,2020-03,261.62,0,0,0,261.62,-187.67
2678020919080188928,2020-04,0,1942.88,0,19.87,-1962.75,-2150.42
2678020919080188928,2020-09,0,1926.16,0,0,-1926.16,-4076.58
2678020919080188928,2020-12,1455.22,0,0,0,1455.22,-2621.36
2678947362399326720,2020-01,1995.33,490.77,0,0,1504.56,1504.56
2678947362399326720,2020-02,1003.51,0,1862.98,1628.65,1237.84,2742.4
2678947362399326720,2020-03,0,907.7,0,1291.46,-2199.16,543.24
2678947362399326720,2020-05,1399.46,0,0,0,1399.46,1942.7
2678947362399326720,2020-08,0,2229.31,3533.25,0,1303.94,3246.64
2678947362399326720,2020-11,0,1709.18,0,0,-1709.18,1537.46
2679135597553206272,2020-01,4470.83,0,1236.57,1507.91,4199.49,4199.49
2679135597553206272,2020-02,3760.27,1062.61,2366.82,4473.8,590.68,4790.17
2679135597553206272,2020-03,580.02,114.68,3145.06,4038.95,-428.55,4361.62
2679135597553206272,2020-04,4507.23,1381.69,3189.94,3835.79,2479.69,6841.31
2679135597553206272,2020-05,1083.97,1835.63,3116.43,3614.95,-1250.18,5591.13
2679135597553206272,2020-06,3373.16,0,4814.7,2421.97,5765.89,11357.02
2679135597553206272,2020-07,3659.67,3595.18,3500.98,3164.35,401.12,11758.14
2679135597553206272,2020-08,2821.66,7570.51,0,349.48,-5098.33,6659.81
2679135597553206272,2020-09,2569.29,4396.95,1574.64,1779.55,-2032.57,4627.24
2679135597553206272,2020-10,4883.48,831.65,2660.42,3794.63,2917.62,7544.86
2679135597553206272,2020-11,2077.1,6829.61,3950.45,3085.24,-3887.3,3657.56
2679135597553206272,2020-12,2319.94,0,4311.58,2360.41,4271.11,7928.67
2679450203951628288,2020-03,954.42,1730.1,17.01,1780.54,-2539.21,-2539.21
2679450203951628288,2020-04,1231.97,0,722.7,0,1954.67,-584.54
2679450203951628288,2020-05,1871.57,2788.32,0,0,-916.75,-1501.29
2679450203951628288,2020-06,1098.67,193.86,0,934.2,-29.39,-1530.68
2679450203951628288,2020-07,0,1965.18,1689.5,1885.01,-2160.69,-3691.37
2679450203951628288,2020-08,1863.59,0,0,718.37,1145.22,-2546.15
2679450203951628288,2020-10,2576.41,0,0,0,2576.41,30.26
2679450203951628288,2020-11,0,950.93,0,0,-950.93,-920.67
2679529763477941760,2020-02,917.06,0,1948.07,0,2865.13,2865.13
2679529763477941760,2020-04,692.89,1674.44,1455.41,0,473.86,3338.99
2679529763477941760,2020-06,0,692.5,0,0,-692.5,2646.49
2679529763477941760,2020-08,0,1930.96,1698.64,1987.11,-2219.43,427.06
2679529763477941760,2020-09,2134.38,1564.74,0,0,569.64,996.7
2679529763477941760,2020-10,559.89,0,0,1474.44,-914.55,82.15
2679529763477941760,2020-11,0,1893.37,0,1764.18,-3657.55,-3575.4
2679529763477941760,2020-12,2725.89,1066.94,0,324.99,1333.96,-2241.44
2679814261292467712,2020-01,0,524.36,733.45,275.16,-66.07,-66.07
2679814261292467712,2020-02,165.53,2970.85,0,997.16,-3802.48,-3868.55
2679814261292467712,2020-03,60.69,1817.51,0,0,-1756.82,-5625.37
2679814261292467712,2020-04,4737.51,6308.14,0,1954.72,-3525.35,-9150.72
2679814261292467712,2020-05,0,296.03,20.93,3068.93,-3344.03,-12494.75
2679814261292467712,2020-06,2625.29,1826.83,0,515.23,283.23,-12211.52
2679814261292467712,2020-07,1997.1,803.5,406.73,0,1600.33,-10611.19
2679814261292467712,2020-08,0,1186.66,717.06,0,-469.6,-11080.79
2679814261292467712,2020-09,0,1767.32,675.53,364.65,-1456.44,-12537.23
2679814261292467712,2020-10,1017.33,905.32,815.19,650,277.2,-12260.03
2679814261292467712,2020-11,0,1183.04,2420.06,1136.71,100.31,-12159.72
2679814261292467712,2020-12,1517.51,1913.83,0,0,-396.32,-12556.04
2680088723548370432,2020-04,2443.16,0,0,122.97,2320.19,2320.19
2680088723548370432,2020-05,1557.64,1897.81,0,1082.94,-1423.11,897.08
2680088723548370432,2020-06,1740.61,0,0,0,1740.61,2637.69
2680088723548370432,2020-08,367.31,0,0,573.01,-205.7,2431.99
2680088723548370432,2020-09,75.96,1687.87,0,0,-1611.91,820.08
2680088723548370432,2020-11,0,3479.68,0,0,-3479.68,-2659.6
2680088723548370432,2020-12,1322.5,772.54,943.39,0,1493.35,-1166.25
2681304642267265024,2020-01,3690.88,0,3671.56,1793.24,5569.2,5569.2
2681304642267265024,2020-02,1356.14,2730.89,0,724.67,-2099.42,3469.78
2681304642267265024,2020-03,4491.56,0,2104.48,80.81,6515.23,9985.01
2681304642267265024,2020-04,1921.62,917.76,0,0,1003.86,10988.87
2681304642267265024,2020-05,2275.37,846.7,0,2143.71,-715.04,10273.83
2681304642267265024,2020-06,903.86,0,2812.12,2550.99,1164.99,11438.82
2681304642267265024,2020-07,1529.38,0,2090.79,5465.41,-1845.24,9593.58
2681304642267265024,2020-08,127.17,2810.89,4191.49,1692.75,-184.98,9408.6
2681304642267265024,2020-09,3144.52,2935.37,1086.75,2869.1,-1573.2,7835.4
2681304642267265024,2020-10,2549.01,3764.77,1634.54,766,-347.22,7488.18
2681304642267265024,2020-11,449.24,1796.23,1283.83,440.43,-503.59,6984.59
2681304642267265024,2020-12,3117.05,1091.28,1775.94,0,3801.71,10786.3
2683849568717477888,2020-01,0,2660.77,0,678.85,-3339.62,-3339.62
2683849568717477888,2020-02,1548.09,1954.08,619.79,1875.26,-1661.46,-5001.08
2683849568717477888,2020-03,4285.01,2996.77,2615.44,231.42,3672.26,-1328.82
2683849568717477888,2020-04,2589.15,4809.84,1350.26,2274.69,-3145.12,-4473.94
2683849568717477888,2020-05,1934.11,1952.39,0,1367.95,-1386.23,-5860.17
2683849568717477888,2020-06,2282.76,971.47,1189.19,1750.01,750.47,-5109.7
2683849568717477888,2020-07,1401.54,3604.31,0,0,-2202.77,-7312.47
2683849568717477888,2020-08,1631.83,4268.21,0,4993.39,-7629.77,-14942.24
2683849568717477888,2020-09,4021.91,207.73,3963.04,661.36,7115.86,-7826.38
2683849568717477888,2020-10,2411.31,1822.5,0,455.17,133.64,-7692.74
2683849568717477888,2020-11,1946.66,2771.09,1103.02,3137.97,-2859.38,-10552.12
2683849568717477888,2020-12,395.44,718.26,2712.94,3885.8,-1495.68,-12047.8
2684344566867357696,2020-01,2108.77,659.11,2196.36,854.91,2791.11,2791.11
2684344566867357696,2020-02,5580.71,5433.43,1964.46,2851.16,-739.42,2051.69
2684344566867357696,2020-03,3412.04,4694.45,2030.7,6677.5,-5929.21,-3877.52
2684344566867357696,2020-04,2091.59,3078.41,2895.31,3751.86,-1843.37,-5720.89
2684344566867357696,2020-05,3866.83,1531.68,3713.21,1767.51,4280.85,-1440.04
2684344566867357696,2020-06,3805.72,3892.09,5933.34,0,5846.97,4406.93
2684344566867357696,2020-07,2266.62,701.05,2991.7,4545.08,12.19,4419.12
2684344566867357696,2020-08,1743.37,1034.44,2854.66,344.79,3218.8,7637.92
2684344566867357696,2020-09,1559.47,232.09,1849.25,897.67,2278.96,9916.88
2684344566867357696,2020-10,3194.14,4031.03,4791.16,5620.66,-1666.39,8250.49
2684344566867357696,2020-11,3260.56,4612.2,6610.52,695.32,4563.56,12814.05
2684344566867357696,2020-12,5002.59,1078.65,1081.88,1513.48,3492.34,16306.39
2684657256168998400,2020-01,6063.9,8129.95,5892.76,6670.1,-2843.39,-2843.39
2684657256168998400,2020-02,4390.74,2428.11,5714.37,6648.81,1028.19,-1815.2
2684657256168998400,2020-03,456.89,1135.41,11191.46,4571.69,5941.25,4126.05
2684657256168998400,2020-04,817.45,3152.58,4349.68,5196.22,-3181.67,944.38
2684657256168998400,2020-05,3196.09,5442.76,4483.36,5020.68,-2783.99,-1839.61
2684657256168998400,2020-06,5202.07,1915.09,7335.18,5810.82,4811.34,2971.73
2684657256168998400,2020-07,6088.85,6492,6598.46,2315.79,3879.52,6851.25
2684657256168998400,2020-08,6257.91,5436.74,5184.06,3004.47,3000.76,9852.01
2684657256168998400,2020-09,4440.83,2424.71,7293.9,7215.37,2094.65,11946.66
2684657256168998400,2020-10,4822.11,2307.54,3839.1,8729.61,-2375.94,9570.72
2684657256168998400,2020-11,9100.4,4618.42,11965.87,10556.51,5891.34,15462.06
2684657256168998400,2020-12,3509.12,1802.19,4614.34,6463.94,-142.67,15319.39
2684720646873596928,2020-01,589.05,3493.91,4155.03,1404.06,-153.89,-153.89
2684720646873596928,2020-02,973.57,1452.54,0,0,-478.97,-632.86
2684720646873596928,2020-03,1290.42,1319.84,560.86,1893.27,-1361.83,-1994.69
2684720646873596928,2020-04,109.05,4109.37,3084.2,652.27,-1568.39,-3563.08
2684720646873596928,2020-05,0,2204.02,968.91,1839.38,-3074.49,-6637.57
2684720646873596928,2020-06,1643.79,1982.74,385.02,0,46.07,-6591.5
2684720646873596928,2020-07,1833.17,0,1701.1,1689.35,1844.92,-4746.58
2684720646873596928,2020-08,1684.96,2869.86,1605.95,885.06,-464.01,-5210.59
2684720646873596928,2020-09,1554.7,0,0,0,1554.7,-3655.89
2684720646873596928,2020-10,1818.35,1068.64,0,0,749.71,-2906.18
2684720646873596928,2020-11,0,2153.21,0,762.96,-2916.17,-5822.35
2684720646873596928,2020-12,0,3639.55,2213.51,0,-1426.04,-7248.39
2685239022619780096,2020-01,4111.21,2739.5,5360.52,1583.45,5148.78,5148.78
2685239022619780096,2020-02,635.39,1875.33,3628.15,736.56,1651.65,6800.43
2685239022619780096,2020-03,3728.9,7524.09,1558.62,3903.4,-6139.97,660.46
2685239022619780096,2020-04,2701.79,0,2274.79,860.45,4116.13,4776.59
2685239022619780096,2020-05,6026.63,2461.66,1385.49,2575.85,2374.61,7151.2
2685239022619780096,2020-06,0,1185.19,291.88,1763.46,-2656.77,4494.43
2685239022619780096,2020-07,5077.02,3456.22,833.75,35.43,2419.12,6913.55
2685239022619780096,2020-08,2378.38,741.92,316.29,3307.82,-1355.07,5558.48
2685239022619780096,2020-09,6058.47,5401.15,3544.89,1754.39,2447.82,8006.3
2685239022619780096,2020-10,1017.17,4905.67,4622.14,3174.73,-2441.09,5565.21
2685239022619780096,2020-11,1307.37,3420.48,2935.72,2973.78,-2151.17,3414.04
2685239022619780096,2020-12,3565.6,1487.67,704.15,3255.14,-473.06,2940.98
2685455547278109184,2020-01,7084.49,3223.67,3742.74,2406.42,5197.14,5197.14
2685455547278109184,2020-02,3694.17,3439.45,2319.26,2013.22,560.76,5757.9
2685455547278109184,2020-03,4316.35,4267.96,4809.23,4454.46,403.16,6161.06
2685455547278109184,2020-04,605.88,3882.33,3162.27,1665.53,-1779.71,4381.35
2685455547278109184,2020-05,4716.57,1342.84,3905.37,1741.98,5537.12,9918.47
2685455547278109184,2020-06,1631.18,1100.32,7230.73,4902.87,2858.72,12777.19
2685455547278109184,2020-07,5530.38,0,520.69,1352.21,4698.86,17476.05
2685455547278109184,2020-08,5184.16,8193.26,11998.62,4419.73,4569.79,22045.84
2685455547278109184,2020-09,2965.66,1885.71,2249.44,2712.77,616.62,22662.46
2685455547278109184,2020-10,4214.95,1789.67,5787.27,6211.05,2001.5,24663.96
2685455547278109184,2020-11,5374.35,4864.49,4701.8,6653.91,-1442.25,23221.71
2685455547278109184,2020-12,1437.13,2505.18,3806.64,3807,-1068.41,22153.3
2685809573926179328,2020-01,1470.91,1589.74,1543.94,1757.43,-332.32,-332.32
2685809573926179328,2020-02,4077.09,2636.67,1106.7,0,2547.12,2214.8
2685809573926179328,2020-03,5035.99,3272.68,2043.1,2734.14,1072.27,3287.07
2685809573926179328,2020-04,1413.95,4951.38,324.99,0,-3212.44,74.63
2685809573926179328,2020-05,3690.92,7692.73,0,4843.92,-8845.73,-8771.1
2685809573926179328,2020-06,747.78,0,209.54,4414.13,-3456.81,-12227.91
2685809573926179328,2020-07,796.93,3337.34,3282.65,0,742.24,-11485.67
2685809573926179328,2020-08,2541.09,1744.39,4513.36,2154.54,3155.52,-8330.15
2685809573926179328,2020-09,0,1458.22,1100.87,2454.9,-2812.25,-11142.4
2685809573926179328,2020-10,2198.6,1036.7,1965.37,0,3127.27,-8015.13
2685809573926179328,2020-11,1080.72,939.84,1518.03,1807.97,-149.06,-8164.19
2685809573926179328,2020-12,221.18,2292.41,1277.8,0,-793.43,-8957.62
2687881507357235200,2020-01,1997.14,0,1936.76,2734.99,1198.91,1198.91
2687881507357235200,2020-02,3004.34,5677.96,2279.54,4250.18,-4644.26,-3445.35
2687881507357235200,2020-03,1926.93,1838.43,0,2789.87,-2701.37,-6146.72
2687881507357235200,2020-04,1067.77,1145.32,2519.75,1834,608.2,-5538.52
2687881507357235200,2020-05,2743.78,2045.51,2736.9,4395.49,-960.32,-6498.84
2687881507357235200,2020-06,1334.99,3171.56,4927.47,2918.9,172,-6326.84
2687881507357235200,2020-07,2603.65,5035.82,3988.98,2116.6,-559.79,-6886.63
2687881507357235200,2020-08,7026.51,0,0,4391.24,2635.27,-4251.36
2687881507357235200,2020-09,2999.02,2288.93,7352.39,2888.83,5173.65,922.29
2687881507357235200,2020-10,0,2230.16,6949.65,5509.17,-789.68,132.61
2687881507357235200,2020-11,3489.88,3931.28,228.93,2994.68,-3207.15,-3074.54
2687881507357235200,2020-12,1524.05,5042.25,1844.12,1950.09,-3624.17,-6698.71
2689228755605244928,2020-01,1291.08,6773.51,5806.83,706.36,-381.96,-381.96
2689228755605244928,2020-02,3119.16,5452.26,4741.09,12110.77,-9702.78,-10084.74
2689228755605244928,2020-03,6668.62,655.03,5901.41,4354.49,7560.51,-2524.23
2689228755605244928,2020-04,2454.55,5201.25,803.78,2011.6,-3954.52,-6478.75
2689228755605244928,2020-05,4813.93,2479.65,2974.83,5021.64,287.47,-6191.28
2689228755605244928,2020-06,7195.57,4893.12,4978.67,4761.07,2520.05,-3671.23
2689228755605244928,2020-07,801.09,1771.26,8663.61,4348.95,3344.49,-326.74
2689228755605244928,2020-08,10946.21,6878.56,2605.93,8750.81,-2077.23,-2403.97
2689228755605244928,2020-09,1958.19,1322.94,1791.11,2579.86,-153.5,-2557.47
2689228755605244928,2020-10,6608.53,124.29,1995.87,3264.39,5215.72,2658.25
2689228755605244928,2020-11,6980.78,4419.41,4235.61,6875.63,-78.65,2579.6
2689228755605244928,2020-12,2950.06,2045.06,2597.63,4786.27,-1283.64,1295.96
2689271315799784448,2020-01,2734.13,1910.99,516.96,2936.42,-1596.32,-1596.32
2689271315799784448,2020-05,1059.24,1245.61,194.5,0,8.13,-1588.19
2689271315799784448,2020-06,393.96,0,85.5,961.38,-481.92,-2070.11
2689271315799784448,2020-07,349.26,2636.59,0,531.25,-2818.58,-4888.69
2689271315799784448,2020-08,3638.63,1508.39,0,2955.87,-825.63,-5714.32
2689271315799784448,2020-09,1860.79,0,2567.92,1653.02,2775.69,-2938.63
2689271315799784448,2020-10,571.58,0,3162.98,1522.19,2212.37,-726.26
2689271315799784448,2020-11,1852.49,2945.86,6048.8,692.15,4263.28,3537.02
2689271315799784448,2020-12,1578.18,0,770.38,0,2348.56,5885.58
2690457117327715328,2020-01,1967.57,3425.2,4258.85,3441.9,-640.68,-640.68
2690457117327715328,2020-02,3852.01,6862.66,5580.08,6430.02,-3860.59,-4501.27
2690457117327715328,2020-03,3090.11,6031.12,7569.82,4870.33,-241.52,-4742.79
2690457117327715328,2020-04,4204.08,1188.49,5268.72,0,8284.31,3541.52
2690457117327715328,2020-05,5195.59,7130.04,1879,9493.41,-9548.86,-6007.34
2690457117327715328,2020-06,0,4491.97,2272.65,2844.81,-5064.13,-11071.47
2690457117327715328,2020-07,3037.86,3766.35,5302.66,3344.66,1229.51,-9841.96
2690457117327715328,2020-08,673.8,4413.03,3248.96,3697.95,-4188.22,-14030.18
2690457117327715328,2020-09,2142.37,2477.96,3854.18,1291.36,2227.23,-11802.95
2690457117327715328,2020-10,70.45,4690.26,1613.01,3482.72,-6489.52,-18292.47
2690457117327715328,2020-11,3076.98,1782.91,2698.25,0,3992.32,-14300.15
2690457117327715328,2020-12,739.67,5822.14,0,1458.21,-6540.68,-20840.83
2691205484675760128,2020-01,2812.07,2926.31,3198.56,5158.16,-2073.84,-2073.84
2691205484675760128,2020-02,1856.64,2801.32,994.58,1597.24,-1547.34,-3621.18
2691205484675760128,2020-03,1967.86,2167.54,7606.12,2127.66,5278.78,1657.6
2691205484675760128,2020-04,3787.08,5302.39,6515.69,2474.8,2525.58,4183.18
2691205484675760128,2020-05,877.63,2825.98,6097.82,4191.78,-42.31,4140.87
2691205484675760128,2020-06,3706.47,2685.61,457.46,6404.09,-4925.77,-784.9
2691205484675760128,2020-07,3937.45,6037.86,2702.66,85.32,516.93,-267.97
2691205484675760128,2020-08,2671.83,1442.87,5911.02,4314.78,2825.2,2557.23
2691205484675760128,2020-09,2019.34,218.13,2983.82,6964.89,-2179.86,377.37
2691205484675760128,2020-10,7489.45,5249.72,2147.12,3643.66,743.19,1120.56
2691205484675760128,2020-11,3356.73,1588.5,2246.7,5519.72,-1504.79,-384.23
2691205484675760128,2020-12,5757.09,6448.37,11544.06,2099.86,8752.92,8368.69
2691210455941451264,2020-01,3287.65,363.34,3769.76,5588.31,1105.76,1105.76
2691210455941451264,2020-02,2390.91,2282.24,48.8,5526.66,-5369.19,-4263.43
2691210455941451264,2020-03,6433.61,3022.84,5751.45,3962.81,5199.41,935.98
2691210455941451264,2020-04,1828.69,2682.08,2947.5,4593.83,-2499.72,-1563.74
2691210455941451264,2020-05,5229.76,1956.64,6138.87,9580.59,-168.6,-1732.34
2691210455941451264,2020-06,5653.57,4721.63,1740.62,0,2672.56,940.22
2691210455941451264,2020-07,3910.09,6121.97,3882.58,1624.75,45.95,986.17
2691210455941451264,2020-08,2856.05,1921.17,1245.39,3914.6,-1734.33,-748.16
2691210455941451264,2020-09,3913.37,6036.16,6445.05,0,4322.26,3574.1
2691210455941451264,2020-10,2534.1,2516.42,7966.82,3411.19,4573.31,8147.41
2691210455941451264,2020-11,3999.2,4288.08,3578.68,6443.29,-3153.49,4993.92
2691210455941451264,2020-12,2699.31,3423.4,5775.69,3694.1,1357.5,6351.42
2691266986101044736,2020-01,1959.85,2926.37,8346.57,1398.67,5981.38,5981.38
2691266986101044736,2020-02,3492.26,3488.34,4504.15,761.42,3746.65,9728.03
2691266986101044736,2020-03,858.81,3020.99,730.51,1971.72,-3403.39,6324.64
2691266986101044736,2020-04,831.14,1689.35,2192.78,2762.93,-1428.36,4896.28
2691266986101044736,2020-05,3215.66,2976.59,4474.9,1053.62,3660.35,8556.63
2691266986101044736,2020-06,3444.59,5630.7,2642.29,1397.64,-941.46,7615.17
2691266986101044736,2020-07,376.62,868.35,3323.26,0,2831.53,10446.7
2691266986101044736,2020-08,1770.09,2930.18,0,3426.32,-4586.41,5860.29
2691266986101044736,2020-09,4520.02,0,4466.62,1927.09,7059.55,12919.84
2691266986101044736,2020-10,1733.37,2481.83,3000.45,7271.65,-5019.66,7900.18
2691266986101044736,2020-11,4895.58,1223.05,2256.91,2585.7,3343.74,11243.92
2691266986101044736,2020-12,3987.89,1369.81,1679.34,2784.33,1513.09,12757.01
2691675145750009856,2020-01,1186.4,8145.06,1581.16,6025.37,-11402.87,-11402.87
2691675145750009856,2020-02,1232.64,2983.18,1901.5,0,150.96,-11251.91
2691675145750009856,2020-03,477.39,1879.57,3123.2,3758.3,-2037.28,-13289.19
2691675145750009856,2020-04,11804.16,3922.21,4181.73,5075.08,6988.6,-6300.59
2691675145750009856,2020-05,4898.88,5846.37,3147.73,4542.63,-2342.39,-8642.98
2691675145750009856,2020-06,1504.05,3531.05,509.27,3751.12,-5268.85,-13911.83
2691675145750009856,2020-07,0,6999.82,3594.05,997.32,-4403.09,-18314.92
2691675145750009856,2020-08,5229.09,1771.45,4683.44,6912.35,1228.73,-17086.19
2691675145750009856,2020-09,3444.32,2012.19,1872.92,2404.59,900.46,-16185.73
2691675145750009856,2020-10,3080.1,1842.06,1794.35,2439.24,593.15,-15592.58
2691675145750009856,2020-11,848.25,5772.4,996.61,1928.46,-5856,-21448.58
2691675145750009856,2020-12,456.09,2268.96,1562.3,6428.85,-6679.42,-28128
2691998179009438720,2020-01,1950.48,452.62,6247.19,2880.97,4864.08,4864.08
2691998179009438720,2020-02,3846.8,1622.09,1381.66,986.25,2620.12,7484.2
2691998179009438720,2020-03,4972.21,1163.72,2544.05,1732.95,4619.59,12103.79
2691998179009438720,2020-04,234.88,0,2582.36,2040.25,776.99,12880.78
2691998179009438720,2020-05,3495.12,5559.16,2140.48,1346.23,-1269.79,11610.99
2691998179009438720,2020-06,4789.85,812.7,678.16,0,4655.31,16266.3
2691998179009438720,2020-07,2223.07,3909.87,1369.34,199.43,-516.89,15749.41
2691998179009438720,2020-08,3630.18,708.61,2786.4,4906.97,801,16550.41
2691998179009438720,2020-09,856.78,3198.85,1162.19,1420.45,-2600.33,13950.08
2691998179009438720,2020-10,1948.78,3001.26,2341.04,1697.11,-408.55,13541.53
2691998179009438720,2020-11,2956.48,0,960.69,397.16,3520.01,17061.54
2691998179009438720,2020-12,1774.92,0,643.51,4154.81,-1736.38,15325.16
2692037534616408064,2020-02,2097.72,0,150.21,0,2247.93,2247.93
2692037534616408064,2020-03,0,1900.34,0,0,-1900.34,347.59
2692037534616408064,2020-04,1843.81,0,0,1664.94,178.87,526.46
2692037534616408064,2020-05,124.42,0,1668.84,1215.54,577.72,1104.18
2692037534616408064,2020-06,1591.99,0,1281.92,208.27,2665.64,3769.82
2692037534616408064,2020-07,244.7,0,0,1875.85,-1631.15,2138.67
2692037534616408064,2020-08,2821.97,0,2015.58,0,4837.55,6976.22
2692037534616408064,2020-09,2882.7,1160.61,1224.02,2108.86,837.25,7813.47
2692037534616408064,2020-10,0,2664.16,0,0,-2664.16,5149.31
2692037534616408064,2020-11,0,1291.73,1389.24,342.09,-244.58,4904.73
2692037534616408064,2020-12,0,2551.01,623.72,752.57,-2679.86,2224.87
2692210322867088896,2020-01,1125.27,0,3714.48,1565.55,3274.2,3274.2
2692210322867088896,2020-02,1425.83,5472.25,1124.41,5871.11,-8793.12,-5518.92
2692210322867088896,2020-03,4405.56,2188.76,397.74,4230.02,-1615.48,-7134.4
2692210322867088896,2020-04,5854.08,1349.59,5411.61,3903.99,6012.11,-1122.29
2692210322867088896,2020-05,5916.13,1304.31,5336.66,3290.86,6657.62,5535.33
2692210322867088896,2020-06,3099.37,768.19,5525.92,1184.53,6672.57,12207.9
2692210322867088896,2020-07,6185.66,8355.81,6670.9,5139.87,-639.12,11568.78
2692210322867088896,2020-08,4157.22,5190.72,0,2439.8,-3473.3,8095.48
2692210322867088896,2020-09,3836.95,3620.89,4963.38,3183.77,1995.67,10091.15
2692210322867088896,2020-10,5043.17,2834.6,680.11,1471.5,1417.18,11508.33
2692210322867088896,2020-11,5003.8,2756.71,8897.54,9728.99,1415.64,12923.97
2692210322867088896,2020-12,2063.48,4969.36,8542.09,7891.18,-2254.97,10669
2693799226726239232,2020-01,5600.03,4590.91,785.07,1384.66,409.53,409.53
2693799226726239232,2020-02,2024.07,1201.09,2457.49,1894.08,1386.39,1795.92
2693799226726239232,2020-03,3284.95,5199.62,3366.51,4399.72,-2947.88,-1151.96
2693799226726239232,2020-04,5785.27,845.1,424.74,3296.31,2068.6,916.64
2693799226726239232,2020-05,21,3751.31,2545.74,818.98,-2003.55,-1086.91
2693799226726239232,2020-06,307.86,626.5,2035.02,2548.93,-832.55,-1919.46
2693799226726239232,2020-07,3859.64,6554.99,1020.64,2126.58,-3801.29,-5720.75
2693799226726239232,2020-08,0,2329.94,6660.14,1154.21,3175.99,-2544.76
2693799226726239232,2020-09,671.22,2280.33,1324.08,8579.36,-8864.39,-11409.15
2693799226726239232,2020-10,720.13,735.19,3531.41,364.86,3151.49,-8257.66
2693799226726239232,2020-11,3583.29,0,1857.36,0,5440.65,-2817.01
2693799226726239232,2020-12,1372.01,619.28,3092.76,0,3845.49,1028.48
2693932021677224448,2020-01,2940.1,3170.57,2511.31,5337,-3056.16,-3056.16
2693932021677224448,2020-02,6297.91,1289.22,1915.29,942.41,5981.57,2925.41
2693932021677224448,2020-03,7641.09,4267.94,2883.52,3986.41,2270.26,5195.67
2693932021677224448,2020-04,3797.65,4639.09,3831.42,0,2989.98,8185.65
2693932021677224448,2020-05,4000.2,2548.44,614.43,0,2066.19,10251.84
2693932021677224448,2020-06,4533.72,1636.36,530.09,1550.92,1876.53,12128.37
2693932021677224448,2020-07,1687.03,6019.75,263.95,3056.11,-7124.88,5003.49
2693932021677224448,2020-08,4844.35,0,3815.14,4184.49,4475,9478.49
2693932021677224448,2020-09,6291.51,3441.84,2367.01,8925.85,-3709.17,5769.32
2693932021677224448,2020-10,4633.29,6044.4,3359.46,6118.51,-4170.16,1599.16
2693932021677224448,2020-11,1407.82,0,4815.31,2494.81,3728.32,5327.48
2693932021677224448,2020-12,3083.16,3099.52,914.55,1716.61,-818.42,4509.06
2694201243909081088,2020-01,124.04,1459.82,0,1814.6,-3150.38,-3150.38
2694201243909081088,2020-02,2890.4,1863.2,0,0,1027.2,-2123.18
2694201243909081088,2020-03,824.2,873.38,1637.01,0,1587.83,-535.35
2694201243909081088,2020-04,1975.2,935.59,4313.64,175.69,5177.56,4642.21
2694201243909081088,2020-05,1052.56,0,1053.61,1450.87,655.3,5297.51
2694201243909081088,2020-06,1159.93,336.93,0,1589.41,-766.41,4531.1
2694201243909081088,2020-07,1357.33,1837.6,1700.72,0,1220.45,5751.55
2694201243909081088,2020-08,0,3666.37,1394.98,0,-2271.39,3480.16
2694201243909081088,2020-09,1651.08,0,0,192.2,1458.88,4939.04
2694201243909081088,2020-10,1374.74,741.3,0,2050.88,-1417.44,3521.6
2694201243909081088,2020-11,0,1459.97,0,0,-1459.97,2061.63
2694201243909081088,2020-12,2140.7,2344.13,3072.81,2012.18,857.2,2918.83
2695297461902018560,2020-01,1032.06,2304.74,1254.83,1399.37,-1417.22,-1417.22
2695297461902018560,2020-02,2013.34,582.66,3527.66,2041.81,2916.53,1499.31
2695297461902018560,2020-03,2021.55,0,3899.09,6380.72,-460.08,1039.23
2695297461902018560,2020-04,1785.05,436.55,3453.7,4686.72,115.48,1154.71
2695297461902018560,2020-05,2134.61,3624.59,251.61,2139.66,-3378.03,-2223.32
2695297461902018560,2020-06,2300.65,2064.53,2560.37,3216.6,-420.11,-2643.43
2695297461902018560,2020-07,0,5051.14,2329.78,3823.6,-6544.96,-9188.39
2695297461902018560,2020-08,1326.68,432.12,3670.12,1382.71,3181.97,-6006.42
2695297461902018560,2020-09,70.64,3777.06,5155.29,36.24,1412.63,-4593.79
2695297461902018560,2020-10,155.89,2888.54,5751.51,2097.03,921.83,-3671.96
2695297461902018560,2020-11,1736.73,321.44,300.96,155.85,1560.4,-2111.56
2695297461902018560,2020-12,0,4387.53,0,1326.8,-5714.33,-7825.89
2697055930343270912,2020-01,0,1661.69,1834.01,0,172.32,172.32
2697055930343270912,2020-02,37.19,1037.38,1455.73,0,455.54,627.86
2697055930343270912,2020-04,1068.42,0,658.04,0,1726.46,2354.32
2697055930343270912,2020-05,916.55,0,0,0,916.55,3270.87
2697055930343270912,2020-07,425.07,0,0,120.79,304.28,3575.15
2697055930343270912,2020-09,0,620.31,0,0,-620.31,2954.84
2697055930343270912,2020-10,912.92,0,0,1004.36,-91.44,2863.4
2697055930343270912,2020-11,1625.74,0,0,856.11,769.63,3633.03
2697858863864597504,2020-01,6376.99,4458.22,5706.06,3932,3692.83,3692.83
2697858863864597504,2020-02,842.59,3005.96,2504.28,2269.11,-1928.2,1764.63
2697858863864597504,2020-03,8874.82,10470.73,2528.07,2807.58,-1875.42,-110.79
2697858863864597504,2020-04,4654.46,4966.05,0,6091.15,-6402.74,-6513.53
2697858863864597504,2020-05,5558.71,867.21,3398.32,2600.52,5489.3,-1024.23
2697858863864597504,2020-06,3766.99,7331.2,6856.72,1730.66,1561.85,537.62
2697858863864597504,2020-07,3793.84,9937.93,7816.34,5903.79,-4231.54,-3693.92
2697858863864597504,2020-08,3606.08,5014.23,8228.57,5418.04,1402.38,-2291.54
2697858863864597504,2020-09,5250.46,6008.33,4669.78,4251.01,-339.1,-2630.64
2697858863864597504,2020-10,2591.88,4395.15,6229.44,7538.83,-3112.66,-5743.3
2697858863864597504,2020-11,4120.99,3996.9,4079.48,2337.67,1865.9,-3877.4
2697858863864597504,2020-12,6157.62,2385.27,2414.68,4263.23,1923.8,-1953.6
2698314641949598720,2020-01,0,2207.73,0,0,-2207.73,-2207.73
2698314641949598720,2020-02,1536.7,0,1805.88,1944.66,1397.92,-809.81
2698314641949598720,2020-03,3243.43,0,3602.62,0,6846.05,6036.24
2698314641949598720,2020-05,3462.87,149.72,3180.13,1873.1,4620.18,10656.42
2698314641949598720,2020-06,0,564.44,287.77,0,-276.67,10379.75
2698314641949598720,2020-07,1910.78,0,1692.85,6026.11,-2422.48,7957.27
2698314641949598720,2020-08,0,554,9067.24,6781.54,1731.7,9688.97
2698314641949598720,2020-09,110.06,2449.5,2602.97,1641.5,-1377.97,8311
2698314641949598720,2020-10,1816.69,62.01,3860.96,2213.31,3402.33,11713.33
2698314641949598720,2020-11,290.96,3154.18,4066.14,0,1202.92,12916.25
2698314641949598720,2020-12,884.14,0,1405.41,916.85,1372.7,14288.95
2699308538849977856,2020-01,0,1589.38,2977.94,362.36,1026.2,1026.2
2699308538849977856,2020-02,3274.82,179.44,2473.55,870.76,4698.17,5724.37
2699308538849977856,2020-03,1832.53,1568.06,1217.04,12437.56,-10956.05,-5231.68
2699308538849977856,2020-04,0,950.46,1002.59,6062.98,-6010.85,-11242.53
2699308538849977856,2020-05,2135.95,213.34,7821.45,0,9744.06,-1498.47
2699308538849977856,2020-06,2435.69,2618.07,245.46,6227.25,-6164.17,-7662.64
2699308538849977856,2020-07,729.41,2485.93,3383.7,3367.52,-1740.34,-9402.98
2699308538849977856,2020-08,669.33,1808.31,2725.63,0,1586.65,-7816.33
2699308538849977856,2020-09,2904.74,832.34,3000.83,3576.7,1496.53,-6319.8
2699308538849977856,2020-10,299.91,0,3684.03,4394.12,-410.18,-6729.98
2699308538849977856,2020-11,1730.94,1041.35,0,3083.17,-2393.58,-9123.56
2699308538849977856,2020-12,4293.66,0,0,51.23,4242.43,-4881.13
2699969937104141312,2020-01,806.02,3314.21,1808.54,2271.2,-2970.85,-2970.85
2699969937104141312,2020-02,2759.69,7983.78,3688.83,1100.78,-2636.04,-5606.89
2699969937104141312,2020-03,1504.28,596.13,640.4,882,666.55,-4940.34
2699969937104141312,2020-04,0,2297.07,850.76,1216.93,-2663.24,-7603.58
2699969937104141312,2020-05,2786.84,180.44,2399.23,1840.15,3165.48,-4438.1
2699969937104141312,2020-06,0,2141.3,5124.88,0,2983.58,-1454.52
2699969937104141312,2020-07,2564.81,891.23,2855.62,1374.61,3154.59,1700.07
2699969937104141312,2020-08,262.04,1376.87,0,1032.13,-2146.96,-446.89
2699969937104141312,2020-09,1715.39,0,2649.82,7094.42,-2729.21,-3176.1
2699969937104141312,2020-10,0,57.36,2670.51,2887.42,-274.27,-3450.37
2699969937104141312,2020-11,0,449.54,1312.92,86.79,776.59,-2673.78
2699969937104141312,2020-12,531.83,1982.49,1888.58,1034.46,-596.54,-3270.32
2703068392763950592,2020-01,1745.54,1123.8,1778.62,1026.33,1374.03,1374.03
2703068392763950592,2020-02,711.13,5519.2,4485.34,8173.09,-8495.82,-7121.79
2703068392763950592,2020-03,539.59,1481.51,2218.28,5275.39,-3999.03,-11120.82
2703068392763950592,2020-04,2078.31,0,1674.02,4052.29,-299.96,-11420.78
2703068392763950592,2020-05,2527.36,3063.43,3917.34,2554.56,826.71,-10594.07
2703068392763950592,2020-06,3862.6,1317.09,7247.7,3637.49,6155.72,-4438.35
2703068392763950592,2020-07,0,5830.05,2252.36,3660.05,-7237.74,-11676.09
2703068392763950592,2020-08,1083.22,1731.11,2410.29,1427.26,335.14,-11340.95
2703068392763950592,2020-09,0,4672.57,2978.89,2309.96,-4003.64,-15344.59
2703068392763950592,2020-10,2427.19,4543.67,2426.1,2433.32,-2123.7,-17468.29
2703068392763950592,2020-11,1907.82,5617.73,1927.62,1078.37,-2860.66,-20328.95
2703068392763950592,2020-12,3486.55,3030.28,3023.14,2395.26,1084.15,-19244.8
2703447678887705088,2020-01,3948.17,7605.88,5231.83,4705.82,-3131.7,-3131.7
2703447678887705088,2020-02,3576.27,4194.88,4150.28,6894.14,-3362.47,-6494.17
2703447678887705088,2020-03,2419.61,9006.67,7771.39,2655.09,-1470.76,-7964.93
2703447678887705088,2020-04,6889,4339.52,6044.86,4496.17,4098.17,-3866.76
2703447678887705088,2020-05,4919.45,4725.04,7403.62,7165.33,432.7,-3434.06
2703447678887705088,2020-06,4261.56,3559.28,5198.45,6922.37,-1021.64,-4455.7
2703447678887705088,2020-07,5090.73,7618.69,3543.52,6015.7,-5000.14,-9455.84
2703447678887705088,2020-08,2651.25,4013.49,3319.88,4101.88,-2144.24,-11600.08
2703447678887705088,2020-09,3182.98,1410.84,1179.67,6284.92,-3333.11,-14933.19
2703447678887705088,2020-10,3761.43,3948.9,2317.83,4179.31,-2048.95,-16982.14
2703447678887705088,2020-11,4039.9,4635.12,2152.31,0,1557.09,-15425.05
2703447678887705088,2020-12,11177.63,10519.76,6103.88,455.43,6306.32,-9118.73
2706346233609073152,2020-01,5956.43,2031.24,6301.79,3072.64,7154.34,7154.34
2706346233609073152,2020-02,3140.78,5806.37,2477.12,2687.75,-2876.22,4278.12
2706346233609073152,2020-03,6706.31,4224.38,2920.99,1625.62,3777.3,8055.42
2706346233609073152,2020-04,5217.26,6900.82,6628.34,3815.56,1129.22,9184.64
2706346233609073152,2020-05,5191.89,5129.66,6633.72,635.59,6060.36,15245
2706346233609073152,2020-06,1240.21,3129.95,6308.62,7161.19,-2742.31,12502.69
2706346233609073152,2020-07,908.98,6768.55,7627.48,6904.2,-5136.29,7366.4
2706346233609073152,2020-08,4607.8,8460.59,4419.91,0,567.12,7933.52
2706346233609073152,2020-09,6471.46,8701.42,4202.41,4968.91,-2996.46,4937.06
2706346233609073152,2020-10,5376.58,4942.02,2379.19,1861.89,951.86,5888.92
2706346233609073152,2020-11,4934.09,2087.43,3083.63,2840.62,3089.67,8978.59
2706346233609073152,2020-12,0,5458.39,6354.87,9275.76,-8379.28,599.31
2706413434856439296,2020-01,7073.33,7704.99,4789.04,4634.3,-476.92,-476.92
2706413434856439296,2020-02,7100.33,2626.28,323.17,1088.27,3708.95,3232.03
2706413434856439296,2020-03,3775.87,2501.68,5203.1,4742.48,1734.81,4966.84
2706413434856439296,2020-04,2269.85,4694.65,3365.37,532.76,407.81,5374.65
2706413434856439296,2020-05,7957.66,6265.81,2096.35,6107.64,-2319.44,3055.21
2706413434856439296,2020-06,5108.39,4891.09,1866.76,1659.43,424.63,3479.84
2706413434856439296,2020-07,2593.9,4749.73,2969.51,1508.82,-695.14,2784.7
2706413434856439296,2020-08,3619.13,6354.99,4387.34,3976.99,-2325.51,459.19
2706413434856439296,2020-09,7688.02,7320.99,6490.24,4548.26,2309.01,2768.2
2706413434856439296,2020-10,5212.69,4870.84,6363.47,2999.47,3705.85,6474.05
2706413434856439296,2020-11,2228.78,5189.92,6197.46,6165.98,-2929.66,3544.39
2706413434856439296,2020-12,719.79,3305.24,3686.66,1732.7,-631.49,2912.9
2706796535861008896,2020-01,1580.66,2150.78,321.85,753.09,-1001.36,-1001.36
2706796535861008896,2020-02,1771.62,0,3089.46,0,4861.08,3859.72
2706796535861008896,2020-04,0,1927.16,1167.2,1032.06,-1792.02,2067.7
2706796535861008896,2020-05,729.63,1375.6,0,3250.23,-3896.2,-1828.5
2706796535861008896,2020-06,0,1650.35,1700.64,572.73,-522.44,-2350.94
2706796535861008896,2020-07,3307.68,611.78,0,3262.54,-566.64,-2917.58
2706796535861008896,2020-08,1968.13,595.62,736.81,807.56,1301.76,-1615.82
2706796535861008896,2020-09,122.58,2354,1812.79,2680.44,-3099.07,-4714.89
2706796535861008896,2020-10,2253.45,4092.09,1753.15,2133.3,-2218.79,-6933.68
2706796535861008896,2020-11,1805.79,174.91,0,604.72,1026.16,-5907.52
2706796535861008896,2020-12,0,5641.02,1681.55,0,-3959.47,-9866.99
2706910335826955264,2020-01,0,4461.65,1210.63,150,-3401.02,-3401.02
2706910335826955264,2020-02,2561.16,0,0,4001.95,-1440.79,-4841.81
2706910335826955264,2020-03,782.62,1258.28,5115.45,4576.31,63.48,-4778.33
2706910335826955264,2020-04,2177.79,2763.67,4391.81,1012.18,2793.75,-1984.58
2706910335826955264,2020-05,3009.04,2124.82,1450.95,0,2335.17,350.59
2706910335826955264,2020-06,0,400.72,0,342.36,-743.08,-392.49
2706910335826955264,2020-07,1042.42,1600.46,1122.13,2094.87,-1530.78,-1923.27
2706910335826955264,2020-08,7050.12,2979.23,1705.94,1824.78,3952.05,2028.78
2706910335826955264,2020-09,0,1939.67,6062.58,2076.24,2046.67,4075.45
2706910335826955264,2020-10,2753.43,0,3704.29,1605.43,4852.29,8927.74
2706910335826955264,2020-11,816.96,2876.47,1672.21,5453.26,-5840.56,3087.18
2706910335826955264,2020-12,3407.64,0,3671.96,1546.78,5532.82,8620
2707424651907414528,2020-01,0,813.3,0,0,-813.3,-813.3
2707424651907414528,2020-02,1417.28,0,0,0,1417.28,603.98
2707424651907414528,2020-03,1627.67,0,1745.62,0,3373.29,3977.27
2707424651907414528,2020-04,77.79,412.96,0,0,-335.17,3642.1
2707424651907414528,2020-06,1658.22,1063.76,1055.29,0,1649.75,5291.85
2707424651907414528,2020-08,733.84,0,1740.37,0,2474.21,7766.06
2707424651907414528,2020-10,108.86,0,1691.43,1912.15,-111.86,7654.2
2710096802775491584,2020-01,5473.8,2310.43,3079.87,4226.29,2016.95,2016.95
2710096802775491584,2020-02,6433.76,1094.22,2361.51,6811.02,890.03,2906.98
2710096802775491584,2020-03,1181.07,4154.64,4122.49,7685.05,-6536.13,-3629.15
2710096802775491584,2020-04,2970.75,4410.8,5448.07,2590.38,1417.64,-2211.51
2710096802775491584,2020-05,6358.28,6455.52,6184.71,5449.98,637.49,-1574.02
2710096802775491584,2020-06,3356.48,1301.84,3244.26,5411.14,-112.24,-1686.26
2710096802775491584,2020-07,1394.74,10256.05,3018.66,4920.34,-10762.99,-12449.25
2710096802775491584,2020-08,1424.24,4823.78,3061.83,4349.78,-4687.49,-17136.74
2710096802775491584,2020-09,3008.48,2865.53,2371.1,8402.32,-5888.27,-23025.01
2710096802775491584,2020-10,5771.16,2948.14,5625.35,1991.57,6456.8,-16568.21
2710096802775491584,2020-11,4602.82,5430.24,5661.07,2051.6,2782.05,-13786.16
2710096802775491584,2020-12,7101.62,1033.4,3788.98,3955.86,5901.34,-7884.82
2710280229294267904,2020-01,5834.35,1430.73,2284.48,4001.69,2686.41,2686.41
2710280229294267904,2020-02,3087,6864.59,1303.48,5719.43,-8193.54,-5507.13
2710280229294267904,2020-03,4116.64,6795.12,2925.01,4613.68,-4367.15,-9874.28
2710280229294267904,2020-04,3497.24,323.7,2724.08,2248.62,3649,-6225.28
2710280229294267904,2020-05,1066.56,6057.5,4871.68,466.32,-585.58,-6810.86
2710280229294267904,2020-06,4661.2,2762.94,10529.64,1064.92,11362.98,4552.12
2710280229294267904,2020-07,0,4171.02,1240.31,2236.95,-5167.66,-615.54
2710280229294267904,2020-08,1608.01,254.91,2986.4,170.25,4169.25,3553.71
2710280229294267904,2020-09,7239.61,3439.52,4102.36,3854.19,4048.26,7601.97
2710280229294267904,2020-10,1205,1780.89,4767.14,0,4191.25,11793.22
2710280229294267904,2020-11,66.66,3885.69,5402.26,6418.97,-4835.74,6957.48
2710280229294267904,2020-12,2652.14,4370.34,3844.22,1102.06,1023.96,7981.44
2711327822648657408,2020-01,1384.7,2174.9,2470.65,1528.88,151.57,151.57
2711327822648657408,2020-02,0,2855.26,0,0,-2855.26,-2703.69
2711327822648657408,2020-04,291.24,835.92,0,0,-544.68,-3248.37
2711327822648657408,2020-07,1394.03,874.84,0,454.73,64.46,-3183.91
2711327822648657408,2020-08,3958.62,4431.94,0,1875.58,-2348.9,-5532.81
2711327822648657408,2020-09,767.21,2724.3,660.52,1674.66,-2971.23,-8504.04
2711327822648657408,2020-10,1948.73,0,1955.93,3997.47,-92.81,-8596.85
2711327822648657408,2020-11,1722.79,1858.26,2806.4,3213.1,-542.17,-9139.02
2711327822648657408,2020-12,0,3033.89,1002.57,0,-2031.32,-11170.34
2713043002139156480,2020-01,2182.91,5858.5,2584.7,5545.81,-6636.7,-6636.7
2713043002139156480,2020-02,0,2398.32,2715.59,3359.66,-3042.39,-9679.09
2713043002139156480,2020-03,1800.97,2507.71,6038.07,942.82,4388.51,-5290.58
2713043002139156480,2020-04,5400.34,1931.02,1767.19,4881.59,354.92,-4935.66
2713043002139156480,2020-05,3969.78,8305.11,2229.81,3238.35,-5343.87,-10279.53
2713043002139156480,2020-06,3789.21,1852.45,1359.03,1597.17,1698.62,-8580.91
2713043002139156480,2020-07,0,1633.27,4908.41,2928.24,346.9,-8234.01
2713043002139156480,2020-08,3124.32,3927.83,0,3245.77,-4049.28,-12283.29
2713043002139156480,2020-09,3250.58,2237.43,8913.95,1179.36,8747.74,-3535.55
2713043002139156480,2020-10,1959.42,1167.98,3396.18,1948.64,2238.98,-1296.57
2713043002139156480,2020-11,4340.58,1043.44,1654.72,3229.68,1722.18,425.61
2713043002139156480,2020-12,2700.65,0,4126.85,4230.87,2596.63,3022.24
2713627701861671936,2020-02,712.91,339.64,0,1386.85,-1013.58,-1013.58
2713627701861671936,2020-03,0,1837.63,0,1340.13,-3177.76,-4191.34
2713627701861671936,2020-04,0,89.55,366.79,0,277.24,-3914.1
2713627701861671936,2020-07,278.32,0,4362.54,705.04,3935.82,21.72
2713627701861671936,2020-08,3831.1,1749.54,0,3358.97,-1277.41,-1255.69
2713627701861671936,2020-09,0,1303.64,0,2387.09,-3690.73,-4946.42
2713627701861671936,2020-10,0,1625.58,0,0,-1625.58,-6572
2713627701861671936,2020-11,1426.59,3232.06,0,1582.2,-3387.67,-9959.67
2713627701861671936,2020-12,0,1761.86,2889.04,0,1127.18,-8832.49
2713967095512356864,2020-01,1471.38,2028.36,7554.6,3669.91,3327.71,3327.71
2713967095512356864,2020-02,4866.54,460.65,113.1,1160.26,3358.73,6686.44
2713967095512356864,2020-03,2202.58,0,1231.03,1651.28,1782.33,8468.77
2713967095512356864,2020-04,4290.53,0,1371.92,2175.41,3487.04,11955.81
2713967095512356864,2020-05,250.82,2805.29,3734.13,1364.08,-184.42,11771.39
2713967095512356864,2020-07,3119.22,2297.47,5943.48,1437.53,5327.7,17099.09
2713967095512356864,2020-08,4302.34,1727.38,3784.74,5156.14,1203.56,18302.65
2713967095512356864,2020-09,3682.64,3517.88,2387.06,779.47,1772.35,20075
2713967095512356864,2020-10,0,966.98,2691.68,2963.49,-1238.79,18836.21
2713967095512356864,2020-11,876.22,2364.65,824.5,6501.05,-7164.98,11671.23
2713967095512356864,2020-12,1257.83,0,2664.39,0,3922.22,15593.45
2715691577825980416,2020-01,0,1784.06,626.06,0,-1158,-1158
2715691577825980416,2020-02,1186.7,0,4791.82,1553.44,4425.08,3267.08
2715691577825980416,2020-03,1899.18,1091.46,2817.91,6867.66,-3242.03,25.05
2715691577825980416,2020-04,1428.35,145.5,1555.02,7314.35,-4476.48,-4451.43
2715691577825980416,2020-05,2155.17,346.35,4245,4492.31,1561.51,-2889.92
2715691577825980416,2020-06,1319.13,972.49,0,3295.42,-2948.78,-5838.7
2715691577825980416,2020-07,2424.29,6174.95,0,5400.27,-9150.93,-14989.63
2715691577825980416,2020-08,3002.65,3637.68,5310.33,1893.72,2781.58,-12208.05
2715691577825980416,2020-09,1478.35,2948.58,172.67,3058.6,-4356.16,-16564.21
2715691577825980416,2020-10,1950.81,5591.22,2200.63,1145.12,-2584.9,-19149.11
2715691577825980416,2020-11,1225.37,2824.67,0,1392.41,-2991.71,-22140.82
2715691577825980416,2020-12,2287.9,4018.93,0,2863.05,-4594.08,-26734.9
2717613291668044288,2020-01,5767.85,3877.29,7472.13,3716.63,5646.06,5646.06
2717613291668044288,2020-02,2703.05,4197.9,1976.33,657.19,-175.71,5470.35
2717613291668044288,2020-03,5146.49,2064.23,2483.44,4101.03,1464.67,6935.02
2717613291668044288,2020-04,3191.15,3392.99,523.15,1915.58,-1594.27,5340.75
2717613291668044288,2020-05,3883.73,3391.57,3297.26,5314.09,-1524.67,3816.08
2717613291668044288,2020-06,1535.98,3567.89,1507.86,2012.02,-2536.07,1280.01
2717613291668044288,2020-07,1400.25,3821.56,2408.32,0,-12.99,1267.02
2717613291668044288,2020-08,9001.96,2651.82,2960.79,4290.9,5020.03,6287.05
2717613291668044288,2020-09,6665.08,2053.26,1107.68,3476.96,2242.54,8529.59
2717613291668044288,2020-10,4918.18,4788.4,3797.9,2635.22,1292.46,9822.05
2717613291668044288,2020-11,1038.56,0,1888.66,3088.12,-160.9,9661.15
2717613291668044288,2020-12,2907.05,2632.27,3708.7,1178.39,2805.09,12466.24
2719672827189726720,2020-03,2284.81,0,0,0,2284.81,2284.81
2719672827189726720,2020-04,2347.91,1480.57,0,963.56,-96.22,2188.59
2719672827189726720,2020-05,2411.12,0,0,2531.73,-120.61,2067.98
2719672827189726720,2020-06,660.69,1242.87,1395.09,1399.2,-586.29,1481.69
2719672827189726720,2020-07,1540.75,0,0,0,1540.75,3022.44
2719672827189726720,2020-09,1648.42,0,1286.69,0,2935.11,5957.55
2720547543964478976,2020-01,2862.24,4006.52,4282.07,3777.54,-639.75,-639.75
2720547543964478976,2020-02,1346.7,1310.15,1896.07,943.57,989.05,349.3
2720547543964478976,2020-03,2458.61,5059.44,3759.36,3024.79,-1866.26,-1516.96
2720547543964478976,2020-04,3254.97,2596.86,1553.31,3863.84,-1652.42,-3169.38
2720547543964478976,2020-05,0,2986.6,2368.08,2646.77,-3265.29,-6434.67
2720547543964478976,2020-06,4979.6,0,1104.24,3581.79,2502.05,-3932.62
2720547543964478976,2020-07,2079.79,2438.55,3105.61,5248.25,-2501.4,-6434.02
2720547543964478976,2020-08,3535.69,1906.47,3788.1,0,5417.32,-1016.7
2720547543964478976,2020-09,1175.69,1134.27,4763.5,3523.44,1281.48,264.78
2720547543964478976,2020-10,1657.08,1472.85,852,1296.15,-259.92,4.86
2720547543964478976,2020-11,1847.46,2757.29,5317.5,4604.21,-196.54,-191.68
2720547543964478976,2020-12,6532.44,1498.6,3334.89,1504.25,6864.48,6672.8
2722076345515904512,2020-01,2047.97,2557.65,0,0,-509.68,-509.68
2722076345515904512,2020-02,1348.69,3459.27,0,2004.76,-4115.34,-4625.02
2722076345515904512,2020-03,2363.85,1058.19,5236.37,3280.86,3261.17,-1363.85
2722076345515904512,2020-04,2082.08,2117.05,1205.98,1580.58,-409.57,-1773.42
2722076345515904512,2020-05,4847.27,3306.54,3476.38,2095.28,2921.83,1148.41
2722076345515904512,2020-06,283.12,3231.29,1933.61,1744.48,-2759.04,-1610.63
2722076345515904512,2020-07,1015.24,27.18,1111.71,1098.94,1000.83,-609.8
2722076345515904512,2020-08,2889.64,315.24,1576.13,466.61,3683.92,3074.12
2722076345515904512,2020-09,301.31,538.26,1704.62,1393.63,74.04,3148.16
2722076345515904512,2020-10,1245.89,1577.5,112.64,4219.65,-4438.62,-1290.46
2722076345515904512,2020-11,882.82,0,2083.07,899.2,2066.69,776.23
2722076345515904512,2020-12,2521.09,1243.03,4905.39,1617.01,4566.44,5342.67
2722432012312605184,2020-01,7097.24,12174.45,3678.57,3745.12,-5143.76,-5143.76
2722432012312605184,2020-02,2476.36,7172.12,5844.12,3721.95,-2573.59,-7717.35
2722432012312605184,2020-03,3438.43,687.16,2600.98,4965.58,386.67,-7330.68
2722432012312605184,2020-04,5734.91,3676.89,3316.77,6820.99,-1446.2,-8776.88
2722432012312605184,2020-05,940.31,3048.82,2579.64,9972.19,-9501.06,-18277.94
2722432012312605184,2020-06,1869.4,1041.74,4880.39,6223.79,-515.74,-18793.68
2722432012312605184,2020-07,10396.29,6029.5,3511.78,2753.58,5124.99,-13668.69
2722432012312605184,2020-08,3414,10199.45,2170.99,8699.71,-13314.17,-26982.86
2722432012312605184,2020-09,1536.6,5029.03,6414.73,5482.75,-2560.45,-29543.31
2722432012312605184,2020-10,4241.88,5785.59,2286.47,2922.98,-2180.22,-31723.53
2722432012312605184,2020-11,3293.75,1779.21,3276.5,8374.64,-3583.6,-35307.13
2722432012312605184,2020-12,1011.95,6809.4,6179.68,2326.81,-1944.58,-37251.71
2725553298761572864,2020-01,6642.25,3385.46,4120.29,3824.75,3552.33,3552.33
2725553298761572864,2020-02,2607.6,8080.84,2845.32,5135.75,-7763.67,-4211.34
2725553298761572864,2020-03,5836.65,2129.38,2035.52,3800.11,1942.68,-2268.66
2725553298761572864,2020-04,9224.39,3840.92,4700.5,2802.13,7281.84,5013.18
2725553298761572864,2020-05,7481.75,8741.21,4810.78,6802.18,-3250.86,1762.32
2725553298761572864,2020-06,8033.18,2763.18,402.28,922.65,4749.63,6511.95
2725553298761572864,2020-07,2805.58,1810.45,2706.58,5972.78,-2271.07,4240.88
2725553298761572864,2020-08,7598.51,1522.81,10284.88,6217.79,10142.79,14383.67
2725553298761572864,2020-09,3051.16,2559.99,3831,6574.05,-2251.88,12131.79
2725553298761572864,2020-10,6048.9,3097.46,2875.93,10782.64,-4955.27,7176.52
2725553298761572864,2020-11,1989.29,4901.94,2280.82,4040.38,-4672.21,2504.31
2725553298761572864,2020-12,7034.77,3263.12,1084.19,4497.4,358.44,2862.75
2725594378771988992,2020-01,1537.3,1960,896.22,650.36,-176.84,-176.84
2725594378771988992,2020-02,2168.78,1753.67,2302.9,13.61,2704.4,2527.56
2725594378771988992,2020-03,3933.78,1020.98,1965.12,5800.26,-922.34,1605.22
2725594378771988992,2020-04,1739.36,365.62,648.36,1762.25,259.85,1865.07
2725594378771988992,2020-05,0,1726.12,172.16,2041.07,-3595.03,-1729.96
2725594378771988992,2020-06,1239.96,2587.49,538.39,7232.54,-8041.68,-9771.64
2725594378771988992,2020-07,3493.6,392.92,1890.68,8202.42,-3211.06,-12982.7
2725594378771988992,2020-08,603.4,0,2539.25,4079.12,-936.47,-13919.17
2725594378771988992,2020-09,3914.9,0,2542.88,3042.91,3414.87,-10504.3
2725594378771988992,2020-10,1721.19,609.79,0,0,1111.4,-9392.9
2725594378771988992,2020-11,61.05,1423.94,1565.48,4716.59,-4514,-13906.9
2725594378771988992,2020-12,1887.73,1287.56,2781.84,0,3382.01,-10524.89
2725834529701381120,2020-01,2603.63,3210.39,4159.03,1544.77,2007.5,2007.5
2725834529701381120,2020-02,1130.69,5198.92,7138.69,5026.77,-1956.31,51.19
2725834529701381120,2020-03,3911.96,4068.73,2489.75,3419.3,-1086.32,-1035.13
2725834529701381120,2020-04,4510.17,5974.9,3787.34,2189.94,132.67,-902.46
2725834529701381120,2020-05,4042.14,3501.05,3452.09,2259.23,1733.95,831.49
2725834529701381120,2020-06,1897.36,838.37,2604.31,7091.49,-3428.19,-2596.7
2725834529701381120,2020-07,102.55,5428.18,1566.4,2532.37,-6291.6,-8888.3
2725834529701381120,2020-08,2204.9,2160.71,1909.74,1616.93,337,-8551.3
2725834529701381120,2020-09,1804.97,2442.14,1522.91,2036.32,-1150.58,-9701.88
2725834529701381120,2020-10,2175.34,3210.16,2539.03,2234.86,-730.65,-10432.53
2725834529701381120,2020-11,2639.13,1222.64,4289.45,524.55,5181.39,-5251.14
2725834529701381120,2020-12,0,5586.43,3427.2,4600.08,-6759.31,-12010.45
2726244005006798336,2020-01,241.84,1730.43,1327.17,1185.32,-1346.74,-1346.74
2726244005006798336,2020-02,1849.22,1848.81,2637.5,1561.07,1076.84,-269.9
2726244005006798336,2020-03,0,977.56,0,1942.85,-2920.41,-3190.31
2726244005006798336,2020-04,1815.86,0,1207.07,0,3022.93,-167.38
2726244005006798336,2020-06,1040.41,2147.45,0,0,-1107.04,-1274.42
2726244005006798336,2020-07,339.92,2611.46,0,0,-2271.54,-3545.96
2726244005006798336,2020-08,1896.41,113.08,0,1241.83,541.5,-3004.46
2726244005006798336,2020-09,0,2596.89,0,2102.47,-4699.36,-7703.82
2726244005006798336,2020-12,3130.98,1905.8,1526.73,0,2751.91,-4951.91
2728377282182425088,2020-01,5318.16,384.07,1081.78,900.51,5115.36,5115.36
2728377282182425088,2020-02,6838.14,1393.87,5888.53,1956.2,9376.6,14491.96
2728377282182425088,2020-03,2683.33,2544.47,4544.59,3451.29,1232.16,15724.12
2728377282182425088,2020-04,4371.74,1386.15,0,5279.11,-2293.52,13430.6
2728377282182425088,2020-05,6344.93,1566.61,3476.32,2942.34,5312.3,18742.9
2728377282182425088,2020-06,750.61,0,562.03,5272.76,-3960.12,14782.78
2728377282182425088,2020-07,1423.93,1524.3,5316.69,6725.42,-1509.1,13273.68
2728377282182425088,2020-08,965.85,2599.81,6409.79,0,4775.83,18049.51
2728377282182425088,2020-09,10616.1,3480.87,0,2532.17,4603.06,22652.57
2728377282182425088,2020-10,1111,2941.52,3257.7,4537.34,-3110.16,19542.41
2728377282182425088,2020-11,1069.39,1094.07,1231.99,4568.3,-3360.99,16181.42
2728377282182425088,2020-12,3763.2,1941.83,4214.79,2458.44,3577.72,19759.14
2729991315204087808,2020-01,3903.05,3229.19,12924.13,4432.14,9165.85,9165.85
2729991315204087808,2020-02,2440.53,2359.14,1574.74,5149.4,-3493.27,5672.58
2729991315204087808,2020-03,3739.12,2775.58,818.77,2318.16,-535.85,5136.73
2729991315204087808,2020-04,4115.8,3152.1,4704.17,2359.03,3308.84,8445.57
2729991315204087808,2020-05,5336.33,4255.97,5113.44,4055.25,2138.55,10584.12
2729991315204087808,2020-06,2057.4,1001.92,5037.67,3291.53,2801.62,13385.74
2729991315204087808,2020-07,3408.19,3487.64,5938.87,4860.1,999.32,14385.06
2729991315204087808,2020-08,5103.42,4468.78,4504.87,6915.13,-1775.62,12609.44
2729991315204087808,2020-09,4879.15,3168.29,3945.48,3646.31,2010.03,14619.47
2729991315204087808,2020-10,2070.8,1562.32,7983.62,3377.97,5114.13,19733.6
2729991315204087808,2020-11,720.63,3965.18,2441.73,3418.32,-4221.14,15512.46
2729991315204087808,2020-12,0,3254.5,4321.37,5508.77,-4441.9,11070.56
2732329515840476672,2020-01,1560.25,3836.62,6845.65,176.21,4393.07,4393.07
2732329515840476672,2020-02,5568.15,9605.48,4822.83,4224.27,-3438.77,954.3
2732329515840476672,2020-03,4004.75,3227.54,2408.6,4655.44,-1469.63,-515.33
2732329515840476672,2020-04,0,2395.24,1137.88,3323.98,-4581.34,-5096.67
2732329515840476672,2020-05,3193.1,2874.15,1150.91,2651.95,-1182.09,-6278.76
2732329515840476672,2020-06,3482.48,381.93,482.33,4349.91,-767.03,-7045.79
2732329515840476672,2020-07,3134.29,4005.83,6900.17,3314.2,2714.43,-4331.36
2732329515840476672,2020-08,3203.45,5557.94,4551.26,4720.58,-2523.81,-6855.17
2732329515840476672,2020-09,3228.71,3181.07,6837.38,4252.61,2632.41,-4222.76
2732329515840476672,2020-10,817.61,2720.91,3017.6,3118.26,-2003.96,-6226.72
2732329515840476672,2020-11,5629.79,5176.93,6196.17,3424.42,3224.61,-3002.11
2732329515840476672,2020-12,2452.8,5348.91,3861.67,871.22,94.34,-2907.77
2732612839591134720,2020-01,154.73,1033.8,1692.58,7166.51,-6353,-6353
2732612839591134720,2020-02,1484.49,5132.86,929.26,2695.39,-5414.5,-11767.5
2732612839591134720,2020-03,3550.63,0,379.17,5426.21,-1496.41,-13263.91
2732612839591134720,2020-04,3956.98,4908.61,1318.64,0,367.01,-12896.9
2732612839591134720,2020-05,794.9,5441.68,2900.15,790.5,-2537.13,-15434.03
2732612839591134720,2020-06,2000.94,2644.59,6377.85,3376.01,2358.19,-13075.84
2732612839591134720,2020-07,1964.14,1813.68,3074.99,1203.01,2022.44,-11053.4
2732612839591134720,2020-08,55.04,5338.65,1301.21,847.3,-4829.7,-15883.1
2732612839591134720,2020-09,953.74,2052.33,2011.05,6453.4,-5540.94,-21424.04
2732612839591134720,2020-10,3868.58,1434.47,197.86,1944.91,687.06,-20736.98
2732612839591134720,2020-11,1386.1,3454.08,3333.84,3176.87,-1911.01,-22647.99
2732612839591134720,2020-12,3291.79,6151.72,3609.81,4947.56,-4197.68,-26845.67
2733291530620530688,2020-01,2418.8,1192.84,0,5000.94,-3774.98,-3774.98
2733291530620530688,2020-02,1248.37,1414.3,0,1105.74,-1271.67,-5046.65
2733291530620530688,2020-03,0,4982.62,2617.59,4373.35,-6738.38,-11785.03
2733291530620530688,2020-04,0,1354.04,6289.15,4748.53,186.58,-11598.45
2733291530620530688,2020-05,3794.71,5368.92,1728.78,3590.66,-3436.09,-15034.54
2733291530620530688,2020-06,4334.36,1808.33,3791.9,574.3,5743.63,-9290.91
2733291530620530688,2020-07,1576.23,4139.91,3486.2,3061.54,-2139.02,-11429.93
2733291530620530688,2020-08,306.96,6177.37,0,230.37,-6100.78,-17530.71
2733291530620530688,2020-09,1818.24,1720.08,2411.92,540.9,1969.18,-15561.53
2733291530620530688,2020-10,1334.54,0,1503.39,4305.4,-1467.47,-17029
2733291530620530688,2020-11,192.4,903.77,1064.8,437.13,-83.7,-17112.7
2733291530620530688,2020-12,830.73,2783.39,2053.73,1782.77,-1681.7,-18794.4
2733466533209110528,2020-01,0,2218.68,2414.29,112.07,83.54,83.54
2733466533209110528,2020-02,3807.34,5517.42,769.8,4619.49,-5559.77,-5476.23
2733466533209110528,2020-03,11741.06,0,0,2287.07,9453.99,3977.76
2733466533209110528,2020-04,1643.79,1984.35,0,1709.4,-2049.96,1927.8
2733466533209110528,2020-05,375.19,3718.61,3959.27,9310.32,-8694.47,-6766.67
2733466533209110528,2020-06,1255.42,2914.46,1273.82,2011.98,-2397.2,-9163.87
2733466533209110528,2020-07,1660.46,565.42,0,2031.24,-936.2,-10100.07
2733466533209110528,2020-08,3374.54,1745.38,2703.75,1313.9,3019.01,-7081.06
2733466533209110528,2020-09,1588.21,3409.55,1129.66,801.8,-1493.48,-8574.54
2733466533209110528,2020-10,1554.11,0,2836.46,4263.25,127.32,-8447.22
2733466533209110528,2020-11,1434.4,2415.6,2071.73,2284.98,-1194.45,-9641.67
2733466533209110528,2020-12,0,6516.98,2675.44,2034.51,-5876.05,-15517.72
2734622979367848448,2020-01,4675.17,514.18,5577.86,5747.38,3991.47,3991.47
2734622979367848448,2020-02,3043.36,1451.74,4376.64,2133.29,3834.97,7826.44
2734622979367848448,2020-03,3110.11,1962.01,4282.86,2168.48,3262.48,11088.92
2734622979367848448,2020-04,5084.29,1060.77,115.78,2655.17,1484.13,12573.05
2734622979367848448,2020-05,4803.12,4981.29,4013.04,3558.98,275.89,12848.94
2734622979367848448,2020-06,1899.74,44.15,1869,4519.33,-794.74,12054.2
2734622979367848448,2020-07,0,4627.56,461.7,2265.91,-6431.77,5622.43
2734622979367848448,2020-08,1049.93,1654.19,0,1966.7,-2570.96,3051.47
2734622979367848448,2020-09,2834.55,6696.85,1504.05,2011.93,-4370.18,-1318.71
2734622979367848448,2020-10,2437.47,6193.97,2364.25,4680.94,-6073.19,-7391.9
2734622979367848448,2020-11,2290.98,2223.24,1631.14,4455.37,-2756.49,-10148.39
2734622979367848448,2020-12,0,4113.79,3860.55,2583.68,-2836.92,-12985.31
2734904238562079232,2020-01,4975.7,5772.27,2182.13,0,1385.56,1385.56
2734904238562079232,2020-02,5260.22,3939.64,1638.33,2680.56,278.35,1663.91
2734904238562079232,2020-03,1340.18,0,8355.15,6025.36,3669.97,5333.88
2734904238562079232,2020-04,2472.93,3816.5,4970.55,3240.84,386.14,5720.02
2734904238562079232,2020-05,3965.63,5107.03,4405.56,4736.04,-1471.88,4248.14
2734904238562079232,2020-06,4371.46,6250.12,4153.79,7270.37,-4995.24,-747.1
2734904238562079232,2020-07,1739.65,1058.31,4784.02,2687.37,2777.99,2030.89
2734904238562079232,2020-08,5041.19,3372.05,1332.05,5139.97,-2138.78,-107.89
2734904238562079232,2020-09,2053.81,3391.12,4851.04,9063.11,-5549.38,-5657.27
2734904238562079232,2020-10,5842.33,4579.31,2392.14,988.49,2666.67,-2990.6
2734904238562079232,2020-11,6055.5,2232.98,1985.33,9357.74,-3549.89,-6540.49
2734904238562079232,2020-12,6932.67,5385.92,4425.78,5511.06,461.47,-6079.02
2735994828598838272,2020-01,500.2,3276.29,2753.64,453.34,-475.79,-475.79
2735994828598838272,2020-02,5080.22,4111.92,1684.87,3246.45,-593.28,-1069.07
2735994828598838272,2020-03,2249.58,1208.63,3687.83,4503.31,225.47,-843.6
2735994828598838272,2020-04,6181.88,2147.7,1614.43,1190.02,4458.59,3614.99
2735994828598838272,2020-05,4646.77,1766.46,16.34,3798.63,-901.98,2713.01
2735994828598838272,2020-06,5090.22,2891,4524.58,909.53,5814.27,8527.28
2735994828598838272,2020-07,3247.6,353.83,1711.62,4650.31,-44.92,8482.36
2735994828598838272,2020-08,2519.22,928.52,7858.88,2377.33,7072.25,15554.61
2735994828598838272,2020-09,2540.57,1667.43,1776.48,1541.69,1107.93,16662.54
2735994828598838272,2020-10,647.58,272.44,1233.52,2715.78,-1107.12,15555.42
2735994828598838272,2020-11,0,1869.38,1854.36,5218.92,-5233.94,10321.48
2735994828598838272,2020-12,2605.7,3989.83,3170.86,5392.5,-3605.77,6715.71
2736096596525627392,2020-01,3466.67,2329.59,6434.75,7557.74,14.09,14.09
2736096596525627392,2020-02,565.01,335.91,6108.48,2845.17,3492.41,3506.5
2736096596525627392,2020-03,5012.76,2310.3,4880.36,4975.4,2607.42,6113.92
2736096596525627392,2020-04,205.52,9943.07,3437.28,4082.39,-10382.66,-4268.74
2736096596525627392,2020-05,4722.3,5646.2,6575.51,7359.82,-1708.21,-5976.95
2736096596525627392,2020-06,2625.96,6913.69,2062,2206.33,-4432.06,-10409.01
2736096596525627392,2020-07,5278.75,8439.53,8732.43,5978.27,-406.62,-10815.63
2736096596525627392,2020-08,0,7642.81,4237.39,2881.43,-6286.85,-17102.48
2736096596525627392,2020-09,6632.35,4229.96,2665.59,3418.78,1649.2,-15453.28
2736096596525627392,2020-10,10277.46,7702.83,7928.35,8295,2207.98,-13245.3
2736096596525627392,2020-11,7029.26,6388.42,1715.24,7054.93,-4698.85,-17944.15
2736096596525627392,2020-12,1939.09,1096.75,4657.42,2581.69,2918.07,-15026.08
2736285151783418880,2020-01,1576,5492.07,3382.39,2166.83,-2700.51,-2700.51
2736285151783418880,2020-02,2396.61,1304.54,2093.52,3765.67,-580.08,-3280.59
2736285151783418880,2020-03,0,2397.31,4734.05,1388.46,948.28,-2332.31
2736285151783418880,2020-04,2913.14,3652.17,1954.24,3860.46,-2645.25,-4977.56
2736285151783418880,2020-05,1537.22,2274.51,1156.29,5167.55,-4748.55,-9726.11
2736285151783418880,2020-06,1950.18,1702.21,2692.15,254.41,2685.71,-7040.4
2736285151783418880,2020-07,2260.94,3733.27,3679.83,2313.65,-106.15,-7146.55
2736285151783418880,2020-08,190.66,3676.7,4010.05,0,524.01,-6622.54
2736285151783418880,2020-09,2309.91,2551.05,3061.99,271.21,2549.64,-4072.9
2736285151783418880,2020-10,857.44,4429.6,6513.35,1272.63,1668.56,-2404.34
2736285151783418880,2020-11,1576.98,1810.64,1415.16,494.94,686.56,-1717.78
2736285151783418880,2020-12,0,5459.76,2007.82,1468.33,-4920.27,-6638.05
2737142542405185536,2020-01,4159.76,723.07,727.32,766.39,3397.62,3397.62
2737142542405185536,2020-02,1371.62,2098.38,0,0,-726.76,2670.86
2737142542405185536,2020-03,465.07,1590.34,3497.48,1663.65,708.56,3379.42
2737142542405185536,2020-04,3434.14,0,2033.27,1715.45,3751.96,7131.38
2737142542405185536,2020-05,3390.11,3811.18,303.93,0,-117.14,7014.24
2737142542405185536,2020-06,2162.27,655.39,1552.52,2950.8,108.6,7122.84
2737142542405185536,2020-07,2354.31,1289.67,1925.85,1888.85,1101.64,8224.48
2737142542405185536,2020-08,1713.19,632.83,5206.27,385.32,5901.31,14125.79
2737142542405185536,2020-09,37.25,393.34,0,6585.62,-6941.71,7184.08
2737142542405185536,2020-10,973.67,1758.55,1206.04,1115.28,-694.12,6489.96
2737142542405185536,2020-11,2506.89,0,1985.17,4304.19,187.87,6677.83
2737142542405185536,2020-12,0,2866.27,478.3,4536.75,-6924.72,-246.89
2737289577272280064,2020-01,2086.91,678.23,1360.72,4097.92,-1328.52,-1328.52
2737289577272280064,2020-02,1921.6,5260.88,328.7,1397.77,-4408.35,-5736.87
2737289577272280064,2020-03,7570.93,2385.6,0,1783.21,3402.12,-2334.75
2737289577272280064,2020-04,118.87,4556.52,2480.6,1807.24,-3764.29,-6099.04
2737289577272280064,2020-05,3790.56,4603.92,3119.41,0,2306.05,-3792.99
2737289577272280064,2020-06,1693.9,6248.76,3013.17,4498.22,-6039.91,-9832.9
2737289577272280064,2020-07,5109.53,3280.06,3885.55,2647.84,3067.18,-6765.72
2737289577272280064,2020-08,2992.44,2912.66,1771.89,4008.52,-2156.85,-8922.57
2737289577272280064,2020-09,1341.32,7338.15,4610.67,517.26,-1903.42,-10825.99
2737289577272280064,2020-10,457.09,4564.78,4979.26,4381.07,-3509.5,-14335.49
2737289577272280064,2020-11,3080.45,7664.33,2693.37,1531.41,-3421.92,-17757.41
2737289577272280064,2020-12,503.01,3390.93,4485.45,5115.6,-3518.07,-21275.48
2737932478567112192,2020-01,0,849.12,0,0,-849.12,-849.12
2737932478567112192,2020-10,0,1443.87,2300.73,0,856.86,7.74
2737932478567112192,2020-11,798.59,26.53,0,0,772.06,779.8
2737932478567112192,2020-12,1669.49,0,1824.95,511.57,2982.87,3762.67
2738787417205901824,2020-01,0,1759.2,0,0,-1759.2,-1759.2
2738787417205901824,2020-02,0,1395.39,0,0,-1395.39,-3154.59
2738787417205901824,2020-03,1700.5,0,1228.74,0,2929.24,-225.35
2738787417205901824,2020-05,0,22.88,0,0,-22.88,-248.23
2738787417205901824,2020-08,0,480.27,0,0,-480.27,-728.5
2738787417205901824,2020-09,1015.44,0,0,0,1015.44,286.94
2738787417205901824,2020-10,497.95,862.97,0,0,-365.02,-78.08
2740643627696656896,2020-01,0,211.61,3279.69,635.65,2432.43,2432.43
2740643627696656896,2020-02,0,4070.35,2677.93,740.74,-2133.16,299.27
2740643627696656896,2020-04,4585.24,0,0,1010.62,3574.62,3873.89
2740643627696656896,2020-05,4094.6,0,0,2231.56,1863.04,5736.93
2740643627696656896,2020-06,1211.54,6408.1,928.36,521.27,-4789.47,947.46
2740643627696656896,2020-07,3128.8,1334.05,2163.15,4301.74,-343.84,603.62
2740643627696656896,2020-08,0,3261,1322.88,1255.16,-3193.28,-2589.66
2740643627696656896,2020-09,453.55,2141.06,680.56,2703.35,-3710.3,-6299.96
2740643627696656896,2020-11,1998.68,1726.79,1390.71,1554.69,107.91,-6192.05
2744341108562184704,2020-01,4476.8,5648.26,4519.28,9540.56,-6192.74,-6192.74
2744341108562184704,2020-02,928.83,4139.17,5274.99,459.44,1605.21,-4587.53
2744341108562184704,2020-03,0,2483.27,127.55,1743.43,-4099.15,-8686.68
2744341108562184704,2020-04,5827.07,1007.98,3763.13,5843.06,2739.16,-5947.52
2744341108562184704,2020-05,244.5,965.15,1951.74,4650.31,-3419.22,-9366.74
2744341108562184704,2020-06,1688.08,8114.77,4955.21,6098.5,-7569.98,-16936.72
2744341108562184704,2020-07,4029.45,520.68,3155.78,7529.57,-865.02,-17801.74
2744341108562184704,2020-08,1729.64,6445.83,6053.27,2008.18,-671.1,-18472.84
2744341108562184704,2020-09,6813.9,2273.77,4512.91,2716.27,6336.77,-12136.07
2744341108562184704,2020-10,5295.43,5676.16,4174.44,1887.92,1905.79,-10230.28
2744341108562184704,2020-11,4862.49,2651.24,4133.29,5322.6,1021.94,-9208.34
2744341108562184704,2020-12,2170.13,2517.71,5557.92,5728.84,-518.5,-9726.84
2744638029619633152,2020-01,345.49,0,0,219.62,125.87,125.87
2744638029619633152,2020-02,117.94,0,0,0,117.94,243.81
2744638029619633152,2020-03,1372.76,1634.06,1839.18,526.49,1051.39,1295.2
2744638029619633152,2020-05,1690.2,0,413.9,399.49,1704.61,2999.81
2744638029619633152,2020-06,614.57,0,359.7,764.71,209.56,3209.37
2744638029619633152,2020-07,0,1117.58,0,0,-1117.58,2091.79
2744638029619633152,2020-08,1205.07,453.85,1022.97,0,1774.19,3865.98
2744638029619633152,2020-09,0,1010.43,0,0,-1010.43,2855.55
2744638029619633152,2020-10,129.92,0,0,0,129.92,2985.47
2744638029619633152,2020-11,2558.6,71.08,412.14,1853.06,1046.6,4032.07
2744638029619633152,2020-12,998.79,0,0,0,998.79,5030.86
2745875311889766400,2020-01,4136.07,4209.65,4057.18,3914.44,69.16,69.16
2745875311889766400,2020-02,3441.9,3237.63,2432.27,0,2636.54,2705.7
2745875311889766400,2020-03,8663.36,5191.83,3030.46,0,6501.99,9207.69
2745875311889766400,2020-04,185.65,1469.21,1997.51,1608.16,-894.21,8313.48
2745875311889766400,2020-05,4184.91,2838.24,3177.76,6607.09,-2082.66,6230.82
2745875311889766400,2020-06,2304.83,2480.64,5996.74,6173.43,-352.5,5878.32
2745875311889766400,2020-07,2393.79,2317.41,3196.3,7737.19,-4464.51,1413.81
2745875311889766400,2020-08,3534.39,3135.05,3249.67,4683.01,-1034,379.81
2745875311889766400,2020-09,5888.25,836.56,3459.06,2994.09,5516.66,5896.47
2745875311889766400,2020-10,4945.76,1466.74,1895.26,0,5374.28,11270.75
2745875311889766400,2020-11,2363.75,1803.29,6261.12,4764.62,2056.96,13327.71
2745875311889766400,2020-12,5450.98,0,1284.49,4285.34,2450.13,15777.84
2746410672461254144,2020-01,1524.11,3304.63,7073.18,3069.71,2222.95,2222.95
2746410672461254144,2020-02,1304.34,1218.02,5858.81,3565.11,2380.02,4602.97
2746410672461254144,2020-03,2234.34,570.87,10908.41,2783.62,9788.26,14391.23
2746410672461254144,2020-04,3847.88,6425.39,2864.46,6986.05,-6699.1,7692.13
2746410672461254144,2020-05,8645.89,5329.38,2523.95,3018.28,2822.18,10514.31
2746410672461254144,2020-06,6383.09,4857.91,987.87,3554.49,-1041.44,9472.87
2746410672461254144,2020-07,6482,7167.78,3938.79,1054.48,2198.53,11671.4
2746410672461254144,2020-08,1440.69,1484.14,3067.69,330.84,2693.4,14364.8
2746410672461254144,2020-09,3277.38,334.7,1998.42,1674.38,3266.72,17631.52
2746410672461254144,2020-10,2048.76,1873.75,2470.35,4959.34,-2313.98,15317.54
2746410672461254144,2020-11,6376.39,3703.07,2577.21,5102.86,147.67,15465.21
2746410672461254144,2020-12,0,457.54,7821.64,2318.02,5046.08,20511.29
2747256619800276480,2020-01,282.74,2742.32,1594.95,3778.22,-4642.85,-4642.85
2747256619800276480,2020-02,3825.92,2021.38,599.1,3069.85,-666.21,-5309.06
2747256619800276480,2020-03,970.56,5067.27,2915.19,6977.16,-8158.68,-13467.74
2747256619800276480,2020-04,3009.28,1967.84,890.62,9318.77,-7386.71,-20854.45
2747256619800276480,2020-05,3343.83,2067.01,5830.19,1259.15,5847.86,-15006.59
2747256619800276480,2020-06,1343.71,1562.15,16230.98,2328.82,13683.72,-1322.87
2747256619800276480,2020-07,7766.87,3517.88,4646.41,2851.76,6043.64,4720.77
2747256619800276480,2020-08,4930.53,6417.03,4627.59,4550.77,-1409.68,3311.09
2747256619800276480,2020-09,368.2,4354.51,4249.53,1009.48,-746.26,2564.83
2747256619800276480,2020-10,1747.87,7584.58,7877.46,1176.35,864.4,3429.23
2747256619800276480,2020-11,6055.2,8551.83,794,5012.99,-6715.62,-3286.39
2747256619800276480,2020-12,4078.69,4521.49,3461.2,6600.66,-3582.26,-6868.65
2748175160167892992,2020-01,2936.87,3082.33,6108.4,3176.29,2786.65,2786.65
2748175160167892992,2020-02,6107.81,6827.28,7141.74,1666.05,4756.22,7542.87
2748175160167892992,2020-03,2194.03,2443.81,7045.38,7566.86,-771.26,6771.61
2748175160167892992,2020-04,2507.75,2689.93,4738.71,4625.86,-69.33,6702.28
2748175160167892992,2020-05,2499.69,4530.04,4712.47,3951.32,-1269.2,5433.08
2748175160167892992,2020-06,5044.38,584.93,6572.17,1636.74,9394.88,14827.96
2748175160167892992,2020-07,3341.14,3166.83,4737.63,6062.09,-1150.15,13677.81
2748175160167892992,2020-08,2953.72,5454.29,3205.25,7566.1,-6861.42,6816.39
2748175160167892992,2020-09,3299.37,6048.15,3352.88,7963.01,-7358.91,-542.52
2748175160167892992,2020-10,423.56,6443.87,693.48,5759.76,-11086.59,-11629.11
2748175160167892992,2020-11,7726.77,1543.92,3564.2,4005.2,5741.85,-5887.26
2748175160167892992,2020-12,2778.78,4922.07,3237.4,1930.21,-836.1,-6723.36
2749423287762897408,2020-01,2664.73,1632.72,9872.73,4906.19,5998.55,5998.55
2749423287762897408,2020-02,3491.93,3106.5,4695.41,4252.45,828.39,6826.94
2749423287762897408,2020-03,4395.93,3337.31,4963.29,4449.74,1572.17,8399.11
2749423287762897408,2020-04,4163.85,5855.9,1073.28,0,-618.77,7780.34
2749423287762897408,2020-05,3995.61,2876.47,0,542.86,576.28,8356.62
2749423287762897408,2020-06,4015.98,3330.37,1742.99,2548.93,-120.33,8236.29
2749423287762897408,2020-07,2920.84,4311.7,1124.23,7749.66,-8016.29,220
2749423287762897408,2020-08,121.55,2484.04,2950.61,3743.69,-3155.57,-2935.57
2749423287762897408,2020-09,0,1900.67,808.09,7253.88,-8346.46,-11282.03
2749423287762897408,2020-10,5176.41,4389.53,4724.59,1828.32,3683.15,-7598.88
2749423287762897408,2020-11,3216.02,2176.64,3760.08,3843.06,956.4,-6642.48
2749423287762897408,2020-12,3139.79,1427.11,595.57,5508.75,-3200.5,-9842.98
2749846110487309312,2020-01,3415.58,3999.21,1870.64,2851.45,-1564.44,-1564.44
2749846110487309312,2020-02,2512.11,0,2225.76,479.49,4258.38,2693.94
2749846110487309312,2020-03,2938.34,51.56,2239.38,4908.85,217.31,2911.25
2749846110487309312,2020-04,4694.49,1511.5,917,1971.53,2128.46,5039.71
2749846110487309312,2020-05,2193.89,4265.13,687.71,33.39,-1416.92,3622.79
2749846110487309312,2020-06,861.55,1678.65,2537.18,0,1720.08,5342.87
2749846110487309312,2020-07,1187.51,1331.26,2494.77,1730.88,620.14,5963.01
2749846110487309312,2020-08,4252.41,3017.77,2380.1,4874.51,-1259.77,4703.24
2749846110487309312,2020-09,0,2839.92,2023.85,1543.6,-2359.67,2343.57
2749846110487309312,2020-10,3073.56,380.3,5493.7,35.11,8151.85,10495.42
2749846110487309312,2020-11,2595.21,2324.54,0,0,270.67,10766.09
2749846110487309312,2020-12,1692.31,3551.84,2085.44,4197.48,-3971.57,6794.52
2750064073522882560,2020-02,3209.95,0,1516.86,1805.91,2920.9,2920.9
2750064073522882560,2020-03,1170.94,428.83,0,1543.8,-801.69,2119.21
2750064073522882560,2020-04,2840.14,1891.94,1984.68,2810.76,122.12,2241.33
2750064073522882560,2020-05,0,628.27,2802.08,2179.44,-5.63,2235.7
2750064073522882560,2020-06,3317.19,663.39,669.74,1296.09,2027.45,4263.15
2750064073522882560,2020-07,4419.42,4967.84,893.74,2143.71,-1798.39,2464.76
2750064073522882560,2020-08,3311.21,737.81,0,2327.22,246.18,2710.94
2750064073522882560,2020-09,0,6628.26,769.91,0,-5858.35,-3147.41
2750064073522882560,2020-10,0,1256.46,1480.51,1726.42,-1502.37,-4649.78
2750064073522882560,2020-12,0,3278.06,0,0,-3278.06,-7927.84
2750414880760028160,2020-01,3312.78,0,0,321.43,2991.35,2991.35
2750414880760028160,2020-02,546.96,1962.06,1847.86,5891.71,-5458.95,-2467.6
2750414880760028160,2020-03,1133.45,0,1739.93,3461.48,-588.1,-3055.7
2750414880760028160,2020-04,1342.31,0,2865.72,1494.76,2713.27,-342.43
2750414880760028160,2020-05,2205.22,0,2066.87,0,4272.09,3929.66
2750414880760028160,2020-06,3402.53,1614.1,1088.93,0,2877.36,6807.02
2750414880760028160,2020-07,911.68,2186.33,1792.47,2441.29,-1923.47,4883.55
2750414880760028160,2020-08,2464.81,0,0,0,2464.81,7348.36
2750414880760028160,2020-09,3629.11,0,3162.37,2550.89,4240.59,11588.95
2750414880760028160,2020-10,189.15,4301.16,1970.88,4412.17,-6553.3,5035.65
2750414880760028160,2020-11,1206.13,1020.46,1723.1,3758.46,-1849.69,3185.96
2750414880760028160,2020-12,2241.43,2863.54,0,3102.31,-3724.42,-538.46
2750534906703339520,2020-01,4369.69,1958.98,6441.59,2809.63,6042.67,6042.67
2750534906703339520,2020-02,3444.48,0,1980.13,3383.03,2041.58,8084.25
2750534906703339520,2020-03,2418.94,2747.1,3136.86,6722.95,-3914.25,4170
2750534906703339520,2020-04,4266.56,6139.79,4108.64,2462.37,-226.96,3943.04
2750534906703339520,2020-05,3463.49,3611.47,5402.38,679.17,4575.23,8518.27
2750534906703339520,2020-06,998.46,3327.3,2684.97,1878.04,-1521.91,6996.36
2750534906703339520,2020-07,0,812.96,4340.02,3678.77,-151.71,6844.65
2750534906703339520,2020-08,4002.38,6914.93,4483.16,4879.99,-3309.38,3535.27
2750534906703339520,2020-09,2956.68,5200.69,6499.47,2928.28,1327.18,4862.45
2750534906703339520,2020-10,9611.05,3380.68,11.36,841.82,5399.91,10262.36
2750534906703339520,2020-11,3486.87,4197.07,10451.61,1317.67,8423.74,18686.1
2750534906703339520,2020-12,0,2334.43,2925.05,6633.3,-6042.68,12643.42
2750752480496327680,2020-01,4710.36,0,1954.99,3680.35,2985,2985
2750752480496327680,2020-04,703.16,0,1787.28,2748.98,-258.54,2726.46
2750752480496327680,2020-05,2375.84,752.04,2163.65,2119.53,1667.92,4394.38
2750752480496327680,2020-06,0,3813.82,1817.1,1240.5,-3237.22,1157.16
2750752480496327680,2020-07,99.13,1958.63,2814.16,1866.4,-911.74,245.42
2750752480496327680,2020-09,1445.31,564.85,639.53,835.84,684.15,929.57
2750752480496327680,2020-10,638.03,2478.92,3821.78,585.68,1395.21,2324.78
2750752480496327680,2020-11,2672.4,1335.36,1143.04,0,2480.08,4804.86
2750752480496327680,2020-12,1697.39,590.06,2107.8,5360.12,-2144.99,2659.87
2752320295767115264,2020-01,1761.58,3616.92,2011.65,3321.8,-3165.49,-3165.49
2752320295767115264,2020-02,3099.72,4545.47,1868.42,2104.15,-1681.48,-4846.97
2752320295767115264,2020-03,718.9,1751.21,0,3633.78,-4666.09,-9513.06
2752320295767115264,2020-04,3829.8,1481.2,2078.42,2070.47,2356.55,-7156.51
2752320295767115264,2020-05,83.65,1586.07,3635.89,6624.91,-4491.44,-11647.95
2752320295767115264,2020-06,0,7944.28,501.41,4566.5,-12009.37,-23657.32
2752320295767115264,2020-07,2361.94,3946.43,0,7859.76,-9444.25,-33101.57
2752320295767115264,2020-08,3383.82,2604.42,2134.82,3652.29,-738.07,-33839.64
2752320295767115264,2020-09,1662.06,659.66,4142.58,1348.43,3796.55,-30043.09
2752320295767115264,2020-10,1943.18,6414.44,4122.2,1008.54,-1357.6,-31400.69
2752320295767115264,2020-11,3327.69,8519.2,7275.66,970.91,1113.24,-30287.45
2752320295767115264,2020-12,4510.31,4390.89,821.7,3467.08,-2525.96,-32813.41
2752846521700900864,2020-01,0,2246.08,3586.15,6611.25,-5271.18,-5271.18
2752846521700900864,2020-02,4032.64,3100.49,9577.13,3023.9,7485.38,2214.2
2752846521700900864,2020-03,1440.92,3738.72,1772.03,9114.78,-9640.55,-7426.35
2752846521700900864,2020-04,0,5134.49,1510.42,4017.64,-7641.71,-15068.06
2752846521700900864,2020-05,6427.14,6493.6,1406.96,6694.05,-5353.55,-20421.61
2752846521700900864,2020-06,1943.05,1876.33,4711.19,6700.57,-1922.66,-22344.27
2752846521700900864,2020-07,4942.06,2935.59,7338.6,4334.53,5010.54,-17333.73
2752846521700900864,2020-08,5034.89,730.94,3443.63,3268.66,4478.92,-12854.81
2752846521700900864,2020-09,5047.62,3379,880.79,2380,169.41,-12685.4
2752846521700900864,2020-10,5069.35,2416.61,4722.76,1869.94,5505.56,-7179.84
2752846521700900864,2020-11,1030.96,25.82,1685.19,3287.23,-596.9,-7776.74
2752846521700900864,2020-12,0,1844.96,1550.18,4949.79,-5244.57,-13021.31
2753454547016312320,2020-01,2919.19,1625.56,1144.72,3314.41,-876.06,-876.06
2753454547016312320,2020-02,916.83,878.58,3099.01,0,3137.26,2261.2
2753454547016312320,2020-03,1076.49,2613.26,0,3083.59,-4620.36,-2359.16
2753454547016312320,2020-04,1084.16,5781.73,2771.47,41.35,-1967.45,-4326.61
2753454547016312320,2020-05,1447.6,3360,1804.07,1489.43,-1597.76,-5924.37
2753454547016312320,2020-06,376.4,1451.86,2700.33,1559.2,65.67,-5858.7
2753454547016312320,2020-07,1064.29,6441.64,3448.44,3201.75,-5130.66,-10989.36
2753454547016312320,2020-08,2182.31,3800.4,314.08,1683.24,-2987.25,-13976.61
2753454547016312320,2020-09,3024.17,2745.25,2413.98,0,2692.9,-11283.71
2753454547016312320,2020-10,4810.28,1655.2,3261.91,569.1,5847.89,-5435.82
2753454547016312320,2020-11,205.83,4528.16,1963.84,1951.49,-4309.98,-9745.8
2753454547016312320,2020-12,2535.01,397.68,281.26,0,2418.59,-7327.21
2753523421108881408,2020-02,0,652.96,1850.71,0,1197.75,1197.75
2753523421108881408,2020-03,789.5,3145.09,0,615.82,-2971.41,-1773.66
2753523421108881408,2020-04,341.7,1515.08,0,557.79,-1731.17,-3504.83
2753523421108881408,2020-05,0,1648.96,1959.29,141.46,168.87,-3335.96
2753523421108881408,2020-06,554.93,558.92,1989.27,1370.36,614.92,-2721.04
2753523421108881408,2020-07,1270.77,0,1017.29,1241.13,1046.93,-1674.11
2753523421108881408,2020-08,885.87,778.72,437.21,429.05,115.31,-1558.8
2753523421108881408,2020-09,2579.48,3272.84,0,0,-693.36,-2252.16
2753523421108881408,2020-10,0,2146.38,1022.44,178.42,-1302.36,-3554.52
2753523421108881408,2020-11,0,868.84,2083.13,1431.52,-217.23,-3771.75
2753892785740466688,2020-01,1064.33,4652.84,2796.06,1761.65,-2554.1,-2554.1
2753892785740466688,2020-02,2697.23,932.18,911.98,5077.25,-2400.22,-4954.32
2753892785740466688,2020-03,1536.32,2006.67,3015.76,2437.73,107.68,-4846.64
2753892785740466688,2020-04,4958.25,0,3852.05,367.36,8442.94,3596.3
2753892785740466688,2020-05,602.58,732.16,3480.25,6172.77,-2822.1,774.2
2753892785740466688,2020-06,2165.38,2304.33,2190.61,2391.86,-340.2,434
2753892785740466688,2020-07,2875.99,6611.63,2385.42,499.12,-1849.34,-1415.34
2753892785740466688,2020-08,1574.6,2045.11,4223.51,1943.31,1809.69,394.35
2753892785740466688,2020-09,0,4714.52,4933.75,2637.59,-2418.36,-2024.01
2753892785740466688,2020-10,7210.29,1935.94,500.87,3450.4,2324.82,300.81
2753892785740466688,2020-11,864.42,0,3281.56,2081.01,2064.97,2365.78
2753892785740466688,2020-12,3562.58,5164.54,1047.65,4924.69,-5479,-3113.22
2755812866873567744,2020-01,901.72,1398.49,2924.79,2308.52,119.5,119.5
2755812866873567744,2020-03,1851.26,1441.2,2901.12,6278.43,-2967.25,-2847.75
2755812866873567744,2020-04,3051.43,2601.51,1653.72,1146.81,956.83,-1890.92
2755812866873567744,2020-05,2457.58,4467.77,0,160.45,-2170.64,-4061.56
2755812866873567744,2020-06,1480.59,404.84,2004.38,1777.23,1302.9,-2758.66
2755812866873567744,2020-07,1513.09,7984.72,5990.12,1914.78,-2396.29,-5154.95
2755812866873567744,2020-08,724.43,1160.35,2321.82,2267.59,-381.69,-5536.64
2755812866873567744,2020-09,1533.77,1614.59,854.2,3034.26,-2260.88,-7797.52
2755812866873567744,2020-10,5114.69,1488.7,2881.76,1125.54,5382.21,-2415.31
2755812866873567744,2020-11,1106.3,3460.4,1385.18,1265.81,-2234.73,-4650.04
2755812866873567744,2020-12,2749.48,3727.62,4637.19,3579.2,79.85,-4570.19
2756387416962433024,2020-01,5550.09,2433.38,4595.77,1676.05,6036.43,6036.43
2756387416962433024,2020-02,3283.99,6819.02,4324.13,7104.83,-6315.73,-279.3
2756387416962433024,2020-03,4183.53,3099.42,4688.38,2078.15,3694.34,3415.04
2756387416962433024,2020-04,858.77,3643.9,3802.93,5320.99,-4303.19,-888.15
2756387416962433024,2020-05,1219.2,2854.64,3821.15,3704.26,-1518.55,-2406.7
2756387416962433024,2020-06,3067.99,1702.67,4968.14,6642.84,-309.38,-2716.08
2756387416962433024,2020-07,2667.64,3405.42,534.07,2420.35,-2624.06,-5340.14
2756387416962433024,2020-08,1461.51,3257.34,4480.42,3313.91,-629.32,-5969.46
2756387416962433024,2020-09,2435,4507.2,4478.42,830.62,1575.6,-4393.86
2756387416962433024,2020-10,3705.26,1708.9,2667.34,4715.94,-52.24,-4446.1
2756387416962433024,2020-11,4512.25,4348.8,2603.89,10529.62,-7762.28,-12208.38
2756387416962433024,2020-12,1355.55,2328.19,2906.99,4766.7,-2832.35,-15040.73
2757498649726221824,2020-01,0,1249.06,4288.38,1762.3,1277.02,1277.02
2757498649726221824,2020-02,0,367.86,1687.26,546.32,773.08,2050.1
2757498649726221824,2020-03,3348.12,1336.54,569.23,0,2580.81,4630.91
2757498649726221824,2020-05,0,2399.79,3278.09,1076.09,-197.79,4433.12
2757498649726221824,2020-06,120.78,1715.14,1868.81,1509.53,-1235.08,3198.04
2757498649726221824,2020-07,206.43,0,0,0,206.43,3404.47
2757498649726221824,2020-08,0,2359.24,1596.57,932.41,-1695.08,1709.39
2757498649726221824,2020-09,1430.69,403.75,2875.63,1675.83,2226.74,3936.13
2757498649726221824,2020-10,0,3584.39,1844.36,2354.91,-4094.94,-158.81
2757498649726221824,2020-11,2871.3,0,620.84,3501.16,-9.02,-167.83
2757498649726221824,2020-12,4284.23,914.43,0,1641.34,1728.46,1560.63
2757979238754733056,2020-01,4123.23,3578.81,5508.91,4455.92,1597.41,1597.41
2757979238754733056,2020-02,4418.22,3737.56,1743.61,3397.63,-973.36,624.05
2757979238754733056,2020-03,4079.18,3527.54,5224.97,5381.95,394.66,1018.71
2757979238754733056,2020-04,7335.54,6061.6,4953.05,3321.32,2905.67,3924.38
2757979238754733056,2020-05,1735.51,3424.74,1306.21,3790.88,-4173.9,-249.52
2757979238754733056,2020-06,2297.81,4702.39,2414.32,5095.28,-5085.54,-5335.06
2757979238754733056,2020-07,5003.04,4539.06,4902.06,7818.71,-2452.67,-7787.73
2757979238754733056,2020-08,10520.36,4045.78,4827.27,3460.34,7841.51,53.78
2757979238754733056,2020-09,748.31,2640.24,2457.26,6731.6,-6166.27,-6112.49
2757979238754733056,2020-10,1412.07,3564.51,6548.92,5599.81,-1203.33,-7315.82
2757979238754733056,2020-11,3794.71,2599.38,7529.32,5093.94,3630.71,-3685.11
2757979238754733056,2020-12,5883.79,3518.62,7522.32,1314.41,8573.08,4887.97
2758148312359684096,2020-01,0,3566.67,5967.57,1819.58,581.32,581.32
2758148312359684096,2020-02,3046.51,2264.7,1222.73,2568.04,-563.5,17.82
2758148312359684096,2020-03,3196.76,1560.16,2415.43,4358.33,-306.3,-288.48
2758148312359684096,2020-04,4733.83,1343.13,3052,917,5525.7,5237.22
2758148312359684096,2020-05,3552.92,6307.08,3494.95,3730.25,-2989.46,2247.76
2758148312359684096,2020-06,2405.19,1572.11,6848.59,3395.08,4286.59,6534.35
2758148312359684096,2020-07,4070.83,3916.6,3191.82,1103.54,2242.51,8776.86
2758148312359684096,2020-08,1878.7,3665.96,4027.8,0,2240.54,11017.4
2758148312359684096,2020-09,8751.69,3408.45,1062.56,3465.24,2940.56,13957.96
2758148312359684096,2020-10,1333.38,0,3023.87,4349.12,8.13,13966.09
2758148312359684096,2020-11,3270.66,2265.29,3919.88,2792.34,2132.91,16099
2758148312359684096,2020-12,4283.38,5116.89,2857.94,1467.77,556.66,16655.66
2758359142785595392,2020-01,3845.33,4638.58,7124.69,6424.46,-93.02,-93.02
2758359142785595392,2020-02,0,4568.3,5796.09,9110.48,-7882.69,-7975.71
2758359142785595392,2020-03,5529.67,6438.12,3144.4,3672.31,-1436.36,-9412.07
2758359142785595392,2020-04,1983.05,917.39,3665.52,2897.05,1834.13,-7577.94
2758359142785595392,2020-05,6154.12,5070.38,9443.31,4902.36,5624.69,-1953.25
2758359142785595392,2020-06,6651.65,9848.37,1975.26,2302.22,-3523.68,-5476.93
2758359142785595392,2020-07,6487.62,4099.26,5291.34,6083.99,1595.71,-3881.22
2758359142785595392,2020-08,2240.13,3834.69,7330.58,5537.46,198.56,-3682.66
2758359142785595392,2020-09,6287.06,6663.51,7441.28,4397.18,2667.65,-1015.01
2758359142785595392,2020-10,7769.12,2738.18,5382.25,2410.18,8003.01,6988
2758359142785595392,2020-11,4446.41,4500.32,4683.6,5100.62,-470.93,6517.07
2758359142785595392,2020-12,2832.99,2727.65,3134.45,3765.04,-525.25,5991.82
2758684665678217728,2020-01,4303.86,2416.15,4403.76,4030,2261.47,2261.47
2758684665678217728,2020-02,6896.22,4744.46,5821.92,2865.11,5108.57,7370.04
2758684665678217728,2020-03,3490.92,2081.66,6715.56,1215.04,6909.78,14279.82
2758684665678217728,2020-04,1497.49,5568.37,5947.78,5592.87,-3715.97,10563.85
2758684665678217728,2020-05,5077.89,8045.15,5040.53,6073.9,-4000.63,6563.22
2758684665678217728,2020-06,4111.06,2076.16,2797.82,3306.33,1526.39,8089.61
2758684665678217728,2020-07,4183.79,3891.64,6932.16,6604.57,619.74,8709.35
2758684665678217728,2020-08,6156.71,4729.42,7426.11,665.53,8187.87,16897.22
2758684665678217728,2020-09,1843.31,2859.48,5255.45,50.42,4188.86,21086.08
2758684665678217728,2020-10,5468.26,4569.77,7171.26,3648.48,4421.27,25507.35
2758684665678217728,2020-11,8092.42,7256.63,1834.38,5043.46,-2373.29,23134.06
2758684665678217728,2020-12,5149.66,8359.59,3992.27,1349.72,-567.38,22566.68
2759410600999316480,2020-01,10496.47,2713.42,5750.36,1091.27,12442.14,12442.14
2759410600999316480,2020-02,5122.57,4972.5,2291.41,652.98,1788.5,14230.64
2759410600999316480,2020-03,2689.74,5589.29,2758.48,9143.51,-9284.58,4946.06
2759410600999316480,2020-04,5948.8,386.36,1910.24,2777.23,4695.45,9641.51
2759410600999316480,2020-05,485.28,4109.01,3938.02,6466.12,-6151.83,3489.68
2759410600999316480,2020-06,4455.65,7289.37,3034.36,7676.01,-7475.37,-3985.69
2759410600999316480,2020-07,10084.48,8188.36,6608.33,2757.96,5746.49,1760.8
2759410600999316480,2020-08,4974.25,2892.66,2092.18,8343.13,-4169.36,-2408.56
2759410600999316480,2020-09,7604.11,7473.63,5840.63,1667.93,4303.18,1894.62
2759410600999316480,2020-10,3678.71,3255.08,5022.35,7112.74,-1666.76,227.86
2759410600999316480,2020-11,2341.49,5096.98,6374.22,7292.55,-3673.82,-3445.96
2759410600999316480,2020-12,8730.56,275.1,1248.13,1293.97,8409.62,4963.66
2760799843960068608,2020-01,0,827.2,0,0,-827.2,-827.2
2760799843960068608,2020-02,1431.99,812.58,0,2209.75,-1590.34,-2417.54
2760799843960068608,2020-03,0,1750.37,1301.74,1721.33,-2169.96,-4587.5
2760799843960068608,2020-06,0,189.86,0,0,-189.86,-4777.36
2760799843960068608,2020-08,676.32,0,0,0,676.32,-4101.04
2760799843960068608,2020-09,2252.18,0,1650.69,1076.1,2826.77,-1274.27
2760799843960068608,2020-10,223.02,0,2568.21,0,2791.23,1516.96
2760799843960068608,2020-11,0,1573.58,0,0,-1573.58,-56.62
2760799843960068608,2020-12,1498.81,1024.55,1387.13,0,1861.39,1804.77
2762983354941939200,2020-01,2921.51,2424.21,786.52,879.03,404.79,404.79
2762983354941939200,2020-02,3510.34,2275.62,1820.35,1485.89,1569.18,1973.97
2762983354941939200,2020-03,0,1990.05,497.04,1942.12,-3435.13,-1461.16
2762983354941939200,2020-04,0,103.33,3081.62,1891.4,1086.89,-374.27
2762983354941939200,2020-05,1903.22,0,3171.05,0,5074.27,4700
2762983354941939200,2020-06,1886.66,1966.82,0,560.04,-640.2,4059.8
2762983354941939200,2020-07,3652.33,0,1105.66,2466.12,2291.87,6351.67
2762983354941939200,2020-08,684.67,0,1894.32,865.76,1713.23,8064.9
2762983354941939200,2020-09,1429.06,0,2307.77,827.86,2908.97,10973.87
2762983354941939200,2020-10,3320.2,63.75,5107.74,1486.39,6877.8,17851.67
2762983354941939200,2020-11,1601.86,4894.5,2440.46,4464.24,-5316.42,12535.25
2762983354941939200,2020-12,1843.92,0,973.51,3332.17,-514.74,12020.51
2765785231470206464,2020-01,346.26,0,1171.3,0,1517.56,1517.56
2765785231470206464,2020-07,122.98,3164.87,0,0,-3041.89,-1524.33
2765785231470206464,2020-10,1677.12,0,0,0,1677.12,152.79
2765785231470206464,2020-11,1142.15,0,0,0,1142.15,1294.94
2765785231470206464,2020-12,1490.98,0,0,1376.68,114.3,1409.24
2765835653988175360,2020-01,2707.13,2038.64,2738.23,2743.39,663.33,663.33
2765835653988175360,2020-02,2508.52,2508.49,2811.11,0,2811.14,3474.47
2765835653988175360,2020-03,5607.86,4455.32,810.83,3356.58,-1393.21,2081.26
2765835653988175360,2020-04,2253.11,571.64,3836.82,2318.34,3199.95,5281.21
2765835653988175360,2020-05,3481.16,1896.57,5757.09,1789.44,5552.24,10833.45
2765835653988175360,2020-06,1092.52,3238.91,4913.36,6145.71,-3378.74,7454.71
2765835653988175360,2020-07,1714.1,4171.02,1355.95,7279.51,-8380.48,-925.77
2765835653988175360,2020-08,2455.51,3644.57,7313.97,2859.86,3265.05,2339.28
2765835653988175360,2020-09,1496.53,4434.32,1564.33,4729.27,-6102.73,-3763.45
2765835653988175360,2020-10,563.77,347.63,5565.54,4336.71,1444.97,-2318.48
2765835653988175360,2020-11,3881.34,91.85,1037.8,2283.12,2544.17,225.69
2765835653988175360,2020-12,2866.59,3965.33,1112.3,504.14,-490.58,-264.89
2765880607092933632,2020-01,3503.73,5818.62,4689.32,4663.56,-2289.13,-2289.13
2765880607092933632,2020-02,6796,1139.31,0,1006.31,4650.38,2361.25
2765880607092933632,2020-03,5025.85,5251.12,1966.92,3769.46,-2027.81,333.44
2765880607092933632,2020-04,532.55,1345.14,3645.28,4022.58,-1189.89,-856.45
2765880607092933632,2020-05,1906.82,6811.05,2947.34,4161.97,-6118.86,-6975.31
2765880607092933632,2020-06,3524.21,2105.43,5878.44,0,7297.22,321.91
2765880607092933632,2020-07,4608.46,4846,2252.46,2635.79,-620.87,-298.96
2765880607092933632,2020-08,3040.4,3177.46,3001.24,5061.77,-2197.59,-2496.55
2765880607092933632,2020-09,1533.86,8095.64,5475.95,1930.13,-3015.96,-5512.51
2765880607092933632,2020-10,54.34,2995.57,1903.35,3160.73,-4198.61,-9711.12
2765880607092933632,2020-11,4173.47,1481.25,1778.16,413.33,4057.05,-5654.07
2765880607092933632,2020-12,4137.41,0,3714.06,6873.09,978.38,-4675.69
2766736107452577792,2020-02,0,42.35,0,0,-42.35,-42.35
2766736107452577792,2020-05,0,1378.65,0,0,-1378.65,-1421
2766736107452577792,2020-06,330.33,280.72,1721.96,0,1771.57,350.57
2766736107452577792,2020-07,1704.97,0,1773.84,0,3478.81,3829.38
2766736107452577792,2020-09,266.95,0,0,0,266.95,4096.33
2766736107452577792,2020-12,1092.17,0,556.13,0,1648.3,5744.63
2769428393006994432,2020-01,4292.12,3520.22,1600.11,234.05,2137.96,2137.96
2769428393006994432,2020-02,1679.48,4198.32,1825.66,346.33,-1039.51,1098.45
2769428393006994432,2020-03,1761.07,3829.03,1975.19,5719.86,-5812.63,-4714.18
2769428393006994432,2020-04,3226.63,2847.06,1788.57,1511.28,656.86,-4057.32
2769428393006994432,2020-05,2803.36,0,3839.62,4193.46,2449.52,-1607.8
2769428393006994432,2020-06,719.95,2547.07,3788.29,3405.88,-1444.71,-3052.51
2769428393006994432,2020-07,1692.91,948.23,914.11,4292.22,-2633.43,-5685.94
2769428393006994432,2020-08,1690.26,1801.66,2820.15,2282.82,425.93,-5260.01
2769428393006994432,2020-09,3853.38,2240.16,1810.98,7313.56,-3889.36,-9149.37
2769428393006994432,2020-10,3569.83,50.58,1385.54,2274.78,2630.01,-6519.36
2769428393006994432,2020-11,3445.76,3401.79,1429.21,529.71,943.47,-5575.89
2769428393006994432,2020-12,0,960.21,1138.47,3629.96,-3451.7,-9027.59
2769628516875552256,2020-01,1658.93,2643.65,1658.69,76.12,597.85,597.85
2769628516875552256,2020-02,0,1696.66,737.28,1747.71,-2707.09,-2109.24
2769628516875552256,2020-03,0,932.34,0,1846.3,-2778.64,-4887.88
2769628516875552256,2020-04,788.51,1323.93,2364.83,0,1829.41,-3058.47
2769628516875552256,2020-05,1509.14,1820.4,0,2548.21,-2859.47,-5917.94
2769628516875552256,2020-06,1921.22,960.89,1002.85,912.96,1050.22,-4867.72
2769628516875552256,2020-07,0,2197.85,1213.9,0,-983.95,-5851.67
2769628516875552256,2020-08,577.88,4831.23,819.21,380.99,-3815.13,-9666.8
2769628516875552256,2020-09,2335.67,0,0,933.14,1402.53,-8264.27
2769628516875552256,2020-10,513.36,144.32,0,2710.91,-2341.87,-10606.14
2769628516875552256,2020-11,936.9,3095.25,0,1415.08,-3573.43,-14179.57
2769628516875552256,2020-12,0,1489.04,1108.98,0,-380.06,-14559.63
2769914948604239360,2020-01,4184.72,3977.96,4172.52,1421.41,2957.87,2957.87
2769914948604239360,2020-02,654.56,1235.48,0,2407.26,-2988.18,-30.31
2769914948604239360,2020-03,1916.39,1787.79,1461.17,1439.1,150.67,120.36
2769914948604239360,2020-04,3009.91,4059.68,4210.47,4670.86,-1510.16,-1389.8
2769914948604239360,2020-05,562.17,4472.73,5095.24,6497.28,-5312.6,-6702.4
2769914948604239360,2020-06,1924.37,1907.68,3023.59,5500.81,-2460.53,-9162.93
2769914948604239360,2020-07,779.57,1453.55,311.59,2544.81,-2907.2,-12070.13
2769914948604239360,2020-08,3570.97,3089.21,4644.57,862.62,4263.71,-7806.42
2769914948604239360,2020-09,3099.95,2094.19,1901.22,533.85,2373.13,-5433.29
2769914948604239360,2020-10,2413.64,0,1153.59,4717.33,-1150.1,-6583.39
2769914948604239360,2020-11,134.54,4246.02,3973.32,4753.95,-4892.11,-11475.5
2769914948604239360,2020-12,1367.51,2185.91,9112.42,3163.43,5130.59,-6344.91
2770562231362653184,2020-01,1647.84,0,0,0,1647.84,1647.84
2770562231362653184,2020-02,814.25,0,626.79,2112.41,-671.37,976.47
2770562231362653184,2020-03,517.45,5.22,2899.93,0,3412.16,4388.63
2770562231362653184,2020-05,0,439.88,2379.99,1600.1,340.01,4728.64
2770562231362653184,2020-06,390.66,1764.61,1270.56,88.53,-191.92,4536.72
2770562231362653184,2020-09,0,1074.71,10.37,1233.19,-2297.53,2239.19
2770562231362653184,2020-10,0,1226.72,0,961.89,-2188.61,50.58
2770562231362653184,2020-11,0,137.69,1121.5,0,983.81,1034.39
2770562231362653184,2020-12,339.67,1161.06,0,0,-821.39,213
2770698042164520960,2020-01,2413,2687.62,2094.91,1959.21,-138.92,-138.92
2770698042164520960,2020-02,2626.23,2449.03,0,4232.34,-4055.14,-4194.06
2770698042164520960,2020-03,4697.73,6483.73,865.21,1040.58,-1961.37,-6155.43
2770698042164520960,2020-04,8369.96,4258.09,1430.59,3925.31,1617.15,-4538.28
2770698042164520960,2020-05,3342.96,8452.78,2859.12,4180.39,-6431.09,-10969.37
2770698042164520960,2020-06,1799.55,3628.85,3477.55,2332.71,-684.46,-11653.83
2770698042164520960,2020-07,6054.26,2774.77,6099.13,1401.65,7976.97,-3676.86
2770698042164520960,2020-08,5037.65,7301.68,4126.94,342.86,1520.05,-2156.81
2770698042164520960,2020-09,2012.07,1381.51,3635.97,3132.65,1133.88,-1022.93
2770698042164520960,2020-10,3204.4,2109.42,3384.57,11882.41,-7402.86,-8425.79
2770698042164520960,2020-11,3566.13,3752.67,3983.18,454.82,3341.82,-5083.97
2770698042164520960,2020-12,1286.18,2002.77,2757.19,3003.96,-963.36,-6047.33
2771177008465697792,2020-01,3195.43,0,2651.77,2068.24,3778.96,3778.96
2771177008465697792,2020-02,0,563.53,829.56,2699.87,-2433.84,1345.12
2771177008465697792,2020-03,160.56,4220.04,3974.62,2755.87,-2840.73,-1495.61
2771177008465697792,2020-04,2218.17,1254.34,1114.5,0,2078.33,582.72
2771177008465697792,2020-05,2623.23,1181.43,0,1842.53,-400.73,181.99
2771177008465697792,2020-06,2323.7,1112.33,1963.95,6056.6,-2881.28,-2699.29
2771177008465697792,2020-07,0,3436.63,4160.88,1566.51,-842.26,-3541.55
2771177008465697792,2020-08,717.62,1804.66,1300.14,6398.68,-6185.58,-9727.13
2771177008465697792,2020-09,1015.77,3080.9,2101.73,3788.92,-3752.32,-13479.45
2771177008465697792,2020-10,2169.01,595.02,4299.46,1402.29,4471.16,-9008.29
2771177008465697792,2020-11,1593.63,2056.23,2731.98,3438.75,-1169.37,-10177.66
2771177008465697792,2020-12,1973.73,3178.18,6055.99,2862.17,1989.37,-8188.29
2771889243008298496,2020-01,1279.97,5298.81,4570.81,54.81,497.16,497.16
2771889243008298496,2020-02,5695.22,617.54,897.21,1990.53,3984.36,4481.52
2771889243008298496,2020-03,4155.88,925.76,1785.78,834.59,4181.31,8662.83
2771889243008298496,2020-04,2354.89,1906.05,1012.5,2242.94,-781.6,7881.23
2771889243008298496,2020-05,2210.6,11192.03,702.19,4205.6,-12484.84,-4603.61
2771889243008298496,2020-06,850.67,5015.84,1683.28,6047.71,-8529.6,-13133.21
2771889243008298496,2020-07,3779.77,0,4447.24,4825.99,3401.02,-9732.19
2771889243008298496,2020-08,5449.08,4394.42,2749.95,4947.5,-1142.89,-10875.08
2771889243008298496,2020-09,5021.82,3226.89,4306.71,31.91,6069.73,-4805.35
2771889243008298496,2020-10,5077.4,1511.39,1555.59,5121.72,-0.12,-4805.47
2771889243008298496,2020-11,1238.98,2543.83,5373.18,4223.55,-155.22,-4960.69
2771889243008298496,2020-12,5618.72,1703.35,4830.38,3532.64,5213.11,252.42
2772957967225869312,2020-01,1818.72,2167.33,747.8,3037.22,-2638.03,-2638.03
2772957967225869312,2020-02,3313.07,705.15,746.45,1422.05,1932.32,-705.71
2772957967225869312,2020-03,4336.04,3016.38,4504.31,3202.46,2621.51,1915.8
2772957967225869312,2020-04,1052.56,3871.79,1550.06,4415.78,-5684.95,-3769.15
2772957967225869312,2020-05,6061.19,0,62.43,2034.39,4089.23,320.08
2772957967225869312,2020-06,1316.44,1044.24,4126.28,6755.61,-2357.13,-2037.05
2772957967225869312,2020-07,6072.75,2483.11,1621.25,3325.86,1885.03,-152.02
2772957967225869312,2020-08,3251.83,1744.06,6707.15,0,8214.92,8062.9
2772957967225869312,2020-09,2411.77,3735.81,2664.13,1246.57,93.52,8156.42
2772957967225869312,2020-10,3746.78,5921.4,739.42,486.14,-1921.34,6235.08
2772957967225869312,2020-11,3189.33,5604.89,3273.16,3577.85,-2720.25,3514.83
2772957967225869312,2020-12,3703.56,5076.51,6154.13,2686.86,2094.32,5609.15
2773316159885360128,2020-01,8384.89,5267.25,6605.49,2934.63,6788.5,6788.5
2773316159885360128,2020-02,4847.03,8092.43,8359.23,2574.74,2539.09,9327.59
2773316159885360128,2020-03,124.79,4989.89,4880.49,4810.03,-4794.64,4532.95
2773316159885360128,2020-04,9648.12,1209.65,4378.48,2890.05,9926.9,14459.85
2773316159885360128,2020-05,5023.46,10553.58,8290.35,2329.85,430.38,14890.23
2773316159885360128,2020-06,2992.74,1060.41,6512.55,5026.18,3418.7,18308.93
2773316159885360128,2020-07,1739.72,8682.87,6336.55,5505.62,-6112.22,12196.71
2773316159885360128,2020-08,4175.4,12041.73,5715.78,7155.44,-9305.99,2890.72
2773316159885360128,2020-09,2035.06,2960.29,2914.95,3364.84,-1375.12,1515.6
2773316159885360128,2020-10,3604.56,3818.45,3548.58,7877.59,-4542.9,-3027.3
2773316159885360128,2020-11,3314.8,1323.17,3857.97,873.9,4975.7,1948.4
2773316159885360128,2020-12,5191.53,7505.11,6822.06,2204.38,2304.1,4252.5
2774185563162609152,2020-01,2413.36,1589.29,1889.69,2823.5,-109.74,-109.74
2774185563162609152,2020-02,1534.89,4251.07,1715.45,4404.96,-5405.69,-5515.43
2774185563162609152,2020-03,3841.82,1054.48,2982.41,4905.16,864.59,-4650.84
2774185563162609152,2020-04,1899.79,3358.96,772.31,310.7,-997.56,-5648.4
2774185563162609152,2020-05,4979.84,4944.53,1554.5,0,1589.81,-4058.59
2774185563162609152,2020-06,2833.81,2824.08,4623.76,2721.28,1912.21,-2146.38
2774185563162609152,2020-07,2373.04,5228.09,3367.44,0,512.39,-1633.99
2774185563162609152,2020-08,2031.07,6059.6,2433.62,3722.06,-5316.97,-6950.96
2774185563162609152,2020-09,3789.56,5927.97,0,0,-2138.41,-9089.37
2774185563162609152,2020-10,0,1942.84,3146.38,2142.72,-939.18,-10028.55
2774185563162609152,2020-11,969.42,3977.77,3212.65,741.05,-536.75,-10565.3
2774185563162609152,2020-12,3761.74,4469.11,0,592.76,-1300.13,-11865.43
2775414857543133184,2020-01,511.24,3624.68,1061.42,1680.36,-3732.38,-3732.38
2775414857543133184,2020-02,3486.81,844.53,1373.9,6924.76,-2908.58,-6640.96
2775414857543133184,2020-03,2003,4313.56,4415.69,3825.19,-1720.06,-8361.02
2775414857543133184,2020-04,8004.9,3659.25,4087.96,1857.41,6576.2,-1784.82
2775414857543133184,2020-05,2473.7,9806.51,8666.49,4437.18,-3103.5,-4888.32
2775414857543133184,2020-06,3499.58,4251.19,6280.31,8831.17,-3302.47,-8190.79
2775414857543133184,2020-07,2067.42,2300.59,6393.09,8087.74,-1927.82,-10118.61
2775414857543133184,2020-08,3985.09,4349.54,5668.82,4224.76,1079.61,-9039
2775414857543133184,2020-09,486.63,5372.51,5139.96,8350.81,-8096.73,-17135.73
2775414857543133184,2020-10,1175.27,6939.83,6417.28,11316.94,-10664.22,-27799.95
2775414857543133184,2020-11,4000.38,4263.74,6354.33,6426.3,-335.33,-28135.28
2775414857543133184,2020-12,6701.41,1177.87,1357.49,5180.11,1700.92,-26434.36
2775679246283308032,2020-01,3365.32,2578.03,585,1879.56,-507.27,-507.27
2775679246283308032,2020-04,0,379.85,0,4493.41,-4873.26,-5380.53
2775679246283308032,2020-05,713.91,655.41,509.35,0,567.85,-4812.68
2775679246283308032,2020-06,621.06,2528.65,2248.4,3090.37,-2749.56,-7562.24
2775679246283308032,2020-07,1334.05,1460.36,0,1538.63,-1664.94,-9227.18
2775679246283308032,2020-08,1022.41,0,0,2079.67,-1057.26,-10284.44
2775679246283308032,2020-09,1818.13,1600.87,1671.58,0,1888.84,-8395.6
2775679246283308032,2020-10,2268.98,1548.67,0,3107.43,-2387.12,-10782.72
2775679246283308032,2020-11,1777.41,995.54,0,1991.6,-1209.73,-11992.45
2775679246283308032,2020-12,0,1181.01,1580.33,0,399.32,-11593.13
2777037250019109888,2020-01,4819.4,303.53,6163.53,2024.88,8654.52,8654.52
2777037250019109888,2020-02,0,5798.66,5855.35,1206.48,-1149.79,7504.73
2777037250019109888,2020-03,3521.67,3589.47,1015.07,1389.02,-441.75,7062.98
2777037250019109888,2020-04,5848.55,2830.56,2316.41,3598.21,1736.19,8799.17
2777037250019109888,2020-05,0,1760.68,219.46,4837.31,-6378.53,2420.64
2777037250019109888,2020-06,3786.65,1840.73,2469.21,3248.48,1166.65,3587.29
2777037250019109888,2020-07,3788.3,3612.18,6941.36,5508.67,1608.81,5196.1
2777037250019109888,2020-08,2939.76,2570.35,2757.51,2999.53,127.39,5323.49
2777037250019109888,2020-09,610.37,506.56,2931.53,1113.43,1921.91,7245.4
2777037250019109888,2020-10,1928.31,2083.18,2378.78,888.99,1334.92,8580.32
2777037250019109888,2020-11,4837.89,653.71,5365.26,3554.72,5994.72,14575.04
2777037250019109888,2020-12,3441.33,1171.09,892.08,388.21,2774.11,17349.15
2777201147147817472,2020-01,1585.59,6358.53,2876.95,4549.65,-6445.64,-6445.64
2777201147147817472,2020-02,1311.46,7214.32,2328.35,8236.9,-11811.41,-18257.05
2777201147147817472,2020-03,6529.36,4735.66,955.7,89.33,2660.07,-15596.98
2777201147147817472,2020-04,0,3510.7,3783.52,1377.55,-1104.73,-16701.71
2777201147147817472,2020-05,5135.89,2797.67,3492.2,3714.65,2115.77,-14585.94
2777201147147817472,2020-06,3881.9,6137.21,4068.91,3775.88,-1962.28,-16548.22
2777201147147817472,2020-07,3309.73,3238.92,4053.42,2139.48,1984.75,-14563.47
2777201147147817472,2020-08,1992.99,11077.03,7623.18,2581.33,-4042.19,-18605.66
2777201147147817472,2020-09,5004.02,5881.92,6327.67,3936.37,1513.4,-17092.26
2777201147147817472,2020-10,5960.02,7247.2,6618.89,3655.3,1676.41,-15415.85
2777201147147817472,2020-11,7769.91,4852.47,3790.53,3890.19,2817.78,-12598.07
2777201147147817472,2020-12,3433.61,3467.17,5190.78,4838.47,318.75,-12279.32
2777661816274882560,2020-01,680.66,0,433.74,0,1114.4,1114.4
2777661816274882560,2020-02,816.82,1694.08,0,0,-877.26,237.14
2777661816274882560,2020-03,2157.9,0,0,0,2157.9,2395.04
2777661816274882560,2020-04,753.89,0,177.54,1570.68,-639.25,1755.79
2777661816274882560,2020-05,0,1517.6,1103.32,1278.11,-1692.39,63.4
2777661816274882560,2020-06,468.25,2870.18,560.56,3766.3,-5607.67,-5544.27
2777661816274882560,2020-07,1709.15,0,1273.98,1383.25,1599.88,-3944.39
2777661816274882560,2020-08,1931.5,0,0,0,1931.5,-2012.89
2777661816274882560,2020-09,42.64,1506.91,0,1073.83,-2538.1,-4550.99
2777661816274882560,2020-10,0,789.65,1369.67,1674.44,-1094.42,-5645.41
2777661816274882560,2020-12,0,1063.39,1011.49,1358.72,-1410.62,-7056.03
2779112475850916864,2020-01,676.69,494.95,740.26,2443.68,-1521.68,-1521.68
2779112475850916864,2020-02,1438.48,5752.07,2053.35,2928.15,-5188.39,-6710.07
2779112475850916864,2020-03,1221.41,3459.32,1840.63,3406.64,-3803.92,-10513.99
2779112475850916864,2020-04,0,4241.4,3582.89,2026.48,-2684.99,-13198.98
2779112475850916864,2020-05,879.33,2587.43,5765.63,1624.16,2433.37,-10765.61
2779112475850916864,2020-06,4228.64,1999.01,1592.14,922.18,2899.59,-7866.02
2779112475850916864,2020-07,4452.58,1806.72,839.2,1406.06,2079,-5787.02
2779112475850916864,2020-08,1222.58,2310.55,2795.82,0,1707.85,-4079.17
2779112475850916864,2020-09,794.76,250.49,1144.41,1936.82,-248.14,-4327.31
2779112475850916864,2020-10,474.47,2303.88,292.21,622.22,-2159.42,-6486.73
2779112475850916864,2020-11,143.11,1821.33,2045.64,4641.87,-4274.45,-10761.18
2779112475850916864,2020-12,4109.55,5626.59,5108.28,3852.04,-260.8,-11021.98
2779490869695671296,2020-01,5469.92,7621.67,4568.94,2752.45,-335.26,-335.26
2779490869695671296,2020-02,4199.03,4604.05,9188.42,3824.66,4958.74,4623.48
2779490869695671296,2020-03,9567.07,5032.36,2722.98,6864.26,393.43,5016.91
2779490869695671296,2020-04,3159.95,3501.81,8828.16,2763.3,5723,10739.91
2779490869695671296,2020-05,4428.12,1626.03,5454.67,1109.42,7147.34,17887.25
2779490869695671296,2020-06,3095.74,726.81,780.88,4414.46,-1264.65,16622.6
2779490869695671296,2020-07,3991.36,1304.88,4319.97,4975.86,2030.59,18653.19
2779490869695671296,2020-08,4674.41,9144.93,3651.24,775.9,-1595.18,17058.01
2779490869695671296,2020-09,993.92,1472.95,6783.49,3392.34,2912.12,19970.13
2779490869695671296,2020-10,380.07,4297.58,3197.1,493.83,-1214.24,18755.89
2779490869695671296,2020-11,2051.33,4608.83,6101.93,5701.6,-2157.17,16598.72
2779490869695671296,2020-12,4546.15,2148.83,5179.91,3782.96,3794.27,20392.99
2780582299699734016,2020-01,1331.44,2083.9,3515.52,2513.69,249.37,249.37
2780582299699734016,2020-02,307.06,1914.41,2867.24,4716.12,-3456.23,-3206.86
2780582299699734016,2020-03,3196.71,5457.52,3905.47,4015.89,-2371.23,-5578.09
2780582299699734016,2020-04,1012.71,3171.24,0,1445.48,-3604.01,-9182.1
2780582299699734016,2020-05,0,4712.43,2033.41,1246.44,-3925.46,-13107.56
2780582299699734016,2020-06,1301.3,299.92,897.33,1568.79,329.92,-12777.64
2780582299699734016,2020-07,1689.97,1179.39,1525,2625.35,-589.77,-13367.41
2780582299699734016,2020-08,0,812.82,4657.1,1902.25,1942.03,-11425.38
2780582299699734016,2020-09,1429.49,3895.42,0,2790.75,-5256.68,-16682.06
2780582299699734016,2020-10,2215.71,1055.01,1673.5,4689.53,-1855.33,-18537.39
2780582299699734016,2020-11,253.71,1382.96,2150.82,2199.79,-1178.22,-19715.61
2780582299699734016,2020-12,1436.42,0,3450.07,0,4886.49,-14829.12
2781163737952410112,2020-01,4113.25,0,4148.68,5568.93,2693,2693
2781163737952410112,2020-02,2610.77,4711.87,1179.11,2692.55,-3614.54,-921.54
2781163737952410112,2020-03,4980.69,930.84,1453.38,733.06,4770.17,3848.63
2781163737952410112,2020-04,9569.61,1459.66,5706.23,1241.11,12575.07,16423.7
2781163737952410112,2020-05,1274.14,1485.07,2033.66,5005.49,-3182.76,13240.94
2781163737952410112,2020-06,314.26,3871.46,745.86,2476.1,-5287.44,7953.5
2781163737952410112,2020-07,2244.94,529.93,3222.42,9469.61,-4532.18,3421.32
2781163737952410112,2020-08,5446.83,7824.31,2307.64,6399.28,-6469.12,-3047.8
2781163737952410112,2020-09,2046.26,2086.26,4351.27,3057.91,1253.36,-1794.44
2781163737952410112,2020-10,5577.57,2786.16,5236.61,2271.05,5756.97,3962.53
2781163737952410112,2020-11,3623.83,778.51,3124.2,3133.92,2835.6,6798.13
2781163737952410112,2020-12,1592.25,440.69,1493.74,1768.13,877.17,7675.3
2781360088635773952,2020-01,2126.72,7348.66,2580.95,7109.49,-9750.48,-9750.48
2781360088635773952,2020-02,3536.43,6946.94,1795.84,2400.75,-4015.42,-13765.9
2781360088635773952,2020-03,9255.83,6802.98,2610.83,5598.74,-535.06,-14300.96
2781360088635773952,2020-04,1660.86,2380.7,3709.85,3026.23,-36.22,-14337.18
2781360088635773952,2020-05,2038.04,4888.23,4545.33,236.14,1459,-12878.18
2781360088635773952,2020-06,2878.34,3707.29,4515.18,4760.87,-1074.64,-13952.82
2781360088635773952,2020-07,3191.5,6537.98,2596.77,2439.67,-3189.38,-17142.2
2781360088635773952,2020-08,2107.71,5189.29,0,9268.45,-12350.03,-29492.23
2781360088635773952,2020-09,8006.94,1875.02,6863.49,4824.71,8170.7,-21321.53
2781360088635773952,2020-10,2246.65,3974.7,0,3442.25,-5170.3,-26491.83
2781360088635773952,2020-11,2647.52,3859.61,1752.33,2306.25,-1766.01,-28257.84
2781360088635773952,2020-12,3483.66,4014.58,1167.11,4131.55,-3495.36,-31753.2
2781848412282230272,2020-01,3522.47,740.94,3440.96,2380,3842.49,3842.49
2781848412282230272,2020-02,1446.41,3877.9,2601.77,2312.31,-2142.03,1700.46
2781848412282230272,2020-03,5097.64,4805.48,2539.02,2553.06,278.12,1978.58
2781848412282230272,2020-04,7211.6,1532.08,4347.15,2769.87,7256.8,9235.38
2781848412282230272,2020-05,2274.53,4562.84,671.8,4426.17,-6042.68,3192.7
2781848412282230272,2020-06,7575.36,2723.78,7050.22,4727.23,7174.57,10367.27
2781848412282230272,2020-07,3154.97,7170.23,2586.31,6560.17,-7989.12,2378.15
2781848412282230272,2020-08,4710.08,3079.19,4049.81,5033.74,646.96,3025.11
2781848412282230272,2020-09,8380.54,3856.77,5524.65,3923.53,6124.89,9150
2781848412282230272,2020-10,7376.17,3455.56,6472.2,2837.09,7555.72,16705.72
2781848412282230272,2020-11,801.95,3419.22,2735.91,4884.32,-4765.68,11940.04
2781848412282230272,2020-12,4164.29,1400.68,4156.96,3262.1,3658.47,15598.51
2782953705600286208,2020-01,1166.61,1576.62,6005.88,0,5595.87,5595.87
2782953705600286208,2020-02,2991.78,1135.18,2942.24,2503.14,2295.7,7891.57
2782953705600286208,2020-03,0,3117.41,3246.64,3977.48,-3848.25,4043.32
2782953705600286208,2020-04,5168.56,1230.17,3227.43,7763.71,-597.89,3445.43
2782953705600286208,2020-05,1227.32,4060.16,7493.38,2094.49,2566.05,6011.48
2782953705600286208,2020-06,3126.85,3765.16,5035.07,2970.54,1426.22,7437.7
2782953705600286208,2020-07,4173.26,5961.84,5374.92,880.23,2706.11,10143.81
2782953705600286208,2020-08,2028.75,3504.94,5254.01,1657.7,2120.12,12263.93
2782953705600286208,2020-09,3979.75,2660.68,6938.67,5159.81,3097.93,15361.86
2782953705600286208,2020-10,0,1441.35,6546.58,61.45,5043.78,20405.64
2782953705600286208,2020-11,0,192.81,6524.64,2266.12,4065.71,24471.35
2782953705600286208,2020-12,777.25,3146.99,482.69,3107.43,-4994.48,19476.87
2784171078991463936,2020-01,5041.78,1708.59,3369.31,3609.42,3093.08,3093.08
2784171078991463936,2020-02,1799.31,3376.25,5595.34,2465.16,1553.24,4646.32
2784171078991463936,2020-03,4082.66,1498.57,3153.73,331.33,5406.49,10052.81
2784171078991463936,2020-04,0,1218.83,1832.91,6184.53,-5570.45,4482.36
2784171078991463936,2020-05,4523.22,4247.04,4786.76,1642.09,3420.85,7903.21
2784171078991463936,2020-06,2302.98,3178.3,5138.11,478.52,3784.27,11687.48
2784171078991463936,2020-07,4429.08,6365.83,6750.42,7054.95,-2241.28,9446.2
2784171078991463936,2020-08,2959.97,7213.13,1615.99,1963.39,-4600.56,4845.64
2784171078991463936,2020-09,1994.59,8421.03,0,1834.55,-8260.99,-3415.35
2784171078991463936,2020-10,1918.18,1771.77,2062,6208.19,-3999.78,-7415.13
2784171078991463936,2020-11,6544.75,2846.86,2327.28,5957.04,68.13,-7347
2784171078991463936,2020-12,5579.01,2188.47,7439.47,6739.72,4090.29,-3256.71
2784731037985171456,2020-01,2588.37,4612.46,374.27,4212.3,-5862.12,-5862.12
2784731037985171456,2020-02,5246.65,1501.42,2196.83,40.49,5901.57,39.45
2784731037985171456,2020-03,0,2546.27,1310.43,1021.36,-2257.2,-2217.75
2784731037985171456,2020-04,2650.34,0,1069.9,2147.35,1572.89,-644.86
2784731037985171456,2020-05,0,5016.07,2323.52,3462.8,-6155.35,-6800.21
2784731037985171456,2020-06,948.87,0,4952.7,2283.09,3618.48,-3181.73
2784731037985171456,2020-07,3654.85,3580.14,4619.68,2386.22,2308.17,-873.56
2784731037985171456,2020-08,1533.52,3375.1,3011.05,11101.4,-9931.93,-10805.49
2784731037985171456,2020-09,782.31,217.91,2430.4,3484.09,-489.29,-11294.78
2784731037985171456,2020-10,1978.54,1075.84,0,8044.86,-7142.16,-18436.94
2784731037985171456,2020-11,87.82,995.29,2371.4,4131.06,-2667.13,-21104.07
2784731037985171456,2020-12,1866.41,2199.1,186.7,1256.56,-1402.55,-22506.62
2785216338733542912,2020-01,0,2760.01,566.1,0,-2193.91,-2193.91
2785216338733542912,2020-02,0,1256.08,0,2389.62,-3645.7,-5839.61
2785216338733542912,2020-03,0,4616.19,1085.94,2380.61,-5910.86,-11750.47
2785216338733542912,2020-06,2980.7,660.36,1291.3,0,3611.64,-8138.83
2785216338733542912,2020-07,1130.05,0,2880.94,0,4010.99,-4127.84
2785216338733542912,2020-08,766.58,0,0,2763.21,-1996.63,-6124.47
2785216338733542912,2020-10,574.21,0,0,1382.49,-808.28,-6932.75
2785216338733542912,2020-11,718.74,0,1488.11,0,2206.85,-4725.9
2785216338733542912,2020-12,0,330.29,1067.06,1132.87,-396.1,-5122
2785716193625576448,2020-01,2436.49,1991.81,3452.71,497.4,3399.99,3399.99
2785716193625576448,2020-02,1075.22,2399.14,3008.64,1183.68,501.04,3901.03
2785716193625576448,2020-03,2149.56,1301.09,6009.54,1486.81,5371.2,9272.23
2785716193625576448,2020-04,4990.5,913.34,4262.96,1126.86,7213.26,16485.49
2785716193625576448,2020-05,6550.89,5349.71,1812.87,2629.15,384.9,16870.39
2785716193625576448,2020-06,3411.54,0,713.19,3180.57,944.16,17814.55
2785716193625576448,2020-07,553.19,818.74,2973.52,464.32,2243.65,20058.2
2785716193625576448,2020-08,3336.28,1662.02,791.62,3676.72,-1210.84,18847.36
2785716193625576448,2020-09,2645.61,0,4948.09,560.74,7032.96,25880.32
2785716193625576448,2020-10,1179.61,2102.55,2911.47,1763.95,224.58,26104.9
2785716193625576448,2020-11,0,4823.05,2550.24,881.3,-3154.11,22950.79
2785716193625576448,2020-12,3273.95,2596.22,1122.23,2978.67,-1178.71,21772.08
2789011782308483584,2020-01,3273.9,6027.4,1817,7421.64,-8358.14,-8358.14
2789011782308483584,2020-02,6907.57,1556.54,7318.94,1130.29,11539.68,3181.54
2789011782308483584,2020-03,0,7073.46,4625.27,6616.93,-9065.12,-5883.58
2789011782308483584,2020-04,4822.8,1966.57,10226.46,1524.06,11558.63,5675.05
2789011782308483584,2020-05,2040.35,6183.41,5460.4,2950.71,-1633.37,4041.68
2789011782308483584,2020-06,2406.32,411.72,807.21,5735.1,-2933.29,1108.39
2789011782308483584,2020-07,3659.45,7243.58,2715.22,9586.25,-10455.16,-9346.77
2789011782308483584,2020-08,2487.13,3572.37,3606.76,3677.51,-1155.99,-10502.76
2789011782308483584,2020-09,3768.77,693.98,6158.87,3850.76,5382.9,-5119.86
2789011782308483584,2020-10,7237.96,897.6,2626.35,5059.28,3907.43,-1212.43
2789011782308483584,2020-11,1853.15,5452.01,3328.25,0,-270.61,-1483.04
2789011782308483584,2020-12,5441.13,1746.44,1736.6,3862.15,1569.14,86.1
2789191198208346112,2020-01,9661.39,5173.14,658.66,2759.58,2387.33,2387.33
2789191198208346112,2020-02,3435.44,1163.55,1888.36,3843.55,316.7,2704.03
2789191198208346112,2020-03,3697.46,2719.79,13270.21,4543.9,9703.98,12408.01
2789191198208346112,2020-04,1278.68,6189.69,2238.5,2300.75,-4973.26,7434.75
2789191198208346112,2020-05,5432.01,2900.16,4390.36,5242.51,1679.7,9114.45
2789191198208346112,2020-06,2969.03,2403.57,2454.03,7446.31,-4426.82,4687.63
2789191198208346112,2020-07,4693.23,3942.67,1523.84,3480.45,-1206.05,3481.58
2789191198208346112,2020-08,599.65,6493.68,6395.95,2804.64,-2302.72,1178.86
2789191198208346112,2020-09,3298.63,4943.91,7376.9,9620.26,-3888.64,-2709.78
2789191198208346112,2020-10,6794.36,2824.98,2394.65,3873.02,2491.01,-218.77
2789191198208346112,2020-11,752.66,4324.97,3160.75,4329.36,-4740.92,-4959.69
2789191198208346112,2020-12,5277.24,3147.38,4428.15,2409.22,4148.79,-810.9
2790387147700001792,2020-01,2572.81,2757.44,2322.08,296.41,1841.04,1841.04
2790387147700001792,2020-02,1671.03,6918.61,4027.9,6637.51,-7857.19,-6016.15
2790387147700001792,2020-03,3619.49,4522.12,3111.51,1518.51,690.37,-5325.78
2790387147700001792,2020-04,3573.35,2462.7,4405.22,4155.14,1360.73,-3965.05
2790387147700001792,2020-05,6294.96,3611.61,2001.49,8246.18,-3561.34,-7526.39
2790387147700001792,2020-06,4465.08,2535.25,2141.85,2519.13,1552.55,-5973.84
2790387147700001792,2020-07,4492.63,1027.31,5571.33,27.08,9009.57,3035.73
2790387147700001792,2020-08,1494.58,4119.08,6424.19,1836.88,1962.81,4998.54
2790387147700001792,2020-09,6722.63,3180.66,2243.62,5431.26,354.33,5352.87
2790387147700001792,2020-10,2102.89,5489.96,5457.26,1336.5,733.69,6086.56
2790387147700001792,2020-11,1423.6,2440.46,3906.48,6768.56,-3878.94,2207.62
2790387147700001792,2020-12,4462.64,2765.52,2145.72,2078.2,1764.64,3972.26
2790452017808482304,2020-01,0,304.93,1455.25,105.32,1045,1045
2790452017808482304,2020-02,0,1343,1828.6,16.52,469.08,1514.08
2790452017808482304,2020-03,107.58,109.27,0,0,-1.69,1512.39
2790452017808482304,2020-04,2600.82,1440.42,0,0,1160.4,2672.79
2790452017808482304,2020-05,1569.18,4229.49,1257.1,367.58,-1770.79,902
2790452017808482304,2020-06,613.96,1923.92,4643.22,776.37,2556.89,3458.89
2790452017808482304,2020-07,154.03,904.78,3170.34,769.93,1649.66,5108.55
2790452017808482304,2020-08,2722.84,2147.89,1515.28,3864.72,-1774.49,3334.06
2790452017808482304,2020-09,994.92,1123.01,3079.02,4766.58,-1815.65,1518.41
2790452017808482304,2020-10,1906.88,489.06,678.06,0,2095.88,3614.29
2790452017808482304,2020-11,821.15,1463.8,4145.75,821.39,2681.71,6296
2790452017808482304,2020-12,1165.34,3323.26,3613.76,0,1455.84,7751.84
2791209688957478400,2020-01,222.68,145.04,536.54,5745.51,-5131.33,-5131.33
2791209688957478400,2020-02,1637.69,2304.33,0,123.7,-790.34,-5921.67
2791209688957478400,2020-03,0,1266.19,1950.49,3438.67,-2754.37,-8676.04
2791209688957478400,2020-04,1235.36,0,1278.11,4763.67,-2250.2,-10926.24
2791209688957478400,2020-05,1540.8,642.67,435.9,0,1334.03,-9592.21
2791209688957478400,2020-06,1041.34,0,1222.97,3041.04,-776.73,-10368.94
2791209688957478400,2020-07,0,2979.75,0,164.47,-3144.22,-13513.16
2791209688957478400,2020-08,1844.62,1844.12,898,981.26,-82.76,-13595.92
2791209688957478400,2020-09,0,1092.13,830.81,3058.37,-3319.69,-16915.61
2791209688957478400,2020-10,1439.76,2065.86,1571.71,0,945.61,-15970
2791209688957478400,2020-11,0,1071.25,20.34,3398.42,-4449.33,-20419.33
2791209688957478400,2020-12,3594.73,1251.01,0,312.44,2031.28,-18388.05
2791504396913818624,2020-01,37.35,1481.91,312.63,0,-1131.93,-1131.93
2791504396913818624,2020-02,1242.14,1610.96,876.69,2856.9,-2349.03,-3480.96
2791504396913818624,2020-03,1777.51,4139.35,3720.78,1449.09,-90.15,-3571.11
2791504396913818624,2020-04,2105.66,230.83,1814.47,0,3689.3,118.19
2791504396913818624,2020-05,0,549.8,2749.64,814.75,1385.09,1503.28
2791504396913818624,2020-06,999.34,1790.5,375.87,1791.91,-2207.2,-703.92
2791504396913818624,2020-07,0,412.42,385.01,3635.53,-3662.94,-4366.86
2791504396913818624,2020-08,0,400.84,1782.93,0,1382.09,-2984.77
2791504396913818624,2020-09,1511.96,869.96,2903.73,955.34,2590.39,-394.38
2791504396913818624,2020-10,1903.32,879.75,0,0,1023.57,629.19
2791504396913818624,2020-11,0,3302.92,680.87,2689.31,-5311.36,-4682.17
2791504396913818624,2020-12,1779.38,0,0,1793.69,-14.31,-4696.48
2792060586608787456,2020-02,0,1962.46,0,0,-1962.46,-1962.46
2792060586608787456,2020-03,381.06,0,0,0,381.06,-1581.4
2792060586608787456,2020-06,1967.18,0,0,1455.52,511.66,-1069.74
2792060586608787456,2020-10,2443.99,0,0,0,2443.99,1374.25
2792656701894514688,2020-01,3971.06,4915.02,2262.53,0,1318.57,1318.57
2792656701894514688,2020-02,4056.95,3475.08,562.75,6123.81,-4979.19,-3660.62
2792656701894514688,2020-03,0,1355.33,1703.07,258.83,88.91,-3571.71
2792656701894514688,2020-04,1714.76,0,1032.33,615.07,2132.02,-1439.69
2792656701894514688,2020-05,362.05,0,1406.83,2916.91,-1148.03,-2587.72
2792656701894514688,2020-06,849.04,2851.89,991.84,179.68,-1190.69,-3778.41
2792656701894514688,2020-07,0,4974.18,179.65,425.57,-5220.1,-8998.51
2792656701894514688,2020-08,1340.37,1634.22,0,1894.27,-2188.12,-11186.63
2792656701894514688,2020-09,1608.9,0,1839.21,1248.98,2199.13,-8987.5
2792656701894514688,2020-10,1167.72,1438.24,2177.23,598.27,1308.44,-7679.06
2792656701894514688,2020-11,1706.81,324.56,0,5345.21,-3962.96,-11642.02
2792656701894514688,2020-12,793.01,1966.92,1785.58,1601.94,-990.27,-12632.29
2793296613093407744,2020-01,5196.04,3541.7,4965.8,5063.44,1556.7,1556.7
2793296613093407744,2020-02,3708.02,3403.76,1006.24,6800.72,-5490.22,-3933.52
2793296613093407744,2020-03,363,2975.55,4487.46,4867.76,-2992.85,-6926.37
2793296613093407744,2020-04,2342.77,4679.78,1797.26,1077.72,-1617.47,-8543.84
2793296613093407744,2020-05,1506.88,788.5,1826.54,4520.3,-1975.38,-10519.22
2793296613093407744,2020-06,6609.19,863.81,1646.12,587.44,6804.06,-3715.16
2793296613093407744,2020-07,4901.59,3331.23,1885.47,3505.78,-49.95,-3765.11
2793296613093407744,2020-08,614.75,4669.3,4348.16,5267.98,-4974.37,-8739.48
2793296613093407744,2020-09,2307.49,3665.06,2410.43,1320.18,-267.32,-9006.8
2793296613093407744,2020-10,6701.29,2678.11,2990.28,4457.46,2556,-6450.8
2793296613093407744,2020-11,1774.68,0,7506.65,5660.91,3620.42,-2830.38
2793296613093407744,2020-12,8134.85,4182.79,0,3308.62,643.44,-2186.94
2794109541131801600,2020-01,1384.26,0,0,1026.44,357.82,357.82
2794109541131801600,2020-02,0,230.46,839.51,0,609.05,966.87
2794109541131801600,2020-03,4516.19,1150.62,818.33,1761.24,2422.66,3389.53
2794109541131801600,2020-04,2680.26,3523.17,2420,779.81,797.28,4186.81
2794109541131801600,2020-05,1950.12,1706.87,0,1098.6,-855.35,3331.46
2794109541131801600,2020-06,3431.84,4322.38,0,190.79,-1081.33,2250.13
2794109541131801600,2020-07,116.54,958.12,1073.93,1490.78,-1258.43,991.7
2794109541131801600,2020-08,4300.27,1441.67,2683.77,47.29,5495.08,6486.78
2794109541131801600,2020-09,0,6447.32,0,44.01,-6491.33,-4.55
2794109541131801600,2020-10,1815.4,3983.86,1263.15,2714.5,-3619.81,-3624.36
2794109541131801600,2020-11,1523.5,2036.3,2239.73,0,1726.93,-1897.43
2794109541131801600,2020-12,1221.16,0,1197.06,0,2418.22,520.79
2795763928166728192,2020-01,266.82,3088.87,1798.7,2230.7,-3254.05,-3254.05
2795763928166728192,2020-02,2355.77,2694.28,4962.57,4140.63,483.43,-2770.62
2795763928166728192,2020-03,1929.79,486.31,1445.68,1140.63,1748.53,-1022.09
2795763928166728192,2020-04,1622.63,4757.99,904.26,1895.57,-4126.67,-5148.76
2795763928166728192,2020-05,2325.69,404.34,2637.32,365.55,4193.12,-955.64
2795763928166728192,2020-06,1339.63,0,0,0,1339.63,383.99
2795763928166728192,2020-07,3000.76,2807.28,4503.72,1846.82,2850.38,3234.37
2795763928166728192,2020-08,4111.21,2321.21,2545.06,0,4335.06,7569.43
2795763928166728192,2020-09,1762.47,1937.19,2856.69,3775.38,-1093.41,6476.02
2795763928166728192,2020-10,0.42,1838.21,4862,1124.75,1899.46,8375.48
2795763928166728192,2020-11,3874.92,4425.24,1712.14,1638.5,-476.68,7898.8
2795763928166728192,2020-12,1982.02,1639.76,1801.81,2627.72,-483.65,7415.15
2796110458005519872,2020-01,0,1958.01,4033.12,1166.32,908.79,908.79
2796110458005519872,2020-02,1512.73,1947.42,1185.74,3189.42,-2438.37,-1529.58
2796110458005519872,2020-03,2148.19,1294.97,1766.18,0,2619.4,1089.82
2796110458005519872,2020-04,1807.88,3317.01,2447.96,1277.6,-338.77,751.05
2796110458005519872,2020-05,2371.55,0,1035.51,160.84,3246.22,3997.27
2796110458005519872,2020-06,1850.27,2140.08,881.33,7.14,584.38,4581.65
2796110458005519872,2020-07,2819.25,3522.71,895.88,0,192.42,4774.07
2796110458005519872,2020-08,2385,107.82,3391.28,0,5668.46,10442.53
2796110458005519872,2020-09,776.4,2140.92,0,0,-1364.52,9078.01
2796110458005519872,2020-10,2681.14,4436.62,0,2155.23,-3910.71,5167.3
2796110458005519872,2020-11,4261.81,0,795.06,0,5056.87,10224.17
2796110458005519872,2020-12,505.72,4411.45,1333.28,4086.48,-6658.93,3565.24
2796264816258122240,2020-01,1694.34,1199.32,5255.75,540.1,5210.67,5210.67
2796264816258122240,2020-02,1541.95,0,0,1668.24,-126.29,5084.38
2796264816258122240,2020-03,928.08,1535.81,1952.84,1763.29,-418.18,4666.2
2796264816258122240,2020-04,399.9,45,1124.67,944.05,535.52,5201.72
2796264816258122240,2020-05,3966.41,645.24,2699.95,1940,4081.12,9282.84
2796264816258122240,2020-06,3345.32,2757.65,0,753.91,-166.24,9116.6
2796264816258122240,2020-07,1535.3,774.26,1158.54,4770.84,-2851.26,6265.34
2796264816258122240,2020-08,651.17,4013.49,158.25,1166.94,-4371.01,1894.33
2796264816258122240,2020-09,1570.42,213.16,207.89,625.07,940.08,2834.41
2796264816258122240,2020-10,989.63,0,1996.79,1050.73,1935.69,4770.1
2796264816258122240,2020-11,2603.53,2152.35,0,5275.99,-4824.81,-54.71
2796264816258122240,2020-12,1899.42,1926.3,0,990.18,-1017.06,-1071.77
2796661521190031872,2020-01,4201.01,4352.22,11692.31,418.05,11123.05,11123.05
2796661521190031872,2020-02,1071.47,4580.12,4478.59,6352.47,-5382.53,5740.52
2796661521190031872,2020-03,1344.05,4267.77,7679.96,4763,-6.76,5733.76
2796661521190031872,2020-04,5620.39,6016.15,7143.71,4113.75,2634.2,8367.96
2796661521190031872,2020-05,2143.38,5132.8,4493.42,3766.41,-2262.41,6105.55
2796661521190031872,2020-06,2823.67,7120.9,4817.28,1842.27,-1322.22,4783.33
2796661521190031872,2020-07,4828.44,3561.2,5215.62,4186.8,2296.06,7079.39
2796661521190031872,2020-08,2412.09,8591.56,2587.98,2721.88,-6313.37,766.02
2796661521190031872,2020-09,8442.06,4181.85,6203.83,5066.94,5397.1,6163.12
2796661521190031872,2020-10,5037.95,8512.47,4303.53,4613.81,-3784.8,2378.32
2796661521190031872,2020-11,2451.64,5409.24,1135.63,6645.9,-8467.87,-6089.55
2796661521190031872,2020-12,9807.04,4812.9,4793.43,2709.95,7077.62,988.07
2797629112175076864,2020-01,0,1312.31,230.69,1090.02,-2171.64,-2171.64
2797629112175076864,2020-02,591.08,6047.43,1416.9,2130.65,-6170.1,-8341.74
2797629112175076864,2020-03,8164.44,1960.84,2693.1,1126.17,7770.53,-571.21
2797629112175076864,2020-04,0,5459.36,1727.35,0,-3732.01,-4303.22
2797629112175076864,2020-06,1865.32,0,2643.2,2205.62,2302.9,-2000.32
2797629112175076864,2020-07,0,1183.47,927.74,1670.97,-1926.7,-3927.02
2797629112175076864,2020-08,3135.09,733.14,1271.17,731.59,2941.53,-985.49
2797629112175076864,2020-09,2097.34,1434.48,0,147.15,515.71,-469.78
2797629112175076864,2020-10,1198.53,1371.64,0,1697.51,-1870.62,-2340.4
2797629112175076864,2020-11,2741.52,3384.6,1437.05,3266.32,-2472.35,-4812.75
2797629112175076864,2020-12,4286.41,0,696.28,1912.99,3069.7,-1743.05
2798953153547346944,2020-01,3482.03,2855.88,1608.49,1405.41,829.23,829.23
2798953153547346944,2020-02,2520.88,0,4560.92,4942.81,2138.99,2968.22
2798953153547346944,2020-03,4462.44,3677.67,1167.72,293.27,1659.22,4627.44
2798953153547346944,2020-04,70.32,7062.9,2607.02,1719.95,-6105.51,-1478.07
2798953153547346944,2020-05,823.9,1670.99,1697.96,4315.41,-3464.54,-4942.61
2798953153547346944,2020-06,2464.79,4704.33,3467.76,5160.14,-3931.92,-8874.53
2798953153547346944,2020-07,2439.69,0,4695.05,2748.6,4386.14,-4488.39
2798953153547346944,2020-08,2809.25,2835.69,0,5287.64,-5314.08,-9802.47
2798953153547346944,2020-09,1678.75,2101.19,4658.14,810.27,3425.43,-6377.04
2798953153547346944,2020-10,6936.42,1566.35,2334.78,2783.71,4921.14,-1455.9
2798953153547346944,2020-11,0,3089.19,1820.24,987.69,-2256.64,-3712.54
2798953153547346944,2020-12,3532.99,2524.94,1718.96,3419.81,-692.8,-4405.34
2799508538521339392,2020-01,0,3505.22,0,1748.94,-5254.16,-5254.16
2799508538521339392,2020-02,3550.04,1021.93,0,2915.34,-387.23,-5641.39
2799508538521339392,2020-03,1983.91,1878.05,4089.98,2677.95,1517.89,-4123.5
2799508538521339392,2020-04,2203.98,0,1618.36,3253.49,568.85,-3554.65
2799508538521339392,2020-05,4926.86,0,2860.21,6344.94,1442.13,-2112.52
2799508538521339392,2020-06,936.6,428.36,0,1915.27,-1407.03,-3519.55
2799508538521339392,2020-07,1642.42,1166.3,4186.35,3601,1061.47,-2458.08
2799508538521339392,2020-08,482.93,2106.9,7463.97,3627.32,2212.68,-245.4
2799508538521339392,2020-09,662.71,1487.78,2213.25,1665.55,-277.37,-522.77
2799508538521339392,2020-10,2623.89,1951.73,810.67,4386.13,-2903.3,-3426.07
2799508538521339392,2020-11,3344.48,809.93,2261.38,3287.53,1508.4,-1917.67
2799508538521339392,2020-12,4942.42,4559.02,0,762.35,-378.95,-2296.62
2802241117813343744,2020-01,2684.11,0,2096.61,0,4780.72,4780.72
2802241117813343744,2020-02,1577.76,0,1176.32,3344.16,-590.08,4190.64
2802241117813343744,2020-03,2615.7,439.4,2668.13,0,4844.43,9035.07
2802241117813343744,2020-04,1655.25,1914.59,0,1353.45,-1612.79,7422.28
2802241117813343744,2020-05,1033.93,4794.83,902.07,2079.12,-4937.95,2484.33
2802241117813343744,2020-06,995,830.74,1198.45,1797.52,-434.81,2049.52
2802241117813343744,2020-07,0,4898.99,0,1165.81,-6064.8,-4015.28
2802241117813343744,2020-08,926.68,114.06,3110.6,0,3923.22,-92.06
2802241117813343744,2020-09,1712.69,0,2101.88,0,3814.57,3722.51
2802241117813343744,2020-10,384.86,77.83,1333.31,325.52,1314.82,5037.33
2802241117813343744,2020-11,0,197.13,406.65,26.81,182.71,5220.04
2802575613201426432,2020-09,0,80.5,1143.15,0,1062.65,1062.65
2802575613201426432,2020-10,0,1920.38,0,131.57,-2051.95,-989.3
2802575613201426432,2020-11,0,214.44,0,0,-214.44,-1203.74
2803196921423960576,2020-01,4911.12,1553.92,5969.34,5146.91,4179.63,4179.63
2803196921423960576,2020-02,2864.98,1117.8,3758.82,1712.4,3793.6,7973.23
2803196921423960576,2020-03,181.31,3085.27,3573.12,4785.92,-4116.76,3856.47
2803196921423960576,2020-04,3812.3,5260.56,592.6,6963.8,-7819.46,-3962.99
2803196921423960576,2020-05,361.75,5851.63,3113.1,3964.67,-6341.45,-10304.44
2803196921423960576,2020-06,3268.25,4304.94,950.77,3668.45,-3754.37,-14058.81
2803196921423960576,2020-07,6334.78,9079.84,1879.82,1329.94,-2195.18,-16253.99
2803196921423960576,2020-08,3544.33,5878.7,3516.39,4674.32,-3492.3,-19746.29
2803196921423960576,2020-09,2199.47,0,2254.06,1065.39,3388.14,-16358.15
2803196921423960576,2020-10,5683.95,1630.72,1604.62,6467.32,-809.47,-17167.62
2803196921423960576,2020-11,566.4,3124.75,216.99,523.61,-2864.97,-20032.59
2803196921423960576,2020-12,1746.88,3689.02,6655.35,2220.6,2492.61,-17539.98
2804578548799307776,2020-01,4543.64,4018.64,3097.56,5970.98,-2348.42,-2348.42
2804578548799307776,2020-02,6728.06,529.44,4160.63,1844.36,8514.89,6166.47
2804578548799307776,2020-03,3999.34,4924.86,4063.66,2656.39,481.75,6648.22
2804578548799307776,2020-04,6762.71,4285.03,5193.26,1601.59,6069.35,12717.57
2804578548799307776,2020-05,4225.82,3404.71,694.88,2811.26,-1295.27,11422.3
2804578548799307776,2020-06,1328.02,7188.57,5915.63,376.77,-321.69,11100.61
2804578548799307776,2020-07,7554.51,4037.88,0,4681.55,-1164.92,9935.69
2804578548799307776,2020-08,3037.69,1429.81,7261.14,1907.77,6961.25,16896.94
2804578548799307776,2020-09,2317.58,2677.4,2088,2698.51,-970.33,15926.61
2804578548799307776,2020-10,4941.33,8511.22,1887.59,2016.56,-3698.86,12227.75
2804578548799307776,2020-11,3713.86,6694.69,2083.92,3828.17,-4725.08,7502.67
2804578548799307776,2020-12,6801.57,6033.92,806.13,4081.23,-2507.45,4995.22
2804811042762405376,2020-01,2381.7,3372.66,3699.43,4492.37,-1783.9,-1783.9
2804811042762405376,2020-02,2120.53,3007.04,2454.03,1686.29,-118.77,-1902.67
2804811042762405376,2020-03,8908.03,3427.69,1704.53,2586.46,4598.41,2695.74
2804811042762405376,2020-04,2541.43,0,2894.12,1017.42,4418.13,7113.87
2804811042762405376,2020-05,4046.16,518.07,4398.87,1411.2,6515.76,13629.63
2804811042762405376,2020-06,2256.46,5027.29,2401.77,6599.11,-6968.17,6661.46
2804811042762405376,2020-07,1377.01,5113.18,2443.17,2430.7,-3723.7,2937.76
2804811042762405376,2020-08,3675.23,2397.06,10068.48,2992.3,8354.35,11292.11
2804811042762405376,2020-09,3407.51,6207.22,1917.01,5029.6,-5912.3,5379.81
2804811042762405376,2020-10,6840,3117.18,9226.02,2672.48,10276.36,15656.17
2804811042762405376,2020-11,2283.21,924.84,2944.46,5105.02,-802.19,14853.98
2804811042762405376,2020-12,6109.17,0,1611.07,3127.02,4593.22,19447.2
2805227972176352768,2020-01,7875.1,6888.74,3799.83,1844.11,2942.08,2942.08
2805227972176352768,2020-02,4003.51,938.1,5225.6,4413.57,3877.44,6819.52
2805227972176352768,2020-03,4771.73,1314.76,5132.2,5074.14,3515.03,10334.55
2805227972176352768,2020-04,4295.36,7969.14,12326.64,2325.29,6327.57,16662.12
2805227972176352768,2020-05,7948.38,2092.15,10245.67,2872.45,13229.45,29891.57
2805227972176352768,2020-06,7073.14,2611.16,1776.37,1381.47,4856.88,34748.45
2805227972176352768,2020-07,6502.19,0,6004.43,4224.6,8282.02,43030.47
2805227972176352768,2020-08,6270.9,3501.58,1957.47,6092.69,-1365.9,41664.57
2805227972176352768,2020-09,10616.88,9227.12,6269.75,5029.93,2629.58,44294.15
2805227972176352768,2020-10,5356.46,7127.64,4785.59,5301.15,-2286.74,42007.41
2805227972176352768,2020-11,3028.29,6716.95,2655.32,6091.41,-7124.75,34882.66
2805227972176352768,2020-12,5038.6,5648.54,4287.3,3946.32,-268.96,34613.7
2805254131243019776,2020-04,69.75,614.36,0,0,-544.61,-544.61
2805254131243019776,2020-07,587.62,0,0,0,587.62,43.01
2805254131243019776,2020-08,252.47,0,0,0,252.47,295.48
2805254131243019776,2020-09,0,879.33,1019.35,1413.71,-1273.69,-978.21
2807846871731219968,2020-01,2586.42,4473.15,9117.96,1473.29,5757.94,5757.94
2807846871731219968,2020-02,1838.21,3769.87,5322.84,6683.91,-3292.73,2465.21
2807846871731219968,2020-03,3563.11,1812.99,10626.06,2806.98,9569.2,12034.41
2807846871731219968,2020-04,7122.26,8146.64,3830.54,3295.27,-489.11,11545.3
2807846871731219968,2020-05,4895.74,1355.23,3205.98,3986.78,2759.71,14305.01
2807846871731219968,2020-06,109.55,2830.49,4246.7,5708.01,-4182.25,10122.76
2807846871731219968,2020-07,4612.83,4823.33,456.84,4352.07,-4105.73,6017.03
2807846871731219968,2020-08,2491.44,6976.04,3377.19,0,-1107.41,4909.62
2807846871731219968,2020-09,6286.25,4904.42,3076.55,3605.78,852.6,5762.22
2807846871731219968,2020-10,599.74,5978.11,259.58,7034.89,-12153.68,-6391.46
2807846871731219968,2020-11,6985.89,499.85,616.94,10466.5,-3363.52,-9754.98
2807846871731219968,2020-12,5155.78,6730.17,4645.75,4045.68,-974.32,-10729.3
2809643807045446656,2020-06,1087.69,0,0,0,1087.69,1087.69
2809643807045446656,2020-10,0,1187.63,0,0,-1187.63,-99.94
2809727862563811328,2020-01,2675.39,985.69,0,2322.02,-632.32,-632.32
2809727862563811328,2020-03,1909.22,0,1647.92,0,3557.14,2924.82
2809727862563811328,2020-04,0,1336.64,0,3225.93,-4562.57,-1637.75
2809727862563811328,2020-05,613.15,1042.88,0,0,-429.73,-2067.48
2809727862563811328,2020-06,1374.35,0,0,1252.93,121.42,-1946.06
2809727862563811328,2020-07,1157.58,0,1091.36,0,2248.94,302.88
2809727862563811328,2020-09,0,1218.97,1566.27,0,347.3,650.18
2809727862563811328,2020-10,0,366.71,0,62.38,-429.09,221.09
2809727862563811328,2020-11,1549.31,0,1553.13,1499.54,1602.9,1823.99
2809727862563811328,2020-12,0,1950.99,369.69,554.02,-2135.32,-311.33
2811886407547100160,2020-01,0,1538.39,2620.7,934.45,147.86,147.86
2811886407547100160,2020-02,2047.62,0,4587.76,1528.61,5106.77,5254.63
2811886407547100160,2020-03,2012.66,1983.36,4567.91,2965.91,1631.3,6885.93
2811886407547100160,2020-04,5878.12,1346.45,1696.62,1725.72,4502.57,11388.5
2811886407547100160,2020-05,174.06,0,212.18,1511.27,-1125.03,10263.47
2811886407547100160,2020-06,1298.58,5638,2157.9,1526.73,-3708.25,6555.22
2811886407547100160,2020-07,1947.69,0,3573.42,1774,3747.11,10302.33
2811886407547100160,2020-08,0,43.13,0,3542.03,-3585.16,6717.17
2811886407547100160,2020-09,3259.51,0,0,5876.64,-2617.13,4100.04
2811886407547100160,2020-10,2046.32,1192.13,5104.17,565.61,5392.75,9492.79
2811886407547100160,2020-11,2033.36,305.83,0,1491.02,236.51,9729.3
2811886407547100160,2020-12,863.62,0,2672.34,153,3382.96,13112.26
2814132059123044352,2020-01,0,1289.57,6005.64,5285.17,-569.1,-569.1
2814132059123044352,2020-02,820.8,1357.71,5438.76,1839.36,3062.49,2493.39
2814132059123044352,2020-03,475.71,0,7286.22,589,7172.93,9666.32
2814132059123044352,2020-04,2167.23,7380.03,3244.8,4879.27,-6847.27,2819.05
2814132059123044352,2020-05,1840.29,2850.15,2249.54,4191.05,-2951.37,-132.32
2814132059123044352,2020-06,3693.57,2239.95,681.52,10602.32,-8467.18,-8599.5
2814132059123044352,2020-07,4324.79,6255.1,4581.18,6678.8,-4027.93,-12627.43
2814132059123044352,2020-08,4397.91,2373.97,2514.85,3396.52,1142.27,-11485.16
2814132059123044352,2020-09,2173.82,3606.94,945.65,1817.8,-2305.27,-13790.43
2814132059123044352,2020-10,4143.15,2049.26,1064.88,2171.33,987.44,-12802.99
2814132059123044352,2020-11,3991.84,2990.88,3206.04,3272.58,934.42,-11868.57
2814132059123044352,2020-12,914.14,4099.33,3517.79,3981.61,-3649.01,-15517.58
2815364531938725376,2020-01,10795.62,6051.81,2414.12,4058.83,3099.1,3099.1
2815364531938725376,2020-02,8154.59,1954.23,4523.75,4734.47,5989.64,9088.74
2815364531938725376,2020-03,4903.35,3028.05,2405.27,2443.2,1837.37,10926.11
2815364531938725376,2020-04,4617.79,3490.78,3137.28,0,4264.29,15190.4
2815364531938725376,2020-05,5977.93,2659,2766.28,6277.81,-192.6,14997.8
2815364531938725376,2020-06,2944.37,2051.78,4840.3,0,5732.89,20730.69
2815364531938725376,2020-07,1664.05,3215.22,2129.59,641.79,-63.37,20667.32
2815364531938725376,2020-08,2887.57,6480.56,2966.6,5934.74,-6561.13,14106.19
2815364531938725376,2020-09,3363.87,575.29,3066.62,8750.85,-2895.65,11210.54
2815364531938725376,2020-10,5471.28,1580.9,3602.51,5740.75,1752.14,12962.68
2815364531938725376,2020-11,2171.9,4088.45,2521.79,1818.73,-1213.49,11749.19
2815364531938725376,2020-12,2860.59,0,7139.83,609.71,9390.71,21139.9
2815400284977604096,2020-01,12129.51,4569.36,3151.94,3254.67,7457.42,7457.42
2815400284977604096,2020-02,1796.5,7750.15,7353.46,2429.22,-1029.41,6428.01
2815400284977604096,2020-03,1545.06,3192.27,4195.07,6051.29,-3503.43,2924.58
2815400284977604096,2020-04,3507.43,1332.65,4837.04,5302.58,1709.24,4633.82
2815400284977604096,2020-05,7276.43,6126.62,7125.6,4990.35,3285.06,7918.88
2815400284977604096,2020-06,9893.08,2283.52,5248.82,6252.87,6605.51,14524.39
2815400284977604096,2020-07,1829.3,4302.23,7545.36,4681.31,391.12,14915.51
2815400284977604096,2020-08,1558.67,1993.95,2151.57,3308.05,-1591.76,13323.75
2815400284977604096,2020-09,5739.04,10012.24,1078.9,5700.8,-8895.1,4428.65
2815400284977604096,2020-10,9233,2549.55,5801.77,9787.29,2697.93,7126.58
2815400284977604096,2020-11,6014.58,3153.33,1988.4,1697.77,3151.88,10278.46
2815400284977604096,2020-12,5783.11,2972.08,4127.18,8817.77,-1879.56,8398.9
2817048027892314112,2020-01,916.18,0,1611.26,0,2527.44,2527.44
2817048027892314112,2020-02,1441.05,184.22,4714.27,87.84,5883.26,8410.7
2817048027892314112,2020-03,2512.83,1373.09,2714.76,2907,947.5,9358.2
2817048027892314112,2020-04,0,4240.56,691.45,1795.55,-5344.66,4013.54
2817048027892314112,2020-05,1140.25,932.96,3205.95,2895.04,518.2,4531.74
2817048027892314112,2020-06,1562.63,1519.64,1858.52,4799.97,-2898.46,1633.28
2817048027892314112,2020-07,1397.82,1734.44,4624.12,1533.41,2754.09,4387.37
2817048027892314112,2020-08,1342.42,2552.09,1644.03,0,434.36,4821.73
2817048027892314112,2020-09,0,4712.45,607.2,2592.35,-6697.6,-1875.87
2817048027892314112,2020-10,0,3884.76,3802.85,1150.48,-1232.39,-3108.26
2817048027892314112,2020-11,1145.87,161.99,1643.36,498.59,2128.65,-979.61
2817048027892314112,2020-12,2724.88,0,174.45,2020.67,878.66,-100.95
2819171372174669312,2020-01,245.89,2928.79,1551.61,3673.67,-4804.96,-4804.96
2819171372174669312,2020-02,3046.52,307.32,4161.61,0,6900.81,2095.85
2819171372174669312,2020-03,488.72,2108.17,1984.84,1597.24,-1231.85,864
2819171372174669312,2020-04,1169.01,2309.95,1602.17,0,461.23,1325.23
2819171372174669312,2020-05,953.07,1093.71,2704.44,3668.56,-1104.76,220.47
2819171372174669312,2020-06,0,1874.36,4643.44,3408.04,-638.96,-418.49
2819171372174669312,2020-07,1652.76,0,1085.94,1035.93,1702.77,1284.28
2819171372174669312,2020-08,0,1678.28,2729.2,4021.19,-2970.27,-1685.99
2819171372174669312,2020-09,2208.59,3269.45,0,19.4,-1080.26,-2766.25
2819171372174669312,2020-10,1023.88,2067.9,13.24,1131.83,-2162.61,-4928.86
2819171372174669312,2020-11,1407.24,0,4657.69,786.49,5278.44,349.58
2819171372174669312,2020-12,1826.83,3789.04,2999.45,1836.48,-799.24,-449.66
2820194418703611392,2020-01,3275.22,3303.67,1843.5,4493.24,-2678.19,-2678.19
2820194418703611392,2020-02,1824.6,2104.07,5476.23,3177.46,2019.3,-658.89
2820194418703611392,2020-03,1566.61,2901.22,0,5540.47,-6875.08,-7533.97
2820194418703611392,2020-04,2511.2,9503.99,3119.12,2004.24,-5877.91,-13411.88
2820194418703611392,2020-05,1348.94,3076.82,1154.81,6135.1,-6708.17,-20120.05
2820194418703611392,2020-06,9085.53,958.37,2637.4,1437.16,9327.4,-10792.65
2820194418703611392,2020-07,5422.56,4568.57,4817.44,3588.2,2083.23,-8709.42
2820194418703611392,2020-08,2346.09,5375.94,773.53,2957.04,-5213.36,-13922.78
2820194418703611392,2020-09,3277.04,2958.75,298.33,2124.42,-1507.8,-15430.58
2820194418703611392,2020-10,4445.26,6838.51,5558.01,5150.79,-1986.03,-17416.61
2820194418703611392,2020-11,1898.17,1939.7,5108.65,1428.6,3638.52,-13778.09
2820194418703611392,2020-12,2829.89,4351.92,5199.97,1949.56,1728.38,-12049.71
2820695089055158272,2020-01,256.3,1729.46,1136.76,0,-336.4,-336.4
2820695089055158272,2020-02,1816.4,1317.45,1434.99,1822.45,111.49,-224.91
2820695089055158272,2020-03,718.94,0,2417.98,0,3136.92,2912.01
2820695089055158272,2020-05,2086.38,1603.29,1722.86,1686.67,519.28,3431.29
2820695089055158272,2020-06,164.26,0,0,0,164.26,3595.55
2820695089055158272,2020-08,0,1212.75,0,1095.04,-2307.79,1287.76
2820695089055158272,2020-10,302.74,2798.48,3059.2,1790.28,-1226.82,60.94
2820695089055158272,2020-11,978.35,0,2209.63,155.14,3032.84,3093.78
2820695089055158272,2020-12,0,934.02,0,0,-934.02,2159.76
2820708475048207872,2020-01,3192.53,3412.93,4912.12,9145.2,-4453.48,-4453.48
2820708475048207872,2020-02,2688.34,6086.64,2138.8,2697.59,-3957.09,-8410.57
2820708475048207872,2020-03,4109.87,3235.59,3845.23,8163.98,-3444.47,-11855.04
2820708475048207872,2020-04,7117,3414.61,1145.63,2687.2,2160.82,-9694.22
2820708475048207872,2020-05,1859.42,7313.81,3784.74,6248.02,-7917.67,-17611.89
2820708475048207872,2020-06,0,620.79,4333.35,6937.65,-3225.09,-20836.98
2820708475048207872,2020-07,3505.66,6957.54,158.19,2453.16,-5746.85,-26583.83
2820708475048207872,2020-08,1067.94,7438.44,3347.55,3339.24,-6362.19,-32946.02
2820708475048207872,2020-09,213.73,5123.46,835.86,2191.68,-6265.55,-39211.57
2820708475048207872,2020-10,523.42,1219,4307.1,2248.75,1362.77,-37848.8
2820708475048207872,2020-11,1516.16,4408.95,1836.17,3338.21,-4394.83,-42243.63
2820708475048207872,2020-12,2821.28,1751.7,2637.99,3374.59,332.98,-41910.65
2821261360232965632,2020-01,2947.54,0,2934.56,1609.84,4272.26,4272.26
2821261360232965632,2020-02,8.64,3427.17,2658.68,1509.37,-2269.22,2003.04
2821261360232965632,2020-03,4789.98,2702.3,1065.1,4683.79,-1531.01,472.03
2821261360232965632,2020-04,1863.73,913.42,4096.87,1835.24,3211.94,3683.97
2821261360232965632,2020-05,6138.76,1001.25,1652.95,4884.69,1905.77,5589.74
2821261360232965632,2020-06,4209.65,119.89,1929.09,1207.13,4811.72,10401.46
2821261360232965632,2020-07,2581.02,4354.45,852.69,6029.42,-6950.16,3451.3
2821261360232965632,2020-08,2957.5,1702.24,2539.94,3562.16,233.04,3684.34
2821261360232965632,2020-09,5064.27,2890.61,1802.12,1784.15,2191.63,5875.97
2821261360232965632,2020-10,3198.74,989.96,1614.04,704.56,3118.26,8994.23
2821261360232965632,2020-11,1700.63,664.85,2344.94,2924.57,456.15,9450.38
2821261360232965632,2020-12,1175.38,891.15,4700.89,331.4,4653.72,14104.1
2822610918274823680,2020-01,2332.27,8085.69,3353.78,2893.7,-5293.34,-5293.34
2822610918274823680,2020-02,5592.76,1063.36,5645,6084.28,4090.12,-1203.22
2822610918274823680,2020-03,4312.25,8779.73,6879.69,7887.75,-5475.54,-6678.76
2822610918274823680,2020-04,4971.88,1195.28,2559.39,2361.94,3974.05,-2704.71
2822610918274823680,2020-05,2430.5,5717.03,4712.06,11095.49,-9669.96,-12374.67
2822610918274823680,2020-06,4741.99,6834.47,2075.27,5218.75,-5235.96,-17610.63
2822610918274823680,2020-07,4616.18,4543.79,3178.25,3072.34,178.3,-17432.33
2822610918274823680,2020-08,5863.18,0,4866.56,1662.61,9067.13,-8365.2
2822610918274823680,2020-09,2389.22,4546.08,2887.49,1380.24,-649.61,-9014.81
2822610918274823680,2020-10,4865.7,3546.48,4022.43,5195.65,146,-8868.81
2822610918274823680,2020-11,2125.11,1470.76,7320.5,5606.83,2368.02,-6500.79
2822610918274823680,2020-12,5586.39,9494.04,2645.1,4076.94,-5339.49,-11840.28
2823771744268697600,2020-01,3756.02,4718.06,0,2468.67,-3430.71,-3430.71
2823771744268697600,2020-02,2239,3784.89,4669.12,4505.32,-1382.09,-4812.8
2823771744268697600,2020-03,3235.67,5092.72,6095.14,1773.89,2464.2,-2348.6
2823771744268697600,2020-04,2092.61,2631.52,4687.71,530.12,3618.68,1270.08
2823771744268697600,2020-05,1438.4,2919.94,7044.03,3363.66,2198.83,3468.91
2823771744268697600,2020-06,1893.17,3057.62,487.7,2563.97,-3240.72,228.19
2823771744268697600,2020-07,1211.29,314.48,1852.88,2061.7,687.99,916.18
2823771744268697600,2020-08,0,4149.52,4193.56,3644.45,-3600.41,-2684.23
2823771744268697600,2020-09,5321.18,3702.93,4132.98,114.22,5637.01,2952.78
2823771744268697600,2020-10,1873.59,0,926.18,0,2799.77,5752.55
2823771744268697600,2020-11,3239.73,3333.01,3311.22,1915.14,1302.8,7055.35
2823771744268697600,2020-12,5615.73,1124.16,2580.24,601.37,6470.44,13525.79
2823874219133574656,2020-02,0,1037.02,4917.37,0,3880.35,3880.35
2823874219133574656,2020-04,0,2185.73,0,2920.38,-5106.11,-1225.76
2823874219133574656,2020-05,985.67,0,1388.26,1776.93,597,-628.76
2823874219133574656,2020-06,1345.59,0,0,1604.97,-259.38,-888.14
2823874219133574656,2020-07,1093.7,0,0,1548.63,-454.93,-1343.07
2823874219133574656,2020-08,0,2193.53,0,0,-2193.53,-3536.6
2823874219133574656,2020-09,912.66,1304.24,0,1360.16,-1751.74,-5288.34
2823874219133574656,2020-12,1637.46,2059.2,0,1904.33,-2326.07,-7614.41
2824922589514879488,2020-01,0,448.8,1856.7,4559.74,-3151.84,-3151.84
2824922589514879488,2020-02,4414.31,7559.37,2543.67,5767.16,-6368.55,-9520.39
2824922589514879488,2020-03,2380.08,9115.02,824.84,5794.19,-11704.29,-21224.68
2824922589514879488,2020-04,9222.66,2929.72,5632.6,2426.1,9499.44,-11725.24
2824922589514879488,2020-05,9464.43,3393.55,2712.82,6138.46,2645.24,-9080
2824922589514879488,2020-06,3274.74,2171.53,8231.75,4809.77,4525.19,-4554.81
2824922589514879488,2020-07,4671.01,2378.82,1466.11,0,3758.3,-796.51
2824922589514879488,2020-08,857,2435.16,2702.4,2995.53,-1871.29,-2667.8
2824922589514879488,2020-09,7901.95,5405.54,4748.93,3870.1,3375.24,707.44
2824922589514879488,2020-10,927.31,7212.64,5567.19,6307.29,-7025.43,-6317.99
2824922589514879488,2020-11,6307.29,3041.04,1965.96,3395.81,1836.4,-4481.59
2824922589514879488,2020-12,3898.61,1264.36,3523.67,587.72,5570.2,1088.61
2825108722071619072,2020-01,3131.78,1247.4,2766.42,0,4650.8,4650.8
2825108722071619072,2020-02,894.01,0,2152.94,0,3046.95,7697.75
2825108722071619072,2020-03,693.22,0,0,0,693.22,8390.97
2825108722071619072,2020-04,0,2764.5,0,1590,-4354.5,4036.47
2825108722071619072,2020-05,1002.9,1255.01,339.58,118.01,-30.54,4005.93
2825108722071619072,2020-06,2701.75,0,0,1953.76,747.99,4753.92
2825108722071619072,2020-07,2180.65,0,0,2069.44,111.21,4865.13
2825108722071619072,2020-08,1199.68,2174.96,2195.1,1913.27,-693.45,4171.68
2825108722071619072,2020-09,0,1652.33,0,1029.63,-2681.96,1489.72
2825108722071619072,2020-10,1545.55,0,1543.32,1264.46,1824.41,3314.13
2825108722071619072,2020-11,2338.11,0,0,0,2338.11,5652.24
2825108722071619072,2020-12,1071.72,1928.09,713.18,4334.15,-4477.34,1174.9
2827728647200184832,2020-01,1829.37,0,0,358.67,1470.7,1470.7
2827728647200184832,2020-02,272.5,0,1487.1,577.23,1182.37,2653.07
2827728647200184832,2020-03,1003.66,739.87,0,0,263.79,2916.86
2827728647200184832,2020-04,3018.29,3130.69,1880.53,997.44,770.69,3687.55
2827728647200184832,2020-05,798.58,1383.95,0,2553.48,-3138.85,548.7
2827728647200184832,2020-06,0,1322.85,0,1493.68,-2816.53,-2267.83
2827728647200184832,2020-07,3814.74,2099.26,0,2388.62,-673.14,-2940.97
2827728647200184832,2020-09,1133.63,1683.49,1969.82,661.26,758.7,-2182.27
2827728647200184832,2020-10,436.73,1673.66,0,2876.96,-4113.89,-6296.16
2827728647200184832,2020-11,1536.32,0,1141.28,0,2677.6,-3618.56
2827728647200184832,2020-12,2218.47,877.99,0,0,1340.48,-2278.08
2830172995669207552,2020-01,0,622.16,0,0,-622.16,-622.16
2830172995669207552,2020-02,0,1330.86,907.59,0,-423.27,-1045.43
2830172995669207552,2020-03,750.39,0,0,0,750.39,-295.04
2830172995669207552,2020-04,1229.72,0,2422.6,554.64,3097.68,2802.64
2830172995669207552,2020-05,4630.25,0,1819.38,2911.39,3538.24,6340.88
2830172995669207552,2020-06,1154.8,1385.28,0,3156.75,-3387.23,2953.65
2830172995669207552,2020-07,1980.26,165.49,933.74,0,2748.51,5702.16
2830172995669207552,2020-10,0,968.57,1693.76,0,725.19,6427.35
2830172995669207552,2020-11,213.34,146.08,1458.02,1115.05,410.23,6837.58
2830172995669207552,2020-12,0,2044.93,974.27,0,-1070.66,5766.92
2831015709035262464,2020-01,3034.82,3433.42,2399.81,3280.83,-1279.62,-1279.62
2831015709035262464,2020-02,0,961.24,1094.41,1425.01,-1291.84,-2571.46
2831015709035262464,2020-03,1683.38,1056.87,4524.76,1947.71,3203.56,632.1
2831015709035262464,2020-04,1312.49,4197.16,6279.55,5967.87,-2572.99,-1940.89
2831015709035262464,2020-05,3710.84,2244.68,3767.81,2553.08,2680.89,740
2831015709035262464,2020-06,4425.17,5255.63,1352.26,1371.53,-849.73,-109.73
2831015709035262464,2020-07,6801.22,2672.01,2651.38,560.85,6219.74,6110.01
2831015709035262464,2020-08,3751.27,1564.75,3744.48,4037.11,1893.89,8003.9
2831015709035262464,2020-09,1992.37,0,2143.53,4392.64,-256.74,7747.16
2831015709035262464,2020-10,1821.23,3136.41,1000.64,5010.97,-5325.51,2421.65
2831015709035262464,2020-11,2288.18,1710.61,1341.11,2660.63,-741.95,1679.7
2831015709035262464,2020-12,3577.68,3614.02,3584.4,4265.16,-717.1,962.6
2831394230411572224,2020-01,4221.42,1108.58,6164.02,5774.11,3502.75,3502.75
2831394230411572224,2020-02,1324.73,4864.16,5802.34,2424.34,-161.43,3341.32
2831394230411572224,2020-03,6882.19,1765.02,1565.44,9162.11,-2479.5,861.82
2831394230411572224,2020-04,4486.02,2851.12,6402.81,3918.88,4118.83,4980.65
2831394230411572224,2020-05,2507.78,4163.99,3136.3,2770.86,-1290.77,3689.88
2831394230411572224,2020-06,2593.08,6760.99,5470.63,6405.23,-5102.51,-1412.63
2831394230411572224,2020-07,3806.39,3734.93,3462.04,2831.83,701.67,-710.96
2831394230411572224,2020-08,2744.86,4837.44,1114.14,3256.36,-4234.8,-4945.76
2831394230411572224,2020-09,2238.75,3045.04,1968.32,7618.6,-6456.57,-11402.33
2831394230411572224,2020-10,5197.79,4422.24,1786.74,2643.72,-81.43,-11483.76
2831394230411572224,2020-11,483.69,1986.34,2263.22,6700.6,-5940.03,-17423.79
2831394230411572224,2020-12,8179.77,2066.12,10152.88,2183.87,14082.66,-3341.13
2831445867419248640,2020-01,0,495.61,0,0,-495.61,-495.61
2831445867419248640,2020-02,843.99,0,0,0,843.99,348.38
2831445867419248640,2020-03,1367.78,130.53,0,0,1237.25,1585.63
2831445867419248640,2020-04,729.71,0,0,0,729.71,2315.34
2831445867419248640,2020-05,0,1199.38,0,0,-1199.38,1115.96
2831445867419248640,2020-06,0,2423.83,2441.4,471.48,-453.91,662.05
2831445867419248640,2020-07,0,894.13,0,0,-894.13,-232.08
2831445867419248640,2020-08,0,827.97,0,0,-827.97,-1060.05
2831445867419248640,2020-09,0,1642.77,0,1525.97,-3168.74,-4228.79
2831445867419248640,2020-11,0,1865.15,1628.57,840.59,-1077.17,-5305.96
2831445867419248640,2020-12,55.62,0,0,0,55.62,-5250.34
2832719307688005632,2020-01,0,1760.36,527.45,0,-1232.91,-1232.91
2832719307688005632,2020-02,861.08,517.15,0,994.89,-650.96,-1883.87
2832719307688005632,2020-03,1709.39,1670.87,125.49,715.74,-551.73,-2435.6
2832719307688005632,2020-05,872.53,1694.35,154.86,990.02,-1656.98,-4092.58
2832719307688005632,2020-06,1733.6,0,0,0,1733.6,-2358.98
2832719307688005632,2020-07,3419.27,1011.53,558.29,689.1,2276.93,-82.05
2832719307688005632,2020-09,2566,1981.47,120.51,2377.18,-1672.14,-1754.19
2832719307688005632,2020-11,1921.32,0,1972.48,0,3893.8,2139.61
2832719307688005632,2020-12,1962.49,0,0,145.72,1816.77,3956.38
2832944143158805504,2020-01,1561.6,5034.9,75.32,2659.31,-6057.29,-6057.29
2832944143158805504,2020-02,6331.06,2311.77,6727.94,4195.22,6552.01,494.72
2832944143158805504,2020-03,2323.36,1348.27,0,4923.06,-3947.97,-3453.25
2832944143158805504,2020-04,1707.08,5208.31,2161.6,4530.59,-5870.22,-9323.47
2832944143158805504,2020-05,3176.83,5858.46,4718.05,2765.05,-728.63,-10052.1
2832944143158805504,2020-06,3038.37,2772.42,2628.12,6349.12,-3455.05,-13507.15
2832944143158805504,2020-07,696.71,1225.01,1846.04,2788,-1470.26,-14977.41
2832944143158805504,2020-08,1997.1,1696.95,3761.51,5111.94,-1050.28,-16027.69
2832944143158805504,2020-09,2590.57,4735.11,8729.35,2505.76,4079.05,-11948.64
2832944143158805504,2020-10,3594.83,11324.82,2671.52,3268.93,-8327.4,-20276.04
2832944143158805504,2020-11,1178.26,4219.93,1631.02,3671.99,-5082.64,-25358.68
2832944143158805504,2020-12,5737.35,3757.93,4098.24,3721.96,2355.7,-23002.98
2837456309828851200,2020-01,2324.02,1300.43,0,0,1023.59,1023.59
2837456309828851200,2020-02,4036.05,153.53,674.97,5699.08,-1141.59,-118
2837456309828851200,2020-03,0,313.33,3731.81,1462.49,1955.99,1837.99
2837456309828851200,2020-04,2064.01,1467.99,3016.9,323.47,3289.45,5127.44
2837456309828851200,2020-05,1886.32,3357.43,2802.22,0,1331.11,6458.55
2837456309828851200,2020-06,207.19,1853.91,4587.71,1271.43,1669.56,8128.11
2837456309828851200,2020-07,1037.44,1745.74,0,2121.93,-2830.23,5297.88
2837456309828851200,2020-08,0,1061.85,5367.83,2454.55,1851.43,7149.31
2837456309828851200,2020-09,869.03,0,695.42,0,1564.45,8713.76
2837456309828851200,2020-11,1981.28,2811.07,5017.47,1749.01,2438.67,11152.43
2837456309828851200,2020-12,589.1,0,2852.04,1822.06,1619.08,12771.51
2838680368992369664,2020-01,729.99,0,1940.62,356.85,2313.76,2313.76
2838680368992369664,2020-02,3272.84,0,753.47,0,4026.31,6340.07
2838680368992369664,2020-04,0,1160.01,0,0,-1160.01,5180.06
2838680368992369664,2020-05,0,1526.12,3547.9,0,2021.78,7201.84
2838680368992369664,2020-06,37.72,1010.44,0,1508.49,-2481.21,4720.63
2838680368992369664,2020-07,272.31,1045.24,1766.5,620.17,373.4,5094.03
2838680368992369664,2020-08,0,79.24,1716.84,0,1637.6,6731.63
2838680368992369664,2020-12,0,570.16,0,0,-570.16,6161.47
2838859275163095040,2020-04,1426.72,0,0,3057.9,-1631.18,-1631.18
2838859275163095040,2020-05,341.23,0,0,0,341.23,-1289.95
2838859275163095040,2020-07,540.26,0,1375.23,1522.31,393.18,-896.77
2838859275163095040,2020-08,1057.94,1119.87,94.11,0,32.18,-864.59
2838859275163095040,2020-09,2285.01,0,0,0,2285.01,1420.42
2838859275163095040,2020-10,1340.13,0,0,0,1340.13,2760.55
2839707321688514048,2020-01,11010.99,2042.32,6957.22,3545.49,12380.4,12380.4
2839707321688514048,2020-02,2493.12,4201.56,0,4215.02,-5923.46,6456.94
2839707321688514048,2020-03,7817.22,7385.14,1516.27,2665.7,-717.35,5739.59
2839707321688514048,2020-04,254.62,3762.98,1518.28,5055.8,-7045.88,-1306.29
2839707321688514048,2020-05,4501.08,4729.65,2620.49,1194.02,1197.9,-108.39
2839707321688514048,2020-06,3714.49,5409.77,7492.37,3309.05,2488.04,2379.65
2839707321688514048,2020-07,1141.36,3218.17,12405.05,6903.19,3425.05,5804.7
2839707321688514048,2020-08,10338.01,6568.19,5167.68,4195.43,4742.07,10546.77
2839707321688514048,2020-09,2714.59,2748.99,2552.24,1182.06,1335.78,11882.55
2839707321688514048,2020-10,8153.5,7755.57,2579.03,3921.38,-944.42,10938.13
2839707321688514048,2020-11,614.44,6021.58,3254.19,4518.29,-6671.24,4266.89
2839707321688514048,2020-12,7506.9,1875.88,986.16,9108.03,-2490.85,1776.04
2839816490551419904,2020-01,3033,5294.57,495.73,85.71,-1851.55,-1851.55
2839816490551419904,2020-02,2732.24,7621.24,781.76,6428.51,-10535.75,-12387.3
2839816490551419904,2020-03,5441.98,472.59,5430.51,4895.87,5504.03,-6883.27
2839816490551419904,2020-04,3846.97,2660.1,5641.43,5111.4,1716.9,-5166.37
2839816490551419904,2020-05,3708.05,4370.62,5991.66,4838.62,490.47,-4675.9
2839816490551419904,2020-06,10154.01,5203.87,7312.34,2202.03,10060.45,5384.55
2839816490551419904,2020-07,2432.79,12345.04,2862.24,1495.71,-8545.72,-3161.17
2839816490551419904,2020-08,3094.93,5295.35,2351.39,5016.14,-4865.17,-8026.34
2839816490551419904,2020-09,3925.91,0,7494.49,4071.75,7348.65,-677.69
2839816490551419904,2020-10,9267.06,809.29,5658.58,7386.85,6729.5,6051.81
2839816490551419904,2020-11,4541.32,1947.85,5860.66,8793.73,-339.6,5712.21
2839816490551419904,2020-12,1217.11,9518.88,2430.33,4600.99,-10472.43,-4760.22
2842294971234414080,2020-01,848.52,2916.33,3353.72,3416.81,-2130.9,-2130.9
2842294971234414080,2020-02,2789.07,4371.96,5794.81,4199.87,12.05,-2118.85
2842294971234414080,2020-03,4408.46,3523.23,0,3705.37,-2820.14,-4938.99
2842294971234414080,2020-04,1884.4,245.81,1756.87,558.52,2836.94,-2102.05
2842294971234414080,2020-05,4364.31,1785.88,5171.5,2343.81,5406.12,3304.07
2842294971234414080,2020-06,726.36,784.44,3258.06,6903.84,-3703.86,-399.79
2842294971234414080,2020-07,5043.03,2065.57,0,1423.49,1553.97,1154.18
2842294971234414080,2020-08,1889.08,2683.57,5569.3,535.27,4239.54,5393.72
2842294971234414080,2020-09,1448.51,3839.22,967.12,1230.74,-2654.33,2739.39
2842294971234414080,2020-10,4825.36,3671.17,2887.8,2156.83,1885.16,4624.55
2842294971234414080,2020-11,1639.92,1507.81,2454.25,2135.13,451.23,5075.78
2842294971234414080,2020-12,0,1834.72,542.64,4329.83,-5621.91,-546.13
2842994769432771072,2020-01,2823.44,5497.06,1164.45,0,-1509.17,-1509.17
2842994769432771072,2020-02,5908.47,83.68,2419.62,3108.65,5135.76,3626.59
2842994769432771072,2020-03,3574.79,243.52,2754.68,5234.89,851.06,4477.65
2842994769432771072,2020-04,0,157.94,482.4,0,324.46,4802.11
2842994769432771072,2020-05,0,372.58,2331.09,0,1958.51,6760.62
2842994769432771072,2020-06,1219.72,71.96,1157.04,1668.19,636.61,7397.23
2842994769432771072,2020-07,952.65,3515.33,1994.95,1429.61,-1997.34,5399.89
2842994769432771072,2020-08,4730.44,1038.69,3118.15,656.84,6153.06,11552.95
2842994769432771072,2020-09,1343.94,1310.64,1920.54,3617.54,-1663.7,9889.25
2842994769432771072,2020-10,3723.72,1413.19,2733.27,674.77,4369.03,14258.28
2842994769432771072,2020-11,3566.69,1368.35,670.33,3878.86,-1010.19,13248.09
2842994769432771072,2020-12,2918.61,566.06,314.3,1175.92,1490.93,14739.02
2843024430249305088,2020-01,500.74,3156.58,5103.76,2064.44,383.48,383.48
2843024430249305088,2020-02,2994.95,6644.07,3036.93,4336.08,-4948.27,-4564.79
2843024430249305088,2020-03,1557.43,5338.05,2320.17,3048.64,-4509.09,-9073.88
2843024430249305088,2020-04,2837.68,3027.31,2176.16,3313.06,-1326.53,-10400.41
2843024430249305088,2020-05,2287.1,4659.24,2828.41,1396.69,-940.42,-11340.83
2843024430249305088,2020-06,0,2674.38,6330.04,1153.84,2501.82,-8839.01
2843024430249305088,2020-07,3764.57,3683.82,2505.3,2816.34,-230.29,-9069.3
2843024430249305088,2020-08,709.93,2592.81,1834.55,3250.18,-3298.51,-12367.81
2843024430249305088,2020-09,1085.07,4593.29,648.91,1768.3,-4627.61,-16995.42
2843024430249305088,2020-10,2693.13,3733.63,4923.39,0,3882.89,-13112.53
2843024430249305088,2020-11,1976.25,963.32,2957.01,3475.93,494.01,-12618.52
2843024430249305088,2020-12,900.21,4391.69,3218.37,1405.81,-1678.92,-14297.44
2843296999586967040,2020-01,6460.32,2940.14,6726.64,4201.45,6045.37,6045.37
2843296999586967040,2020-02,5253.09,1411.74,1049.53,6047.78,-1156.9,4888.47
2843296999586967040,2020-03,5006.86,2866.82,8691.36,3670.52,7160.88,12049.35
2843296999586967040,2020-04,5947.25,5826.16,7067.73,1271.84,5916.98,17966.33
2843296999586967040,2020-05,6361.39,4581.07,6361.04,6200.07,1941.29,19907.62
2843296999586967040,2020-06,7957.46,10596.13,8884.09,5474.76,770.66,20678.28
2843296999586967040,2020-07,8100.34,3416.31,4274.82,2278.55,6680.3,27358.58
2843296999586967040,2020-08,7116.48,1868.36,4656.64,4594.21,5310.55,32669.13
2843296999586967040,2020-09,3705.87,5452.43,4190.64,5913.9,-3469.82,29199.31
2843296999586967040,2020-10,5165.75,2878.31,2653.48,12307.19,-7366.27,21833.04
2843296999586967040,2020-11,996.6,2163.05,3325.08,5245.87,-3087.24,18745.8
2843296999586967040,2020-12,5045.18,4361.38,8595.13,4286.44,4992.49,23738.29
2843853257911420928,2020-01,2724.54,6186.75,1467.23,683.75,-2678.73,-2678.73
2843853257911420928,2020-02,1645.98,5555.28,2588.57,1326.47,-2647.2,-5325.93
2843853257911420928,2020-03,5111.85,3974.09,2507.48,2876.6,768.64,-4557.29
2843853257911420928,2020-04,1760.18,3308.01,5619.85,2672.43,1399.59,-3157.7
2843853257911420928,2020-05,4929.08,6967.73,4923.84,310.21,2574.98,-582.72
2843853257911420928,2020-06,4003.59,6011.38,5095.91,3872.63,-784.51,-1367.23
2843853257911420928,2020-07,986.7,2601.59,3407.98,2310.84,-517.75,-1884.98
2843853257911420928,2020-08,2895.88,1837.21,3736.25,6399.87,-1604.95,-3489.93
2843853257911420928,2020-09,6780.55,3922.26,6820.57,2964.39,6714.47,3224.54
2843853257911420928,2020-10,1861.39,6451.47,5338.78,2120.34,-1371.64,1852.9
2843853257911420928,2020-11,8240.51,1074.29,6543.93,2732.59,10977.56,12830.46
2843853257911420928,2020-12,5845.12,4353.88,7495.31,2969.53,6017.02,18847.48
2848287878593400320,2020-01,0,527.25,2987.95,3101.27,-640.57,-640.57
2848287878593400320,2020-02,0,19.86,2447.39,1279.36,1148.17,507.6
2848287878593400320,2020-03,1933.98,556.99,0,64.17,1312.82,1820.42
2848287878593400320,2020-04,1962.7,1089.63,0,1030.98,-157.91,1662.51
2848287878593400320,2020-05,1623.16,251.26,1216.83,691.38,1897.35,3559.86
2848287878593400320,2020-06,0,1579.63,0,1310.97,-2890.6,669.26
2848287878593400320,2020-07,0,5038.75,1217.55,1299.24,-5120.44,-4451.18
2848287878593400320,2020-10,785.56,1950.23,976.26,0,-188.41,-4639.59
2848287878593400320,2020-11,1441.11,0,0,2243.48,-802.37,-5441.96
2848287878593400320,2020-12,761.84,0,0,165.9,595.94,-4846.02
2850919223495890944,2020-01,2940.07,2210.24,7972.03,3926.46,4775.4,4775.4
2850919223495890944,2020-02,1225.16,4500.64,3343.65,6804.27,-6736.1,-1960.7
2850919223495890944,2020-03,7714.97,4436.15,3148.14,3296.28,3130.68,1169.98
2850919223495890944,2020-04,1214.2,1584.24,3588.79,4715.82,-1497.07,-327.09
2850919223495890944,2020-05,5132.9,4474.76,5743.51,4148.5,2253.15,1926.06
2850919223495890944,2020-06,5802.67,2688.11,4153.32,3894.48,3373.4,5299.46
2850919223495890944,2020-07,6254.75,3875.29,1387.41,5534.24,-1767.37,3532.09
2850919223495890944,2020-08,5241.82,2333.68,2349.08,1386.97,3870.25,7402.34
2850919223495890944,2020-09,1563.6,2551.8,611.94,5165.22,-5541.48,1860.86
2850919223495890944,2020-10,735.06,6883.18,3794.61,5517.63,-7871.14,-6010.28
2850919223495890944,2020-11,5733.09,0,2418.23,8709.14,-557.82,-6568.1
2850919223495890944,2020-12,5502.97,2888.49,828.86,2806.46,636.88,-5931.22
2851215655493073920,2020-01,430.57,0,1304.83,0,1735.4,1735.4
2851215655493073920,2020-02,0,1136.01,0,1244.32,-2380.33,-644.93
2851215655493073920,2020-04,2153.83,569.93,0,0,1583.9,938.97
2851215655493073920,2020-05,1810.45,0,4131.48,0,5941.93,6880.9
2851215655493073920,2020-06,108.16,666.15,0,0,-557.99,6322.91
2851215655493073920,2020-07,1377.4,0,0,2052.47,-675.07,5647.84
2851215655493073920,2020-08,599.17,2098.99,1314.44,3423.38,-3608.76,2039.08
2851215655493073920,2020-09,0,56.72,1698.89,0,1642.17,3681.25
2851215655493073920,2020-10,2437.41,78.72,0,3400.42,-1041.73,2639.52
2851215655493073920,2020-11,1383.36,0,0,1273.43,109.93,2749.45
2851215655493073920,2020-12,354.94,0,1878.64,480.34,1753.24,4502.69
2854964746486548480,2020-02,861.44,0,0,0,861.44,861.44
2854964746486548480,2020-05,209.89,499,743.25,0,454.14,1315.58
2854964746486548480,2020-06,1757.29,1583.08,0,0,174.21,1489.79
2854964746486548480,2020-07,354.04,0,0,0,354.04,1843.83
2854964746486548480,2020-08,572.6,2210.61,558.78,0,-1079.23,764.6
2854964746486548480,2020-09,0,112.59,0,1082.55,-1195.14,-430.54
2854964746486548480,2020-11,1373.7,0,454.58,1977.29,-149.01,-579.55
2854964746486548480,2020-12,0,526.8,0,0,-526.8,-1106.35
2859882723363792384,2020-01,5838.34,2509.98,1605.3,4073.38,860.28,860.28
2859882723363792384,2020-02,8660.18,1657.99,0,0,7002.19,7862.47
2859882723363792384,2020-03,0,1997.5,0,1007.14,-3004.64,4857.83
2859882723363792384,2020-04,5041.7,2495.11,3959.51,0,6506.1,11363.93
2859882723363792384,2020-05,1888.48,735.53,2805.64,658.36,3300.23,14664.16
2859882723363792384,2020-06,218.63,3410.44,2933.34,3631.39,-3889.86,10774.3
2859882723363792384,2020-07,4756.67,6850.56,2998.6,0,904.71,11679.01
2859882723363792384,2020-08,1162.29,1537.35,2412.91,3097.93,-1060.08,10618.93
2859882723363792384,2020-09,768.35,1878.26,1490.42,1749.7,-1369.19,9249.74
2859882723363792384,2020-10,0,2207.15,0,3079.46,-5286.61,3963.13
2859882723363792384,2020-11,0,906.83,0,1422.96,-2329.79,1633.34
2859882723363792384,2020-12,1889.06,1698.16,1020.45,1320.82,-109.47,1523.87
2859990409115161088,2020-01,894.95,1618.06,0,0,-723.11,-723.11
2859990409115161088,2020-03,1874.19,0,395.98,163.7,2106.47,1383.36
2859990409115161088,2020-05,2714.25,0,1428.68,0,4142.93,5526.29
2859990409115161088,2020-06,0,1225.46,0,964.8,-2190.26,3336.03
2859990409115161088,2020-07,0,2169.87,0,1659.94,-3829.81,-493.78
2859990409115161088,2020-08,0,2019.64,0,2942.31,-4961.95,-5455.73
2859990409115161088,2020-09,963.01,2044.33,1801.32,0,720,-4735.73
2859990409115161088,2020-10,834.42,2493.41,1353.26,186.02,-491.75,-5227.48
2859990409115161088,2020-12,740.3,0,0,944.26,-203.96,-5431.44
2861340736673216512,2020-01,2861.93,529.68,0,10344.2,-8011.95,-8011.95
2861340736673216512,2020-02,4041.55,1828.97,6828.21,4931.79,4109,-3902.95
2861340736673216512,2020-03,9968.18,1940.43,3159.58,5730.32,5457.01,1554.06
2861340736673216512,2020-04,7198.55,4236.93,3992.07,2759.96,4193.73,5747.79
2861340736673216512,2020-05,730.96,1653.62,1948.46,512.58,513.22,6261.01
2861340736673216512,2020-06,3583.19,4042.84,4095.75,881.3,2754.8,9015.81
2861340736673216512,2020-07,83.04,0,2525.72,4352.79,-1744.03,7271.78
2861340736673216512,2020-08,734.04,2744.8,4499.72,1530.74,958.22,8230
2861340736673216512,2020-09,5736.37,2265.03,4958.29,1050.14,7379.49,15609.49
2861340736673216512,2020-10,5852.97,1275.22,3050.72,2143.86,5484.61,21094.1
2861340736673216512,2020-11,7499.48,3570.14,3506.12,1710.26,5725.2,26819.3
2861340736673216512,2020-12,4211.1,5682.26,3035.41,6626.59,-5062.34,21756.96
2863764929602619392,2020-01,2923.9,94.28,5204.5,3233.86,4800.26,4800.26
2863764929602619392,2020-02,0,2808.32,5043.59,638.12,1597.15,6397.41
2863764929602619392,2020-03,1801.62,1675.12,3611.5,2697.73,1040.27,7437.68
2863764929602619392,2020-04,0,785.54,1328.48,220.08,322.86,7760.54
2863764929602619392,2020-05,929.36,2984.36,2366.09,3593.17,-3282.08,4478.46
2863764929602619392,2020-06,2729.68,1563.46,624.54,800.92,989.84,5468.3
2863764929602619392,2020-07,3684.32,0,2949.6,2382.48,4251.44,9719.74
2863764929602619392,2020-08,3125.67,1530.59,1872.55,2589.77,877.86,10597.6
2863764929602619392,2020-09,4453.05,1376.36,3876.91,617.19,6336.41,16934.01
2863764929602619392,2020-10,3938.36,4084.26,3635.99,3553.44,-63.35,16870.66
2863764929602619392,2020-11,0,1522.77,4306.98,1401.11,1383.1,18253.76
2863764929602619392,2020-12,5150.88,6102.18,1891.5,1012.45,-72.25,18181.51
2863956601348310528,2020-01,1480.75,1879.45,0,0,-398.7,-398.7
2863956601348310528,2020-03,0,1940.27,3331.86,1577.85,-186.26,-584.96
2863956601348310528,2020-04,1045.71,1909.96,1852.74,430.03,558.46,-26.5
2863956601348310528,2020-05,0,469.71,0,1325.13,-1794.84,-1821.34
2863956601348310528,2020-06,0,592.82,0,1500.64,-2093.46,-3914.8
2863956601348310528,2020-08,2106.35,418.03,2150.22,2498.36,1340.18,-2574.62
2863956601348310528,2020-10,56.04,546.18,0,0,-490.14,-3064.76
2863956601348310528,2020-11,1420.87,407.5,0,1614.08,-600.71,-3665.47
2863956601348310528,2020-12,761.4,0,1908.94,1677.17,993.17,-2672.3
2864570094415047168,2020-01,4343.16,2962.37,2364.99,859.05,2886.73,2886.73
2864570094415047168,2020-02,1118.47,2707.96,0,1654.37,-3243.86,-357.13
2864570094415047168,2020-03,0,740.3,2864.96,2134.04,-9.38,-366.51
2864570094415047168,2020-04,421.45,2581.57,1892.02,346.63,-614.73,-981.24
2864570094415047168,2020-05,2108.25,1021.25,3493.67,4781.32,-200.65,-1181.89
2864570094415047168,2020-06,2630.91,398.64,0,1414.61,817.66,-364.23
2864570094415047168,2020-07,1543.36,1953.78,3222.75,4178.51,-1366.18,-1730.41
2864570094415047168,2020-08,1766.19,2888.64,598.1,1617.92,-2142.27,-3872.68
2864570094415047168,2020-09,450.9,0,7653.5,810.98,7293.42,3420.74
2864570094415047168,2020-10,3797.87,5010.88,0,3672.75,-4885.76,-1465.02
2864570094415047168,2020-11,436.52,0,2497.69,1019.34,1914.87,449.85
2864570094415047168,2020-12,705.42,0,0,1717.3,-1011.88,-562.03
2867901949121255936,2020-01,1753.03,4474.94,1265.58,3602.24,-5058.57,-5058.57
2867901949121255936,2020-02,5232.31,1673.93,7651.81,2267.21,8942.98,3884.41
2867901949121255936,2020-03,2737.25,2698.5,6203.55,4190.7,2051.6,5936.01
2867901949121255936,2020-04,5750.29,2732.17,7366.68,8955.76,1429.04,7365.05
2867901949121255936,2020-05,59.73,4916.26,5493.82,1487.54,-850.25,6514.8
2867901949121255936,2020-06,6023.27,1909.02,3963.93,3627.85,4450.33,10965.13
2867901949121255936,2020-07,1437.78,5920.26,5492.14,4967.32,-3957.66,7007.47
2867901949121255936,2020-08,9872.71,6530.5,4753.29,5853.39,2242.11,9249.58
2867901949121255936,2020-09,8868.96,6561.04,6515.5,5808.1,3015.32,12264.9
2867901949121255936,2020-10,3916.81,5811.53,1880.7,2897.48,-2911.5,9353.4
2867901949121255936,2020-11,6363.38,2129.76,2063.66,2935.27,3362.01,12715.41
2867901949121255936,2020-12,1846.37,5151.65,2143.21,5042.93,-6205,6510.41
2868349137478836224,2020-01,1971.54,1311.48,742.05,1502.33,-100.22,-100.22
2868349137478836224,2020-04,0,2170.82,0,1880.79,-4051.61,-4151.83
2868349137478836224,2020-05,1763.31,0,0,0,1763.31,-2388.52
2868349137478836224,2020-06,0,1298.76,0,1164.63,-2463.39,-4851.91
2868349137478836224,2020-07,2615.69,0,0,1671.23,944.46,-3907.45
2868349137478836224,2020-09,0,1543.86,22.67,0,-1521.19,-5428.64
2868349137478836224,2020-10,1997.58,0,0,0,1997.58,-3431.06
2868349137478836224,2020-11,0,310.05,0,0,-310.05,-3741.11
2869522898744424960,2020-01,1932.44,3410.18,5495.82,1965.08,2053,2053
2869522898744424960,2020-02,932.98,3195.03,5090.71,2984.97,-156.31,1896.69
2869522898744424960,2020-03,4928.05,5162.03,184.49,3884.04,-3933.53,-2036.84
2869522898744424960,2020-04,1360.33,6879.55,2960.78,3061.94,-5620.38,-7657.22
2869522898744424960,2020-05,2176.71,3624.19,5502.18,2375.13,1679.57,-5977.65
2869522898744424960,2020-06,2665.87,3226.52,2846.4,4890.61,-2604.86,-8582.51
2869522898744424960,2020-07,2467.05,3332.91,2250.24,5362.16,-3977.78,-12560.29
2869522898744424960,2020-08,1250.43,3539.24,3283.19,0,994.38,-11565.91
2869522898744424960,2020-09,144.08,335.04,1076.52,3019.97,-2134.41,-13700.32
2869522898744424960,2020-10,4992.47,2481.85,2678.84,3070.48,2118.98,-11581.34
2869522898744424960,2020-11,2078.23,6816.39,4712.72,859.31,-884.75,-12466.09
2869522898744424960,2020-12,3310.83,3641.45,1900.44,1850.72,-280.9,-12746.99
2870303810701592064,2020-01,0,956.27,1398.8,0,442.53,442.53
2870303810701592064,2020-02,0,345.8,1398.84,3742.48,-2689.44,-2246.91
2870303810701592064,2020-04,0,1091.69,0,0,-1091.69,-3338.6
2870303810701592064,2020-05,2863.24,238.71,0,2907.94,-283.41,-3622.01
2870303810701592064,2020-06,359.91,1544.01,1735.52,0,551.42,-3070.59
2870303810701592064,2020-07,771.76,0,0,1328.8,-557.04,-3627.63
2870303810701592064,2020-08,0,1318.88,0,0,-1318.88,-4946.51
2870303810701592064,2020-09,0,802.23,1232.49,1950.74,-1520.48,-6466.99
2870303810701592064,2020-10,0,1119.95,1166.01,15.66,30.4,-6436.59
2870303810701592064,2020-11,0,3207.47,0,0,-3207.47,-9644.06
2872204555558592000,2020-01,3592.7,3801.59,6928.97,1846.16,4873.92,4873.92
2872204555558592000,2020-02,3190.14,6012.65,6414.51,0,3592,8465.92
2872204555558592000,2020-03,1211.91,2370.65,4207.21,6226.53,-3178.06,5287.86
2872204555558592000,2020-04,4014.13,4756.48,5760.72,2594.27,2424.1,7711.96
2872204555558592000,2020-05,0,7361.98,3781.17,6620.48,-10201.29,-2489.33
2872204555558592000,2020-06,5506.51,7910.3,2809.97,2789.01,-2382.83,-4872.16
2872204555558592000,2020-07,4850.8,1495.6,3862.48,4363.83,2853.85,-2018.31
2872204555558592000,2020-08,103.45,7278.76,11200.99,5000.87,-975.19,-2993.5
2872204555558592000,2020-09,2253.97,1584.75,5361.17,1816.51,4213.88,1220.38
2872204555558592000,2020-10,2985.77,3402.74,2257.33,1298.99,541.37,1761.75
2872204555558592000,2020-11,6414.55,3543.89,2833.33,6136.41,-432.42,1329.33
2872204555558592000,2020-12,4583.8,4899.86,2090.51,0,1774.45,3103.78
2872575613465949184,2020-01,248.47,0,0,1766.42,-1517.95,-1517.95
2872575613465949184,2020-02,3696.98,0,1559.86,1649.04,3607.8,2089.85
2872575613465949184,2020-03,162.95,1961.68,0,1936.07,-3734.8,-1644.95
2872575613465949184,2020-04,1432.6,2193.54,0,0,-760.94,-2405.89
2872575613465949184,2020-05,0,1239.56,3010.25,0,1770.69,-635.2
2872575613465949184,2020-06,859.48,1636.74,0,0,-777.26,-1412.46
2872575613465949184,2020-07,86.27,198.73,1035.03,3141.16,-2218.59,-3631.05
2872575613465949184,2020-09,1566.85,541.06,3387.7,1762.29,2651.2,-979.85
2872575613465949184,2020-10,1390.88,221.23,1488.21,0,2657.86,1678.01
2872575613465949184,2020-11,918.26,2834.26,1568.53,1085.55,-1433.02,244.99
2872575613465949184,2020-12,1704.32,0,0,941.71,762.61,1007.6
2875083272635229696,2020-01,5521.83,5023.42,3136.46,8533.5,-4898.63,-4898.63
2875083272635229696,2020-02,4725.68,3606.18,976.41,2674.63,-578.72,-5477.35
2875083272635229696,2020-03,3348.35,9597.39,5904.77,3555.82,-3900.09,-9377.44
2875083272635229696,2020-04,4127.83,10714.18,7727.17,4207.97,-3067.15,-12444.59
2875083272635229696,2020-05,2199.27,3838.44,16.25,4424.65,-6047.57,-18492.16
2875083272635229696,2020-06,4747.57,3124.2,5851.64,3907.67,3567.34,-14924.82
2875083272635229696,2020-07,4084.43,4424.91,7042.28,5169.49,1532.31,-13392.51
2875083272635229696,2020-08,3950.12,4838.04,6303.18,3012.79,2402.47,-10990.04
2875083272635229696,2020-09,3146.8,4278.75,7205.33,5180.76,892.62,-10097.42
2875083272635229696,2020-10,2671.98,1587.24,2301.67,905.04,2481.37,-7616.05
2875083272635229696,2020-11,2315.45,4185.14,2217.4,3526.37,-3178.66,-10794.71
2875083272635229696,2020-12,4444.84,10267.84,6907.18,5171.12,-4086.94,-14881.65
2875562506256574464,2020-01,442.1,1347.98,1412.85,0,506.97,506.97
2875562506256574464,2020-02,1993.08,2882.12,1117.47,0,228.43,735.4
2875562506256574464,2020-03,1475.74,2631.23,2108.98,0,953.49,1688.89
2875562506256574464,2020-04,1361.64,860.79,262.81,0,763.66,2452.55
2875562506256574464,2020-05,0,288.03,0,0,-288.03,2164.52
2875562506256574464,2020-06,1239.56,1479.97,0,990.74,-1231.15,933.37
2875562506256574464,2020-07,1462.49,1577.1,1038.76,2030.95,-1106.8,-173.43
2875562506256574464,2020-08,323.06,0,5321.59,0,5644.65,5471.22
2875562506256574464,2020-09,2938.28,1729.96,0,0,1208.32,6679.54
2875562506256574464,2020-10,2825.17,1418.55,1083.85,0,2490.47,9170.01
2875562506256574464,2020-11,615.09,0,2167.79,1120.09,1662.79,10832.8
2875562506256574464,2020-12,716.07,295.93,0,624.09,-203.95,10628.85
2876178840448966144,2020-01,1329.98,2080.63,0,4715.5,-5466.15,-5466.15
2876178840448966144,2020-02,1736.66,5742.47,3692.56,143.32,-456.57,-5922.72
2876178840448966144,2020-03,2199.28,4196.04,3211.87,2294.66,-1079.55,-7002.27
2876178840448966144,2020-04,5489.59,3562.09,1853.36,3039.08,741.78,-6260.49
2876178840448966144,2020-05,1722.09,5541.66,0,2263.56,-6083.13,-12343.62
2876178840448966144,2020-06,6456.65,1492.29,2795.61,4027.05,3732.92,-8610.7
2876178840448966144,2020-07,566.2,3868.72,3189.86,4662.12,-4774.78,-13385.48
2876178840448966144,2020-08,95.94,1965.86,3298.65,8368.97,-6940.24,-20325.72
2876178840448966144,2020-09,2515.05,4290.59,1059.28,3858.76,-4575.02,-24900.74
2876178840448966144,2020-10,3276.21,3118.88,325.76,0,483.09,-24417.65
2876178840448966144,2020-11,1171.38,5135.26,1422.14,3224.84,-5766.58,-30184.23
2876178840448966144,2020-12,2171.01,4474.91,2143.23,4078.06,-4238.73,-34422.96
2877145771397578752,2020-01,5747.15,6363.95,450.69,169.73,-335.84,-335.84
2877145771397578752,2020-02,632.46,3768.45,4439.29,5880.54,-4577.24,-4913.08
2877145771397578752,2020-03,1698.48,7532.64,2569.79,1992.07,-5256.44,-10169.52
2877145771397578752,2020-04,5223.48,1897.11,4317.85,3943.27,3700.95,-6468.57
2877145771397578752,2020-05,4415.36,5371.1,2240.23,3220.25,-1935.76,-8404.33
2877145771397578752,2020-06,12805.77,2944.33,3208.28,497.81,12571.91,4167.58
2877145771397578752,2020-07,1841.45,3043.93,3544.26,1465.26,876.52,5044.1
2877145771397578752,2020-08,4466.01,2626.54,4366.57,8305.12,-2099.08,2945.02
2877145771397578752,2020-09,1650.3,2086.83,1401.15,4653.45,-3688.83,-743.81
2877145771397578752,2020-10,4110.99,1238.09,4384.6,5155.92,2101.58,1357.77
2877145771397578752,2020-11,7244.77,4449.7,5802.46,5520.97,3076.56,4434.33
2877145771397578752,2020-12,3320.39,4067.2,578.41,4930.25,-5098.65,-664.32
2879287629711667712,2020-01,2876.37,2370.73,3264.47,2611.68,1158.43,1158.43
2879287629711667712,2020-02,914.71,4193.83,726.67,4133.31,-6685.76,-5527.33
2879287629711667712,2020-03,3724.98,1858.79,0,2703.87,-837.68,-6365.01
2879287629711667712,2020-04,0,2205.26,2189.03,1829.73,-1845.96,-8210.97
2879287629711667712,2020-05,5464.02,0,3687.54,3865.26,5286.3,-2924.67
2879287629711667712,2020-06,1649.33,4673.98,1727.04,4303.03,-5600.64,-8525.31
2879287629711667712,2020-07,597.81,1915.25,259.01,0,-1058.43,-9583.74
2879287629711667712,2020-08,3703.13,3801.6,1644.87,2720.83,-1174.43,-10758.17
2879287629711667712,2020-09,1045.68,2493.65,514.87,0,-933.1,-11691.27
2879287629711667712,2020-10,0,2354.84,3582.22,5515.37,-4287.99,-15979.26
2879287629711667712,2020-11,1015.23,1386.43,2477.44,2776.37,-670.13,-16649.39
2879287629711667712,2020-12,3257.43,1596.36,2272.71,3374.7,559.08,-16090.31
2879540758088751104,2020-01,2202.76,4064.81,0,4100.29,-5962.34,-5962.34
2879540758088751104,2020-02,3195.23,1931.25,9805.04,6910.22,4158.8,-1803.54
2879540758088751104,2020-03,6098.03,7881.72,3887.06,220.74,1882.63,79.09
2879540758088751104,2020-04,5383.74,1108.07,3110.46,3895.34,3490.79,3569.88
2879540758088751104,2020-05,10411.75,5282.53,2706.28,8800.33,-964.83,2605.05
2879540758088751104,2020-06,2565.79,3598.96,2022.79,2806.28,-1816.66,788.39
2879540758088751104,2020-07,6789.15,5638.01,2530.92,2458.11,1223.95,2012.34
2879540758088751104,2020-08,67.84,5229.69,4171.86,3950.53,-4940.52,-2928.18
2879540758088751104,2020-09,5271.57,2737.12,7764.88,4044.84,6254.49,3326.31
2879540758088751104,2020-10,5306.41,7645.45,2589.31,1222.79,-972.52,2353.79
2879540758088751104,2020-11,4211.47,3221.55,7189.01,4095.88,4083.05,6436.84
2879540758088751104,2020-12,4953.43,2722.68,992.5,1028.34,2194.91,8631.75
2880452409563950080,2020-01,1487.43,2946.23,3511.85,3011.37,-958.32,-958.32
2880452409563950080,2020-02,2839.44,3503.16,1229.45,7616.41,-7050.68,-8009
2880452409563950080,2020-03,4845.84,9907.62,2997.36,1960.01,-4024.43,-12033.43
2880452409563950080,2020-04,3943.53,4501.27,476.35,2845.91,-2927.3,-14960.73
2880452409563950080,2020-05,3566.63,7782.19,3322.48,5433.15,-6326.23,-21286.96
2880452409563950080,2020-06,2328.98,5992.72,2824.31,2796.5,-3635.93,-24922.89
2880452409563950080,2020-07,1409.85,5067.98,978.87,4170.44,-6849.7,-31772.59
2880452409563950080,2020-08,6041.18,1673.9,2698.28,6164.1,901.46,-30871.13
2880452409563950080,2020-09,5849,5152.29,5479.27,3469.77,2706.21,-28164.92
2880452409563950080,2020-10,713.66,4033.67,2221.57,7634.53,-8732.97,-36897.89
2880452409563950080,2020-11,7699.3,2581.38,4036.61,1509.81,7644.72,-29253.17
2880452409563950080,2020-12,3433.03,4714.7,5647.49,4955.61,-589.79,-29842.96
2880519304445116928,2020-01,1643.03,8378.82,2343.28,11116.06,-15508.57,-15508.57
2880519304445116928,2020-02,2207.12,1601.09,2344.01,1966.68,983.36,-14525.21
2880519304445116928,2020-03,5077.11,4707.88,0,3731.42,-3362.19,-17887.4
2880519304445116928,2020-04,5682.85,4768.24,6190.52,1746.57,5358.56,-12528.84
2880519304445116928,2020-05,3438.08,11779.39,4351.58,10535.79,-14525.52,-27054.36
2880519304445116928,2020-06,5631.11,3734.4,2978.67,4574.97,300.41,-26753.95
2880519304445116928,2020-07,1564.67,2088.26,6076.2,4801.5,751.11,-26002.84
2880519304445116928,2020-08,5696.87,2313.46,2357.05,856.48,4883.98,-21118.86
2880519304445116928,2020-09,3381.92,4584.78,5991.84,0,4788.98,-16329.88
2880519304445116928,2020-10,1070.35,1882.48,2989.61,3085.12,-907.64,-17237.52
2880519304445116928,2020-11,0,152.48,3637.65,368.69,3116.48,-14121.04
2880519304445116928,2020-12,2314.36,5390.43,4342.19,3018.42,-1752.3,-15873.34
2881152242158676480,2020-01,3269.15,2985.84,1760.19,2878.67,-835.17,-835.17
2881152242158676480,2020-02,1892.35,2522.07,3492.71,3690.33,-827.34,-1662.51
2881152242158676480,2020-03,3529.3,1645.08,1187.68,2689.65,382.25,-1280.26
2881152242158676480,2020-04,0,5475.69,6777.34,2837.32,-1535.67,-2815.93
2881152242158676480,2020-05,3335.97,1515.41,5548.69,1915.65,5453.6,2637.67
2881152242158676480,2020-06,2578.67,2799.57,1670.33,0,1449.43,4087.1
2881152242158676480,2020-07,3676.9,0,1675.32,1298.45,4053.77,8140.87
2881152242158676480,2020-08,2943.06,2359.4,2638.27,4449.73,-1227.8,6913.07
2881152242158676480,2020-09,4708.05,1618.21,0,2787.27,302.57,7215.64
2881152242158676480,2020-10,974.96,3431.12,111.3,1478.2,-3823.06,3392.58
2881152242158676480,2020-11,0,1458.51,4689.44,3207.42,23.51,3416.09
2881152242158676480,2020-12,3493.03,4756.92,2631.12,5137.47,-3770.24,-354.15
2882344179826626048,2020-01,872.79,0,1040.7,2910.27,-996.78,-996.78
2882344179826626048,2020-02,0,1765.35,1624.95,3057.85,-3198.25,-4195.03
2882344179826626048,2020-03,2567.24,0,2073.17,2935.12,1705.29,-2489.74
2882344179826626048,2020-04,1987.18,1487.39,786.88,0,1286.67,-1203.07
2882344179826626048,2020-05,1497.21,2030.85,0,2116.35,-2649.99,-3853.06
2882344179826626048,2020-06,0,2123.32,1751.15,941.04,-1313.21,-5166.27
2882344179826626048,2020-07,1188.36,216.04,2941.89,1844.27,2069.94,-3096.33
2882344179826626048,2020-08,0,223.43,5718.61,2935.88,2559.3,-537.03
2882344179826626048,2020-09,222.48,4410.1,4131.29,1093.31,-1149.64,-1686.67
2882344179826626048,2020-10,534.2,0,3627.76,2760.29,1401.67,-285
2882344179826626048,2020-11,0,2563.66,2293.54,1688.93,-1959.05,-2244.05
2882344179826626048,2020-12,3675.78,0,2227.78,747.91,5155.65,2911.6
2883702203731553792,2020-01,661.71,1696.92,3929.67,3567.21,-672.75,-672.75
2883702203731553792,2020-02,5220.96,5358.33,2392.19,534.94,1719.88,1047.13
2883702203731553792,2020-03,5585.45,3089.26,1463.16,4158.13,-198.78,848.35
2883702203731553792,2020-04,4243.3,1959.33,1901.94,2193.63,1992.28,2840.63
2883702203731553792,2020-05,5762.85,4386.94,1565.89,175.49,2766.31,5606.94
2883702203731553792,2020-06,6278.57,3734.91,3990.34,5919.73,614.27,6221.21
2883702203731553792,2020-07,3806.9,4266.93,1949.09,11147.39,-9658.33,-3437.12
2883702203731553792,2020-08,3915.68,1532.09,4984.81,4136.11,3232.29,-204.83
2883702203731553792,2020-09,273.3,628.11,7936.64,5065.41,2516.42,2311.59
2883702203731553792,2020-10,2635.4,4519.23,1632.79,2139.12,-2390.16,-78.57
2883702203731553792,2020-11,2277,5686.31,347.1,126.1,-3188.31,-3266.88
2883702203731553792,2020-12,7954.89,698.63,1656.71,914.77,7998.2,4731.32
2884148428793431040,2020-02,268.58,0,0,432.66,-164.08,-164.08
2884148428793431040,2020-03,484.69,0,0,0,484.69,320.61
2885338146834190336,2020-01,3593.6,2486,4448.98,7148.76,-1592.18,-1592.18
2885338146834190336,2020-02,4453.03,3165.72,3515.04,5652.61,-850.26,-2442.44
2885338146834190336,2020-03,4647.86,3223.46,10162.84,1993.73,9593.51,7151.07
2885338146834190336,2020-04,8251.05,1521.17,4729.14,0,11459.02,18610.09
2885338146834190336,2020-05,3933.81,8013.34,1860.51,7558.86,-9777.88,8832.21
2885338146834190336,2020-06,6904.98,4566.8,1753.23,3417.91,673.5,9505.71
2885338146834190336,2020-07,3038.53,1774.46,2430.03,3475.43,218.67,9724.38
2885338146834190336,2020-08,2405.1,3083.73,1555.15,187.52,689,10413.38
2885338146834190336,2020-09,2964.04,3356.68,5022.19,3742.63,886.92,11300.3
2885338146834190336,2020-10,4130.95,5870.1,5529.68,4898.52,-1107.99,10192.31
2885338146834190336,2020-11,5516.18,2411.42,1765.66,1773.94,3096.48,13288.79
2885338146834190336,2020-12,610.28,1540.71,2634.12,5226.35,-3522.66,9766.13
2886060822663130112,2020-02,0,278.25,0,0,-278.25,-278.25
2886060822663130112,2020-06,0,510.03,0,0,-510.03,-788.28
2886060822663130112,2020-07,3204.36,2287.34,0,0,917.02,128.74
2886060822663130112,2020-09,150.02,114.07,0,1953.53,-1917.58,-1788.84
2886412803258771968,2020-01,1980.43,1844.74,3486.74,2549.41,1073.02,1073.02
2886412803258771968,2020-02,4609.6,4670.44,0,2977.53,-3038.37,-1965.35
2886412803258771968,2020-03,5385.2,1925.3,1344.71,3494.9,1309.71,-655.64
2886412803258771968,2020-04,3461.81,5137.05,5623.8,3795.96,152.6,-503.04
2886412803258771968,2020-05,668.31,7001.89,3329.11,461.23,-3465.7,-3968.74
2886412803258771968,2020-06,7424.08,0,1553.28,3688.87,5288.49,1319.75
2886412803258771968,2020-07,2690.02,3756.62,7761.12,1259.25,5435.27,6755.02
2886412803258771968,2020-08,1791.57,625.16,4191.32,3265.1,2092.63,8847.65
2886412803258771968,2020-09,1624.86,2988.84,7655.17,3908.45,2382.74,11230.39
2886412803258771968,2020-10,3516.03,4094.68,2514.88,5388.45,-3452.22,7778.17
2886412803258771968,2020-11,3396.41,1556.96,6974.85,2130.18,6684.12,14462.29
2886412803258771968,2020-12,5511.17,4250.43,4212.05,1814.98,3657.81,18120.1
2886912744785149952,2020-01,6766.82,0,4189.22,1092.42,9863.62,9863.62
2886912744785149952,2020-02,1939.12,3866.52,826.16,3230.66,-4331.9,5531.72
2886912744785149952,2020-03,887.61,0,3278.65,2424.19,1742.07,7273.79
2886912744785149952,2020-04,3365.71,895.76,281.36,1269.52,1481.79,8755.58
2886912744785149952,2020-05,1843.42,0,1962.46,317.91,3487.97,12243.55
2886912744785149952,2020-06,3404.12,1022.01,0,0,2382.11,14625.66
2886912744785149952,2020-07,1464.83,662.93,1621.69,3187.22,-763.63,13862.03
2886912744785149952,2020-08,2949.73,0,470.41,958.95,2461.19,16323.22
2886912744785149952,2020-10,361.33,901.87,1566.56,906.36,119.66,16442.88
2886912744785149952,2020-11,1603.22,0,0,970.57,632.65,17075.53
2886912744785149952,2020-12,807.86,0,1495.93,4369.36,-2065.57,15009.96
2887333138095042048,2020-01,5604.68,1472.24,797.87,3616.69,1313.62,1313.62
2887333138095042048,2020-02,3164,902.69,1794.05,1607.18,2448.18,3761.8
2887333138095042048,2020-03,7539.96,1175.92,1832.37,2581.16,5615.25,9377.05
2887333138095042048,2020-04,3917.39,5266.78,2576.72,3676.08,-2448.75,6928.3
2887333138095042048,2020-05,2807.39,5877.65,2959.28,3317.34,-3428.32,3499.98
2887333138095042048,2020-06,2979.83,2009.48,2164.83,726.64,2408.54,5908.52
2887333138095042048,2020-07,1430.55,1553.27,2415.34,1337.17,955.45,6863.97
2887333138095042048,2020-08,8751.25,4479.78,1994.79,0,6266.26,13130.23
2887333138095042048,2020-09,2476.79,2218.9,2172.68,2112.57,318,13448.23
2887333138095042048,2020-10,6055.64,1236.59,1216.26,880.67,5154.64,18602.87
2887333138095042048,2020-11,2897.23,970.35,3521.85,1834.56,3614.17,22217.04
2887333138095042048,2020-12,2614.43,2118.27,4445.46,3322.56,1619.06,23836.1
2888693934163649536,2020-01,4947.23,3572.75,6077.4,1719.36,5732.52,5732.52
2888693934163649536,2020-02,257.75,1565.44,2163.29,5066.77,-4211.17,1521.35
2888693934163649536,2020-03,2401.71,2817.06,2541.97,1540.26,586.36,2107.71
2888693934163649536,2020-04,2600.22,3025.77,2249.16,2111.07,-287.46,1820.25
2888693934163649536,2020-05,1729.85,6321.91,1915.96,1630.33,-4306.43,-2486.18
2888693934163649536,2020-06,2998.28,6269.07,4592.83,1485.03,-162.99,-2649.17
2888693934163649536,2020-07,1868.9,4893.61,3240.2,0,215.49,-2433.68
2888693934163649536,2020-08,0,1721.42,4082.15,798.64,1562.09,-871.59
2888693934163649536,2020-09,4154.29,981.92,292.2,3980.83,-516.26,-1387.85
2888693934163649536,2020-10,5462.02,6465.78,1200.89,1016.51,-819.38,-2207.23
2888693934163649536,2020-11,825.88,5360.28,2596.54,1607.74,-3545.6,-5752.83
2888693934163649536,2020-12,4421.64,1342.63,1740.41,3777.36,1042.06,-4710.77
2889243691415848448,2020-01,2245.56,8812.72,7250.55,2128.2,-1444.81,-1444.81
2889243691415848448,2020-02,9451.9,11363.86,3607.37,3182.42,-1487.01,-2931.82
2889243691415848448,2020-03,12155.1,177.49,7548.48,2326.47,17199.62,14267.8
2889243691415848448,2020-04,6320.61,1225.94,5013.94,7408.44,2700.17,16967.97
2889243691415848448,2020-05,5459.73,3076.82,6520.34,2155.21,6748.04,23716.01
2889243691415848448,2020-06,1281.53,1466.94,3534.57,4414.7,-1065.54,22650.47
2889243691415848448,2020-07,3278.39,7473.09,6612.46,2861.42,-443.66,22206.81
2889243691415848448,2020-08,4066.74,5102.88,5943.09,5020.24,-113.29,22093.52
2889243691415848448,2020-09,9211,2510.39,6573.11,4164.15,9109.57,31203.09
2889243691415848448,2020-10,4004.76,4247.94,2133.6,4609.73,-2719.31,28483.78
2889243691415848448,2020-11,4857.75,5846.28,3458.57,3059.97,-589.93,27893.85
2889243691415848448,2020-12,4164.64,5710.53,5364.02,7335.68,-3517.55,24376.3
2889469352190131200,2020-01,2613.87,4257.03,1446.48,8914.2,-9110.88,-9110.88
2889469352190131200,2020-02,4996.73,3199.91,2690.42,1895.42,2591.82,-6519.06
2889469352190131200,2020-03,1295.78,9334.61,3538.88,9183.33,-13683.28,-20202.34
2889469352190131200,2020-04,3331.52,3941,1994,3630.75,-2246.23,-22448.57
2889469352190131200,2020-05,2216.12,1785.61,2540.98,2029.68,941.81,-21506.76
2889469352190131200,2020-06,2669.24,2278.2,5047.06,1992.94,3445.16,-18061.6
2889469352190131200,2020-07,1710.71,3935.63,2158.09,9480.49,-9547.32,-27608.92
2889469352190131200,2020-08,642.78,3651.56,3424.79,4843.18,-4427.17,-32036.09
2889469352190131200,2020-09,3218.69,2990.21,4148.9,8548.4,-4171.02,-36207.11
2889469352190131200,2020-10,3532.85,2009.78,1028.86,701.63,1850.3,-34356.81
2889469352190131200,2020-11,6085.26,3154.73,4131.28,2141.89,4919.92,-29436.89
2889469352190131200,2020-12,4671.52,5889.87,6424.82,0,5206.47,-24230.42
2889822362177790976,2020-01,2820.76,3562.61,10313.92,1542.04,8030.03,8030.03
2889822362177790976,2020-02,2007.4,1074.21,1671.12,4817.79,-2213.48,5816.55
2889822362177790976,2020-03,0,2380.06,3788.48,157.81,1250.61,7067.16
2889822362177790976,2020-04,3435.47,1213.02,1718.49,4649.5,-708.56,6358.6
2889822362177790976,2020-05,3660.62,137.42,4677.44,2151.35,6049.29,12407.89
2889822362177790976,2020-06,0,4435.05,7573.8,2328.32,810.43,13218.32
2889822362177790976,2020-07,0,657.78,1516.61,1658.2,-799.37,12418.95
2889822362177790976,2020-08,0,1967.66,1275.25,2147.52,-2839.93,9579.02
2889822362177790976,2020-09,3909.8,2096.62,0,3556.22,-1743.04,7835.98
2889822362177790976,2020-10,447.18,4575.41,0,6269.84,-10398.07,-2562.09
2889822362177790976,2020-11,1203.62,806.28,739.1,0,1136.44,-1425.65
2889822362177790976,2020-12,1665.83,2156.13,4253.48,176.02,3587.16,2161.51
2890039446909100544,2020-01,3254.67,3806.28,223.15,5833.53,-6161.99,-6161.99
2890039446909100544,2020-02,2942.19,6109.9,2177.47,4601.2,-5591.44,-11753.43
2890039446909100544,2020-03,5315.94,1621.06,0,4712.88,-1018,-12771.43
2890039446909100544,2020-04,2770.56,3197.27,3216.75,0,2790.04,-9981.39
2890039446909100544,2020-05,6095,7888.35,2982.02,2199.18,-1010.51,-10991.9
2890039446909100544,2020-06,6012.54,2288.49,1650.73,1598.17,3776.61,-7215.29
2890039446909100544,2020-07,3380.67,2238.91,5775.33,5387.84,1529.25,-5686.04
2890039446909100544,2020-08,4753.53,6506.57,3930.93,4571.14,-2393.25,-8079.29
2890039446909100544,2020-09,3701.23,3797.12,1804.57,607.14,1101.54,-6977.75
2890039446909100544,2020-10,3554.67,4329.75,835.32,5869.92,-5809.68,-12787.43
2890039446909100544,2020-11,3358.8,5364.83,3899.45,3186.58,-1293.16,-14080.59
2890039446909100544,2020-12,2103.15,3634.8,689.8,1283.56,-2125.41,-16206
2891463124435300352,2020-01,287.24,1546.53,0,0,-1259.29,-1259.29
2891463124435300352,2020-02,576.99,0,436.55,0,1013.54,-245.75
2891463124435300352,2020-03,2124.85,1847.8,270.42,58.96,488.51,242.76
2891463124435300352,2020-04,1624.05,1620.74,0,0,3.31,246.07
2891463124435300352,2020-05,569.42,0,2376.73,2292.48,653.67,899.74
2891463124435300352,2020-06,1657.85,0,0,1442.39,215.46,1115.2
2891463124435300352,2020-07,0,220.89,1611.84,745.91,645.04,1760.24
2891463124435300352,2020-09,0,538.74,567.86,3228.78,-3199.66,-1439.42
2891463124435300352,2020-10,0,140.78,1114.59,0,973.81,-465.61
2891463124435300352,2020-11,0,2258.36,2395.95,0,137.59,-328.02
2891463124435300352,2020-12,391.47,1728,1643.05,0,306.52,-21.5
2891560484195500032,2020-01,1103.1,1248.22,0,413.34,-558.46,-558.46
2891560484195500032,2020-02,971.09,0,0,239.58,731.51,173.05
2891560484195500032,2020-04,1582.36,1866.6,2929.27,1125.37,1519.66,1692.71
2891560484195500032,2020-06,1414.45,3425.55,1827.56,475.52,-659.06,1033.65
2891560484195500032,2020-07,1056.6,1408.12,427.45,0,75.93,1109.58
2891560484195500032,2020-08,1120.66,2339.72,843.66,0,-375.4,734.18
2891560484195500032,2020-09,0,1200.86,4080.07,2151.54,727.67,1461.85
2891560484195500032,2020-11,58.42,0,1241.65,0,1300.07,2761.92
2891560484195500032,2020-12,1567.17,0,466.68,0,2033.85,4795.77
2892444110903968768,2020-01,5090.47,2468.62,2972.78,1175.84,4418.79,4418.79
2892444110903968768,2020-02,1940.92,1721.89,2211.24,1252.11,1178.16,5596.95
2892444110903968768,2020-03,1338.79,1104.45,376.14,1198.81,-588.33,5008.62
2892444110903968768,2020-04,0,4955.3,0,0,-4955.3,53.32
2892444110903968768,2020-05,2848.26,0,0,0,2848.26,2901.58
2892444110903968768,2020-06,1344.96,3725.23,254.54,0,-2125.73,775.85
2892444110903968768,2020-07,0,696.82,0,0,-696.82,79.03
2892444110903968768,2020-08,1085.43,1732.25,384.97,54.98,-316.83,-237.8
2892444110903968768,2020-09,0,66.75,0,0,-66.75,-304.55
2892444110903968768,2020-10,1370.75,455.75,0,3044.89,-2129.89,-2434.44
2892444110903968768,2020-11,0,1076.4,581.45,1444.47,-1939.42,-4373.86
2892444110903968768,2020-12,699.98,2706.24,904.24,2952.26,-4054.28,-8428.14
2892909762270302720,2020-01,0,4225.08,3524.76,8135.21,-8835.53,-8835.53
2892909762270302720,2020-02,3633.77,2099.21,2746.64,2978.04,1303.16,-7532.37
2892909762270302720,2020-03,5003.54,5252.72,10064.25,5829.73,3985.34,-3547.03
2892909762270302720,2020-04,1943.94,1974.39,2799.07,905.2,1863.42,-1683.61
2892909762270302720,2020-05,4476.91,1049.86,2784.63,5728.51,483.17,-1200.44
2892909762270302720,2020-06,982.59,9319.63,5110.84,3408.24,-6634.44,-7834.88
2892909762270302720,2020-07,3083.18,4734.06,1991.17,1467.25,-1126.96,-8961.84
2892909762270302720,2020-08,6588.58,3477.43,5132.61,5592.52,2651.24,-6310.6
2892909762270302720,2020-09,1605.31,1236.96,1605.35,7411.72,-5438.02,-11748.62
2892909762270302720,2020-10,5740.59,4413.92,2218.08,4161.35,-616.6,-12365.22
2892909762270302720,2020-11,4998.94,5147.75,263.31,4752.98,-4638.48,-17003.7
2892909762270302720,2020-12,2721.75,2746.82,933.18,5424.07,-4515.96,-21519.66
2892979135826657280,2020-01,1988.28,5644.34,3172.95,3478.11,-3961.22,-3961.22
2892979135826657280,2020-02,2742.46,1457.98,7056.32,5008.72,3332.08,-629.14
2892979135826657280,2020-03,4514.73,3057.58,5459.46,7110.56,-193.95,-823.09
2892979135826657280,2020-04,4410.44,3203.45,1795.3,501.26,2501.03,1677.94
2892979135826657280,2020-05,2311.29,3131.16,4333.36,6318.85,-2805.36,-1127.42
2892979135826657280,2020-06,5608.66,5987.34,4500.93,1784.78,2337.47,1210.05
2892979135826657280,2020-07,3937.04,8032.15,3698.32,4577.57,-4974.36,-3764.31
2892979135826657280,2020-08,501.21,4701.61,827.54,2365.72,-5738.58,-9502.89
2892979135826657280,2020-09,7458.12,4397.04,4221.39,1071.66,6210.81,-3292.08
2892979135826657280,2020-10,2308.01,1879.17,8874.03,4077.63,5225.24,1933.16
2892979135826657280,2020-11,1622.04,7899.48,3542.26,2053.29,-4788.47,-2855.31
2892979135826657280,2020-12,2144.41,3846.46,5899.01,2345.7,1851.26,-1004.05
2893803659291762176,2020-01,1200.88,0,0,1997.59,-796.71,-796.71
2893803659291762176,2020-06,0,1469.17,0,0,-1469.17,-2265.88
2894674167087595520,2020-01,275.71,1293.89,1221.98,2740.18,-2536.38,-2536.38
2894674167087595520,2020-02,3246.84,1422.57,0,3512.35,-1688.08,-4224.46
2894674167087595520,2020-03,3501.47,2780.95,1496.01,2570.97,-354.44,-4578.9
2894674167087595520,2020-04,1624.46,4110.23,1697.47,2236.13,-3024.43,-7603.33
2894674167087595520,2020-05,3669.12,3187.84,0,2993.98,-2512.7,-10116.03
2894674167087595520,2020-06,783.9,0,5391.17,6066.79,108.28,-10007.75
2894674167087595520,2020-08,3915.08,1453.75,0,380.22,2081.11,-7926.64
2894674167087595520,2020-09,0,2977.84,1848.54,1603.66,-2732.96,-10659.6
2894674167087595520,2020-10,4029,2348.64,0,2341.29,-660.93,-11320.53
2894674167087595520,2020-11,0,378.56,3620.84,361.72,2880.56,-8439.97
2894674167087595520,2020-12,0,1496.32,2423.78,0,927.46,-7512.51
2895077755236089344,2020-01,169.11,2840.73,0,0,-2671.62,-2671.62
2895077755236089344,2020-02,1789.49,1720.8,85.97,0,154.66,-2516.96
2895077755236089344,2020-03,1398.85,0,1508.21,0,2907.06,390.1
2895077755236089344,2020-05,0,1558.34,1852.13,855.19,-561.4,-171.3
2895077755236089344,2020-06,1963.74,1717.16,0,927.77,-681.19,-852.49
2895077755236089344,2020-07,0,995.45,0,0,-995.45,-1847.94
2895077755236089344,2020-08,0,1655.72,0,887.33,-2543.05,-4390.99
2895077755236089344,2020-09,0,816.01,757.34,197.09,-255.76,-4646.75
2895077755236089344,2020-12,0,830.7,0,0,-830.7,-5477.45
2895144858102123520,2020-01,641.63,2085.33,0.69,1055.73,-2498.74,-2498.74
2895144858102123520,2020-02,0,1022.6,0,0,-1022.6,-3521.34
2895144858102123520,2020-03,853.46,2296.23,849.53,0,-593.24,-4114.58
2895144858102123520,2020-04,3198.53,2588.09,0,0,610.44,-3504.14
2895144858102123520,2020-05,408.86,2646.98,0,0,-2238.12,-5742.26
2895144858102123520,2020-07,0,459.6,1598.77,0,1139.17,-4603.09
2895144858102123520,2020-09,1821.63,2713.23,815.94,0,-75.66,-4678.75
2895144858102123520,2020-10,637.69,0,1444.51,2388.54,-306.34,-4985.09
2895144858102123520,2020-11,775.07,4835.42,1697.43,0,-2362.92,-7348.01
2895144858102123520,2020-12,4069.32,0,2841.02,4010.37,2899.97,-4448.04
2895893384298390528,2020-01,1975.21,2944.01,3819.44,2929.94,-79.3,-79.3
2895893384298390528,2020-02,1646.19,5176.9,4701.73,3722.6,-2551.58,-2630.88
2895893384298390528,2020-03,2942.68,5234.62,3756.73,783.18,681.61,-1949.27
2895893384298390528,2020-04,447.9,1428.86,1331.84,7917.37,-7566.49,-9515.76
2895893384298390528,2020-05,5492.18,2903.15,4459.02,8009.96,-961.91,-10477.67
2895893384298390528,2020-06,4169.48,0,3032.6,804.7,6397.38,-4080.29
2895893384298390528,2020-07,2668.72,867.9,358.92,2131.25,28.49,-4051.8
2895893384298390528,2020-08,432.48,4341.72,4283.49,1541.76,-1167.51,-5219.31
2895893384298390528,2020-09,334.27,58.58,1831.05,2482.02,-375.28,-5594.59
2895893384298390528,2020-10,390.41,5535.54,2423.61,1981.7,-4703.22,-10297.81
2895893384298390528,2020-11,1785.76,2987.75,5501.18,3931.9,367.29,-9930.52
2895893384298390528,2020-12,3480.37,2670.83,0,3977.97,-3168.43,-13098.95
2896761612428596736,2020-01,4328.26,4267.13,6105,2799.77,3366.36,3366.36
2896761612428596736,2020-02,0,5170.99,704.23,156.22,-4622.98,-1256.62
2896761612428596736,2020-03,3055.14,2518.13,0,4415.49,-3878.48,-5135.1
2896761612428596736,2020-04,2332.54,1342.3,5038.36,3374.42,2654.18,-2480.92
2896761612428596736,2020-05,2084.79,3630.03,3278.79,1937.34,-203.79,-2684.71
2896761612428596736,2020-06,6045.02,1400.85,4207.17,967.15,7884.19,5199.48
2896761612428596736,2020-07,693.53,1907.43,2224.03,1484.53,-474.4,4725.08
2896761612428596736,2020-08,2099.65,1464.97,3250.41,857.46,3027.63,7752.71
2896761612428596736,2020-09,2689.06,4623.31,6864.38,3944.63,985.5,8738.21
2896761612428596736,2020-10,2770.32,6541.91,4170.74,5364.88,-4965.73,3772.48
2896761612428596736,2020-11,1569.86,4612.99,7304.15,2968.77,1292.25,5064.73
2896761612428596736,2020-12,2975.66,0,4324.27,349.69,6950.24,12014.97
2897334592781819904,2020-05,1405.38,0,0,0,1405.38,1405.38
2897334592781819904,2020-06,282.07,0,0,0,282.07,1687.45
2897334592781819904,2020-08,1676.32,0,0,1258.2,418.12,2105.57
2897334592781819904,2020-11,1836.46,0,0,0,1836.46,3942.03
2897666276656630784,2020-01,0,952.8,0,257.3,-1210.1,-1210.1
2897666276656630784,2020-02,0,589.25,0,723.97,-1313.22,-2523.32
2897666276656630784,2020-03,0,1190.7,1284.98,1194.03,-1099.75,-3623.07
2897666276656630784,2020-05,1328.3,0,544.13,0,1872.43,-1750.64
2897666276656630784,2020-06,1187.66,1663.75,0,1481.49,-1957.58,-3708.22
2897666276656630784,2020-07,0,215.56,1045.89,0,830.33,-2877.89
2897666276656630784,2020-08,1676.13,0,3920.85,2908.9,2688.08,-189.81
2897666276656630784,2020-09,1049.83,376.37,0,0,673.46,483.65
2897666276656630784,2020-10,1894.73,918.05,1366.89,0,2343.57,2827.22
2897666276656630784,2020-11,539.37,0,1222.01,2394.38,-633,2194.22
2897666276656630784,2020-12,354.8,1483,0,1314.88,-2443.08,-248.86
2899417569935409664,2020-01,5208.36,6162.14,1335.3,0,381.52,381.52
2899417569935409664,2020-02,7223.81,1190.29,3272.98,0,9306.5,9688.02
2899417569935409664,2020-03,420.46,5021.81,1451.53,6815.98,-9965.8,-277.78
2899417569935409664,2020-04,2487.43,3083.11,4656.16,2056.94,2003.54,1725.76
2899417569935409664,2020-05,4393.78,3449.42,501.12,1513.11,-67.63,1658.13
2899417569935409664,2020-06,4978.99,5322.57,1066.53,2893.62,-2170.67,-512.54
2899417569935409664,2020-07,4578.85,8104.77,1044.64,5099.87,-7581.15,-8093.69
2899417569935409664,2020-08,0,4114.23,2866.63,3707.46,-4955.06,-13048.75
2899417569935409664,2020-09,2738.16,1114.46,2564.19,1665.5,2522.39,-10526.36
2899417569935409664,2020-10,2800,1771.35,6742.92,2318.38,5453.19,-5073.17
2899417569935409664,2020-11,1685.64,2657.75,3067.02,1620.74,474.17,-4599
2899417569935409664,2020-12,2674.3,4089.09,0,3135.9,-4550.69,-9149.69
2899932841063046656,2020-01,3128.05,0,0,0,3128.05,3128.05
2899932841063046656,2020-02,1415.07,779.32,0,1098.04,-462.29,2665.76
2899932841063046656,2020-05,737.57,0,0,0,737.57,3403.33
2899932841063046656,2020-07,1615.99,0,0,787.55,828.44,4231.77
2899932841063046656,2020-08,168.98,1051.66,0,0,-882.68,3349.09
2899932841063046656,2020-09,430.9,588.2,0,2791.91,-2949.21,399.88
2899932841063046656,2020-11,0,1170.8,0,0,-1170.8,-770.92
2900540192097435136,2020-01,0,1219.85,1904.01,2990.75,-2306.59,-2306.59
2900540192097435136,2020-02,1333.45,1490.45,1482.46,839.46,486,-1820.59
2900540192097435136,2020-03,1987.65,2458.64,483.37,3204.32,-3191.94,-5012.53
2900540192097435136,2020-04,1079.22,2045.04,3386.05,920.19,1500.04,-3512.49
2900540192097435136,2020-07,76.93,3386.87,0,1034.64,-4344.58,-7857.07
2900540192097435136,2020-08,1949.13,4325.92,1353.12,562.95,-1586.62,-9443.69
2900540192097435136,2020-09,1826.59,2037.16,1795.43,2005.99,-421.13,-9864.82
2900540192097435136,2020-10,0,1807,1320.93,3799.37,-4285.44,-14150.26
2900540192097435136,2020-11,1448.56,0,0,0,1448.56,-12701.7
2900540192097435136,2020-12,754.49,3130.86,3169.71,237.77,555.57,-12146.13
2904199113820816384,2020-01,886.27,0,1058.47,1570.49,374.25,374.25
2904199113820816384,2020-03,129.13,0,3015.42,0,3144.55,3518.8
2904199113820816384,2020-04,3219.57,1032.63,0,1038.44,1148.5,4667.3
2904199113820816384,2020-05,2191.62,600.6,0,2636.21,-1045.19,3622.11
2904199113820816384,2020-06,1481.61,0,0,0,1481.61,5103.72
2904199113820816384,2020-08,58.28,567.97,0,0,-509.69,4594.03
2904199113820816384,2020-09,659.26,552.16,0,916.78,-809.68,3784.35
2904199113820816384,2020-11,0,27.67,0,0,-27.67,3756.68
2904268766592515072,2020-01,0,1072.38,3869.48,1142.25,1654.85,1654.85
2904268766592515072,2020-02,0,1379.85,1346.6,2930.35,-2963.6,-1308.75
2904268766592515072,2020-03,1259.72,0,2400.76,0,3660.48,2351.73
2904268766592515072,2020-04,1964.94,523.96,0,3004.01,-1563.03,788.7
2904268766592515072,2020-05,956.6,1916.15,1934.57,622.05,352.97,1141.67
2904268766592515072,2020-06,1856.23,2454.02,3336.7,3389.44,-650.53,491.14
2904268766592515072,2020-07,1237.36,604.5,0,0,632.86,1124
2904268766592515072,2020-08,204.26,3800.2,5063.53,3492.76,-2025.17,-901.17
2904268766592515072,2020-09,1085.22,2851.96,0,332.66,-2099.4,-3000.57
2904268766592515072,2020-10,0,1347.14,1866.91,0,519.77,-2480.8
2904268766592515072,2020-11,0,190.82,1552.25,1789.67,-428.24,-2909.04
2904268766592515072,2020-12,2386.19,29.37,0,0,2356.82,-552.22
2904972438479835136,2020-08,98.25,0,288.42,0,386.67,386.67
2904972438479835136,2020-09,0,2752.01,0,0,-2752.01,-2365.34
2905527932476825600,2020-01,4270.61,2890.4,0,1709.28,-329.07,-329.07
2905527932476825600,2020-02,0,3112.54,4407.1,4005.7,-2711.14,-3040.21
2905527932476825600,2020-03,2241.39,6983.48,250.93,3160.25,-7651.41,-10691.62
2905527932476825600,2020-04,2268.55,3460.85,0,2303.25,-3495.55,-14187.17
2905527932476825600,2020-05,1822.5,4959.51,6299.04,573.48,2588.55,-11598.62
2905527932476825600,2020-06,538.19,3944.99,4857.93,1240.07,211.06,-11387.56
2905527932476825600,2020-07,796.92,596.12,2142.66,1991.42,352.04,-11035.52
2905527932476825600,2020-08,2389.31,3405.33,1508.21,1946.55,-1454.36,-12489.88
2905527932476825600,2020-09,1.17,0,5678.5,0,5679.67,-6810.21
2905527932476825600,2020-10,4504.62,3700.76,4773.83,3518.55,2059.14,-4751.07
2905527932476825600,2020-12,2922.31,870.76,2194.9,9003.08,-4756.63,-9507.7
2906536712305543168,2020-01,4192.19,1672.15,0,4038.25,-1518.21,-1518.21
2906536712305543168,2020-02,1491.59,4297.68,804.03,1911.41,-3913.47,-5431.68
2906536712305543168,2020-03,1242.09,1744.42,0,5671.76,-6174.09,-11605.77
2906536712305543168,2020-04,2597.59,0,2456.22,5652.86,-599.05,-12204.82
2906536712305543168,2020-05,5560.14,4740.2,2511.42,1353.44,1977.92,-10226.9
2906536712305543168,2020-06,3027.81,687.66,1204.85,2087.91,1457.09,-8769.81
2906536712305543168,2020-07,2496.44,4012.84,3808.53,5676.65,-3384.52,-12154.33
2906536712305543168,2020-08,2591.52,474.69,421.12,502.45,2035.5,-10118.83
2906536712305543168,2020-09,0,903.19,0,1606.94,-2510.13,-12628.96
2906536712305543168,2020-10,3367.72,690.32,3239.91,4214.46,1702.85,-10926.11
2906536712305543168,2020-11,1697.49,2486.54,493.82,2665.62,-2960.85,-13886.96
2906536712305543168,2020-12,3738.34,4037.23,2940.14,2087.04,554.21,-13332.75
2907204003250391040,2020-03,0,420.7,0,0,-420.7,-420.7
2907204003250391040,2020-07,0,301.15,0,0,-301.15,-721.85
2908016174155505664,2020-01,1935.82,1590.78,0,1758.44,-1413.4,-1413.4
2908016174155505664,2020-03,4233.98,241.95,0,2491.92,1500.11,86.71
2908016174155505664,2020-04,318.4,0,0,1127.2,-808.8,-722.09
2908016174155505664,2020-05,0,481.43,1957.92,0,1476.49,754.4
2908016174155505664,2020-06,418.86,1763.03,0,879.79,-2223.96,-1469.56
2908016174155505664,2020-08,2496.58,2378.13,3725.59,1690.68,2153.36,683.8
2908016174155505664,2020-09,1578.36,0,0,0,1578.36,2262.16
2908016174155505664,2020-10,968.06,410.15,109.95,1617.68,-949.82,1312.34
2908016174155505664,2020-11,0,1873.69,0,0,-1873.69,-561.35
2908016174155505664,2020-12,1940.33,0,0,0,1940.33,1378.98
2909683421679081984,2020-01,2876.95,4744.05,1603.15,1424.5,-1688.45,-1688.45
2909683421679081984,2020-02,1607.63,4595.89,7882.45,3442.7,1451.49,-236.96
2909683421679081984,2020-03,5501.97,1273.62,1884.32,71.48,6041.19,5804.23
2909683421679081984,2020-04,244.23,5466.29,5563.79,4530.55,-4188.82,1615.41
2909683421679081984,2020-05,691.43,1808.14,6304.1,234.63,4952.76,6568.17
2909683421679081984,2020-06,3016.71,3138.73,6457.07,6808.02,-472.97,6095.2
2909683421679081984,2020-07,676.57,6498.82,2439.88,470.89,-3853.26,2241.94
2909683421679081984,2020-08,1751.53,3343.52,0,2199.64,-3791.63,-1549.69
2909683421679081984,2020-09,3257.47,2757.79,5234.3,3678.49,2055.49,505.8
2909683421679081984,2020-10,3675.93,1061.5,4699.69,2801.31,4512.81,5018.61
2909683421679081984,2020-11,2759.02,2802.98,3890.63,1221.39,2625.28,7643.89
2909683421679081984,2020-12,2236.64,3343.84,2830.42,3741.74,-2018.52,5625.37
2910327306232488448,2020-02,3259.73,330.82,846.19,1134.29,2640.81,2640.81
2910327306232488448,2020-03,1108.25,1349.72,0,1401.81,-1643.28,997.53
2910327306232488448,2020-04,0,744.98,1641.44,0,896.46,1893.99
2910327306232488448,2020-05,905.06,2877.02,1185.09,4167.71,-4954.58,-3060.59
2910327306232488448,2020-08,611.6,3056.9,0,703.91,-3149.21,-6209.8
2910327306232488448,2020-09,1924.16,603.89,388.02,1744.79,-36.5,-6246.3
2910327306232488448,2020-10,3391.69,538.85,0,4490.16,-1637.32,-7883.62
2910327306232488448,2020-11,0,1979.19,0,1000.96,-2980.15,-10863.77
2910327306232488448,2020-12,0,73.21,6391.55,0,6318.34,-4545.43
2910713711664977408,2020-01,2147,6504.36,1461.55,4127.99,-7023.8,-7023.8
2910713711664977408,2020-02,3670.66,1550.77,5797.33,1211.41,6705.81,-317.99
2910713711664977408,2020-03,5706.43,5131.41,3714.52,2354.53,1935.01,1617.02
2910713711664977408,2020-04,4791.87,4404.67,3774.45,5098.28,-936.63,680.39
2910713711664977408,2020-05,4517.1,633.65,3872.66,2808.18,4947.93,5628.32
2910713711664977408,2020-06,1057.03,6258.77,3198.96,2863.96,-4866.74,761.58
2910713711664977408,2020-07,3462.24,6070.24,4369.36,1922.6,-161.24,600.34
2910713711664977408,2020-08,3435.6,6112.26,5113.32,3231.46,-794.8,-194.46
2910713711664977408,2020-09,1417.79,2367.39,3472.37,4307.9,-1785.13,-1979.59
2910713711664977408,2020-10,0,7493.67,8220.31,4280.93,-3554.29,-5533.88
2910713711664977408,2020-11,2137.76,3811.71,4490.98,2926.6,-109.57,-5643.45
2910713711664977408,2020-12,3973.54,4107.36,5535.15,2200.85,3200.48,-2442.97
2911735740795400192,2020-01,7303.32,2734.79,2154.67,3364.34,3358.86,3358.86
2911735740795400192,2020-02,1793.63,4501.64,7752.83,4056.45,988.37,4347.23
2911735740795400192,2020-03,5752.77,5959.55,3844.85,4474.46,-836.39,3510.84
2911735740795400192,2020-04,5700.29,6381.41,3410.05,2461.02,267.91,3778.75
2911735740795400192,2020-05,7704.33,3389.08,1134.75,2778.99,2671.01,6449.76
2911735740795400192,2020-06,4477.33,3415.2,4277.44,3417.96,1921.61,8371.37
2911735740795400192,2020-07,3488.62,1634.26,3116.93,2348.19,2623.1,10994.47
2911735740795400192,2020-08,4158.8,6257.49,1688.81,4270.1,-4679.98,6314.49
2911735740795400192,2020-09,6356.62,3198.75,2333.08,1707.34,3783.61,10098.1
2911735740795400192,2020-10,3824.07,2634.16,2289.34,4114.03,-634.78,9463.32
2911735740795400192,2020-11,1942.58,214.34,3541.05,277.93,4991.36,14454.68
2911735740795400192,2020-12,3916.28,4757.74,5286.54,3176.53,1268.55,15723.23
2911904389394802688,2020-01,3396.15,3142.94,2227.87,5734.72,-3253.64,-3253.64
2911904389394802688,2020-02,673.66,3561.66,4789,1394.31,506.69,-2746.95
2911904389394802688,2020-03,2357.29,5822.27,1330.8,3202.78,-5336.96,-8083.91
2911904389394802688,2020-04,2111.5,1286.16,2474.57,6779.07,-3479.16,-11563.07
2911904389394802688,2020-05,456.41,3145.42,3130.73,467.99,-26.27,-11589.34
2911904389394802688,2020-06,6933.77,3625.54,7031.6,2883.78,7456.05,-4133.29
2911904389394802688,2020-07,592.77,1589.23,0,761.28,-1757.74,-5891.03
2911904389394802688,2020-08,5406.9,2226.99,0,1631.18,1548.73,-4342.3
2911904389394802688,2020-09,1681.37,967.54,3508.51,1528.27,2694.07,-1648.23
2911904389394802688,2020-10,5283.26,2553.36,2438.64,3384.14,1784.4,136.17
2911904389394802688,2020-11,2345.92,1019.55,2080.46,2255.1,1151.73,1287.9
2911904389394802688,2020-12,3432.44,1440.32,6950.38,5021.25,3921.25,5209.15
2913254254267207680,2020-01,428.83,1832.78,1783.04,8918.01,-8538.92,-8538.92
2913254254267207680,2020-02,3148.81,431.52,1476.41,8036.27,-3842.57,-12381.49
2913254254267207680,2020-03,4934.25,4.42,7404.74,4213.92,8120.65,-4260.84
2913254254267207680,2020-04,1770.2,2574.81,4105.77,8235.83,-4934.67,-9195.51
2913254254267207680,2020-05,10619.08,541.29,1303.03,3157.52,8223.3,-972.21
2913254254267207680,2020-06,2152.28,4262.39,741.61,2427.74,-3796.24,-4768.45
2913254254267207680,2020-07,2956.76,1659.24,2344.25,6219.18,-2577.41,-7345.86
2913254254267207680,2020-08,311.61,33.25,1090.14,1809.79,-441.29,-7787.15
2913254254267207680,2020-09,2114.65,2288.9,1520.6,4206.22,-2859.87,-10647.02
2913254254267207680,2020-10,1595.75,3723.03,6622.45,1507.81,2987.36,-7659.66
2913254254267207680,2020-11,10650.35,2459.48,5217.54,2724.97,10683.44,3023.78
2913254254267207680,2020-12,2218.38,5261.2,2751.13,5088.85,-5380.54,-2356.76
2917832882375911936,2020-01,2783.08,0,3273.63,215.91,5840.8,5840.8
2917832882375911936,2020-02,610.7,622.84,1374.55,1765.15,-402.74,5438.06
2917832882375911936,2020-03,3066.74,1922.39,4023.16,1213.89,3953.62,9391.68
2917832882375911936,2020-04,1359.01,1465.18,0,1596.04,-1702.21,7689.47
2917832882375911936,2020-05,1998.21,1754.69,0,2726.74,-2483.22,5206.25
2917832882375911936,2020-06,5158.87,0,0,1214.16,3944.71,9150.96
2917832882375911936,2020-07,1400.75,898.05,0,960.88,-458.18,8692.78
2917832882375911936,2020-08,902.56,132.78,2054.93,5931.75,-3107.04,5585.74
2917832882375911936,2020-09,0,2873.5,4511.61,0,1638.11,7223.85
2917832882375911936,2020-10,543.12,4736.75,801.03,0,-3392.6,3831.25
2917832882375911936,2020-11,0,1678.13,1538.93,4197.6,-4336.8,-505.55
2917832882375911936,2020-12,607.43,953.76,1446.04,2940.64,-1840.93,-2346.48
2919009709564130816,2020-01,1362.45,205.62,2436.1,1005.14,2587.79,2587.79
2919009709564130816,2020-03,0,1907.66,175.4,0,-1732.26,855.53
2919009709564130816,2020-04,1052.18,0,1747.67,0,2799.85,3655.38
2919009709564130816,2020-05,1475.21,0,238.85,0,1714.06,5369.44
2919009709564130816,2020-07,3876.37,0,3218.37,741.94,6352.8,11722.24
2919009709564130816,2020-08,0,1098.5,0,0,-1098.5,10623.74
2919009709564130816,2020-09,0,211.47,0,0,-211.47,10412.27
2919009709564130816,2020-10,276.72,0,888.17,1530.72,-365.83,10046.44
2919009709564130816,2020-11,4891.99,2923.87,0,0,1968.12,12014.56
2919009709564130816,2020-12,1369.94,0,1622.97,0,2992.91,15007.47
2922387164977244160,2020-01,1987.24,3010.97,1626.16,6594.51,-5992.08,-5992.08
2922387164977244160,2020-02,1067.55,1127.21,4788.23,4009.5,719.07,-5273.01
2922387164977244160,2020-03,4105.15,4508.65,4437.66,3957.49,76.67,-5196.34
2922387164977244160,2020-04,1617.01,1711.76,2791.1,4375.16,-1678.81,-6875.15
2922387164977244160,2020-05,1680.47,957.46,1728.99,0,2452,-4423.15
2922387164977244160,2020-06,3660.94,645.18,4623.88,2575.33,5064.31,641.16
2922387164977244160,2020-07,2204.06,953.39,2053.39,3603.98,-299.92,341.24
2922387164977244160,2020-08,6938.48,4884.65,2053.03,788.07,3318.79,3660.03
2922387164977244160,2020-09,2021.87,0,351.92,1444.2,929.59,4589.62
2922387164977244160,2020-10,4958.34,3478.06,1840.05,6141.04,-2820.71,1768.91
2922387164977244160,2020-11,0,3150.23,787.64,3288.4,-5650.99,-3882.08
2922387164977244160,2020-12,5619.47,4045.81,1541.29,6037.35,-2922.4,-6804.48
2922595911087815168,2020-01,2666.78,887.37,1480.8,3535.21,-275,-275
2922595911087815168,2020-02,639.93,7559.02,1768.16,2392.6,-7543.53,-7818.53
2922595911087815168,2020-03,4274.95,4395.11,4043.63,0,3923.47,-3895.06
2922595911087815168,2020-04,4881.62,4987.54,6263.04,6486.05,-328.93,-4223.99
2922595911087815168,2020-05,4434.54,4732.62,1632.88,6294.53,-4959.73,-9183.72
2922595911087815168,2020-06,4388.23,2676.37,3355.1,894.01,4172.95,-5010.77
2922595911087815168,2020-07,3435.91,5229.8,6057.66,2919.91,1343.86,-3666.91
2922595911087815168,2020-08,4870.61,2710.37,4744.33,610.2,6294.37,2627.46
2922595911087815168,2020-09,3663.61,2730.58,2549.78,3520.67,-37.86,2589.6
2922595911087815168,2020-10,12516.8,4108.08,1919.46,7803.46,2524.72,5114.32
2922595911087815168,2020-11,1745.87,3981.66,3218.1,2296.29,-1313.98,3800.34
2922595911087815168,2020-12,2013.35,5772.17,3247.53,1538.1,-2049.39,1750.95
2922692094827596800,2020-01,4809.75,0,1206.3,0,6016.05,6016.05
2922692094827596800,2020-03,882.43,2396.3,1020.41,3626.61,-4120.07,1895.98
2922692094827596800,2020-04,2302.01,0,0,1253.71,1048.3,2944.28
2922692094827596800,2020-05,2649.19,2061.56,372.17,4878.14,-3918.34,-974.06
2922692094827596800,2020-06,6403.41,9110.18,2663.59,3311.58,-3354.76,-4328.82
2922692094827596800,2020-07,1491.34,2727.69,4589.39,369.31,2983.73,-1345.09
2922692094827596800,2020-08,6883.39,2601.4,2062.85,0,6344.84,4999.75
2922692094827596800,2020-09,1237.61,4048.97,3304.56,1698.78,-1205.58,3794.17
2922692094827596800,2020-10,719.26,0,0,1773.2,-1053.94,2740.23
2922692094827596800,2020-11,1802.64,3123.6,2803.08,1847.23,-365.11,2375.12
2922692094827596800,2020-12,1405.19,1096.87,0,773.89,-465.57,1909.55
2924087686554192896,2020-01,1501.41,0,1107.58,5162.98,-2553.99,-2553.99
2924087686554192896,2020-02,2362.06,0,0,1182.55,1179.51,-1374.48
2924087686554192896,2020-03,0,328.65,0,0,-328.65,-1703.13
2924087686554192896,2020-04,927.26,0,1902.16,1715.79,1113.63,-589.5
2924087686554192896,2020-05,1442.37,1457.15,0,0,-14.78,-604.28
2924087686554192896,2020-06,2486.62,0,0,0,2486.62,1882.34
2924087686554192896,2020-07,331.59,0,240.69,1570.21,-997.93,884.41
2924087686554192896,2020-08,1634.67,3723.9,716.74,1643.16,-3015.65,-2131.24
2924087686554192896,2020-09,0,1231.41,1442.92,0,211.51,-1919.73
2924087686554192896,2020-10,0,743.75,0,0,-743.75,-2663.48
2924087686554192896,2020-11,220,0,0,0,220,-2443.48
2924401030980823040,2020-01,4047.2,2490,2490.36,2808.3,1239.26,1239.26
2924401030980823040,2020-02,1874.47,1058.29,793.52,0,1609.7,2848.96
2924401030980823040,2020-03,2268.29,909.18,1241.09,2014.09,586.11,3435.07
2924401030980823040,2020-04,240.69,3149.15,596.95,4546.18,-6857.69,-3422.62
2924401030980823040,2020-05,3350.71,5896.5,3305.13,1989.2,-1229.86,-4652.48
2924401030980823040,2020-06,2929.62,1777.38,2680.24,1269.59,2562.89,-2089.59
2924401030980823040,2020-07,2449.08,3712.16,2577.58,4663.68,-3349.18,-5438.77
2924401030980823040,2020-08,718.12,520.11,841.67,214.43,825.25,-4613.52
2924401030980823040,2020-09,3313.96,2917.76,302.32,2127.33,-1428.81,-6042.33
2924401030980823040,2020-10,3346.37,3092.35,817.42,6810.13,-5738.69,-11781.02
2924401030980823040,2020-11,2022.03,1638.37,0,702.48,-318.82,-12099.84
2924401030980823040,2020-12,2892.1,1054.17,1310.79,1231.1,1917.62,-10182.22
2926085790162060288,2020-01,5734.39,4901.99,4796.48,1790.58,3838.3,3838.3
2926085790162060288,2020-02,8898.59,2809.54,3027.44,2146.17,6970.32,10808.62
2926085790162060288,2020-03,8752.61,1285.99,5445.55,5400.83,7511.34,18319.96
2926085790162060288,2020-04,7375.06,2008.02,6713.06,8345.57,3734.53,22054.49
2926085790162060288,2020-05,2898.29,6521.44,2916.81,1277.06,-1983.4,20071.09
2926085790162060288,2020-06,7306.45,5082.18,8476.72,3454.52,7246.47,27317.56
2926085790162060288,2020-07,4086.65,4874.67,4025.52,532.49,2705.01,30022.57
2926085790162060288,2020-08,5852.15,5108.91,3757.75,2190.49,2310.5,32333.07
2926085790162060288,2020-09,9993.65,2742.73,5733.43,8654.86,4329.49,36662.56
2926085790162060288,2020-10,4655.8,9776.05,4251.5,399.36,-1268.11,35394.45
2926085790162060288,2020-11,8669.21,4563.76,1602.96,651.47,5056.94,40451.39
2926085790162060288,2020-12,1753.34,918.18,3690.78,4429.35,96.59,40547.98
2926489068562264064,2020-01,2980.33,0,2128.28,806.1,4302.51,4302.51
2926489068562264064,2020-02,0,1990.76,48.28,0,-1942.48,2360.03
2926489068562264064,2020-03,0,1139.6,0,1740.67,-2880.27,-520.24
2926489068562264064,2020-04,509.58,244.13,0,0,265.45,-254.79
2926489068562264064,2020-06,965.5,1358.46,0,0,-392.96,-647.75
2926489068562264064,2020-07,2248.6,0,598.68,104.27,2743.01,2095.26
2926489068562264064,2020-08,0,1967.68,0,1727.2,-3694.88,-1599.62
2926489068562264064,2020-09,0,518.65,0,0,-518.65,-2118.27
2926489068562264064,2020-10,891.22,2384.28,0,955.38,-2448.44,-4566.71
2926489068562264064,2020-11,131.85,0,0,0,131.85,-4434.86
2927436422922638848,2020-01,2254.91,422.32,2434.72,1216.3,3051.01,3051.01
2927436422922638848,2020-02,1870.85,1238.36,0,2058.91,-1426.42,1624.59
2927436422922638848,2020-03,506.78,1199.12,0,2455.69,-3148.03,-1523.44
2927436422922638848,2020-04,1837.35,0,1229.15,1120.52,1945.98,422.54
2927436422922638848,2020-05,0,434.67,591.21,3658.23,-3501.69,-3079.15
2927436422922638848,2020-08,0,2256.63,1214.11,917.43,-1959.95,-5039.1
2927436422922638848,2020-09,954.83,1049.44,2575.02,1370.74,1109.67,-3929.43
2927436422922638848,2020-10,1704.94,0,1121.47,2810.08,16.33,-3913.1
2927436422922638848,2020-11,1450.78,1857.12,0,1492.46,-1898.8,-5811.9
2927436422922638848,2020-12,0,1974.16,317.51,1041.48,-2698.13,-8510.03
2928197555629094912,2020-01,4780.58,3314.22,378.66,1250.23,594.79,594.79
2928197555629094912,2020-02,1811.57,2383.97,3686.96,0,3114.56,3709.35
2928197555629094912,2020-03,1006.62,3502.07,3673,4459.88,-3282.33,427.02
2928197555629094912,2020-04,3074.62,6808.65,0,7182.22,-10916.25,-10489.23
2928197555629094912,2020-05,8664.31,2041.14,2479.98,4637.08,4466.07,-6023.16
2928197555629094912,2020-06,871.47,3469.43,2319.7,8211.63,-8489.89,-14513.05
2928197555629094912,2020-07,3670.37,2901.9,3248.97,3297.52,719.92,-13793.13
2928197555629094912,2020-08,3051.56,1967.23,2140.82,5835.17,-2610.02,-16403.15
2928197555629094912,2020-09,6865.03,1859.49,955.28,4088.02,1872.8,-14530.35
2928197555629094912,2020-10,3209.69,1924.3,260.96,2480.1,-933.75,-15464.1
2928197555629094912,2020-11,326.58,7339.17,1701.25,0,-5311.34,-20775.44
2928197555629094912,2020-12,1127.06,4437.16,7747.28,4805.32,-368.14,-21143.58
2928786163381332992,2020-01,3930.07,632.07,2585.33,0,5883.33,5883.33
2928786163381332992,2020-02,1719.24,0,1692.37,2137.75,1273.86,7157.19
2928786163381332992,2020-03,1877.11,4152.72,2949.56,1260.14,-586.19,6571
2928786163381332992,2020-04,906.93,258.04,3556.19,313.01,3892.07,10463.07
2928786163381332992,2020-05,5671.11,3221.59,3400.37,4154.64,1695.25,12158.32
2928786163381332992,2020-06,1797.72,3692.83,564.26,6030.32,-7361.17,4797.15
2928786163381332992,2020-07,9461.79,2029.38,0,0,7432.41,12229.56
2928786163381332992,2020-08,623.81,4461.42,723.59,2320.81,-5434.83,6794.73
2928786163381332992,2020-09,1122.98,1310.39,1820.39,1799.18,-166.2,6628.53
2928786163381332992,2020-10,213.3,3346.47,683.12,65.19,-2515.24,4113.29
2928786163381332992,2020-11,1135.92,1506.72,1356.02,101.82,883.4,4996.69
2928786163381332992,2020-12,618.09,2441.79,1690.51,3085.91,-3219.1,1777.59
2932794698551646720,2020-01,313.73,796.57,0,210.96,-693.8,-693.8
2932794698551646720,2020-02,0,1713.32,0,0,-1713.32,-2407.12
2932794698551646720,2020-03,948.26,0,529.08,226.75,1250.59,-1156.53
2932794698551646720,2020-04,0,1094.17,972.45,0,-121.72,-1278.25
2932794698551646720,2020-05,1442.4,0,0,352.32,1090.08,-188.17
2932794698551646720,2020-07,1606.62,0,1111.31,0,2717.93,2529.76
2932794698551646720,2020-08,699.93,177.26,0,0,522.67,3052.43
2932794698551646720,2020-09,268.34,0,115.27,1892.05,-1508.44,1543.99
2932794698551646720,2020-10,0,1399.95,0,0,-1399.95,144.04
2932794698551646720,2020-11,2292.18,0,0,0,2292.18,2436.22
2933491816654898176,2020-01,2196.64,1508.43,1567.62,5620.12,-3364.29,-3364.29
2933491816654898176,2020-02,657.06,3906.5,1184.61,5005.2,-7070.03,-10434.32
2933491816654898176,2020-03,1442.15,6675.5,3731.18,1043.15,-2545.32,-12979.64
2933491816654898176,2020-04,0,770.45,3078.57,2218.8,89.32,-12890.32
2933491816654898176,2020-05,2794.29,0,627.62,4263.95,-842.04,-13732.36
2933491816654898176,2020-06,2722.15,0,1912.95,1089.01,3546.09,-10186.27
2933491816654898176,2020-07,2981.74,1046.15,1784.09,3359.44,360.24,-9826.03
2933491816654898176,2020-08,2511.6,3028.83,2662.51,1611.69,533.59,-9292.44
2933491816654898176,2020-09,3338.16,808.17,3168.13,0,5698.12,-3594.32
2933491816654898176,2020-10,1366.63,0,1366.26,872.52,1860.37,-1733.95
2933491816654898176,2020-11,1850.87,7165.4,2584.01,2388.09,-5118.61,-6852.56
2933491816654898176,2020-12,2224.45,2543.35,166.75,1287.99,-1440.14,-8292.7
2933604936071806464,2020-01,4221.9,1105.59,94.41,3918.42,-707.7,-707.7
2933604936071806464,2020-02,3256.31,4696.21,2447.8,2795.34,-1787.44,-2495.14
2933604936071806464,2020-03,6727.78,3903.12,3158.93,6950.78,-967.19,-3462.33
2933604936071806464,2020-04,1792.05,0,161.72,4914.21,-2960.44,-6422.77
2933604936071806464,2020-05,3291.49,6376.11,7831.57,2165.69,2581.26,-3841.51
2933604936071806464,2020-06,0,4301.18,3878.69,5515.41,-5937.9,-9779.41
2933604936071806464,2020-07,5886.28,5696.46,2911.62,2653.6,447.84,-9331.57
2933604936071806464,2020-08,4606.28,7751.13,6206.2,4838.33,-1776.98,-11108.55
2933604936071806464,2020-09,2927.34,0,3452.33,2428.89,3950.78,-7157.77
2933604936071806464,2020-10,7584.98,7422.83,1857.49,9570.83,-7551.19,-14708.96
2933604936071806464,2020-11,1871.36,2206.1,5732.13,5885.1,-487.71,-15196.67
2933604936071806464,2020-12,4233.54,0,3637.13,5617.42,2253.25,-12943.42
2934391350591596544,2020-01,4815.16,2512.89,169.26,3333.42,-861.89,-861.89
2934391350591596544,2020-02,3008.74,1934.63,3417.41,2428.34,2063.18,1201.29
2934391350591596544,2020-03,4657.63,3459.08,3691.42,6262.78,-1372.81,-171.52
2934391350591596544,2020-04,6655.39,5717.15,5972.54,4375.93,2534.85,2363.33
2934391350591596544,2020-05,3476.71,5632.1,7358.73,3470.84,1732.5,4095.83
2934391350591596544,2020-06,4084.98,6768.84,3989.47,4344.1,-3038.49,1057.34
2934391350591596544,2020-07,8793.78,4684.05,6025.55,4879.81,5255.47,6312.81
2934391350591596544,2020-08,2946.02,1354.1,3444.54,5002.9,33.56,6346.37
2934391350591596544,2020-09,10505.05,103.53,8046.29,7910.97,10536.84,16883.21
2934391350591596544,2020-10,6937.42,3289.75,4564.43,4845.83,3366.27,20249.48
2934391350591596544,2020-11,5042.94,5435.42,5091.97,5160.17,-460.68,19788.8
2934391350591596544,2020-12,5093.49,1515.11,146.57,2150.31,1574.64,21363.44
2934537218124936704,2020-02,0,1222.56,2319.84,0,1097.28,1097.28
2934537218124936704,2020-03,1588.1,0,0,0,1588.1,2685.38
2934537218124936704,2020-05,214.25,1901.39,0,609.37,-2296.51,388.87
2934537218124936704,2020-06,2216.75,79.12,115.25,2125.88,127,515.87
2934537218124936704,2020-08,795.86,2609.89,2992.01,479.4,698.58,1214.45
2934537218124936704,2020-09,1020.15,4534.21,591.08,0,-2922.98,-1708.53
2934537218124936704,2020-10,0,3624.47,3382.93,3035.39,-3276.93,-4985.46
2934537218124936704,2020-11,29.94,1451.78,0,622.79,-2044.63,-7030.09
2935436165413334528,2020-01,5448.98,7319.53,3923.66,2579.41,-526.3,-526.3
2935436165413334528,2020-02,1415.1,2960.5,3379.3,1073.49,760.41,234.11
2935436165413334528,2020-03,1475.34,3693.36,6266.21,1739.89,2308.3,2542.41
2935436165413334528,2020-04,4183.83,2890.55,4873.94,2052.94,4114.28,6656.69
2935436165413334528,2020-05,2998.67,2962.54,2300.95,0,2337.08,8993.77
2935436165413334528,2020-06,4685.73,484.97,1228.74,6518.11,-1088.61,7905.16
2935436165413334528,2020-07,1960.01,4340.34,4258.77,8684.85,-6806.41,1098.75
2935436165413334528,2020-08,8628.04,4965.79,2385.72,4223.55,1824.42,2923.17
2935436165413334528,2020-09,2028.66,3222.72,1575.69,4459.19,-4077.56,-1154.39
2935436165413334528,2020-10,3760.67,1463.59,3014.98,4775.07,536.99,-617.4
2935436165413334528,2020-11,3098.41,10214.57,3992.62,4049.24,-7172.78,-7790.18
2935436165413334528,2020-12,5492.89,6819.53,2361.75,4909.45,-3874.34,-11664.52
2936785803984546304,2020-01,6368.24,1936.75,3445.97,365.57,7511.89,7511.89
2936785803984546304,2020-02,0,5092.97,3518.46,2282.3,-3856.81,3655.08
2936785803984546304,2020-03,2741,1628.6,2998.65,1427.9,2683.15,6338.23
2936785803984546304,2020-04,3590.19,2093.3,3726.22,1104.13,4118.98,10457.21
2936785803984546304,2020-05,3558.49,2932.29,2329.07,0,2955.27,13412.48
2936785803984546304,2020-06,6516.17,3059.32,1502.89,4162.83,796.91,14209.39
2936785803984546304,2020-07,3718.91,2942.97,1411.02,1651.36,535.6,14744.99
2936785803984546304,2020-08,5159.61,6098.9,5746.87,5992.18,-1184.6,13560.39
2936785803984546304,2020-09,4568.26,5532.12,2933.84,7253.15,-5283.17,8277.22
2936785803984546304,2020-10,3822.78,3106.77,1240.06,7706.48,-5750.41,2526.81
2936785803984546304,2020-11,4800.28,5353.46,1826.51,9709.3,-8435.97,-5909.16
2936785803984546304,2020-12,1877.61,2408.18,761.95,3782.25,-3550.87,-9460.03
2937528979097176576,2020-01,7384.98,6163.78,2500.32,5406.49,-1684.97,-1684.97
2937528979097176576,2020-02,0,705.99,4076.49,1824.24,1546.26,-138.71
2937528979097176576,2020-03,5204.66,3710.08,3789.62,4632.8,651.4,512.69
2937528979097176576,2020-04,1828.48,5208.11,0,2409.09,-5788.72,-5276.03
2937528979097176576,2020-05,2733.3,5182.75,3106.16,2458.54,-1801.83,-7077.86
2937528979097176576,2020-06,1412.9,5690.61,0,514.03,-4791.74,-11869.6
2937528979097176576,2020-07,2816.83,1977.64,5147.18,5677.54,308.83,-11560.77
2937528979097176576,2020-08,1705.51,7884.34,2733.05,1627.65,-5073.43,-16634.2
2937528979097176576,2020-09,4024.67,2755.98,6683.86,0,7952.55,-8681.65
2937528979097176576,2020-10,6065.78,3466.68,5575.88,692.93,7482.05,-1199.6
2937528979097176576,2020-11,3532.92,113.82,2281.62,534.09,5166.63,3967.03
2937528979097176576,2020-12,2061.71,2688.77,1498.63,877.44,-5.87,3961.16
2937976282315198464,2020-01,4393.49,2871.3,1127.11,1164.48,1484.82,1484.82
2937976282315198464,2020-02,0,799.92,1970.65,0,1170.73,2655.55
2937976282315198464,2020-03,3120.52,659.74,1612.21,2189.46,1883.53,4539.08
2937976282315198464,2020-04,0,2388.39,6277.92,1860.64,2028.89,6567.97
2937976282315198464,2020-05,2960.06,2802.5,2296.09,2431.23,22.42,6590.39
2937976282315198464,2020-06,1421.28,1976.4,4021.37,1256.92,2209.33,8799.72
2937976282315198464,2020-07,904.27,2539.16,0,0,-1634.89,7164.83
2937976282315198464,2020-08,1557.89,618.45,493.33,2211.81,-779.04,6385.79
2937976282315198464,2020-09,4119.68,2328.59,0,1899.53,-108.44,6277.35
2937976282315198464,2020-10,1326.54,1372.01,1621.43,0,1575.96,7853.31
2937976282315198464,2020-11,0,421.58,325.63,100.41,-196.36,7656.95
2937976282315198464,2020-12,3612.28,0,0,1405.18,2207.1,9864.05
2938011927030781440,2020-02,1340.93,0,51.95,1677.78,-284.9,-284.9
2938011927030781440,2020-04,2356.91,0,1746.31,0,4103.22,3818.32
2938011927030781440,2020-05,1278.38,150.31,0,0,1128.07,4946.39
2938011927030781440,2020-06,1047.87,1362.56,1019.26,0,704.57,5650.96
2938011927030781440,2020-07,1115.64,1013.94,522.85,2445.46,-1820.91,3830.05
2938011927030781440,2020-08,49.77,864.7,243.37,2522.4,-3093.96,736.09
2938011927030781440,2020-09,860.84,588.46,0,0,272.38,1008.47
2938011927030781440,2020-10,0,1038.71,1464.13,0,425.42,1433.89
2938011927030781440,2020-11,2503.1,0,486.55,1925.69,1063.96,2497.85
2938011927030781440,2020-12,3014.33,0,0,706.11,2308.22,4806.07
2938155053469195264,2020-01,2985.98,2693.16,3788.51,3863.38,217.95,217.95
2938155053469195264,2020-02,10172.87,9339.23,3078.98,2602.3,1310.32,1528.27
2938155053469195264,2020-03,9243.98,268.22,2254.54,2972.75,8257.55,9785.82
2938155053469195264,2020-04,1231.7,4336.69,5324.44,5039.46,-2820.01,6965.81
2938155053469195264,2020-05,4511.54,3948.13,3357.53,3440.33,480.61,7446.42
2938155053469195264,2020-06,3114.94,6656.79,3971.91,2787.17,-2357.11,5089.31
2938155053469195264,2020-07,5437.35,4650.21,5746.38,6708.86,-175.34,4913.97
2938155053469195264,2020-08,3035.36,4577.18,5151.94,4099.45,-489.33,4424.64
2938155053469195264,2020-09,4653.76,2979.33,3534.92,2070.27,3139.08,7563.72
2938155053469195264,2020-10,3774.18,9186.49,1603.64,5809.06,-9617.73,-2054.01
2938155053469195264,2020-11,4842.43,5237.84,1329.5,6142.53,-5208.44,-7262.45
2938155053469195264,2020-12,5465.64,2912.15,8207.73,9748.59,1012.63,-6249.82
2938485807396352000,2020-01,0,943.22,2556.91,2517.27,-903.58,-903.58
2938485807396352000,2020-02,28.31,0,2281.28,1093.18,1216.41,312.83
2938485807396352000,2020-03,1685.75,1835.92,4597.11,3738.19,708.75,1021.58
2938485807396352000,2020-04,6213.66,8702.1,3666.17,5769.91,-4592.18,-3570.6
2938485807396352000,2020-05,1801.73,6593.03,4004.22,2277.25,-3064.33,-6634.93
2938485807396352000,2020-06,1837.97,2427.98,4592.19,3209.8,792.38,-5842.55
2938485807396352000,2020-07,4242.72,4100.28,2834.09,3625.49,-648.96,-6491.51
2938485807396352000,2020-08,5466.05,1504.11,2546.94,2725.74,3783.14,-2708.37
2938485807396352000,2020-09,2321.44,3868,7847.6,1072.02,5229.02,2520.65
2938485807396352000,2020-10,6738.15,4569.39,2338.73,3495.68,1011.81,3532.46
2938485807396352000,2020-11,12236.28,2187.24,1577.97,3066.52,8560.49,12092.95
2938485807396352000,2020-12,6222.39,71.25,899.71,0,7050.85,19143.8
2938567524254948864,2020-01,3615.91,2009.81,2936.74,4583.34,-40.5,-40.5
2938567524254948864,2020-02,270.6,5864.64,2009.79,1732.22,-5316.47,-5356.97
2938567524254948864,2020-03,3853.03,3929.67,3175.89,709.38,2389.87,-2967.1
2938567524254948864,2020-04,4498.98,4008.49,2279.34,609.16,2160.67,-806.43
2938567524254948864,2020-05,3962.64,2357.37,5377.68,6486.29,496.66,-309.77
2938567524254948864,2020-06,1601.78,4620.79,5291.74,0,2272.73,1962.96
2938567524254948864,2020-07,1474.35,2136.95,1626.07,2243.6,-1280.13,682.83
2938567524254948864,2020-08,4364.1,529.78,2293.34,5798.76,328.9,1011.73
2938567524254948864,2020-09,2550.42,6779.97,11243.88,2083.83,4930.5,5942.23
2938567524254948864,2020-10,167.88,5050.04,1778.88,4803.6,-7906.88,-1964.65
2938567524254948864,2020-11,5664.29,1137.78,2248.98,4308.78,2466.71,502.06
2938567524254948864,2020-12,4864.6,4961.94,4266.7,2978.85,1190.51,1692.57
2940293047534737408,2020-01,660.21,1186.94,2520.38,0,1993.65,1993.65
2940293047534737408,2020-02,0,801.87,0,1882.61,-2684.48,-690.83
2940293047534737408,2020-03,604.59,1742.54,918.19,1949.59,-2169.35,-2860.18
2940293047534737408,2020-04,2311.5,1578.06,0,0,733.44,-2126.74
2940293047534737408,2020-05,3536.6,0,34.53,6092.18,-2521.05,-4647.79
2940293047534737408,2020-06,810.47,2393.61,0,1222.41,-2805.55,-7453.34
2940293047534737408,2020-07,2278.14,1879.51,1245.8,1774.83,-130.4,-7583.74
2940293047534737408,2020-08,3436.89,1873.92,0,1758.4,-195.43,-7779.17
2940293047534737408,2020-09,812.58,0,1284.76,1454.28,643.06,-7136.11
2940293047534737408,2020-10,0,870.27,1921.41,1783.08,-731.94,-7868.05
2940293047534737408,2020-11,5661.7,3363.6,2034.97,3403.65,929.42,-6938.63
2940293047534737408,2020-12,962.59,1866.95,1557.22,3286.15,-2633.29,-9571.92
2940764872507333632,2020-01,511.51,1047.98,1566.22,2436.5,-1406.75,-1406.75
2940764872507333632,2020-02,1937.12,0,1207.4,2336.59,807.93,-598.82
2940764872507333632,2020-03,0,765.47,1358.75,458.8,134.48,-464.34
2940764872507333632,2020-04,1626.26,1363.37,212.77,1.05,474.61,10.27
2940764872507333632,2020-05,0,2286.56,2389.26,1859.89,-1757.19,-1746.92
2940764872507333632,2020-06,62.43,1456.35,142.04,858.88,-2110.76,-3857.68
2940764872507333632,2020-07,3222.44,0,1294.69,2559.28,1957.85,-1899.83
2940764872507333632,2020-08,1536.42,0,0,8170.83,-6634.41,-8534.24
2940764872507333632,2020-09,0,1290.73,1016.03,3092.54,-3367.24,-11901.48
2940764872507333632,2020-10,170.79,811.4,1792.46,1915.86,-764.01,-12665.49
2940764872507333632,2020-11,2260.88,1293.3,2690.31,3189.39,468.5,-12196.99
2940764872507333632,2020-12,1163.33,231.68,1740.08,2680.44,-8.71,-12205.7
2941094327342075392,2020-01,2068.52,5156.81,2117.28,3005.16,-3976.17,-3976.17
2941094327342075392,2020-02,2473.33,2969.33,1998.13,4150.88,-2648.75,-6624.92
2941094327342075392,2020-03,2478.75,3539.99,1041.22,3905.11,-3925.13,-10550.05
2941094327342075392,2020-04,5576.75,3207.4,4369.62,2083.86,4655.11,-5894.94
2941094327342075392,2020-05,4506.92,1437.61,4381.22,8223.26,-772.73,-6667.67
2941094327342075392,2020-06,8522.54,2029.72,3992.72,5239.33,5246.21,-1421.46
2941094327342075392,2020-07,22.63,2259.37,3355.24,3569.64,-2451.14,-3872.6
2941094327342075392,2020-08,4441.04,4346.63,6917.34,4597.2,2414.55,-1458.05
2941094327342075392,2020-09,7323.03,958.6,4837.62,4052.91,7149.14,5691.09
2941094327342075392,2020-10,1073.36,3161.29,3829.02,9682.5,-7941.41,-2250.32
2941094327342075392,2020-11,2144.31,6644.23,2005.77,6098.65,-8592.8,-10843.12
2941094327342075392,2020-12,2593.05,0,1623.13,5786.76,-1570.58,-12413.7
2941204054118214656,2020-01,0,1995.66,1529.16,1946.58,-2413.08,-2413.08
2941204054118214656,2020-02,2346.03,3435.34,1151.41,587.88,-525.78,-2938.86
2941204054118214656,2020-03,2027.47,0,1965.28,2006.38,1986.37,-952.49
2941204054118214656,2020-04,0,1465.53,1481.44,2889.67,-2873.76,-3826.25
2941204054118214656,2020-05,1655.42,820.67,8279.1,467.34,8646.51,4820.26
2941204054118214656,2020-06,3782.81,3851.91,3729.68,6220.32,-2559.74,2260.52
2941204054118214656,2020-07,4917.53,2128.85,2965.27,2245.22,3508.73,5769.25
2941204054118214656,2020-08,5820.45,3859.06,2350.91,1214.13,3098.17,8867.42
2941204054118214656,2020-09,0,2693.36,1573.36,1473.15,-2593.15,6274.27
2941204054118214656,2020-10,1658.9,3585.06,113.33,1288.4,-3101.23,3173.04
2941204054118214656,2020-11,2824.61,1441.1,2616.77,2395.38,1604.9,4777.94
2941204054118214656,2020-12,239.37,5026.71,3902.83,822.01,-1706.52,3071.42
2941316468853664768,2020-01,4617.43,4844.03,2926.12,4926.69,-2227.17,-2227.17
2941316468853664768,2020-02,2958.95,3362.39,4340.33,2366.2,1570.69,-656.48
2941316468853664768,2020-03,1476.43,3739.37,1936.45,914.21,-1240.7,-1897.18
2941316468853664768,2020-04,1627.07,3879.36,3841.39,3200.71,-1611.61,-3508.79
2941316468853664768,2020-05,5344.51,5531.35,1197.5,5813.19,-4802.53,-8311.32
2941316468853664768,2020-06,2938.6,4069.75,2450.25,0,1319.1,-6992.22
2941316468853664768,2020-07,8702.1,4591.93,4129.27,6122.67,2116.77,-4875.45
2941316468853664768,2020-08,11091.84,1737.84,586.11,4185.06,5755.05,879.6
2941316468853664768,2020-09,5202.06,365.1,2169.32,2978.9,4027.38,4906.98
2941316468853664768,2020-10,4234.8,436.54,5087.35,3378.3,5507.31,10414.29
2941316468853664768,2020-11,281.7,3613.9,5809.09,9412.43,-6935.54,3478.75
2941316468853664768,2020-12,858.13,2431.86,4093.92,2430.47,89.72,3568.47
2941365674317021184,2020-03,1593.16,0,0,0,1593.16,1593.16
2941365674317021184,2020-09,711.49,0,158.04,0,869.53,2462.69
2941365674317021184,2020-10,1672.18,0,0,2207.16,-534.98,1927.71
2941365674317021184,2020-11,0,574.05,353.86,0,-220.19,1707.52
2941449287269392384,2020-01,0,5407.73,1425.81,4741.18,-8723.1,-8723.1
2941449287269392384,2020-02,4428.79,1845.36,1868.52,3117.84,1334.11,-7388.99
2941449287269392384,2020-03,71.02,223.83,57.14,3021.75,-3117.42,-10506.41
2941449287269392384,2020-04,1890.01,482.73,3015.35,1299.45,3123.18,-7383.23
2941449287269392384,2020-05,0,3870.86,2144.94,1982.8,-3708.72,-11091.95
2941449287269392384,2020-06,676.77,1561.19,1904.73,4272.42,-3252.11,-14344.06
2941449287269392384,2020-07,797.42,342.14,1022.43,2597.4,-1119.69,-15463.75
2941449287269392384,2020-08,708.73,1471.86,3849.34,639.48,2446.73,-13017.02
2941449287269392384,2020-09,655.02,0,3387.08,4105.58,-63.48,-13080.5
2941449287269392384,2020-10,2724.95,0,651.14,2719.82,656.27,-12424.23
2941449287269392384,2020-11,0,1243.87,4347.72,301.45,2802.4,-9621.83
2941449287269392384,2020-12,2660.56,205.62,3.23,3590.84,-1132.67,-10754.5
2941714830387687424,2020-04,0,1022.92,0,0,-1022.92,-1022.92
2941714830387687424,2020-06,0,1810,339.57,0,-1470.43,-2493.35
2941714830387687424,2020-07,726.42,0,0,0,726.42,-1766.93
2941714830387687424,2020-08,0,1736.93,1001.86,0,-735.07,-2502
2943213494644099072,2020-01,3923.05,5607.83,2614.93,6076.69,-5146.54,-5146.54
2943213494644099072,2020-02,3524.32,3587.5,10942.98,1327.85,9551.95,4405.41
2943213494644099072,2020-03,4647.34,3581.38,6846.46,4203.06,3709.36,8114.77
2943213494644099072,2020-04,2027.47,1285.43,6248.24,4005.38,2984.9,11099.67
2943213494644099072,2020-05,8181.5,3911.83,3440.72,2212.22,5498.17,16597.84
2943213494644099072,2020-06,2714.82,5359.9,7729.93,2965.25,2119.6,18717.44
2943213494644099072,2020-07,5424.87,12273.25,3202.36,4794.57,-8440.59,10276.85
2943213494644099072,2020-08,7655.13,8647.06,6972.43,2122.2,3858.3,14135.15
2943213494644099072,2020-09,3169.09,6741.16,2646.94,528,-1453.13,12682.02
2943213494644099072,2020-10,1947.51,6256.56,2093.79,5450.65,-7665.91,5016.11
2943213494644099072,2020-11,1590,2380.24,4883.98,5507.77,-1414.03,3602.08
2943213494644099072,2020-12,2271.35,1991.08,2700.29,9858.87,-6878.31,-3276.23
2943715859109928448,2020-01,3605.7,1446.14,49.92,2521.92,-312.44,-312.44
2943715859109928448,2020-02,163.03,5137.54,5549.65,2011.69,-1436.55,-1748.99
2943715859109928448,2020-03,5784.94,3112.36,2136.04,0,4808.62,3059.63
2943715859109928448,2020-04,5216.91,3067.31,9128.7,1912.41,9365.89,12425.52
2943715859109928448,2020-05,1699.29,1304.78,1704.96,3547.22,-1447.75,10977.77
2943715859109928448,2020-06,1737.3,2627.8,2738.7,3296.94,-1448.74,9529.03
2943715859109928448,2020-07,1621.68,1535.03,3463.68,4911.96,-1361.63,8167.4
2943715859109928448,2020-08,1240.35,1685.38,2040.16,67.15,1527.98,9695.38
2943715859109928448,2020-09,2970.23,279.05,4929.29,3304.2,4316.27,14011.65
2943715859109928448,2020-10,1889.15,817.76,2375.39,3248.97,197.81,14209.46
2943715859109928448,2020-11,0,2628.56,3128.49,1051.11,-551.18,13658.28
2943715859109928448,2020-12,5628.28,2787.89,2667.55,4057.6,1450.34,15108.62
2945126423034219520,2020-01,1138.02,1436.54,0,0,-298.52,-298.52
2945126423034219520,2020-02,0,2016.33,3305.37,2223.66,-934.62,-1233.14
2945126423034219520,2020-03,4479.35,2343.24,876.89,3111.79,-98.79,-1331.93
2945126423034219520,2020-04,4141.09,1119.94,0,1049.95,1971.2,639.27
2945126423034219520,2020-05,4200.67,2144.45,2695,1962.76,2788.46,3427.73
2945126423034219520,2020-07,2874,0,1893.32,0,4767.32,8195.05
2945126423034219520,2020-08,492.87,0,3745.03,4599.02,-361.12,7833.93
2945126423034219520,2020-09,6668.89,6789.99,3940.93,1300.52,2519.31,10353.24
2945126423034219520,2020-10,0,3200.3,0,434.04,-3634.34,6718.9
2945126423034219520,2020-11,2081.77,1458.02,2885.1,1069.6,2439.25,9158.15
2945126423034219520,2020-12,3754.36,2147.17,1872.37,0,3479.56,12637.71
2946746227057725440,2020-01,1302.65,5540.92,4539.59,3235.1,-2933.78,-2933.78
2946746227057725440,2020-02,5740.97,4598.7,7859.99,1862.56,7139.7,4205.92
2946746227057725440,2020-03,5437.13,3167.06,3057.1,5134.35,192.82,4398.74
2946746227057725440,2020-04,787.89,8793.95,2605.23,3044.68,-8445.51,-4046.77
2946746227057725440,2020-05,6274.52,5984.29,5696.11,2469.39,3516.95,-529.82
2946746227057725440,2020-06,6405.08,1075.51,10494.24,1398.32,14425.49,13895.67
2946746227057725440,2020-07,580.27,2070.79,6234.33,3631.02,1112.79,15008.46
2946746227057725440,2020-08,3174.73,4215.62,4151.78,7025.89,-3915,11093.46
2946746227057725440,2020-09,1847.84,2983.95,0,3487.99,-4624.1,6469.36
2946746227057725440,2020-10,937.37,3446.21,3308.17,6564.85,-5765.52,703.84
2946746227057725440,2020-11,6316.35,2459.42,4561.51,3732.52,4685.92,5389.76
2946746227057725440,2020-12,2496.22,7377.59,2297.69,5698.66,-8282.34,-2892.58
2947751004172453376,2020-01,5344.99,1978.92,5029.3,6423.63,1971.74,1971.74
2947751004172453376,2020-02,0,2589.35,4274.5,4360.52,-2675.37,-703.63
2947751004172453376,2020-03,7584.04,5617.69,7937.92,8324.15,1580.12,876.49
2947751004172453376,2020-04,3402.14,5365.39,5571.55,2592.58,1015.72,1892.21
2947751004172453376,2020-05,7831.65,1824.8,4107.33,3989.4,6124.78,8016.99
2947751004172453376,2020-06,3184.35,3622.33,4197.21,10104.29,-6345.06,1671.93
2947751004172453376,2020-07,3831.8,3311.97,11581.49,1755.19,10346.13,12018.06
2947751004172453376,2020-08,9921.27,5998.29,4134.68,3477.17,4580.49,16598.55
2947751004172453376,2020-09,7307.2,6216.56,3872.68,4233.24,730.08,17328.63
2947751004172453376,2020-10,3557.02,5412.91,1464.94,3069.98,-3460.93,13867.7
2947751004172453376,2020-11,6388.23,3497.29,5633.52,1766.15,6758.31,20626.01
2947751004172453376,2020-12,0,5768,4668.34,3689.86,-4789.52,15836.49
2949166700459937792,2020-01,0,1249.48,4481.4,6525.62,-3293.7,-3293.7
2949166700459937792,2020-02,6010.22,603.02,2862.7,928.29,7341.61,4047.91
2949166700459937792,2020-03,466.75,1903.78,3809.36,422.14,1950.19,5998.1
2949166700459937792,2020-04,3573.16,5732.55,1712.61,771.44,-1218.22,4779.88
2949166700459937792,2020-05,2497.09,2155.7,2637.41,4827.56,-1848.76,2931.12
2949166700459937792,2020-06,1167.84,1899.71,4886.89,2739.11,1415.91,4347.03
2949166700459937792,2020-07,553.65,2266.05,187.66,5170.36,-6695.1,-2348.07
2949166700459937792,2020-08,711.41,1682.96,1223.9,1536.3,-1283.95,-3632.02
2949166700459937792,2020-09,5558.87,6135.6,303.16,1565.22,-1838.79,-5470.81
2949166700459937792,2020-10,1765.08,5827.91,0,2237.59,-6300.42,-11771.23
2949166700459937792,2020-11,978.73,3435.08,0,0,-2456.35,-14227.58
2949166700459937792,2020-12,2503.89,1891.82,5639.74,3022.84,3228.97,-10998.61
2949663882990292992,2020-01,2672.89,1306.37,0,2081.33,-714.81,-714.81
2949663882990292992,2020-03,2359.87,0,0,0,2359.87,1645.06
2949663882990292992,2020-05,440.73,1007.44,0,0,-566.71,1078.35
2949663882990292992,2020-06,0,1716.23,1744.96,0,28.73,1107.08
2949663882990292992,2020-07,1051.54,915.53,0,2144.9,-2008.89,-901.81
2949663882990292992,2020-08,3321.83,1392.08,0,1538.07,391.68,-510.13
2949663882990292992,2020-12,3350.56,864.46,3560.61,585.15,5461.56,4951.43
2950790175869649408,2020-01,1236.13,0,0,0,1236.13,1236.13
2950790175869649408,2020-03,24.62,0,0,0,24.62,1260.75
2950790175869649408,2020-05,0,788.49,0,0,-788.49,472.26
2950790175869649408,2020-06,0,1771.34,0,0,-1771.34,-1299.08
2950790175869649408,2020-09,1199.95,0,0,0,1199.95,-99.13
2950790175869649408,2020-10,0,905.5,0,0,-905.5,-1004.63
2951087985308170240,2020-01,686.97,3088.86,0,985.19,-3387.08,-3387.08
2951087985308170240,2020-02,2682.64,5291.62,1847.22,1575.12,-2336.88,-5723.96
2951087985308170240,2020-03,2668.38,493.8,2269.75,1279.96,3164.37,-2559.59
2951087985308170240,2020-04,1607.86,1554.53,0,3953.58,-3900.25,-6459.84
2951087985308170240,2020-05,1801.29,1458.91,4526.95,2992.21,1877.12,-4582.72
2951087985308170240,2020-06,775.8,590.39,0,4833.54,-4648.13,-9230.85
2951087985308170240,2020-07,3749.9,3387.57,6035.23,579.57,5817.99,-3412.86
2951087985308170240,2020-08,2363.35,0,3379.05,1796.08,3946.32,533.46
2951087985308170240,2020-09,0,664.88,4025.42,806.41,2554.13,3087.59
2951087985308170240,2020-10,1696.32,3262.79,1228.61,5109.86,-5447.72,-2360.13
2951087985308170240,2020-11,3287.1,3474.61,2523.73,0,2336.22,-23.91
2951087985308170240,2020-12,1652,1986.83,1349.41,6426.21,-5411.63,-5435.54
2953253088711503872,2020-01,2731.43,2967.3,7465.18,4097.91,3131.4,3131.4
2953253088711503872,2020-02,6755,465,7118.77,5484.67,7924.1,11055.5
2953253088711503872,2020-03,3194.03,3536.2,858.23,2315.98,-1799.92,9255.58
2953253088711503872,2020-04,7242.82,5202.51,3334.16,7971.27,-2596.8,6658.78
2953253088711503872,2020-05,9648.28,5111.34,5034.93,74.39,9497.48,16156.26
2953253088711503872,2020-06,4671.52,5647.25,1604.05,6707.79,-6079.47,10076.79
2953253088711503872,2020-07,4059.07,4986.31,4509.79,3737.25,-154.7,9922.09
2953253088711503872,2020-08,2859.66,9283.87,3861.37,5517.92,-8080.76,1841.33
2953253088711503872,2020-09,663.76,1253.81,4077.9,2896.04,591.81,2433.14
2953253088711503872,2020-10,4041.95,1111.65,3928.91,5274.02,1585.19,4018.33
2953253088711503872,2020-11,1275.76,1941.01,8222.89,5324.31,2233.33,6251.66
2953253088711503872,2020-12,6946.59,4059.47,4428.34,739.06,6576.4,12828.06
2953728048780692992,2020-01,2234.15,1359.19,93.12,3214.74,-2246.66,-2246.66
2953728048780692992,2020-02,1054.9,1013.48,1571.4,0,1612.82,-633.84
2953728048780692992,2020-03,0,617.93,2479.31,0,1861.38,1227.54
2953728048780692992,2020-04,1067.3,0,2035.47,0,3102.77,4330.31
2953728048780692992,2020-05,2817.15,1715,147.68,0,1249.83,5580.14
2953728048780692992,2020-06,1948.14,1316.73,0,0,631.41,6211.55
2953728048780692992,2020-07,840.84,686.03,0,0,154.81,6366.36
2953728048780692992,2020-08,345.25,0,1556.74,0,1901.99,8268.35
2953728048780692992,2020-09,0,116.57,0,1935.45,-2052.02,6216.33
2953728048780692992,2020-11,3093.09,590.19,296.73,432.6,2367.03,8583.36
2954357458117190144,2020-01,603.11,0,20.27,877.31,-253.93,-253.93
2954357458117190144,2020-02,1683.61,0,0,0,1683.61,1429.68
2954357458117190144,2020-03,1790.94,1502.03,0,1340.73,-1051.82,377.86
2954357458117190144,2020-04,2436.94,695.62,0,4798.91,-3057.59,-2679.73
2954357458117190144,2020-05,0,2044.94,1873.32,794.67,-966.29,-3646.02
2954357458117190144,2020-06,0,1330.27,2273.11,231.59,711.25,-2934.77
2954357458117190144,2020-07,1145.42,1851.1,1732.49,1746.42,-719.61,-3654.38
2954357458117190144,2020-08,95,28.67,1759.14,0,1825.47,-1828.91
2954357458117190144,2020-09,0,1412.37,1327.73,0,-84.64,-1913.55
2954357458117190144,2020-10,3230.7,346.08,1232.01,2040.77,2075.86,162.31
2954357458117190144,2020-11,1959.6,973.05,345.42,2414.7,-1082.73,-920.42
2954357458117190144,2020-12,372.37,1622.63,1618.03,743.9,-376.13,-1296.55
2956055209823356416,2020-01,0,3192.76,1686.44,1909.8,-3416.12,-3416.12
2956055209823356416,2020-02,2007.71,0,0,0,2007.71,-1408.41
2956055209823356416,2020-03,2369.96,2503.49,0,3087.44,-3220.97,-4629.38
2956055209823356416,2020-04,1349.51,437.69,1734.77,0,2646.59,-1982.79
2956055209823356416,2020-05,3278.09,1712.03,800.02,130.47,2235.61,252.82
2956055209823356416,2020-06,586.44,431.31,1541.13,2617.5,-921.24,-668.42
2956055209823356416,2020-07,3929.9,1221.65,0,2909.76,-201.51,-869.93
2956055209823356416,2020-08,0,1729.18,1968.37,3225.13,-2985.94,-3855.87
2956055209823356416,2020-09,0,1480.95,334.52,2264.69,-3411.12,-7266.99
2956055209823356416,2020-10,0,1745.94,5172.89,0,3426.95,-3840.04
2956055209823356416,2020-11,435.44,1029.07,1047.35,0,453.72,-3386.32
2956055209823356416,2020-12,3865.01,3152.47,0,0,712.54,-2673.78
2956522121084559872,2020-01,1402.39,0,0,0,1402.39,1402.39
2956522121084559872,2020-03,0,1530.33,1940.39,2335.95,-1925.89,-523.5
2956522121084559872,2020-04,0,759.66,0,0,-759.66,-1283.16
2956522121084559872,2020-06,0,113.44,0,190.39,-303.83,-1586.99
2956522121084559872,2020-07,658.05,0,741.66,0,1399.71,-187.28
2956522121084559872,2020-08,1983.34,500.48,0,0,1482.86,1295.58
2956522121084559872,2020-12,1908.95,0,1044.12,0,2953.07,4248.65
2956717885003385856,2020-01,4697.72,2709.05,535.02,6492.39,-3968.7,-3968.7
2956717885003385856,2020-02,1740.39,2555.2,3681.06,2019.85,846.4,-3122.3
2956717885003385856,2020-03,4653.86,9922.55,3572.7,5501.23,-7197.22,-10319.52
2956717885003385856,2020-04,1113.53,7820.21,6594.11,2096.26,-2208.83,-12528.35
2956717885003385856,2020-05,5028.18,2158.49,2886.15,7566.32,-1810.48,-14338.83
2956717885003385856,2020-06,2626.27,4263.39,2045.68,0,408.56,-13930.27
2956717885003385856,2020-07,5723.91,7370.66,116.2,4492.34,-6022.89,-19953.16
2956717885003385856,2020-08,4802.03,1619.99,4572.77,4585.94,3168.87,-16784.29
2956717885003385856,2020-09,4944.29,8512.6,6937.53,3352.47,16.75,-16767.54
2956717885003385856,2020-10,3359.18,3934.33,5177.78,6066.55,-1463.92,-18231.46
2956717885003385856,2020-11,5128.99,886.36,9447.35,1780.94,11909.04,-6322.42
2956717885003385856,2020-12,5793.45,839.43,5633.41,617.15,9970.28,3647.86
2956958841598940672,2020-01,3587.44,7075.33,8611.62,4698.19,425.54,425.54
2956958841598940672,2020-02,3378.89,3086.28,6741.68,3622.26,3412.03,3837.57
2956958841598940672,2020-03,6242.86,5304.29,1148.37,4485.83,-2398.89,1438.68
2956958841598940672,2020-04,4603.74,4677.64,5836.71,5962.48,-199.67,1239.01
2956958841598940672,2020-05,3577.62,5152.72,5751.15,6503.85,-2327.8,-1088.79
2956958841598940672,2020-06,7476.64,3171.84,2764.97,11234.67,-4164.9,-5253.69
2956958841598940672,2020-07,4251.43,12290.55,5141.32,3324.27,-6222.07,-11475.76
2956958841598940672,2020-08,1561.97,8521.91,6750.47,7927.59,-8137.06,-19612.82
2956958841598940672,2020-09,4021.28,4819.52,9976.25,554.78,8623.23,-10989.59
2956958841598940672,2020-10,5534.21,2407.91,5761.54,5640.33,3247.51,-7742.08
2956958841598940672,2020-11,4444.83,4011.88,1846.89,6112.16,-3832.32,-11574.4
2956958841598940672,2020-12,7620.91,2629.76,4858.15,3318.36,6530.94,-5043.46
2961147902348049408,2020-02,2568.78,1346.69,0,0,1222.09,1222.09
2961147902348049408,2020-03,2185.8,0,1372.06,637.9,2919.96,4142.05
2961147902348049408,2020-04,608.94,762.37,0,1244.41,-1397.84,2744.21
2961147902348049408,2020-07,2047.21,0,1389.37,0,3436.58,6180.79
2961147902348049408,2020-08,0,803.39,1570.43,0,767.04,6947.83
2961147902348049408,2020-09,871.41,1093.12,0,0,-221.71,6726.12
2961147902348049408,2020-10,2041.38,3092.95,0,1957.04,-3008.61,3717.51
2961147902348049408,2020-11,1575.63,0,1291.06,1555.65,1311.04,5028.55
2961147902348049408,2020-12,510.61,0,0,0,510.61,5539.16
2961280050973780480,2020-01,3518.93,2659.95,1867.26,3135.88,-409.64,-409.64
2961280050973780480,2020-02,2394.32,5604.56,531.59,3161.11,-5839.76,-6249.4
2961280050973780480,2020-03,2191.46,3453.67,3370.29,2699.28,-591.2,-6840.6
2961280050973780480,2020-05,0,3745.92,3333.31,677.23,-1089.84,-7930.44
2961280050973780480,2020-06,1322.22,3130.34,0,1615.03,-3423.15,-11353.59
2961280050973780480,2020-07,2230.29,2302.3,1649.56,3479.71,-1902.16,-13255.75
2961280050973780480,2020-08,3660.31,2494.1,752.41,1787.37,131.25,-13124.5
2961280050973780480,2020-09,1480.12,0,3051.22,4050.84,480.5,-12644
2961280050973780480,2020-10,2444.77,2209.42,2791.46,3356.67,-329.86,-12973.86
2961280050973780480,2020-11,5465.11,3091.18,809.27,4287.61,-1104.41,-14078.27
2961280050973780480,2020-12,2368.21,5586.96,8695.07,0,5476.32,-8601.95
2962272832597041152,2020-01,861.83,1453.32,5610.36,386.06,4632.81,4632.81
2962272832597041152,2020-02,3316.06,567.45,1868.57,6213.54,-1596.36,3036.45
2962272832597041152,2020-03,5017.53,4395.38,4292.16,8353.92,-3439.61,-403.16
2962272832597041152,2020-04,1585.29,6241.79,1838.27,0,-2818.23,-3221.39
2962272832597041152,2020-05,0,582.62,180.81,1675.34,-2077.15,-5298.54
2962272832597041152,2020-06,2851.58,3178.62,2198.85,4072.71,-2200.9,-7499.44
2962272832597041152,2020-07,1904.29,4686.96,1869.47,2022.52,-2935.72,-10435.16
2962272832597041152,2020-08,1067.71,3245.81,1106.47,1960.78,-3032.41,-13467.57
2962272832597041152,2020-09,1744.74,3670.63,4498.53,2913.59,-340.95,-13808.52
2962272832597041152,2020-10,3846.08,1014.71,3654.79,2199.18,4286.98,-9521.54
2962272832597041152,2020-11,5386.78,691.13,4038.81,4682.37,4052.09,-5469.45
2962272832597041152,2020-12,1723.05,5831.7,3195.53,1995.8,-2908.92,-8378.37
2962806535114024960,2020-01,3503.85,0,3914.13,1094.33,6323.65,6323.65
2962806535114024960,2020-02,536.74,1278.02,0,0,-741.28,5582.37
2962806535114024960,2020-03,152.16,0,0,3511.02,-3358.86,2223.51
2962806535114024960,2020-04,128,2572.59,687.96,0,-1756.63,466.88
2962806535114024960,2020-06,0,23.79,0,1752.35,-1776.14,-1309.26
2962806535114024960,2020-07,1463.43,1388.86,1029.85,3263.58,-2159.16,-3468.42
2962806535114024960,2020-08,1836.32,426.88,1662.85,0,3072.29,-396.13
2962806535114024960,2020-09,262.42,1505.04,1180.54,3452.9,-3514.98,-3911.11
2962806535114024960,2020-10,1802.7,2182.41,1514.95,341.79,793.45,-3117.66
2962806535114024960,2020-12,0,500.4,452.57,2100.53,-2148.36,-5266.02
2962876219943366144,2020-01,643.53,0,0,0,643.53,643.53
2962876219943366144,2020-03,1012.23,2624.48,0,0,-1612.25,-968.72
2962876219943366144,2020-06,224.37,0,0,0,224.37,-744.35
2962876219943366144,2020-10,2323.92,0,0,2218.52,105.4,-638.95
2964474187239879680,2020-01,0,1704.18,0,2931.65,-4635.83,-4635.83
2964474187239879680,2020-02,0,1998.35,1970.83,0,-27.52,-4663.35
2964474187239879680,2020-03,437.11,1601.51,217.9,786.55,-1733.05,-6396.4
2964474187239879680,2020-05,853.8,0,1221.46,1391.58,683.68,-5712.72
2964474187239879680,2020-06,461.94,0,1402.52,0,1864.46,-3848.26
2964474187239879680,2020-07,0,1824.91,0,958.65,-2783.56,-6631.82
2964474187239879680,2020-08,893.45,0,192.04,1769.88,-684.39,-7316.21
2964474187239879680,2020-09,0,741.68,1750.66,0,1008.98,-6307.23
2964474187239879680,2020-10,0,1187.99,0,399.93,-1587.92,-7895.15
2964474187239879680,2020-11,815.63,0,2125.34,0,2940.97,-4954.18
2964474187239879680,2020-12,887.29,0,0,0,887.29,-4066.89
2965036092520983552,2020-01,1052.46,3331.72,3540.45,1003.47,257.72,257.72
2965036092520983552,2020-02,1227.66,513.81,957.24,2643.96,-972.87,-715.15
2965036092520983552,2020-03,1332.77,2087.49,3107.15,5575.65,-3223.22,-3938.37
2965036092520983552,2020-04,1379.5,5042.28,385.25,2473.37,-5750.9,-9689.27
2965036092520983552,2020-05,45.47,2017.73,1481.57,2869.8,-3360.49,-13049.76
2965036092520983552,2020-06,1447.26,613.3,328.97,1541.08,-378.15,-13427.91
2965036092520983552,2020-07,1454.39,4891.51,3759.52,2060.37,-1737.97,-15165.88
2965036092520983552,2020-08,1911.1,2920.14,2713.51,1585.26,119.21,-15046.67
2965036092520983552,2020-09,585.69,1883.28,9232.85,722.28,7212.98,-7833.69
2965036092520983552,2020-10,1022.86,971.88,4603.43,2532.22,2122.19,-5711.5
2965036092520983552,2020-11,3871.97,0,0,2426.98,1444.99,-4266.51
2965036092520983552,2020-12,1263.24,1200.82,2114.62,2885.49,-708.45,-4974.96
2966558018685396992,2020-01,4868.29,9316.71,5047.11,841.31,-242.62,-242.62
2966558018685396992,2020-02,3873.61,4471.51,4280.44,5093.29,-1410.75,-1653.37
2966558018685396992,2020-03,2149.09,4361.92,0,7814.98,-10027.81,-11681.18
2966558018685396992,2020-04,4049.52,7546.41,7141.31,6141.92,-2497.5,-14178.68
2966558018685396992,2020-05,7976.56,1583.46,1107,7347.76,152.34,-14026.34
2966558018685396992,2020-06,0,2540.07,7750.78,3479.4,1731.31,-12295.03
2966558018685396992,2020-07,3907.42,7405.68,3347.23,6077.2,-6228.23,-18523.26
2966558018685396992,2020-08,5755.8,4049.4,3412.36,3227.35,1891.41,-16631.85
2966558018685396992,2020-09,1978.87,2561.98,718.03,1440.48,-1305.56,-17937.41
2966558018685396992,2020-10,5502.94,3832.15,3515.55,4241.22,945.12,-16992.29
2966558018685396992,2020-11,2724.42,5867.53,7880.29,4128.87,608.31,-16383.98
2966558018685396992,2020-12,3016.45,4179.34,171.99,7303.89,-8294.79,-24678.77
2966889399171786752,2020-01,0,1212.66,2139.49,249.74,677.09,677.09
2966889399171786752,2020-02,3714.8,1463.76,0,201.77,2049.27,2726.36
2966889399171786752,2020-03,869.65,2687.14,0,104.35,-1921.84,804.52
2966889399171786752,2020-04,0,1486.92,2336.49,0,849.57,1654.09
2966889399171786752,2020-05,0,904.32,2608.8,0,1704.48,3358.57
2966889399171786752,2020-06,3997.06,0,1524.54,1263.11,4258.49,7617.06
2966889399171786752,2020-07,3075.9,0,3360.94,1770.29,4666.55,12283.61
2966889399171786752,2020-09,921.42,0,1775.62,1198.06,1498.98,13782.59
2966889399171786752,2020-11,544.52,358.05,353.21,392.5,147.18,13929.77
2966889399171786752,2020-12,601.38,2982.78,954.69,181.82,-1608.53,12321.24
2967478431683690496,2020-01,3332.84,3499.38,1202.74,6223.88,-5187.68,-5187.68
2967478431683690496,2020-02,1372.41,2752.25,3868.36,2456.48,32.04,-5155.64
2967478431683690496,2020-03,3960.49,6367.44,3615.35,6306.16,-5097.76,-10253.4
2967478431683690496,2020-04,1421.49,678.55,5927.06,5651.2,1018.8,-9234.6
2967478431683690496,2020-05,6107.99,9313.1,2188.73,5173.41,-6189.79,-15424.39
2967478431683690496,2020-06,2372.72,1989.68,1280.79,3615.02,-1951.19,-17375.58
2967478431683690496,2020-07,2380.34,957.04,3002.24,6884.02,-2458.48,-19834.06
2967478431683690496,2020-08,1193.74,3828.05,6538.16,2873.4,1030.45,-18803.61
2967478431683690496,2020-09,989.31,2334.73,6087.38,2440.39,2301.57,-16502.04
2967478431683690496,2020-10,5182.22,1111.48,2309.13,3073.49,3306.38,-13195.66
2967478431683690496,2020-11,6096.67,4797.56,2225.29,4864.22,-1339.82,-14535.48
2967478431683690496,2020-12,154.15,1077.24,3788.59,3683.79,-818.29,-15353.77
2968451932276558848,2020-01,1854.71,384.78,445.58,2963,-1047.49,-1047.49
2968451932276558848,2020-02,1338.9,985.21,1723.92,3143.35,-1065.74,-2113.23
2968451932276558848,2020-03,582.93,1494.73,0,2811.8,-3723.6,-5836.83
2968451932276558848,2020-04,1228.76,1028.02,0,422.09,-221.35,-6058.18
2968451932276558848,2020-05,1485.38,2118.95,1950.78,3168.1,-1850.89,-7909.07
2968451932276558848,2020-06,1554.51,1857.66,60.52,618.62,-861.25,-8770.32
2968451932276558848,2020-07,3072.15,487.12,238.75,655.38,2168.4,-6601.92
2968451932276558848,2020-08,1234.92,1395.1,552.45,0,392.27,-6209.65
2968451932276558848,2020-09,1774.21,715.98,1106.25,1561.66,602.82,-5606.83
2968451932276558848,2020-10,1986.63,0,0,1700.3,286.33,-5320.5
2968451932276558848,2020-11,375.28,1990.75,1963.2,0,347.73,-4972.77
2968451932276558848,2020-12,0,566.42,1634.92,1578.9,-510.4,-5483.17
2969035751846470656,2020-01,0,279.4,0,0,-279.4,-279.4
2969035751846470656,2020-02,0,1123.58,1043.44,0,-80.14,-359.54
2969035751846470656,2020-03,79.18,0,0,0,79.18,-280.36
2969035751846470656,2020-04,933.2,0,0,1677.78,-744.58,-1024.94
2969035751846470656,2020-05,1494.81,625.28,149.07,0,1018.6,-6.34
2969035751846470656,2020-07,616.21,158.74,0,0,457.47,451.13
2969035751846470656,2020-08,1170.39,611.85,533.86,0,1092.4,1543.53
2969035751846470656,2020-12,0,1591.77,1924.87,0,333.1,1876.63
2969670869022269440,2020-01,0,1962,1449.41,496.83,-1009.42,-1009.42
2969670869022269440,2020-02,2996.34,2413.59,1705.87,1155.17,1133.45,124.03
2969670869022269440,2020-03,653.02,2874.63,1272.95,1045.05,-1993.71,-1869.68
2969670869022269440,2020-04,0,2085.86,3806.67,1761.93,-41.12,-1910.8
2969670869022269440,2020-05,1556.81,103.85,2433.12,1047.17,2838.91,928.11
2969670869022269440,2020-06,2441.87,1442.47,551.87,2142.73,-591.46,336.65
2969670869022269440,2020-07,253.82,2265.25,2765.71,1642.6,-888.32,-551.67
2969670869022269440,2020-08,0,934.52,1213.17,3797.23,-3518.58,-4070.25
2969670869022269440,2020-09,1741.66,2422.69,823.6,1390.45,-1247.88,-5318.13
2969670869022269440,2020-10,910.19,1126.82,3157.26,0,2940.63,-2377.5
2969670869022269440,2020-11,1528.65,3408.1,1570.53,2198.69,-2507.61,-4885.11
2969670869022269440,2020-12,6436.31,1706.75,0,2056.65,2672.91,-2212.2
2970688064066182656,2020-01,3981.72,3536.81,2001.88,5755.13,-3308.34,-3308.34
2970688064066182656,2020-02,8722.22,4253.95,5358.37,4740.18,5086.46,1778.12
2970688064066182656,2020-03,8407.21,0,2269.31,4722.59,5953.93,7732.05
2970688064066182656,2020-04,4478.69,6833.42,3438,3237.36,-2154.09,5577.96
2970688064066182656,2020-05,2394.87,7507.46,3117.31,2305.3,-4300.58,1277.38
2970688064066182656,2020-06,4057.73,6022.29,2758.06,5242.79,-4449.29,-3171.91
2970688064066182656,2020-07,7484.01,5700.91,3225.22,7711.89,-2703.57,-5875.48
2970688064066182656,2020-08,4743.13,8006.54,2937.58,5674.67,-6000.5,-11875.98
2970688064066182656,2020-09,5064.75,4675.23,7176.11,8789.8,-1224.17,-13100.15
2970688064066182656,2020-10,5803.97,3075.76,2741.07,637.27,4832.01,-8268.14
2970688064066182656,2020-11,1449.23,4835.17,5916.45,5215.26,-2684.75,-10952.89
2970688064066182656,2020-12,5888.7,627.98,9254.06,773.81,13740.97,2788.08
2970695966042196992,2020-03,1911.73,0,374.87,0,2286.6,2286.6
2970695966042196992,2020-05,542.27,0,0,0,542.27,2828.87
2970695966042196992,2020-06,1873.26,0,0,0,1873.26,4702.13
2970695966042196992,2020-08,1542.19,1173.08,0,0,369.11,5071.24
2970695966042196992,2020-10,0,492.07,0,0,-492.07,4579.17
2971546107121325568,2020-01,5313.3,5459.22,4813.86,1646.17,3021.77,3021.77
2971546107121325568,2020-02,2962.6,4891.63,5863.24,4597.32,-663.11,2358.66
2971546107121325568,2020-03,2126.6,4506.67,4890.92,4047.48,-1536.63,822.03
2971546107121325568,2020-04,1089.71,729.64,2970.48,1572.53,1758.02,2580.05
2971546107121325568,2020-05,1579.16,2088.63,4675.53,697.02,3469.04,6049.09
2971546107121325568,2020-06,2181.32,6779.89,0,6815.39,-11413.96,-5364.87
2971546107121325568,2020-07,2775.91,643.01,4229,7633.78,-1271.88,-6636.75
2971546107121325568,2020-08,3011.81,4443.57,1669.13,6630.91,-6393.54,-13030.29
2971546107121325568,2020-09,4424.57,2991.95,2874.7,1978.24,2329.08,-10701.21
2971546107121325568,2020-10,1353.95,2230.75,3633.12,2751.99,4.33,-10696.88
2971546107121325568,2020-11,2379.56,6976.4,2816.78,1777.32,-3557.38,-14254.26
2971546107121325568,2020-12,1468.7,2762.12,3122.68,4911.91,-3082.65,-17336.91
2976181457961640448,2020-01,5682.34,5723.65,6050.26,4732.62,1276.33,1276.33
2976181457961640448,2020-02,2007.78,6788.85,10946.28,5854.59,310.62,1586.95
2976181457961640448,2020-03,7501.16,5828.01,7736.62,4934.02,4475.75,6062.7
2976181457961640448,2020-04,955.82,2267.81,3561.56,3957.51,-1707.94,4354.76
2976181457961640448,2020-05,5089.81,4436.95,4055.5,5522.3,-813.94,3540.82
2976181457961640448,2020-06,4295.41,6472.29,6892.66,4258.66,457.12,3997.94
2976181457961640448,2020-07,5041.16,5340.97,1571.31,721.51,549.99,4547.93
2976181457961640448,2020-08,4070.09,2595.08,2732.7,3538.65,669.06,5216.99
2976181457961640448,2020-09,4544.03,2855.57,4802.66,5286.91,1204.21,6421.2
2976181457961640448,2020-10,4120.31,7790.01,3801.53,6097.24,-5965.41,455.79
2976181457961640448,2020-11,3789.93,1952,4075.2,5712.2,200.93,656.72
2976181457961640448,2020-12,6141.48,3503.3,2255.15,3127.65,1765.68,2422.4
2976280670278968320,2020-01,6364.57,1093.9,1622.22,3822.04,3070.85,3070.85
2976280670278968320,2020-02,1586.04,6040.4,1625.35,339.95,-3168.96,-98.11
2976280670278968320,2020-03,2154.76,5058.25,1905.09,1827.7,-2826.1,-2924.21
2976280670278968320,2020-04,606.65,3335.11,6794.81,2646.93,1419.42,-1504.79
2976280670278968320,2020-05,3509.65,4871.33,3758.67,3857.91,-1460.92,-2965.71
2976280670278968320,2020-06,1000.61,4428.1,2795.23,3766.76,-4399.02,-7364.73
2976280670278968320,2020-07,546.48,0,3557.44,4116.44,-12.52,-7377.25
2976280670278968320,2020-08,7008.13,4335.89,3220.03,2449.54,3442.73,-3934.52
2976280670278968320,2020-09,3855.13,7012.6,3773.78,5567.17,-4950.86,-8885.38
2976280670278968320,2020-10,1400.57,6756.81,4614.42,1891.52,-2633.34,-11518.72
2976280670278968320,2020-11,3688.67,1006.06,2608.55,4970.63,320.53,-11198.19
2976280670278968320,2020-12,5285.86,4164.83,2983.29,4810.11,-705.79,-11903.98
2976364869602783232,2020-01,2693.47,2011.83,2585.83,8978.19,-5710.72,-5710.72
2976364869602783232,2020-02,1638.86,1981.5,1346.4,1720.98,-717.22,-6427.94
2976364869602783232,2020-03,4010.73,3277.57,2595.8,1217.56,2111.4,-4316.54
2976364869602783232,2020-04,6916.37,3225.11,5086.37,0,8777.63,4461.09
2976364869602783232,2020-05,0,3258.07,4297.93,4101.21,-3061.35,1399.74
2976364869602783232,2020-06,4177.66,3095.35,6099.81,2592.98,4589.14,5988.88
2976364869602783232,2020-07,6533.17,2864.67,2448.83,2533.4,3583.93,9572.81
2976364869602783232,2020-08,5086.39,2346.24,1271.57,4025.85,-14.13,9558.68
2976364869602783232,2020-09,8933.14,8676.66,2453.68,7385.6,-4675.44,4883.24
2976364869602783232,2020-10,6324.07,2614.56,3903.13,8968.3,-1355.66,3527.58
2976364869602783232,2020-11,1811.03,4086.08,4074.38,5481.75,-3682.42,-154.84
2976364869602783232,2020-12,4751.92,1867.97,649.63,2662.19,871.39,716.55
2977519790025158656,2020-01,6584.74,451.16,3460.7,3721.19,5873.09,5873.09
2977519790025158656,2020-02,5520.82,0,781.62,694.27,5608.17,11481.26
2977519790025158656,2020-03,2537.75,1297.18,917.92,2961.9,-803.41,10677.85
2977519790025158656,2020-04,4017.7,0,1745.37,3503.01,2260.06,12937.91
2977519790025158656,2020-05,455.4,1511.53,937.72,3613.1,-3731.51,9206.4
2977519790025158656,2020-06,2280.64,3271.41,661.44,3409.66,-3738.99,5467.41
2977519790025158656,2020-07,5823.12,1856.29,820.8,2032.57,2755.06,8222.47
2977519790025158656,2020-08,1960.3,965.41,3887.2,1626.23,3255.86,11478.33
2977519790025158656,2020-09,3369.16,0,4510.15,3816.31,4063,15541.33
2977519790025158656,2020-10,2987.7,3016.22,1090.45,2873.28,-1811.35,13729.98
2977519790025158656,2020-11,0,1726.01,1080.14,753.59,-1399.46,12330.52
2977519790025158656,2020-12,1849.1,710.93,1882.56,305.14,2715.59,15046.11
2978446283380732416,2020-01,1669.45,3372.8,2136.86,5975.87,-5542.36,-5542.36
2978446283380732416,2020-02,2417.07,4981.87,4105.15,3864.01,-2323.66,-7866.02
2978446283380732416,2020-03,3556.18,4339.75,2416.18,539.62,1092.99,-6773.03
2978446283380732416,2020-04,3029.67,1307.91,5584.65,7487.32,-180.91,-6953.94
2978446283380732416,2020-05,2887.88,5387.82,1504.61,9766.69,-10762.02,-17715.96
2978446283380732416,2020-06,4209.7,0,3048.75,5359.42,1899.03,-15816.93
2978446283380732416,2020-07,10347.78,1165.44,5857.95,4540.27,10500.02,-5316.91
2978446283380732416,2020-08,434,4363.76,2353.77,10535,-12110.99,-17427.9
2978446283380732416,2020-09,6028.44,7171.16,4435.85,628.26,2664.87,-14763.03
2978446283380732416,2020-10,3974.28,5468.11,1297.94,106.41,-302.3,-15065.33
2978446283380732416,2020-11,2138.19,7112.04,1829.64,4398.05,-7542.26,-22607.59
2978446283380732416,2020-12,5078.36,7384.37,3929.76,3834.87,-2211.12,-24818.71
2978478050201703424,2020-01,465.83,2743.92,1795.42,1509.25,-1991.92,-1991.92
2978478050201703424,2020-02,0,1035.04,1250.8,565.73,-349.97,-2341.89
2978478050201703424,2020-03,989.02,0,872.25,2843.58,-982.31,-3324.2
2978478050201703424,2020-04,1953.92,797.03,1732.26,0,2889.15,-435.05
2978478050201703424,2020-06,1831.38,660.65,1516.64,0,2687.37,2252.32
2978478050201703424,2020-07,1776.26,809.5,1698.49,0,2665.25,4917.57
2978478050201703424,2020-08,2489.53,0,0,1016.77,1472.76,6390.33
2978478050201703424,2020-09,4546.82,1358.98,0,767.67,2420.17,8810.5
2978478050201703424,2020-10,1700.49,2994.69,343.59,0,-950.61,7859.89
2978478050201703424,2020-11,2383.98,1508.6,0,1825.91,-950.53,6909.36
2978478050201703424,2020-12,3058.62,437.64,0,1084.35,1536.63,8445.99
2978947492045198848,2020-01,3222.08,2273.61,1199.27,2598.22,-450.48,-450.48
2978947492045198848,2020-02,0,1040.62,2572.33,2710.16,-1178.45,-1628.93
2978947492045198848,2020-03,1953.84,3373.86,0,506.4,-1926.42,-3555.35
2978947492045198848,2020-04,4281.72,796.9,1570.15,0,5054.97,1499.62
2978947492045198848,2020-05,0,3928.21,325.39,756.09,-4358.91,-2859.29
2978947492045198848,2020-06,1051.63,5379.74,0,3631.01,-7959.12,-10818.41
2978947492045198848,2020-08,1760.11,2202.91,3240.47,1146.4,1651.27,-9167.14
2978947492045198848,2020-09,1595.95,2108.31,2679.11,172.88,1993.87,-7173.27
2978947492045198848,2020-10,2411.21,1446.52,3198.14,5379.53,-1216.7,-8389.97
2978947492045198848,2020-11,4609.82,5401.26,1778.59,823.1,164.05,-8225.92
2978947492045198848,2020-12,1152.12,1895.2,1907.85,0,1164.77,-7061.15
2979237365562676224,2020-01,0,7007.42,4604.84,2680.42,-5083,-5083
2979237365562676224,2020-02,2765.66,4760.09,7033.1,2170.38,2868.29,-2214.71
2979237365562676224,2020-03,4605.26,2468.91,4006.05,6345.36,-202.96,-2417.67
2979237365562676224,2020-04,5652.03,4427.92,4296.09,865.85,4654.35,2236.68
2979237365562676224,2020-05,3720.1,4446.24,2166.19,4947.73,-3507.68,-1271
2979237365562676224,2020-06,5709.66,4850.08,3309.02,2518.82,1649.78,378.78
2979237365562676224,2020-07,3763.88,3106.9,4440.66,2057.09,3040.55,3419.33
2979237365562676224,2020-08,1357.08,3473.99,1678.34,1036.58,-1475.15,1944.18
2979237365562676224,2020-09,2215.79,970.38,2028.98,4944.42,-1670.03,274.15
2979237365562676224,2020-10,780.81,7012.77,2494.4,2948.17,-6685.73,-6411.58
2979237365562676224,2020-11,2629.35,1870.9,1002.36,2434.96,-674.15,-7085.73
2979237365562676224,2020-12,4130.82,1863.7,1171.98,3283.62,155.48,-6930.25
2979735802076084736,2020-01,2341.05,1351.59,0,0,989.46,989.46
2979735802076084736,2020-02,114.83,0,0,0,114.83,1104.29
2979735802076084736,2020-03,0,441.43,942.16,1673.3,-1172.57,-68.28
2979735802076084736,2020-04,633.65,328.44,1610.69,2007.63,-91.73,-160.01
2979735802076084736,2020-06,493.45,0,1825.35,0,2318.8,2158.79
2979735802076084736,2020-07,798.54,2797.41,1644.18,0,-354.69,1804.1
2979735802076084736,2020-08,1888.03,0,0,1495.68,392.35,2196.45
2979735802076084736,2020-09,0,633.76,747.92,1015.57,-901.41,1295.04
2979735802076084736,2020-10,1198.35,0,1540.78,730.8,2008.33,3303.37
2980524244762993152,2020-01,3096.11,1097.87,2813.96,3930.43,881.77,881.77
2980524244762993152,2020-02,3413.41,339.1,0,2893.05,181.26,1063.03
2980524244762993152,2020-04,1818.68,267.32,1980.73,4094.7,-562.61,500.42
2980524244762993152,2020-05,1684.31,7044.74,0,1438.04,-6798.47,-6298.05
2980524244762993152,2020-06,2487.59,2699.98,4459.19,2168.37,2078.43,-4219.62
2980524244762993152,2020-07,1096.29,1399.05,2606.49,0,2303.73,-1915.89
2980524244762993152,2020-08,469.12,0,1152.36,3272.68,-1651.2,-3567.09
2980524244762993152,2020-09,2383.18,2366.11,965.19,0,982.26,-2584.83
2980524244762993152,2020-10,1871.6,6965.92,488.92,1591.59,-6196.99,-8781.82
2980524244762993152,2020-11,1779.16,4348.82,4208.28,222.59,1416.03,-7365.79
2980524244762993152,2020-12,1773.68,264.75,3355.12,1475.42,3388.63,-3977.16
2981290475652246528,2020-01,1200.98,6687.79,2288.89,1029.35,-4227.27,-4227.27
2981290475652246528,2020-02,760.94,1312.4,2492.5,2682.08,-741.04,-4968.31
2981290475652246528,2020-03,1908.88,1390.16,2893.67,2426.28,986.11,-3982.2
2981290475652246528,2020-04,4587.67,2359.94,1441.7,1391.12,2278.31,-1703.89
2981290475652246528,2020-05,5234.36,1377.32,2344.81,188.3,6013.55,4309.66
2981290475652246528,2020-06,2530.2,3270.17,2373.45,52.08,1581.4,5891.06
2981290475652246528,2020-07,3584.06,2447.6,1612.51,6937.53,-4188.56,1702.5
2981290475652246528,2020-08,3519.75,1872.42,5245.09,2153,4739.42,6441.92
2981290475652246528,2020-09,2317.2,2353.78,3800.63,872.41,2891.64,9333.56
2981290475652246528,2020-10,5156.1,1239.21,2690.53,2631.72,3975.7,13309.26
2981290475652246528,2020-11,2506.24,1861.6,837.1,5970.87,-4489.13,8820.13
2981290475652246528,2020-12,664.83,5156.5,0,5808.2,-10299.87,-1479.74
2985080186464538112,2020-01,427.31,2094.62,1593.98,1778.48,-1851.81,-1851.81
2985080186464538112,2020-02,2332.06,1456.75,2646.18,3203.48,318.01,-1533.8
2985080186464538112,2020-03,1971.31,1346.36,2869.96,2481.92,1012.99,-520.81
2985080186464538112,2020-04,4838.55,1855.77,3171.45,7696.42,-1542.19,-2063
2985080186464538112,2020-06,2010.64,1233.49,5722.82,1367.65,5132.32,3069.32
2985080186464538112,2020-07,2324.48,5154.41,2262.64,6700.26,-7267.55,-4198.23
2985080186464538112,2020-08,5007.57,4121.01,5850.24,5358.2,1378.6,-2819.63
2985080186464538112,2020-09,3166.04,1265.85,1696.96,0,3597.15,777.52
2985080186464538112,2020-10,894.43,689.91,2106.03,3365.98,-1055.43,-277.91
2985080186464538112,2020-11,0,3045.02,3503.69,4304.55,-3845.88,-4123.79
2985080186464538112,2020-12,402.74,1546.62,4079.54,8415.53,-5479.87,-9603.66
2986604095275190272,2020-01,0,1914.63,1100.07,2288.14,-3102.7,-3102.7
2986604095275190272,2020-02,1954.24,2973.96,0,0,-1019.72,-4122.42
2986604095275190272,2020-03,821.41,0,0,0,821.41,-3301.01
2986604095275190272,2020-04,0,579.72,0,2585.81,-3165.53,-6466.54
2986604095275190272,2020-08,948.75,0,0,0,948.75,-5517.79
2986604095275190272,2020-12,0,946.19,0,0,-946.19,-6463.98
2987482869686169600,2020-01,2683.02,5788.93,1854.53,1822.25,-3073.63,-3073.63
2987482869686169600,2020-02,1281.36,5159.59,2758.11,5372.56,-6492.68,-9566.31
2987482869686169600,2020-03,8144.97,4239.07,5800.23,2133.48,7572.65,-1993.66
2987482869686169600,2020-04,9008.01,12197.41,2792.51,4732.76,-5129.65,-7123.31
2987482869686169600,2020-05,3700.82,1144.61,5406.45,1925.68,6036.98,-1086.33
2987482869686169600,2020-06,2193.18,4487.93,7406.7,3973.46,1138.49,52.16
2987482869686169600,2020-07,1398.26,3087.61,2347.75,8852.67,-8194.27,-8142.11
2987482869686169600,2020-08,6467.57,3439.42,4388.06,2922.06,4494.15,-3647.96
2987482869686169600,2020-09,6838.34,9535.4,3527.73,7787.63,-6956.96,-10604.92
2987482869686169600,2020-10,2368.07,4227.52,2558.61,6953.07,-6253.91,-16858.83
2987482869686169600,2020-11,7107.93,8429.82,4551.54,4737.47,-1507.82,-18366.65
2987482869686169600,2020-12,2583.62,2031.53,3038.69,7308.08,-3717.3,-22083.95
2987513841050538496,2020-01,4992.65,1877.91,7410.05,4544.29,5980.5,5980.5
2987513841050538496,2020-02,3449.2,4212.05,5000.46,3150.81,1086.8,7067.3
2987513841050538496,2020-03,1442.96,2459.61,3799.57,1555.92,1227,8294.3
2987513841050538496,2020-04,3337,2767.13,8199.78,5578.84,3190.81,11485.11
2987513841050538496,2020-05,3777.08,0,2588.13,3761.37,2603.84,14088.95
2987513841050538496,2020-06,2716.55,2455.54,13754.25,3058,10957.26,25046.21
2987513841050538496,2020-07,5315.09,4294.73,12151.85,4430.82,8741.39,33787.6
2987513841050538496,2020-08,5076.21,1151.48,6629.85,9505.74,1048.84,34836.44
2987513841050538496,2020-09,2486.79,2913.07,4322.6,1809.63,2086.69,36923.13
2987513841050538496,2020-10,1738.21,6986.23,6735.94,1794.15,-306.23,36616.9
2987513841050538496,2020-11,5631.11,2610.22,3884.47,2859.49,4045.87,40662.77
2987513841050538496,2020-12,4211.33,1334.51,11277.5,2755.44,11398.88,52061.65
2987760701434039808,2020-01,1168.12,0,0,1530.39,-362.27,-362.27
2987760701434039808,2020-02,357.65,0,0,0,357.65,-4.62
2987760701434039808,2020-04,58.2,0,0,0,58.2,53.58
2987760701434039808,2020-05,1126.52,0,1068.57,821.37,1373.72,1427.3
2987760701434039808,2020-07,0,2727.1,0,0,-2727.1,-1299.8
2987760701434039808,2020-08,0,1635.25,0,1881.06,-3516.31,-4816.11
2987827671116766208,2020-01,3409.8,0,5046.76,3616.1,4840.46,4840.46
2987827671116766208,2020-02,4446.84,3708.12,3861.55,5874.71,-1274.44,3566.02
2987827671116766208,2020-03,7124.21,4257.14,7922.33,1046.46,9742.94,13308.96
2987827671116766208,2020-04,2440.04,3591.17,5359.13,3674.05,533.95,13842.91
2987827671116766208,2020-05,7297.14,3456.51,3274.79,697.71,6417.71,20260.62
2987827671116766208,2020-06,1347.48,1487.16,3962.4,4244.86,-422.14,19838.48
2987827671116766208,2020-07,9158.66,5860.71,3193.56,3949.06,2542.45,22380.93
2987827671116766208,2020-08,6858.49,3952.52,4394.33,8385.29,-1084.99,21295.94
2987827671116766208,2020-09,3753.09,2898.02,4267.94,144.25,4978.76,26274.7
2987827671116766208,2020-10,3101.24,5409.89,7850.69,4546.9,995.14,27269.84
2987827671116766208,2020-11,1454.26,5073.19,3183.36,2403.98,-2839.55,24430.29
2987827671116766208,2020-12,6795.66,6379.71,3497.46,643.45,3269.96,27700.25
2988196615512474624,2020-01,1236.17,1255.7,2100.05,2309.18,-228.66,-228.66
2988196615512474624,2020-02,2801.52,5167.9,3567.39,3312.63,-2111.62,-2340.28
2988196615512474624,2020-03,4056.31,4543.35,7630.69,3757.95,3385.7,1045.42
2988196615512474624,2020-04,9097.01,3413.33,3939.97,2521.92,7101.73,8147.15
2988196615512474624,2020-05,4869.61,797.5,1820.96,6863.42,-970.35,7176.8
2988196615512474624,2020-06,3560.95,1526.68,755.66,7140,-4350.07,2826.73
2988196615512474624,2020-07,0,3851.77,8373.59,7715.07,-3193.25,-366.52
2988196615512474624,2020-08,6535.34,3458.68,3039.69,4379.73,1736.62,1370.1
2988196615512474624,2020-09,4605.99,4112.05,3552.65,0,4046.59,5416.69
2988196615512474624,2020-10,2377.63,4083.5,2458.73,948.61,-195.75,5220.94
2988196615512474624,2020-11,3528.66,4624.17,1892.14,4612.19,-3815.56,1405.38
2988196615512474624,2020-12,5940.25,3191.99,738.48,1201.33,2285.41,3690.79
2988253331630306816,2020-01,2521.74,5462.63,1369.68,2473.61,-4044.82,-4044.82
2988253331630306816,2020-02,2199.55,5480.13,4800.88,8754.14,-7233.84,-11278.66
2988253331630306816,2020-03,5809.64,3326.06,2241.4,2095.67,2629.31,-8649.35
2988253331630306816,2020-04,5829.36,3262.45,2814.97,5005.55,376.33,-8273.02
2988253331630306816,2020-05,7416.35,1265.14,4092.15,2569.47,7673.89,-599.13
2988253331630306816,2020-06,9276.02,4516.24,6024.33,5193.25,5590.86,4991.73
2988253331630306816,2020-07,3478.63,8216.68,6912.46,6565.14,-4390.73,601
2988253331630306816,2020-08,2812.56,3793.69,2012.71,5399.2,-4367.62,-3766.62
2988253331630306816,2020-09,3169.87,1572.16,4126.49,4840.55,883.65,-2882.97
2988253331630306816,2020-10,8029.19,3277.98,8571.48,4193.94,9128.75,6245.78
2988253331630306816,2020-11,10292.28,3511.46,3882.74,5380.85,5282.71,11528.49
2988253331630306816,2020-12,3197.22,1698.5,2708.58,1058.66,3148.64,14677.13
2988649029797010432,2020-01,1485.26,724.39,1334.28,0,2095.15,2095.15
2988649029797010432,2020-02,1491.64,0,0,0,1491.64,3586.79
2988649029797010432,2020-03,1576.93,68.31,0,0,1508.62,5095.41
2988649029797010432,2020-05,1031.67,1938.89,1675.88,0,768.66,5864.07
2988649029797010432,2020-07,1970.17,1187.26,0,0,782.91,6646.98
2988649029797010432,2020-08,0,1013.59,1051.1,0,37.51,6684.49
2988649029797010432,2020-09,0,751.07,0,0,-751.07,5933.42
2988649029797010432,2020-11,1722.81,2724.49,0,0,-1001.68,4931.74
2988649029797010432,2020-12,1819.26,0,0,238.16,1581.1,6512.84
2990426882239176704,2020-01,3045.7,4298.36,2564.23,5735.11,-4423.54,-4423.54
2990426882239176704,2020-02,3097.27,0,1240.32,4920.99,-583.4,-5006.94
2990426882239176704,2020-03,2436.72,769.1,1813.77,1414.78,2066.61,-2940.33
2990426882239176704,2020-04,5669.47,337.58,1884.62,1340.07,5876.44,2936.11
2990426882239176704,2020-05,2070.54,5445.6,4277.01,1242.83,-340.88,2595.23
2990426882239176704,2020-06,662.08,2717.95,2944.78,0,888.91,3484.14
2990426882239176704,2020-07,2628.43,1952.32,5349.07,85.58,5939.6,9423.74
2990426882239176704,2020-08,3565.45,6346.95,1003.52,0,-1777.98,7645.76
2990426882239176704,2020-09,4837.25,983.32,4312.43,6197.96,1968.4,9614.16
2990426882239176704,2020-10,392.3,3937.72,854.66,4344.56,-7035.32,2578.84
2990426882239176704,2020-11,4300.4,0,2089.1,7085.73,-696.23,1882.61
2990426882239176704,2020-12,1542.31,3990.93,2701.33,6512.58,-6259.87,-4377.26
2990605686385641984,2020-01,4430.85,637.65,2980.26,4411.95,2361.51,2361.51
2990605686385641984,2020-02,3227.69,6710.74,2743.91,1866.68,-2605.82,-244.31
2990605686385641984,2020-03,4987.32,5653.79,6433.76,5733.4,33.89,-210.42
2990605686385641984,2020-04,4066.27,4863.44,3059.78,7145.3,-4882.69,-5093.11
2990605686385641984,2020-05,6885.45,1110.24,4389.54,8485.12,1679.63,-3413.48
2990605686385641984,2020-06,4426.63,4584.72,7713.06,6454.19,1100.78,-2312.7
2990605686385641984,2020-07,3249.14,7055.88,2418.3,1867.04,-3255.48,-5568.18
2990605686385641984,2020-08,2413.74,1891.9,3174.25,4987.24,-1291.15,-6859.33
2990605686385641984,2020-09,1816.47,4158.96,4673.49,5793.47,-3462.47,-10321.8
2990605686385641984,2020-10,7536.84,4313.96,3756.78,5533.77,1445.89,-8875.91
2990605686385641984,2020-11,8938.04,2310.81,1747.13,4154.32,4220.04,-4655.87
2990605686385641984,2020-12,2355.21,2356.73,632.92,3303.59,-2672.19,-7328.06
2990661967551113216,2020-01,2341.18,316.43,0,1700.66,324.09,324.09
2990661967551113216,2020-02,0,775.5,0,633.5,-1409,-1084.91
2990661967551113216,2020-03,4362.65,0,962.79,520.29,4805.15,3720.24
2990661967551113216,2020-04,1632,1605.31,1495.43,1881.53,-359.41,3360.83
2990661967551113216,2020-05,114.31,1956.66,217.2,0,-1625.15,1735.68
2990661967551113216,2020-07,1907.95,244.44,2769.34,0,4432.85,6168.53
2990661967551113216,2020-08,0,7291.69,2005.32,1855.26,-7141.63,-973.1
2990661967551113216,2020-09,607.4,2106.01,120.53,1041.87,-2419.95,-3393.05
2990661967551113216,2020-10,3062.63,0,2464.2,2296.61,3230.22,-162.83
2990661967551113216,2020-11,0,2133.78,203.81,2426.18,-4356.15,-4518.98
2990661967551113216,2020-12,3044.42,1307.43,0,1429.87,307.12,-4211.86
2990852049538244096,2020-01,9609.46,9061.01,7114.98,5920.26,1743.17,1743.17
2990852049538244096,2020-02,3331.46,3069.14,3238.02,2740.2,760.14,2503.31
2990852049538244096,2020-03,7582.18,1229.19,3832.86,179.41,10006.44,12509.75
2990852049538244096,2020-04,906.71,1486.53,2452.06,3842.38,-1970.14,10539.61
2990852049538244096,2020-05,0,5162.08,4971.43,2328.55,-2519.2,8020.41
2990852049538244096,2020-06,6517.75,0,2046.23,4595.07,3968.91,11989.32
2990852049538244096,2020-07,2997.37,2588.81,1090.09,1510.58,-11.93,11977.39
2990852049538244096,2020-08,947.04,1256.8,4640.35,2673.26,1657.33,13634.72
2990852049538244096,2020-09,2800.23,2344.88,1599.31,4184.19,-2129.53,11505.19
2990852049538244096,2020-10,4464.72,4780.57,5664.98,5285.45,63.68,11568.87
2990852049538244096,2020-11,2114.33,5806.29,2568.79,2843.93,-3967.1,7601.77
2990852049538244096,2020-12,3271.06,11567.33,3082.78,4288.12,-9501.61,-1899.84
2992494200916970496,2020-01,1456.75,0,0,852.28,604.47,604.47
2992494200916970496,2020-02,0,162.57,0,0,-162.57,441.9
2992494200916970496,2020-03,0,179.42,0,39.94,-219.36,222.54
2992494200916970496,2020-04,1509.54,0,1931.4,0,3440.94,3663.48
2992494200916970496,2020-05,1786.34,0,0,0,1786.34,5449.82
2992494200916970496,2020-07,355.26,0,0,0,355.26,5805.08
2993544881051877888,2020-01,2571.63,3518.89,6023.26,4863.47,212.53,212.53
2993544881051877888,2020-02,54.1,637.33,872.64,1743.06,-1453.65,-1241.12
2993544881051877888,2020-03,4264.01,4013.25,1973.52,3567.83,-1343.55,-2584.67
2993544881051877888,2020-04,3356.02,1752.97,5353.34,3798.64,3157.75,573.08
2993544881051877888,2020-05,2674.3,1171.69,37.33,8161.41,-6621.47,-6048.39
2993544881051877888,2020-06,2615.31,2919.08,2007.48,1747.27,-43.56,-6091.95
2993544881051877888,2020-07,2188.07,3214,4032.33,1483.26,1523.14,-4568.81
2993544881051877888,2020-08,2121.44,5229.07,6892.93,4745.39,-960.09,-5528.9
2993544881051877888,2020-09,5485.26,2456.65,2510.72,2161.28,3378.05,-2150.85
2993544881051877888,2020-10,6426.43,0,6092.09,5695.72,6822.8,4671.95
2993544881051877888,2020-11,3136.81,5471.53,3728.65,3330.35,-1936.42,2735.53
2993544881051877888,2020-12,3436.46,4242.83,325.13,6475.83,-6957.07,-4221.54
2994300005007639040,2020-01,0,1684.06,0,0,-1684.06,-1684.06
2994300005007639040,2020-02,3304.86,0,487.56,1164.89,2627.53,943.47
2994300005007639040,2020-03,0,1578.71,2547.92,1563.05,-593.84,349.63
2994300005007639040,2020-04,0,1011.08,0,1612.67,-2623.75,-2274.12
2994300005007639040,2020-05,72.6,183.38,2739.11,1482.55,1145.78,-1128.34
2994300005007639040,2020-06,0,726.57,0,633.54,-1360.11,-2488.45
2994300005007639040,2020-07,2925.23,0,0,842.82,2082.41,-406.04
2994300005007639040,2020-08,2719.65,0,0,0,2719.65,2313.61
2994300005007639040,2020-12,494.86,1700.82,1471.97,0,266.01,2579.62
2994371552465053184,2020-01,1114.41,0,238.64,0,1353.05,1353.05
2994371552465053184,2020-02,2008.57,0,0,0,2008.57,3361.62
2994371552465053184,2020-03,211.76,0,1821.87,0,2033.63,5395.25
2994371552465053184,2020-04,2914.61,2456.98,2958.61,2847.44,568.8,5964.05
2994371552465053184,2020-05,0,1963.67,0,0,-1963.67,4000.38
2994371552465053184,2020-08,121.25,1121.16,0,807.88,-1807.79,2192.59
2994371552465053184,2020-09,0,1665.1,1222.47,1742.66,-2185.29,7.3
2994371552465053184,2020-10,1140.65,831.61,0,1729.78,-1420.74,-1413.44
2994371552465053184,2020-11,895.19,2263.87,0,1101.95,-2470.63,-3884.07
2996975078227513856,2020-01,312.07,0,1240.2,1338.22,214.05,214.05
2996975078227513856,2020-02,3146.19,0,2412.96,1854.98,3704.17,3918.22
2996975078227513856,2020-03,3697.49,3252.89,1578.88,2603.28,-579.8,3338.42
2996975078227513856,2020-04,1636.48,958.7,249.45,2909.47,-1982.24,1356.18
2996975078227513856,2020-05,257.83,0,0,1282,-1024.17,332.01
2996975078227513856,2020-06,0,662.31,9.65,3947,-4599.66,-4267.65
2996975078227513856,2020-07,3224.86,2588.6,1320.48,696.42,1260.32,-3007.33
2996975078227513856,2020-08,1295.54,2831.05,1580.64,1585.44,-1540.31,-4547.64
2996975078227513856,2020-09,0,179.55,1886.06,0,1706.51,-2841.13
2996975078227513856,2020-10,982.9,295.07,0,1576.65,-888.82,-3729.95
2996975078227513856,2020-11,1937.08,4312.07,2109.48,0,-265.51,-3995.46
2996975078227513856,2020-12,964.4,4181.81,1999.49,4283.73,-5501.65,-9497.11
2997425613149372928,2020-01,1240,5204.3,2530.77,6223.42,-7656.95,-7656.95
2997425613149372928,2020-02,1562.93,2017.67,366.51,1556.46,-1644.69,-9301.64
2997425613149372928,2020-03,5807.57,4870.2,0,3337.25,-2399.88,-11701.52
2997425613149372928,2020-04,76.89,1562.71,1100.27,0,-385.55,-12087.07
2997425613149372928,2020-05,0,3755.89,2882.14,3633.16,-4506.91,-16593.98
2997425613149372928,2020-06,1517.05,2626.41,2510.88,3072,-1670.48,-18264.46
2997425613149372928,2020-07,1605.22,2524.66,4906.77,1933.54,2053.79,-16210.67
2997425613149372928,2020-08,4786.39,83.19,6431.71,1699.87,9435.04,-6775.63
2997425613149372928,2020-09,0,1791.33,0,1369.3,-3160.63,-9936.26
2997425613149372928,2020-10,3418.11,5167.73,37,0,-1712.62,-11648.88
2997425613149372928,2020-11,497.65,3879.03,590.32,1132.06,-3923.12,-15572
2997425613149372928,2020-12,2399.63,1578.49,1910.27,3622.03,-890.62,-16462.62
2999423833827609600,2020-01,8366.65,4189.18,5886.58,0,10064.05,10064.05
2999423833827609600,2020-02,1906.87,3034.07,5344.25,0,4217.05,14281.1
2999423833827609600,2020-03,4254.89,5394.05,2733.3,7496.45,-5902.31,8378.79
2999423833827609600,2020-04,2640.83,6260.08,5412.78,5756.86,-3963.33,4415.46
2999423833827609600,2020-05,6028.27,5487.31,2387.84,8286.93,-5358.13,-942.67
2999423833827609600,2020-06,631.83,4204.81,7824.77,3473.61,778.18,-164.49
2999423833827609600,2020-07,4926.75,3697.54,6932.05,5215,2946.26,2781.77
2999423833827609600,2020-08,327.23,5825.73,5364.91,1428.39,-1561.98,1219.79
2999423833827609600,2020-09,5189.46,5604.59,1810.84,1942.09,-546.38,673.41
2999423833827609600,2020-10,8262.48,1864.86,4868.35,8924.51,2341.46,3014.87
2999423833827609600,2020-11,5390.68,5403.52,2388.33,1745.97,629.52,3644.39
2999423833827609600,2020-12,4731.88,4772.86,2259.87,5468.57,-3249.68,394.71
3000543949997982720,2020-01,3050.73,3925.97,4229.8,3258.47,96.09,96.09
3000543949997982720,2020-02,4014.35,3102.9,4809.81,0,5721.26,5817.35
3000543949997982720,2020-03,7681.89,1461.23,5126.51,6536.48,4810.69,10628.04
3000543949997982720,2020-04,463.08,3805.08,4194.39,3188.14,-2335.75,8292.29
3000543949997982720,2020-05,3570.22,3567.91,3912.67,1307.01,2607.97,10900.26
3000543949997982720,2020-06,7103.9,4359.98,1333.94,6434.86,-2357,8543.26
3000543949997982720,2020-07,4040.51,3827.18,5086.27,2058.61,3240.99,11784.25
3000543949997982720,2020-08,3327.94,1528.71,4794.55,2116.44,4477.34,16261.59
3000543949997982720,2020-09,2548.99,3552.15,5368.44,1357.82,3007.46,19269.05
3000543949997982720,2020-10,4937.73,3590.49,4697.36,2366.13,3678.47,22947.52
3000543949997982720,2020-11,4231.23,4924.64,5649.68,4351.33,604.94,23552.46
3000543949997982720,2020-12,471.87,1808.7,1498.72,925.6,-763.71,22788.75
3001360180456740864,2020-01,1457.7,2085.09,180.52,1375.97,-1822.84,-1822.84
3001360180456740864,2020-02,1496.93,3876.4,1352.76,2736.93,-3763.64,-5586.48
3001360180456740864,2020-03,919.98,2146.46,1114.08,0,-112.4,-5698.88
3001360180456740864,2020-04,135.04,3316.95,0,2035.55,-5217.46,-10916.34
3001360180456740864,2020-05,4504.72,5476.95,2698.34,1780.83,-54.72,-10971.06
3001360180456740864,2020-06,2444.16,2530.22,3837.64,904.58,2847,-8124.06
3001360180456740864,2020-07,5068.17,4561.82,2240.67,3506.89,-759.87,-8883.93
3001360180456740864,2020-08,0,4183.63,1861.13,1739.16,-4061.66,-12945.59
3001360180456740864,2020-09,0,5083.88,149.91,1600.86,-6534.83,-19480.42
3001360180456740864,2020-10,6310.5,2761.42,3068.37,0,6617.45,-12862.97
3001360180456740864,2020-11,24.99,1111.58,4622.76,3148.37,387.8,-12475.17
3001360180456740864,2020-12,0,564.26,3875.44,2752.01,559.17,-11916
3002876649871707648,2020-01,7738.26,4276.84,1631.65,1429.11,3663.96,3663.96
3002876649871707648,2020-02,28.52,538.73,3334.96,2557.39,267.36,3931.32
3002876649871707648,2020-03,4946.27,3154.57,2973.99,760.67,4005.02,7936.34
3002876649871707648,2020-04,1861.17,1707.51,5369.78,3621.41,1902.03,9838.37
3002876649871707648,2020-05,1199.86,5666.11,4023.59,5561.3,-6003.96,3834.41
3002876649871707648,2020-06,5564.75,5218.32,3710.79,3356.3,700.92,4535.33
3002876649871707648,2020-07,4350.6,3490.38,6049.21,2776.47,4132.96,8668.29
3002876649871707648,2020-08,6323.51,1098.5,5321.76,3198.66,7348.11,16016.4
3002876649871707648,2020-09,4115.4,2946.24,3152.49,9472.88,-5151.23,10865.17
3002876649871707648,2020-10,244.84,6866.9,948.4,2041.79,-7715.45,3149.72
3002876649871707648,2020-11,4527.53,1041.59,3144.08,1785.22,4844.8,7994.52
3002876649871707648,2020-12,4447.81,2911.69,1442.05,2066.91,911.26,8905.78
3004230401956217344,2020-01,6848.95,5566.13,4689.73,809.16,5163.39,5163.39
3004230401956217344,2020-02,6809.05,0,2077.2,4512.26,4373.99,9537.38
3004230401956217344,2020-03,5112.11,4797.6,894.42,2198.89,-989.96,8547.42
3004230401956217344,2020-04,4593.98,5073.41,8316.49,293.75,7543.31,16090.73
3004230401956217344,2020-05,5586.89,5500.25,3840.66,1742.19,2185.11,18275.84
3004230401956217344,2020-06,4177.88,4182.82,4643.53,4217.8,420.79,18696.63
3004230401956217344,2020-07,9148.08,5068.02,3385.75,4650.76,2815.05,21511.68
3004230401956217344,2020-08,5463.96,6264.48,5774.91,1036.39,3938,25449.68
3004230401956217344,2020-09,3410.44,2138.42,7930.85,8088.54,1114.33,26564.01
3004230401956217344,2020-10,3084.36,3715.91,7386.97,4420.18,2335.24,28899.25
3004230401956217344,2020-11,3697.83,1702.45,5038.34,2886.62,4147.1,33046.35
3004230401956217344,2020-12,6653.91,3266.44,10002.53,8013.6,5376.4,38422.75
3005027617484353024,2020-01,3773.04,1724.29,5348.26,4513.98,2883.03,2883.03
3005027617484353024,2020-02,12968.89,7014.31,2330.83,2252.85,6032.56,8915.59
3005027617484353024,2020-03,4887.22,10117.05,3689.39,3022.8,-4563.24,4352.35
3005027617484353024,2020-04,7126.98,1717.67,2877.65,4355.26,3931.7,8284.05
3005027617484353024,2020-05,4919.4,0,3393.83,3614.62,4698.61,12982.66
3005027617484353024,2020-06,2611.99,5836.36,2266.78,4560.95,-5518.54,7464.12
3005027617484353024,2020-07,7008.97,1703.08,3339.53,9851.71,-1206.29,6257.83
3005027617484353024,2020-08,6779.83,5350.4,4612.91,1225.85,4816.49,11074.32
3005027617484353024,2020-09,5140.58,7639.38,3926.88,3541.94,-2113.86,8960.46
3005027617484353024,2020-10,1575.44,3651.25,4389.22,2814.72,-501.31,8459.15
3005027617484353024,2020-11,658.26,4633.61,356.84,2162.63,-5781.14,2678.01
3005027617484353024,2020-12,2667.98,1904.57,7722.11,86.73,8398.79,11076.8
3005705656341198336,2020-01,3028.62,1622.56,5164.77,2819.32,3751.51,3751.51
3005705656341198336,2020-02,4351.34,1709.54,4253.1,4453.65,2441.25,6192.76
3005705656341198336,2020-03,4500.93,2502.15,764.15,6932.01,-4169.08,2023.68
3005705656341198336,2020-04,1730.14,1063.03,4556.13,2871.04,2352.2,4375.88
3005705656341198336,2020-05,1592.28,714.63,970.45,3473.02,-1624.92,2750.96
3005705656341198336,2020-06,2676.8,4082.2,3025.53,1991.89,-371.76,2379.2
3005705656341198336,2020-07,2157.79,1735.07,4257.18,5567.5,-887.6,1491.6
3005705656341198336,2020-08,5904.14,4852.89,0,1916.31,-865.06,626.54
3005705656341198336,2020-09,0,2928.99,1626.33,3518.67,-4821.33,-4194.79
3005705656341198336,2020-10,3382.98,7758.78,435.9,4771.61,-8711.51,-12906.3
3005705656341198336,2020-11,3372.16,1970.17,224.14,4167.85,-2541.72,-15448.02
3005705656341198336,2020-12,1461.43,5347.99,710.3,4187.66,-7363.92,-22811.94
3006669265975399424,2020-01,3028.5,7236.49,540.21,6157.52,-9825.3,-9825.3
3006669265975399424,2020-02,2451.2,2599.46,1046.65,6102.28,-5203.89,-15029.19
3006669265975399424,2020-03,8728.84,2017.65,5936.41,820.7,11826.9,-3202.29
3006669265975399424,2020-04,3448.56,3393.53,5781.48,2920.89,2915.62,-286.67
3006669265975399424,2020-05,0,9065.24,4959.32,4549.98,-8655.9,-8942.57
3006669265975399424,2020-06,4679.19,6186.1,2280.47,2265.4,-1491.84,-10434.41
3006669265975399424,2020-07,1122.28,4460.72,3655.52,5426.36,-5109.28,-15543.69
3006669265975399424,2020-08,5398.83,3124.72,5036.88,5839.93,1471.06,-14072.63
3006669265975399424,2020-09,4178.37,5676.86,4134.8,9357.8,-6721.49,-20794.12
3006669265975399424,2020-10,5718.11,2671.55,3307.03,0,6353.59,-14440.53
3006669265975399424,2020-11,1986.92,3789.52,6498.86,2393.27,2302.99,-12137.54
3006669265975399424,2020-12,3585.87,1754.13,854.54,2890.67,-204.39,-12341.93
3007115403857295872,2020-01,5378.9,1427.22,1470.91,3991.25,1431.34,1431.34
3007115403857295872,2020-02,3736.42,5837.48,4234.93,5581.07,-3447.2,-2015.86
3007115403857295872,2020-03,8989.42,7747.38,2912.15,8934.82,-4780.63,-6796.49
3007115403857295872,2020-04,4169.15,2310.36,5177.79,4014.74,3021.84,-3774.65
3007115403857295872,2020-05,1403.53,4656.51,6434.8,572.79,2609.03,-1165.62
3007115403857295872,2020-06,7026.28,4863.2,7984.27,8485.13,1662.22,496.6
3007115403857295872,2020-07,8274.76,6835.95,2854.13,4587.77,-294.83,201.77
3007115403857295872,2020-08,8674.27,4740.68,3965.75,1675.79,6223.55,6425.32
3007115403857295872,2020-09,6681.04,2615.45,4929.93,6456.21,2539.31,8964.63
3007115403857295872,2020-10,5965.21,1456.58,3289.77,5159.19,2639.21,11603.84
3007115403857295872,2020-11,3025.85,5848.03,3102.76,6111.1,-5830.52,5773.32
3007115403857295872,2020-12,2030.28,742.65,2922.53,5550.05,-1339.89,4433.43
3008186621003663360,2020-01,0,1208.17,0,1926.26,-3134.43,-3134.43
3008186621003663360,2020-04,1300.25,0,896.52,1496.44,700.33,-2434.1
3008186621003663360,2020-05,0,252.26,1612,1403.34,-43.6,-2477.7
3008186621003663360,2020-06,1305.37,1764.31,2330.8,1820.53,51.33,-2426.37
3008186621003663360,2020-07,3392.16,997.9,4649.22,1841.24,5202.24,2775.87
3008186621003663360,2020-08,0,1559.87,221.97,1412.8,-2750.7,25.17
3008186621003663360,2020-09,1486.24,195.91,921.03,0,2211.36,2236.53
3008186621003663360,2020-10,1606.44,0,0,0,1606.44,3842.97
3008186621003663360,2020-11,1899.79,2985.77,870.82,0,-215.16,3627.81
3008186621003663360,2020-12,0,2077.25,1172.52,2221.14,-3125.87,501.94
3008631948485303808,2020-01,1885.08,2726.79,0,3279.93,-4121.64,-4121.64
3008631948485303808,2020-02,2642.83,1200.43,3653.59,3666.42,1429.57,-2692.07
3008631948485303808,2020-03,3423.37,3942.47,582.7,1302,-1238.4,-3930.47
3008631948485303808,2020-04,3499.3,2138.11,277.63,333.5,1305.32,-2625.15
3008631948485303808,2020-05,1673.78,6387.35,0,0,-4713.57,-7338.72
3008631948485303808,2020-06,3293.81,1080.8,3293.37,1656.61,3849.77,-3488.95
3008631948485303808,2020-07,1636.69,1516.42,1748.13,1932.97,-64.57,-3553.52
3008631948485303808,2020-08,4061.24,3235.28,1683.48,1342.65,1166.79,-2386.73
3008631948485303808,2020-09,3607.09,1040.01,2328.55,4666.43,229.2,-2157.53
3008631948485303808,2020-10,1553.93,2186.09,540.4,1437.37,-1529.13,-3686.66
3008631948485303808,2020-11,3178.29,1166.3,5712.83,1356.96,6367.86,2681.2
3008631948485303808,2020-12,3276.94,1301.92,930.15,9729.6,-6824.43,-4143.23
3009167590130823168,2020-01,2141.98,1643.32,8515.57,5254.37,3759.86,3759.86
3009167590130823168,2020-02,1537.72,2767.07,7891.97,1550.89,5111.73,8871.59
3009167590130823168,2020-03,4487.92,3254.01,4188.6,227.73,5194.78,14066.37
3009167590130823168,2020-04,4136.61,2789.33,2411.12,652.77,3105.63,17172
3009167590130823168,2020-05,3142.55,1140.24,4381.47,2403.2,3980.58,21152.58
3009167590130823168,2020-06,5765.26,2115.78,8578.16,4855.13,7372.51,28525.09
3009167590130823168,2020-07,11461.77,4377.97,2852.09,7158.48,2777.41,31302.5
3009167590130823168,2020-08,7454.4,3055.83,10036.75,2884.31,11551.01,42853.51
3009167590130823168,2020-09,2355.01,2164.06,3207.63,1240.59,2157.99,45011.5
3009167590130823168,2020-10,5884.46,3435.27,2953.42,7680.61,-2278,42733.5
3009167590130823168,2020-11,3451.18,6603.73,2987.37,2873.73,-3038.91,39694.59
3009167590130823168,2020-12,2732.01,7674.66,0,138.98,-5081.63,34612.96
3009715686013257728,2020-01,2724.42,2156.3,6594.49,4712.3,2450.31,2450.31
3009715686013257728,2020-02,815.25,306.96,8410.33,7655.24,1263.38,3713.69
3009715686013257728,2020-03,4160.02,3796.07,9254.97,2622.63,6996.29,10709.98
3009715686013257728,2020-04,5813.95,7190.18,8033.63,2702.3,3955.1,14665.08
3009715686013257728,2020-05,6372.47,2183.9,6069.95,4023.15,6235.37,20900.45
3009715686013257728,2020-06,3290.87,1907.63,7240.61,0,8623.85,29524.3
3009715686013257728,2020-07,4576.1,718.12,2358.6,5909.36,307.22,29831.52
3009715686013257728,2020-08,2023.81,4593.12,73.11,2208.12,-4704.32,25127.2
3009715686013257728,2020-09,5832.56,1987.19,2373.52,3433.19,2785.7,27912.9
3009715686013257728,2020-10,4295.9,4814.89,4996.83,4140.08,337.76,28250.66
3009715686013257728,2020-11,0,3341.75,7721.2,2842.23,1537.22,29787.88
3009715686013257728,2020-12,9492.38,6293.76,3497.09,2304.18,4391.53,34179.41
3010095908641057792,2020-01,1693.67,6936.48,6171.21,1205.33,-276.93,-276.93
3010095908641057792,2020-02,7225.14,4964.15,9842.66,2404.37,9699.28,9422.35
3010095908641057792,2020-03,3153.19,5067.5,1471.56,3935.91,-4378.66,5043.69
3010095908641057792,2020-04,2046.42,5617.91,5560.51,2634.74,-645.72,4397.97
3010095908641057792,2020-05,3295.32,0,7522.14,2454.64,8362.82,12760.79
3010095908641057792,2020-06,450.06,6496.51,966.1,5944.06,-11024.41,1736.38
3010095908641057792,2020-07,3378.41,8304.66,411.51,6893,-11407.74,-9671.36
3010095908641057792,2020-08,8677.1,3046.9,2396.31,6830.6,1195.91,-8475.45
3010095908641057792,2020-09,2259.07,4327.71,827.24,4112.55,-5353.95,-13829.4
3010095908641057792,2020-10,5779.26,3877.11,2001.87,3586.23,317.79,-13511.61
3010095908641057792,2020-11,1946.51,3645.16,2083.97,1104.64,-719.32,-14230.93
3010095908641057792,2020-12,4680.41,1598.45,8348,4856.95,6573.01,-7657.92
3010775489885322240,2020-02,0,1462.16,45.39,0,-1416.77,-1416.77
3010775489885322240,2020-10,0,1977.11,0,0,-1977.11,-3393.88
3010775489885322240,2020-12,0,1340.98,1162.21,0,-178.77,-3572.65
3012450866514947072,2020-01,5768.52,1077.49,3870.92,2704.25,5857.7,5857.7
3012450866514947072,2020-02,2785.81,4131.16,2360.68,5796.68,-4781.35,1076.35
3012450866514947072,2020-03,6034.81,3143.07,4947.52,3831.55,4007.71,5084.06
3012450866514947072,2020-04,6892.74,7394.65,6275.25,357.23,5416.11,10500.17
3012450866514947072,2020-05,1200.89,5628.28,1231.01,7059.86,-10256.24,243.93
3012450866514947072,2020-06,3048.01,6758.52,4869.55,2129.6,-970.56,-726.63
3012450866514947072,2020-07,2459.75,4557.59,3781.66,3321.86,-1638.04,-2364.67
3012450866514947072,2020-08,1308.11,2791.37,6689.49,3475.77,1730.46,-634.21
3012450866514947072,2020-09,2320.15,2133.13,4954.91,6670.92,-1528.99,-2163.2
3012450866514947072,2020-10,8727.53,2558.02,5260.33,3266.33,8163.51,6000.31
3012450866514947072,2020-11,2847.5,4058.21,5039.81,1740,2089.1,8089.41
3012450866514947072,2020-12,4076.17,3260.53,9513.79,2889.46,7439.97,15529.38
3013344277611646464,2020-01,2957.31,234.71,734.05,2247.81,1208.84,1208.84
3013344277611646464,2020-02,1384.46,0,2823.45,3479.37,728.54,1937.38
3013344277611646464,2020-03,1772.94,1250.9,75.37,1719.74,-1122.33,815.05
3013344277611646464,2020-04,2323.36,3610.47,1704.8,3216.85,-2799.16,-1984.11
3013344277611646464,2020-05,7090.57,2719.82,601.33,4412.13,559.95,-1424.16
3013344277611646464,2020-06,1973.03,0,1087.06,4478.91,-1418.82,-2842.98
3013344277611646464,2020-07,3720.86,0,2737.58,3539.37,2919.07,76.09
3013344277611646464,2020-08,3536.27,0,957,2489.58,2003.69,2079.78
3013344277611646464,2020-09,0,4970.44,370.26,2824.7,-7424.88,-5345.1
3013344277611646464,2020-10,0,1311.01,896.18,1080.87,-1495.7,-6840.8
3013344277611646464,2020-11,4705.53,3594.01,4696.67,1824.06,3984.13,-2856.67
3013344277611646464,2020-12,1814.81,593.18,3890.4,1736.22,3375.81,519.14
3013663196708802560,2020-01,0,1438.51,4438.84,0,3000.33,3000.33
3013663196708802560,2020-02,1738.14,1095.35,415.05,3579.46,-2521.62,478.71
3013663196708802560,2020-03,522.74,1128.64,3001.21,0,2395.31,2874.02
3013663196708802560,2020-04,1564.6,2476.59,3410.69,647.23,1851.47,4725.49
3013663196708802560,2020-05,2940.52,1928.14,0,1210.71,-198.33,4527.16
3013663196708802560,2020-06,2646.6,1894.68,0,3030.74,-2278.82,2248.34
3013663196708802560,2020-07,3532.6,2103.67,4138.25,904.16,4663.02,6911.36
3013663196708802560,2020-08,2385.23,1230.08,6134.56,1917.14,5372.57,12283.93
3013663196708802560,2020-09,0,2955.27,4649.49,6843.71,-5149.49,7134.44
3013663196708802560,2020-10,4232.4,3290.52,1315.2,4382.89,-2125.81,5008.63
3013663196708802560,2020-11,0,2970.78,3993.44,4018.27,-2995.61,2013.02
3013663196708802560,2020-12,5305.78,5316.1,899.39,1682.43,-793.36,1219.66
3013687055445286912,2020-01,2241.18,6037.56,1234.34,483.28,-3045.32,-3045.32
3013687055445286912,2020-02,4276.92,1935.85,2901.12,5968.51,-726.32,-3771.64
3013687055445286912,2020-03,1163.05,6029.79,0,6340.29,-11207.03,-14978.67
3013687055445286912,2020-04,1170.53,5543.94,2314.44,2831.4,-4890.37,-19869.04
3013687055445286912,2020-05,5840.18,1567.48,6642.46,3431.79,7483.37,-12385.67
3013687055445286912,2020-06,2573.63,4424.64,1787.66,3716.85,-3780.2,-16165.87
3013687055445286912,2020-07,1233.41,1469.87,1832.3,640.96,954.88,-15210.99
3013687055445286912,2020-08,2928.96,2154.56,211.28,928.97,56.71,-15154.28
3013687055445286912,2020-09,3980.18,789.9,3159.33,60.26,6289.35,-8864.93
3013687055445286912,2020-10,0,3303.6,496.91,5649.6,-8456.29,-17321.22
3013687055445286912,2020-11,4864.28,397.96,1956.61,1220.72,5202.21,-12119.01
3013687055445286912,2020-12,1648.94,1633.43,289.09,3363.15,-3058.55,-15177.56
3013811038938509312,2020-01,2203.23,2036.17,4240.22,1107.32,3299.96,3299.96
3013811038938509312,2020-02,1901.03,3459.78,4052.72,1218.28,1275.69,4575.65
3013811038938509312,2020-03,4395.86,1546.59,3194.88,1540.98,4503.17,9078.82
3013811038938509312,2020-04,2016.92,2540.05,4447.23,0,3924.1,13002.92
3013811038938509312,2020-05,854.14,2878.6,2067.84,4314.77,-4271.39,8731.53
3013811038938509312,2020-06,622.23,2915.97,1382.32,580.91,-1492.33,7239.2
3013811038938509312,2020-07,501.37,1512.79,650.01,1088.1,-1449.51,5789.69
3013811038938509312,2020-08,0,8858.41,4975,4571.61,-8455.02,-2665.33
3013811038938509312,2020-09,4237.89,6361.22,706.24,0,-1417.09,-4082.42
3013811038938509312,2020-10,1681.46,4880.33,3520.62,2707.19,-2385.44,-6467.86
3013811038938509312,2020-11,5167.24,5547.56,5437.54,6488.62,-1431.4,-7899.26
3013811038938509312,2020-12,4452.57,4105.09,1917.05,3024.47,-759.94,-8659.2
3014014263629077504,2020-02,0,1242.02,179.9,0,-1062.12,-1062.12
3014014263629077504,2020-04,1398.94,0,0,337.3,1061.64,-0.48
3014014263629077504,2020-05,894.65,0,1113.71,1392.44,615.92,615.44
3014014263629077504,2020-06,2811.86,1860.33,1149.99,1314.58,786.94,1402.38
3014014263629077504,2020-07,0,560.94,495.26,733.61,-799.29,603.09
3014014263629077504,2020-08,645.76,1464.75,0,1418.71,-2237.7,-1634.61
3014014263629077504,2020-09,939.56,512.09,2211.33,837.29,1801.51,166.9
3014014263629077504,2020-11,2685.03,2848.65,322.1,1341.41,-1182.93,-1016.03
3014014263629077504,2020-12,1047.68,1305.58,1187.73,665.06,264.77,-751.26
3014826214812298752,2020-01,5006.9,294.86,6652.49,3602.69,7761.84,7761.84
3014826214812298752,2020-02,3800.53,4931.23,2433.86,6742.39,-5439.23,2322.61
3014826214812298752,2020-03,1093.93,2582.05,3633.52,4675.42,-2530.02,-207.41
3014826214812298752,2020-04,5400.55,3351.32,4809.02,5755.63,1102.62,895.21
3014826214812298752,2020-05,5986.46,4379.61,2549.88,4851.9,-695.17,200.04
3014826214812298752,2020-06,4077.75,1504.47,6420.33,3822.12,5171.49,5371.53
3014826214812298752,2020-07,7751.74,2930.14,6154.12,4407.03,6568.69,11940.22
3014826214812298752,2020-08,4025.26,2366.22,1830.35,2831.82,657.57,12597.79
3014826214812298752,2020-09,6062.94,5189.84,4763.39,1885.9,3750.59,16348.38
3014826214812298752,2020-10,2621.51,10287.71,2288.89,1946.95,-7324.26,9024.12
3014826214812298752,2020-11,6140.82,4274.49,1242.64,1438.62,1670.35,10694.47
3014826214812298752,2020-12,2270.69,3191.23,3170.22,6241.39,-3991.71,6702.76
3015346299882187264,2020-01,4376.98,3271.73,4179.78,7412.57,-2127.54,-2127.54
3015346299882187264,2020-02,1512.25,6106.03,7177.25,5041.67,-2458.2,-4585.74
3015346299882187264,2020-03,0,1996.9,3325.06,6532.2,-5204.04,-9789.78
3015346299882187264,2020-04,1406,5958.76,3872.96,3165.28,-3845.08,-13634.86
3015346299882187264,2020-05,2538.38,2797.97,5032.25,2936.39,1836.27,-11798.59
3015346299882187264,2020-06,2651.95,3102.51,3832.34,5220.79,-1839.01,-13637.6
3015346299882187264,2020-07,9170.38,7672.12,7358.46,3322.27,5534.45,-8103.15
3015346299882187264,2020-08,2295.31,4612.12,2797.44,4551.52,-4070.89,-12174.04
3015346299882187264,2020-09,3481.39,5835.72,5302,5436.19,-2488.52,-14662.56
3015346299882187264,2020-10,720.46,3642.15,2096.76,1216.09,-2041.02,-16703.58
3015346299882187264,2020-11,9658.81,8546.37,6967.29,2214.74,5864.99,-10838.59
3015346299882187264,2020-12,7330.07,2646.22,6269.1,457.33,10495.62,-342.97
3015473480076866560,2020-01,1092.91,2375.07,1205.97,1517.42,-1593.61,-1593.61
3015473480076866560,2020-03,0,1561.55,0,77.48,-1639.03,-3232.64
3015473480076866560,2020-06,4154.42,1194.55,0,567.89,2391.98,-840.66
3015473480076866560,2020-07,1726.09,0,499.3,824.8,1400.59,559.93
3015473480076866560,2020-08,2089.01,0,672.15,0,2761.16,3321.09
3015473480076866560,2020-09,1173.28,0,242.63,1794.29,-378.38,2942.71
3015473480076866560,2020-10,1714.5,0,0,4285.46,-2570.96,371.75
3015473480076866560,2020-12,1545.03,0,0,1979.51,-434.48,-62.73
3016114113074120704,2020-01,0,1349.43,0,1257.19,-2606.62,-2606.62
3016114113074120704,2020-02,2328.54,655.87,0,0,1672.67,-933.95
3016114113074120704,2020-03,3929.18,2189.69,0,3503.52,-1764.03,-2697.98
3016114113074120704,2020-04,3301.52,2881.8,0,0,419.72,-2278.26
3016114113074120704,2020-05,3286.27,275.5,0,1408.17,1602.6,-675.66
3016114113074120704,2020-06,4522.25,3516.44,1898.25,0,2904.06,2228.4
3016114113074120704,2020-07,3482.3,0,594.16,0,4076.46,6304.86
3016114113074120704,2020-08,1198.74,1226.14,1351.48,982.63,341.45,6646.31
3016114113074120704,2020-09,0,889.08,0,0,-889.08,5757.23
3016114113074120704,2020-10,1857.13,618.58,3325.3,0,4563.85,10321.08
3017218316999718912,2020-01,4640.21,6158.67,6830.67,1950.13,3362.08,3362.08
3017218316999718912,2020-02,3895.68,3062.45,2916.97,4327.26,-577.06,2785.02
3017218316999718912,2020-03,1386.61,2340.9,1456.25,1411.17,-909.21,1875.81
3017218316999718912,2020-04,4961.35,9422.54,5420.39,658.7,300.5,2176.31
3017218316999718912,2020-05,499.03,2156.3,885.16,3307.05,-4079.16,-1902.85
3017218316999718912,2020-06,2623.28,5628.15,2259.54,2695.89,-3441.22,-5344.07
3017218316999718912,2020-07,4230.61,1830.08,2963.02,2327.21,3036.34,-2307.73
3017218316999718912,2020-08,8252.74,3000.53,3142.3,3974.09,4420.42,2112.69
3017218316999718912,2020-09,1328.57,2135.05,5234.73,5325.85,-897.6,1215.09
3017218316999718912,2020-10,2257.99,1600.31,4513.91,3845.54,1326.05,2541.14
3017218316999718912,2020-11,0,690.98,3248.13,4719.87,-2162.72,378.42
3017218316999718912,2020-12,2709.32,3674.39,214.83,1109.18,-1859.42,-1481
3018054707456894464,2020-01,2194.11,1136.68,3882.05,2096.35,2843.13,2843.13
3018054707456894464,2020-02,5359.47,1019.7,5155.83,5161.72,4333.88,7177.01
3018054707456894464,2020-03,2834.28,2051.29,577.4,4842.88,-3482.49,3694.52
3018054707456894464,2020-04,7438.3,3647.92,0,3997.21,-206.83,3487.69
3018054707456894464,2020-05,3683.01,1068.8,772.22,762.33,2624.1,6111.79
3018054707456894464,2020-06,752.55,7242.51,3468.24,6697.17,-9718.89,-3607.1
3018054707456894464,2020-07,1866.38,3093.76,4855.97,0,3628.59,21.49
3018054707456894464,2020-08,4865.52,2829.89,4710.13,36.75,6709.01,6730.5
3018054707456894464,2020-09,2381.92,512.12,2993.06,1959.11,2903.75,9634.25
3018054707456894464,2020-10,268.66,2751.08,3284.21,1311.85,-510.06,9124.19
3018054707456894464,2020-11,1721.71,1383.83,3122.51,3197.07,263.32,9387.51
3018054707456894464,2020-12,6923.35,460.93,1005.23,6085.54,1382.11,10769.62
3019780072409374208,2020-01,926.56,0,1939.1,1683.03,1182.63,1182.63
3019780072409374208,2020-02,1039.57,601.39,0,235.1,203.08,1385.71
3019780072409374208,2020-03,4023.63,0,1035.44,454.43,4604.64,5990.35
3019780072409374208,2020-04,921.6,207.15,0,0,714.45,6704.8
3019780072409374208,2020-05,1054.73,0,3283.22,1398.87,2939.08,9643.88
3019780072409374208,2020-06,2886.29,3075.64,2887.51,2378.23,319.93,9963.81
3019780072409374208,2020-07,0,842.83,600.87,8256.03,-8497.99,1465.82
3019780072409374208,2020-08,600.19,3605.35,1844.77,0,-1160.39,305.43
3019780072409374208,2020-09,1894.38,3056.52,2818.52,1487.28,169.1,474.53
3019780072409374208,2020-10,3346.76,1689.95,3331.19,2776.15,2211.85,2686.38
3019780072409374208,2020-11,584.28,2612.42,0,0,-2028.14,658.24
3019780072409374208,2020-12,1504.05,1240.53,3908.64,0,4172.16,4830.4
3019988585237458944,2020-01,1881.17,0,5302.22,460.23,6723.16,6723.16
3019988585237458944,2020-02,1035.82,2585.71,3965.23,1898.39,516.95,7240.11
3019988585237458944,2020-03,1624.74,3353.31,3340.86,2445.45,-833.16,6406.95
3019988585237458944,2020-04,3716.58,3689.67,1734.5,3051.44,-1290.03,5116.92
3019988585237458944,2020-05,1558.03,312.54,3039.91,2365.73,1919.67,7036.59
3019988585237458944,2020-06,738.85,1626.29,1583.47,1185.16,-489.13,6547.46
3019988585237458944,2020-07,2181.24,6534.29,5021.77,415.99,252.73,6800.19
3019988585237458944,2020-08,1212.59,4142.39,4750.42,2750.97,-930.35,5869.84
3019988585237458944,2020-09,66.33,5590.55,5940.14,5863.81,-5447.89,421.95
3019988585237458944,2020-10,2785.39,1574.89,6188.83,5564.31,1835.02,2256.97
3019988585237458944,2020-11,1471.98,1165.83,793.34,620.95,478.54,2735.51
3019988585237458944,2020-12,3418.31,453.82,252.96,4292.16,-1074.71,1660.8
3020222185636328960,2020-01,4363.43,2655.48,7250.01,870.96,8087,8087
3020222185636328960,2020-02,2117.86,2856.61,4359.57,5272.02,-1651.2,6435.8
3020222185636328960,2020-03,8147.41,2932.99,3257.68,3412.49,5059.61,11495.41
3020222185636328960,2020-04,5322.69,2406.44,2016.09,5594.71,-662.37,10833.04
3020222185636328960,2020-05,3573.36,1589.21,3591.2,7.88,5567.47,16400.51
3020222185636328960,2020-06,443.24,1907.65,7992.23,2485.73,4042.09,20442.6
3020222185636328960,2020-07,3328.33,498.8,2932.4,3277.73,2484.2,22926.8
3020222185636328960,2020-08,6490.67,5448.29,4874.21,5609.07,307.52,23234.32
3020222185636328960,2020-09,2318.55,1218.2,2566.4,1436.67,2230.08,25464.4
3020222185636328960,2020-10,7638.91,2859.91,3599.75,3845.37,4533.38,29997.78
3020222185636328960,2020-11,3116.42,4767.44,4016.32,1906.89,458.41,30456.19
3020222185636328960,2020-12,1739.92,0,4490.97,5173.94,1056.95,31513.14
3020896659214605824,2020-01,7066.62,4953.82,2698.39,2693.36,2117.83,2117.83
3020896659214605824,2020-02,3719.7,6270.72,974.15,1887.09,-3463.96,-1346.13
3020896659214605824,2020-03,2321.44,2566.75,4856.95,3470.77,1140.87,-205.26
3020896659214605824,2020-04,4843.59,10756.26,2233.38,1315.48,-4994.77,-5200.03
3020896659214605824,2020-05,3477.75,6896.06,6068.08,11247.46,-8597.69,-13797.72
3020896659214605824,2020-06,12112.45,11615.73,1171.3,5418.09,-3750.07,-17547.79
3020896659214605824,2020-07,5280.08,3482.98,4875.56,4760.17,1912.49,-15635.3
3020896659214605824,2020-08,8847.49,1923.8,9076.49,2559.61,13440.57,-2194.73
3020896659214605824,2020-09,8697.94,2669.78,3248,3158.05,6118.11,3923.38
3020896659214605824,2020-10,3714.07,4191.65,8503.67,10034.71,-2008.62,1914.76
3020896659214605824,2020-11,9733.98,2803.48,3560.87,2134.03,8357.34,10272.1
3020896659214605824,2020-12,1247.42,2256.81,7580.8,9455.76,-2884.35,7387.75
3020925332247387648,2020-02,370.62,1719.91,573.36,3062.96,-3838.89,-3838.89
3020925332247387648,2020-03,95.1,1222.96,777.31,1371.36,-1721.91,-5560.8
3020925332247387648,2020-04,0,1537.36,1143.16,2367.65,-2761.85,-8322.65
3020925332247387648,2020-05,489.22,0,489.97,1418.87,-439.68,-8762.33
3020925332247387648,2020-06,1301.28,2324.04,2792.19,0,1769.43,-6992.9
3020925332247387648,2020-07,1703.5,113.04,1243.22,1543.52,1290.16,-5702.74
3020925332247387648,2020-08,1804.54,0,0,1238.27,566.27,-5136.47
3020925332247387648,2020-09,0,686.58,0,826.33,-1512.91,-6649.38
3020925332247387648,2020-10,0,2639.37,1437.21,2434.94,-3637.1,-10286.48
3020925332247387648,2020-11,2291.2,0,1533.3,1195.79,2628.71,-7657.77
3020925332247387648,2020-12,650.86,449.3,0,278.3,-76.74,-7734.51
3020946344824031744,2020-01,319.23,0,0,1651.69,-1332.46,-1332.46
3020946344824031744,2020-02,922.33,0,0,337.82,584.51,-747.95
3020946344824031744,2020-03,0,2623.38,1989.49,0,-633.89,-1381.84
3020946344824031744,2020-04,866.84,1089.91,0,0,-223.07,-1604.91
3020946344824031744,2020-05,4045.47,2549.35,3591.81,0,5087.93,3483.02
3020946344824031744,2020-06,3010.41,336.18,1719.85,0,4394.08,7877.1
3020946344824031744,2020-07,828.35,668.41,985.65,1747.35,-601.76,7275.34
3020946344824031744,2020-08,1664.44,0,1688.58,0,3353.02,10628.36
3020946344824031744,2020-09,1232.06,3934.05,107.17,0,-2594.82,8033.54
3020946344824031744,2020-10,508.54,0,0,0,508.54,8542.08
3020946344824031744,2020-11,0,3634.38,3068.08,1971.45,-2537.75,6004.33
3020946344824031744,2020-12,0,1812.24,1791.35,0,-20.89,5983.44
3021189907865890816,2020-01,11021.43,3832.01,2773.19,4482.77,5479.84,5479.84
3021189907865890816,2020-02,1272.2,0,1468.19,2051.41,688.98,6168.82
3021189907865890816,2020-03,2226.97,1912.41,1819.96,4339.94,-2205.42,3963.4
3021189907865890816,2020-04,2322.94,829.18,6259.13,5795.83,1957.06,5920.46
3021189907865890816,2020-05,3143.58,947.46,2727.76,2657.33,2266.55,8187.01
3021189907865890816,2020-06,1831.72,5188.41,5811.01,914.36,1539.96,9726.97
3021189907865890816,2020-07,2410.16,1823.14,4319.35,4078.87,827.5,10554.47
3021189907865890816,2020-08,5889.74,2109.74,2999.04,6113.43,665.61,11220.08
3021189907865890816,2020-09,740.36,0,7962.69,2217.5,6485.55,17705.63
3021189907865890816,2020-10,1231.88,5372.24,1672.88,1339.57,-3807.05,13898.58
3021189907865890816,2020-11,1137.28,3224.97,3836.55,2614.42,-865.56,13033.02
3021189907865890816,2020-12,11436.14,391.93,2170.3,2340.15,10874.36,23907.38
3021192988050739712,2020-01,1465.56,184.82,1630.29,39.3,2871.73,2871.73
3021192988050739712,2020-02,103,0,190.2,0,293.2,3164.93
3021192988050739712,2020-03,3179.43,0,0,0,3179.43,6344.36
3021192988050739712,2020-05,1995.13,1830.8,0,0,164.33,6508.69
3021192988050739712,2020-07,0,1028.66,0,0,-1028.66,5480.03
3021192988050739712,2020-08,1084.51,0,1842.73,1336.51,1590.73,7070.76
3021192988050739712,2020-10,640.95,0,2465.8,0,3106.75,10177.51
3021192988050739712,2020-11,732.25,0,299.18,0,1031.43,11208.94
3021192988050739712,2020-12,0,47.74,1004.6,0,956.86,12165.8
3021284997986714112,2020-01,2148.49,3854.06,1308.96,3138.81,-3535.42,-3535.42
3021284997986714112,2020-02,2530.71,1428.41,0,2848.21,-1745.91,-5281.33
3021284997986714112,2020-03,1886.06,1620.68,2532.59,2921.95,-123.98,-5405.31
3021284997986714112,2020-04,1830.88,8164.86,3768.88,4436.76,-7001.86,-12407.17
3021284997986714112,2020-05,410.8,5760.76,1450.32,6949.81,-10849.45,-23256.62
3021284997986714112,2020-06,628,1818.85,4570.87,3474.73,-94.71,-23351.33
3021284997986714112,2020-07,5790.6,1233.76,839.62,7802.43,-2405.97,-25757.3
3021284997986714112,2020-08,6362.59,2894.63,2354.7,4852.65,970.01,-24787.29
3021284997986714112,2020-09,3223.2,3932.34,2012.59,5235.36,-3931.91,-28719.2
3021284997986714112,2020-10,1648.86,3708.6,2581.33,3005.56,-2483.97,-31203.17
3021284997986714112,2020-11,4200.18,2295.26,611.92,1887.86,628.98,-30574.19
3021284997986714112,2020-12,0,3140.48,2676.04,3248.48,-3712.92,-34287.11
3021535866994764800,2020-01,1966.64,5736.65,2905.86,1932.16,-2796.31,-2796.31
3021535866994764800,2020-02,3413.32,1971.54,0,712.26,729.52,-2066.79
3021535866994764800,2020-03,2624.45,4540.9,77.47,2100.95,-3939.93,-6006.72
3021535866994764800,2020-04,0,3552.86,2826.73,883.22,-1609.35,-7616.07
3021535866994764800,2020-05,386.76,0,1917.6,772.67,1531.69,-6084.38
3021535866994764800,2020-06,3830.07,1344.74,889.14,3466.44,-91.97,-6176.35
3021535866994764800,2020-08,4353.8,686.86,2423.62,4156.8,1933.76,-4242.59
3021535866994764800,2020-09,232.55,602.29,0,3085.98,-3455.72,-7698.31
3021535866994764800,2020-10,0,1525.31,929.57,662.41,-1258.15,-8956.46
3021535866994764800,2020-11,2450.52,2766.65,4743.6,2747.66,1679.81,-7276.65
3021535866994764800,2020-12,2693.46,1146.27,282.06,320.28,1508.97,-5767.68
3021728428437939712,2020-01,955.16,554.95,2682.17,100.35,2982.03,2982.03
3021728428437939712,2020-02,1881.48,1063.96,1503.96,2707.11,-385.63,2596.4
3021728428437939712,2020-03,3560.52,1406.56,5540.65,2842.2,4852.41,7448.81
3021728428437939712,2020-04,575.02,2712.23,2105.24,847,-878.97,6569.84
3021728428437939712,2020-05,3869.43,68.62,967.32,3698.38,1069.75,7639.59
3021728428437939712,2020-06,2350.34,2990.14,3616.6,4142.09,-1165.29,6474.3
3021728428437939712,2020-07,2620.14,0,3848.14,3941.12,2527.16,9001.46
3021728428437939712,2020-08,2280.05,784.62,3075.2,2105.39,2465.24,11466.7
3021728428437939712,2020-09,2747.48,555.16,3569.84,1142.05,4620.11,16086.81
3021728428437939712,2020-10,1774.02,735.56,7685.54,0,8724,24810.81
3021728428437939712,2020-11,1959.99,4552.78,2194.37,1537.82,-1936.24,22874.57
3021728428437939712,2020-12,177.18,4811,1644.06,1666.63,-4656.39,18218.18
3021794953725494784,2020-01,0,21.69,0,0,-21.69,-21.69
3021794953725494784,2020-04,0,1711.08,0,0,-1711.08,-1732.77
3021794953725494784,2020-05,540.57,957.21,0,1114.49,-1531.13,-3263.9
3021794953725494784,2020-08,1047.1,1076.04,0,0,-28.94,-3292.84
3021794953725494784,2020-10,1587.66,1705.31,0,504.49,-622.14,-3914.98
3021794953725494784,2020-11,1357.26,1604.14,0,0,-246.88,-4161.86
3021809296135193600,2020-01,940.63,1590.22,1338.59,0,689,689
3021809296135193600,2020-02,357.5,1990.45,993.33,3897.47,-4537.09,-3848.09
3021809296135193600,2020-03,3177.51,2783.92,1143.4,1724.72,-187.73,-4035.82
3021809296135193600,2020-04,1373.23,5061.9,103.82,3361.75,-6946.6,-10982.42
3021809296135193600,2020-05,9248.94,4826.93,2153.17,1242.77,5332.41,-5650.01
3021809296135193600,2020-06,1835.5,5398.88,3196.96,4754.97,-5121.39,-10771.4
3021809296135193600,2020-07,1134.87,1867.16,2336.91,3501.19,-1896.57,-12667.97
3021809296135193600,2020-08,4095.63,1631.52,539.22,0,3003.33,-9664.64
3021809296135193600,2020-09,1060.75,923.92,1865.49,2061.34,-59.02,-9723.66
3021809296135193600,2020-10,3482.67,1995.41,4425.83,6094.4,-181.31,-9904.97
3021809296135193600,2020-11,2569.64,5151.2,2282.36,4129.14,-4428.34,-14333.31
3021809296135193600,2020-12,0,4170.45,4325.04,1706.26,-1551.67,-15884.98
3023143129706128896,2020-01,0,1125.74,1815.57,4811.07,-4121.24,-4121.24
3023143129706128896,2020-02,2084.56,0,2267.31,1765.6,2586.27,-1534.97
3023143129706128896,2020-03,5114.86,1314.23,961.71,4223.1,539.24,-995.73
3023143129706128896,2020-04,850.25,1330.39,3897.37,965.4,2451.83,1456.1
3023143129706128896,2020-05,3692.51,2768.5,2279.93,1392.1,1811.84,3267.94
3023143129706128896,2020-06,2405.04,3141.4,2413.14,4021.82,-2345.04,922.9
3023143129706128896,2020-07,3887.41,3242.86,4295.72,1615.3,3324.97,4247.87
3023143129706128896,2020-08,1361.04,1518.69,0,1627.61,-1785.26,2462.61
3023143129706128896,2020-09,530.56,5239.24,1600.33,1336.57,-4444.92,-1982.31
3023143129706128896,2020-10,3143.79,3186.31,2545.77,2552.56,-49.31,-2031.62
3023143129706128896,2020-11,401.98,1794.5,1263.13,1507.4,-1636.79,-3668.41
3023143129706128896,2020-12,2875.58,194.39,2905.04,1837.3,3748.93,80.52
3023687464064619520,2020-01,2748.64,2871.77,2978.3,2637.96,217.21,217.21
3023687464064619520,2020-02,1863.96,589.75,1835.02,1568.51,1540.72,1757.93
3023687464064619520,2020-03,1138.44,1462.57,2487.77,124.78,2038.86,3796.79
3023687464064619520,2020-04,0,1540.79,2673.28,6658.64,-5526.15,-1729.36
3023687464064619520,2020-05,2070.09,2962.87,1024.47,3915.4,-3783.71,-5513.07
3023687464064619520,2020-06,1009.9,1788.24,2507.08,0,1728.74,-3784.33
3023687464064619520,2020-07,1272.18,1929.26,1895.34,85.95,1152.31,-2632.02
3023687464064619520,2020-08,1533.86,145.55,383.5,1965.16,-193.35,-2825.37
3023687464064619520,2020-09,587.86,0,2890.8,0,3478.66,653.29
3023687464064619520,2020-10,985.9,342.44,1867.46,2521.13,-10.21,643.08
3023687464064619520,2020-11,2511.47,1365.14,0,511.83,634.5,1277.58
3023687464064619520,2020-12,700.78,2991.3,3423.57,1795.26,-662.21,615.37
3023907678900841984,2020-01,851.65,0,311.96,1698.72,-535.11,-535.11
3023907678900841984,2020-02,3013.36,1232.75,0,20.7,1759.91,1224.8
3023907678900841984,2020-03,4308.32,932.23,1182.84,0,4558.93,5783.73
3023907678900841984,2020-04,1895.32,283.11,846.63,2739.46,-280.62,5503.11
3023907678900841984,2020-05,0,1983.75,4044.39,2746.37,-685.73,4817.38
3023907678900841984,2020-06,1750.76,0,53.87,1239.18,565.45,5382.83
3023907678900841984,2020-07,1702.38,1924.39,1195.97,0,973.96,6356.79
3023907678900841984,2020-08,658.99,0,468.39,1912.75,-785.37,5571.42
3023907678900841984,2020-10,0,249.71,0,0,-249.71,5321.71
3023907678900841984,2020-11,4242.75,0,2045.03,0,6287.78,11609.49
3023907678900841984,2020-12,360.36,0,2281.5,234.35,2407.51,14017
3024832704258978304,2020-01,3225.34,2348.66,43.28,0,919.96,919.96
3024832704258978304,2020-02,0,2720.92,1419.28,1150.37,-2452.01,-1532.05
3024832704258978304,2020-03,2563.65,0,1563.99,3050.84,1076.8,-455.25
3024832704258978304,2020-04,3307.47,130.37,2307.7,0,5484.8,5029.55
3024832704258978304,2020-05,1679.35,0,1807.4,196.51,3290.24,8319.79
3024832704258978304,2020-06,474.29,1369.21,1272.3,0,377.38,8697.17
3024832704258978304,2020-07,1880.2,1756.24,801.48,0,925.44,9622.61
3024832704258978304,2020-08,0,333.11,2490.58,0,2157.47,11780.08
3024832704258978304,2020-09,1175.9,688.25,730.49,764.88,453.26,12233.34
3024832704258978304,2020-10,1489.76,0,0,1218.51,271.25,12504.59
3024832704258978304,2020-11,2316.49,425.17,1842.51,0,3733.83,16238.42
3024832704258978304,2020-12,1868.54,0,1433.16,0,3301.7,19540.12
3025113988594296320,2020-01,766.27,3730.08,2945.08,1449.01,-1467.74,-1467.74
3025113988594296320,2020-02,3840.09,5307.49,3853.26,7110.41,-4724.55,-6192.29
3025113988594296320,2020-03,3543.83,4014.5,6922.39,1375.69,5076.03,-1116.26
3025113988594296320,2020-04,4429.42,3970.06,3790.45,2722.95,1526.86,410.6
3025113988594296320,2020-05,1936.16,4852.48,2157.7,5443.88,-6202.5,-5791.9
3025113988594296320,2020-06,3325.37,4274.86,7260.81,6496.44,-185.12,-5977.02
3025113988594296320,2020-07,2366.33,3191.37,3490.01,3757.38,-1092.41,-7069.43
3025113988594296320,2020-08,4180.42,6752.26,2145.46,5789.04,-6215.42,-13284.85
3025113988594296320,2020-09,8097.19,3378.41,7364.46,14039.06,-1955.82,-15240.67
3025113988594296320,2020-10,5260.79,2716.31,3489.45,5195.89,838.04,-14402.63
3025113988594296320,2020-11,2662.98,3406.61,6625.18,2443.05,3438.5,-10964.13
3025113988594296320,2020-12,3522.27,7832.97,8466.37,2452.94,1702.73,-9261.4
3025899453201493504,2020-01,3121.69,6332.34,2258.86,1796.94,-2748.73,-2748.73
3025899453201493504,2020-02,4547.21,1944.17,1474.62,5179.95,-1102.29,-3851.02
3025899453201493504,2020-03,3604.39,4892.34,5692.15,4246.73,157.47,-3693.55
3025899453201493504,2020-04,5943.63,7102.45,1767.72,4197.66,-3588.76,-7282.31
3025899453201493504,2020-05,3608.16,3430.81,3554.62,4868.25,-1136.28,-8418.59
3025899453201493504,2020-06,1810.92,8432.99,4242.49,145.65,-2525.23,-10943.82
3025899453201493504,2020-07,3069.33,4086.45,2924.98,1231.04,676.82,-10267
3025899453201493504,2020-08,5855.23,4020.55,5251.39,303.48,6782.59,-3484.41
3025899453201493504,2020-09,6055.37,5613.16,1066.66,3375.07,-1866.2,-5350.61
3025899453201493504,2020-10,242.35,5659.45,1745.41,2547.72,-6219.41,-11570.02
3025899453201493504,2020-11,7152.02,978.07,8027.54,1096.72,13104.77,1534.75
3025899453201493504,2020-12,4388.24,0,4126.09,6003.58,2510.75,4045.5
3026096836462334464,2020-01,3512.23,3415.12,3826.96,3928.66,-4.59,-4.59
3026096836462334464,2020-02,2127.14,4430.74,4939.2,3918.19,-1282.59,-1287.18
3026096836462334464,2020-03,7712.47,2016.76,2228.04,1717.53,6206.22,4919.04
3026096836462334464,2020-04,2697.81,11504.58,1866.99,6424.48,-13364.26,-8445.22
3026096836462334464,2020-05,7748.46,6969.4,2932.8,6488.15,-2776.29,-11221.51
3026096836462334464,2020-06,5776.99,1573.12,5903.11,3894.16,6212.82,-5008.69
3026096836462334464,2020-07,3749.78,6410.77,8083.38,5118.84,303.55,-4705.14
3026096836462334464,2020-08,4109.47,503.71,6207.44,5133.85,4679.35,-25.79
3026096836462334464,2020-09,6942.78,4828.83,5979.32,9179.84,-1086.57,-1112.36
3026096836462334464,2020-10,712.04,2984.94,2546.62,5443.48,-5169.76,-6282.12
3026096836462334464,2020-11,3676.89,951.08,2856.43,3016.98,2565.26,-3716.86
3026096836462334464,2020-12,1044.63,1791.52,4352.25,5076.01,-1470.65,-5187.51
3026687451852088320,2020-01,0,2541.42,2164.89,1919.3,-2295.83,-2295.83
3026687451852088320,2020-02,2778.93,1178.52,2986.22,0,4586.63,2290.8
3026687451852088320,2020-03,1030.02,3826.24,1168.59,1213.45,-2841.08,-550.28
3026687451852088320,2020-04,2220.3,191.35,163.52,2819.14,-626.67,-1176.95
3026687451852088320,2020-05,3040.97,0,2158.11,3912.71,1286.37,109.42
3026687451852088320,2020-06,1584.01,1512.45,2853.35,4278.18,-1353.27,-1243.85
3026687451852088320,2020-07,3233.06,4387.77,1740.41,1772.14,-1186.44,-2430.29
3026687451852088320,2020-08,0,411.67,564.48,1281.85,-1129.04,-3559.33
3026687451852088320,2020-09,0,3567.75,1395.4,0,-2172.35,-5731.68
3026687451852088320,2020-10,1909.56,3272.61,1861.41,1157.46,-659.1,-6390.78
3026687451852088320,2020-11,1405.21,4171.11,1971.81,3404.09,-4198.18,-10588.96
3026687451852088320,2020-12,2583.9,1404.01,2717.61,242.57,3654.93,-6934.03
3027022996242790400,2020-01,0,394.49,0,0,-394.49,-394.49
3027022996242790400,2020-02,0,714.67,0,3138.91,-3853.58,-4248.07
3027022996242790400,2020-05,629.82,1921.56,1939.69,0,647.95,-3600.12
3027022996242790400,2020-06,711.34,1870.85,2090.04,0,930.53,-2669.59
3027022996242790400,2020-07,0,357.82,0,1858.86,-2216.68,-4886.27
3027022996242790400,2020-09,0,1192.26,0,3103.86,-4296.12,-9182.39
3027022996242790400,2020-10,0,388.21,210.61,1376.22,-1553.82,-10736.21
3027022996242790400,2020-11,0,1363.05,234.21,2647.12,-3775.96,-14512.17
3027022996242790400,2020-12,620.95,0,0,2541.36,-1920.41,-16432.58
3027316998217316864,2020-01,3374.14,3170.97,3148.26,3541.52,-190.09,-190.09
3027316998217316864,2020-02,3406.69,4184,1778.13,7514.72,-6513.9,-6703.99
3027316998217316864,2020-03,3049.48,3415.07,2780.73,3472.12,-1056.98,-7760.97
3027316998217316864,2020-04,3361.79,3206.1,582.19,692.94,44.94,-7716.03
3027316998217316864,2020-05,4429.47,3228.08,1948.71,2109.79,1040.31,-6675.72
3027316998217316864,2020-06,3867.53,4578.04,2061.6,2709.25,-1358.16,-8033.88
3027316998217316864,2020-07,2280.39,2716.46,6520.8,5785.31,299.42,-7734.46
3027316998217316864,2020-08,2801.81,1930.62,2965.83,1234.77,2602.25,-5132.21
3027316998217316864,2020-09,5000.47,58.59,9339.01,1492.18,12788.71,7656.5
3027316998217316864,2020-10,7788.78,548.85,487.25,6991.95,735.23,8391.73
3027316998217316864,2020-12,5636.98,2028.32,6662.41,785.07,9486,17877.73
3028105418117580800,2020-01,1737.85,0,0,0,1737.85,1737.85
3028105418117580800,2020-05,0,927.98,1738.56,0,810.58,2548.43
3028105418117580800,2020-07,1257.81,0,0,1333.38,-75.57,2472.86
3028105418117580800,2020-08,38.28,0,216.32,1487.88,-1233.28,1239.58
3028105418117580800,2020-11,0,1378.44,0,0,-1378.44,-138.86
3029969490060020224,2020-01,2201.95,1406.09,0,5576.79,-4780.93,-4780.93
3029969490060020224,2020-02,2395.66,5471.64,0,1403.03,-4479.01,-9259.94
3029969490060020224,2020-04,2206.06,858.87,3136.22,3398.43,1084.98,-8174.96
3029969490060020224,2020-05,4139.89,3998.98,3507.66,2163.94,1484.63,-6690.33
3029969490060020224,2020-06,4140.47,2043.91,3056.76,1453.03,3700.29,-2990.04
3029969490060020224,2020-07,2189.44,4143.3,1317.91,1522.46,-2158.41,-5148.45
3029969490060020224,2020-08,4300.1,536.39,3785.6,3072.53,4476.78,-671.67
3029969490060020224,2020-09,2330.99,1118.41,1493.89,2383.64,322.83,-348.84
3029969490060020224,2020-10,1126.98,7605.13,0,0,-6478.15,-6826.99
3029969490060020224,2020-11,1562.72,0,2892.99,8804.35,-4348.64,-11175.63
3029969490060020224,2020-12,2925.99,1270.75,2043.17,1725.04,1973.37,-9202.26
3030397456751777792,2020-01,680.69,0,1750.54,1950.33,480.9,480.9
3030397456751777792,2020-02,1433.84,0,0,0,1433.84,1914.74
3030397456751777792,2020-03,893.5,0,411.1,0,1304.6,3219.34
3030397456751777792,2020-06,0,2491.48,0,0,-2491.48,727.86
3030397456751777792,2020-07,0,162.7,432.19,0,269.49,997.35
3030397456751777792,2020-08,1294.68,1989.12,188.55,683.62,-1189.51,-192.16
3030397456751777792,2020-10,1647.3,278.12,1650.37,1173.32,1846.23,1654.07
3030397456751777792,2020-11,2704.58,0,1311.41,0,4015.99,5670.06
3030397456751777792,2020-12,0,1445.67,0,0,-1445.67,4224.39
3030622644000044032,2020-01,2917.41,4876.63,1250.99,2825.77,-3534,-3534
3030622644000044032,2020-02,3670.34,3796.35,5078.81,3417.5,1535.3,-1998.7
3030622644000044032,2020-03,1667.92,2457.85,2099.92,1332.28,-22.29,-2020.99
3030622644000044032,2020-04,6593.49,3926.6,1431.22,3991.64,106.47,-1914.52
3030622644000044032,2020-05,945.96,3076.16,1966.71,6424.67,-6588.16,-8502.68
3030622644000044032,2020-06,5561.7,230.42,2310.75,4061.48,3580.55,-4922.13
3030622644000044032,2020-07,5593.26,6102.95,3800.38,4193.68,-902.99,-5825.12
3030622644000044032,2020-08,6765.26,3490.97,1787.01,230.83,4830.47,-994.65
3030622644000044032,2020-09,4489.71,0,7640.31,6953.34,5176.68,4182.03
3030622644000044032,2020-10,1680.69,353.48,1742.13,3050.55,18.79,4200.82
3030622644000044032,2020-11,791.5,4423.37,0,3813.19,-7445.06,-3244.24
3030622644000044032,2020-12,5757.81,5877.47,1225.56,4512.3,-3406.4,-6650.64
3030699206277506560,2020-01,2050.2,2003.72,6444.67,6480.24,10.91,10.91
3030699206277506560,2020-02,2165.13,2381.18,4250.54,0,4034.49,4045.4
3030699206277506560,2020-03,3254.21,2225.9,3636.07,2732.08,1932.3,5977.7
3030699206277506560,2020-04,2344.97,5781.79,1590.98,726.44,-2572.28,3405.42
3030699206277506560,2020-05,3613.67,4173.5,2506.94,2151.49,-204.38,3201.04
3030699206277506560,2020-06,3423.67,5755.34,1606.84,3186.23,-3911.06,-710.02
3030699206277506560,2020-07,6161.03,5104.18,5564.46,0,6621.31,5911.29
3030699206277506560,2020-08,349.6,4057.35,105.08,6589.43,-10192.1,-4280.81
3030699206277506560,2020-09,1736.11,5829.22,3940.31,880.88,-1033.68,-5314.49
3030699206277506560,2020-10,4868.86,4765.53,2362.22,0,2465.55,-2848.94
3030699206277506560,2020-11,1176.28,3405.07,5140.32,2188.75,722.78,-2126.16
3030699206277506560,2020-12,2834.96,0,2191.47,4593.12,433.31,-1692.85
3031133561556326912,2020-01,1745.39,1169.25,260.2,1951.5,-1115.16,-1115.16
3031133561556326912,2020-02,0,4598.31,519.27,3240.82,-7319.86,-8435.02
3031133561556326912,2020-03,603.2,2599.34,2187.27,3482.31,-3291.18,-11726.2
3031133561556326912,2020-04,706.48,1493.44,1187.77,5950.5,-5549.69,-17275.89
3031133561556326912,2020-05,1410.09,1758.98,1247.33,4013.05,-3114.61,-20390.5
3031133561556326912,2020-06,1662.91,1183.01,0,715.65,-235.75,-20626.25
3031133561556326912,2020-07,306.49,1670.67,0,5652.58,-7016.76,-27643.01
3031133561556326912,2020-08,1518.39,1633.09,555.8,356.93,84.17,-27558.84
3031133561556326912,2020-09,1130.38,5482.06,2206.11,2508.15,-4653.72,-32212.56
3031133561556326912,2020-10,1122.07,252.07,496.16,2841.62,-1475.46,-33688.02
3031133561556326912,2020-11,0,2638.86,732.03,863.93,-2770.76,-36458.78
3031133561556326912,2020-12,1896.45,1822.04,2403.49,0,2477.9,-33980.88
3031575715140199424,2020-01,1721.6,2755.48,1684.57,1547.41,-896.72,-896.72
3031575715140199424,2020-02,5512.24,0,0,995.21,4517.03,3620.31
3031575715140199424,2020-03,3321.84,1995.26,0,3816,-2489.42,1130.89
3031575715140199424,2020-04,2124.31,0,1474.12,1748.6,1849.83,2980.72
3031575715140199424,2020-05,1953.68,3401.65,1401.32,3285.72,-3332.37,-351.65
3031575715140199424,2020-07,1382.81,5882.34,2249.68,845.79,-3095.64,-3447.29
3031575715140199424,2020-08,6198.31,4149.44,2746.28,215.85,4579.3,1132.01
3031575715140199424,2020-09,431.62,1234.86,6205.54,523,4879.3,6011.31
3031575715140199424,2020-10,2119.62,1879.06,1594.56,168.05,1667.07,7678.38
3031575715140199424,2020-11,1710.23,2314.34,4037.96,73.33,3360.52,11038.9
3031575715140199424,2020-12,5085.34,1178.31,757.1,2419.22,2244.91,13283.81
3031947849996805632,2020-03,1844.8,1106.87,0,0,737.93,737.93
3031947849996805632,2020-09,0,490.66,0,0,-490.66,247.27
3032319579042147328,2020-01,2453.75,1327.44,931.1,2434.09,-376.68,-376.68
3032319579042147328,2020-02,4043.13,1727.58,2302.15,4784.33,-166.63,-543.31
3032319579042147328,2020-03,1545.5,4846.83,553.2,2679.56,-5427.69,-5971
3032319579042147328,2020-04,2919.12,2254.58,4935.09,903.82,4695.81,-1275.19
3032319579042147328,2020-05,5196.57,3436.44,5170.93,5198.7,1732.36,457.17
3032319579042147328,2020-06,3845.98,1977.41,1639.89,3902.03,-393.57,63.6
3032319579042147328,2020-07,1985.19,2814.92,1952.53,1285.48,-162.68,-99.08
3032319579042147328,2020-08,4897.32,1957.42,561.75,2187.09,1314.56,1215.48
3032319579042147328,2020-09,4092.31,3271.48,96.41,3575.86,-2658.62,-1443.14
3032319579042147328,2020-10,229.97,1594.18,4568.15,908.91,2295.03,851.89
3032319579042147328,2020-11,1783.41,3299.81,1038.8,1807.36,-2284.96,-1433.07
3032319579042147328,2020-12,2735.99,3450.81,3016.28,3864.05,-1562.59,-2995.66
3032798757084893184,2020-01,3665.45,5513.49,2789.02,4234.54,-3293.56,-3293.56
3032798757084893184,2020-02,5429.4,2255.39,3433.12,1134.8,5472.33,2178.77
3032798757084893184,2020-03,6026.6,4850.55,3645.02,2565.6,2255.47,4434.24
3032798757084893184,2020-04,964.35,3259.81,1990.66,4533.32,-4838.12,-403.88
3032798757084893184,2020-05,2796.72,638.53,951.63,2934.89,174.93,-228.95
3032798757084893184,2020-06,1149.78,3489.51,7937.7,1121.86,4476.11,4247.16
3032798757084893184,2020-07,3718.51,1065.6,1977.81,2343.38,2287.34,6534.5
3032798757084893184,2020-08,1728.24,6504.51,1765.3,2820.83,-5831.8,702.7
3032798757084893184,2020-09,3677.4,4436.7,493.12,3355.75,-3621.93,-2919.23
3032798757084893184,2020-10,1571.21,3962.47,1730.03,4665.19,-5326.42,-8245.65
3032798757084893184,2020-11,1532.8,4722.76,4771,4463.81,-2882.77,-11128.42
3032798757084893184,2020-12,4201.86,4638.46,1834.39,2867.25,-1469.46,-12597.88
3033165027790253056,2020-01,2675.79,2284.6,4458.6,556.46,4293.33,4293.33
3033165027790253056,2020-02,709.44,2094,4677.95,4603.15,-1309.76,2983.57
3033165027790253056,2020-03,2336.14,3535.03,0,7327.82,-8526.71,-5543.14
3033165027790253056,2020-04,2948.81,6644.56,1396.78,3789.22,-6088.19,-11631.33
3033165027790253056,2020-05,3715.06,6167.07,5722.27,5620.87,-2350.61,-13981.94
3033165027790253056,2020-06,2676.17,5308.45,3750.64,3872.8,-2754.44,-16736.38
3033165027790253056,2020-07,4609.77,6278.41,1177.97,4035.06,-4525.73,-21262.11
3033165027790253056,2020-08,520.05,3920.51,2953.33,8293.46,-8740.59,-30002.7
3033165027790253056,2020-09,2223.11,5985.34,0,3893.78,-7656.01,-37658.71
3033165027790253056,2020-10,999.69,7300.36,7661.45,4775.94,-3415.16,-41073.87
3033165027790253056,2020-11,7577.09,4317.34,5768.6,1589,7439.35,-33634.52
3033165027790253056,2020-12,4362.92,6523.25,6412.74,2443.97,1808.44,-31826.08
3033256753925873664,2020-01,1809.13,1579.41,555.12,1502.53,-717.69,-717.69
3033256753925873664,2020-02,0,1176.85,4321.22,5365.54,-2221.17,-2938.86
3033256753925873664,2020-03,6385.05,3116.53,4304,2048.78,5523.74,2584.88
3033256753925873664,2020-04,2621.69,2731.1,266.66,0,157.25,2742.13
3033256753925873664,2020-05,1864.69,2939.97,3975.41,1146.86,1753.27,4495.4
3033256753925873664,2020-06,2074.84,6316.25,2171.24,1746.35,-3816.52,678.88
3033256753925873664,2020-07,2365.9,2571.12,5419.4,2148.7,3065.48,3744.36
3033256753925873664,2020-08,3144.39,1278.16,1381.96,4660.9,-1412.71,2331.65
3033256753925873664,2020-09,1959.16,2409.7,5011.58,647.78,3913.26,6244.91
3033256753925873664,2020-10,0,3539.98,1494.9,1286.21,-3331.29,2913.62
3033256753925873664,2020-11,3406.31,614.71,3343.64,2357.06,3778.18,6691.8
3033256753925873664,2020-12,2340.39,4728.71,845.58,1660.36,-3203.1,3488.7
3036319093712370688,2020-01,918.43,0,176.23,0,1094.66,1094.66
3036319093712370688,2020-02,5483.06,0,4986.02,429.7,10039.38,11134.04
3036319093712370688,2020-03,632.4,118.28,0,1806.23,-1292.11,9841.93
3036319093712370688,2020-04,623.15,3194.04,1492.84,1467.97,-2546.02,7295.91
3036319093712370688,2020-05,314.45,0,0,1733.5,-1419.05,5876.86
3036319093712370688,2020-06,400.18,0,0,0,400.18,6277.04
3036319093712370688,2020-08,1498.87,55.84,1987.27,4469.23,-1038.93,5238.11
3036319093712370688,2020-09,0,1231.16,966.93,0,-264.23,4973.88
3036319093712370688,2020-10,1713.58,0,2430.38,0,4143.96,9117.84
3036319093712370688,2020-11,3429.34,0,763.64,1686.73,2506.25,11624.09
3036319093712370688,2020-12,1896.86,662.57,0,0,1234.29,12858.38
3036434183236720128,2020-01,3901.15,4521.82,165.75,4121.34,-4576.26,-4576.26
3036434183236720128,2020-02,1546.46,2856.4,3977.71,2202.87,464.9,-4111.36
3036434183236720128,2020-03,2951.9,1471.17,4724.63,2168.57,4036.79,-74.57
3036434183236720128,2020-04,3233.29,713.49,3060.38,3094.17,2486.01,2411.44
3036434183236720128,2020-05,4268.71,793.49,0,2671.05,804.17,3215.61
3036434183236720128,2020-06,7421.1,1926.3,1743.42,2273.19,4965.03,8180.64
3036434183236720128,2020-07,3001.58,3231.57,5582.53,1592.09,3760.45,11941.09
3036434183236720128,2020-08,1999.39,4040.93,1496.88,957.54,-1502.2,10438.89
3036434183236720128,2020-09,4855.18,7373.6,3685.32,6158.25,-4991.35,5447.54
3036434183236720128,2020-10,4954.53,2529.74,3649.47,1280.44,4793.82,10241.36
3036434183236720128,2020-11,3510.4,3628.01,4277.73,2849.55,1310.57,11551.93
3036434183236720128,2020-12,3033.78,1887.49,2405.5,2719.68,832.11,12384.04
3039288829345702912,2020-01,4620.31,5876.27,3396.76,1072.19,1068.61,1068.61
3039288829345702912,2020-02,2734.33,6981.24,6523.09,4724.94,-2448.76,-1380.15
3039288829345702912,2020-03,3603.45,4465.46,5941.63,4284.53,795.09,-585.06
3039288829345702912,2020-04,5782.35,5705.39,5803.23,1274.06,4606.13,4021.07
3039288829345702912,2020-05,1112.23,2882.54,7793.52,4549.03,1474.18,5495.25
3039288829345702912,2020-06,4261.95,4696.72,3585.42,6385.58,-3234.93,2260.32
3039288829345702912,2020-07,4243.92,8764.97,7188.82,280.84,2386.93,4647.25
3039288829345702912,2020-08,15334.52,4006.54,5068.17,7580.77,8815.38,13462.63
3039288829345702912,2020-09,0,2153.3,7127.44,7233.51,-2259.37,11203.26
3039288829345702912,2020-10,6906.01,3028,6869.81,3866,6881.82,18085.08
3039288829345702912,2020-11,4870.11,5246.47,5504.74,5810.99,-682.61,17402.47
3039288829345702912,2020-12,3505.58,5503.93,4972.37,4304.72,-1330.7,16071.77
3039416930729163776,2020-01,1480.39,1654.69,6472.91,1422.25,4876.36,4876.36
3039416930729163776,2020-02,3763.56,11299.83,4445.4,6978.69,-10069.56,-5193.2
3039416930729163776,2020-03,1732.08,2621.46,4958.13,1571.73,2497.02,-2696.18
3039416930729163776,2020-04,5675.07,6339.1,2984.82,9536.08,-7215.29,-9911.47
3039416930729163776,2020-05,4195.02,1943.9,4618.81,2598.98,4270.95,-5640.52
3039416930729163776,2020-06,2336.06,2457.72,3969.3,4192.13,-344.49,-5985.01
3039416930729163776,2020-07,10090.17,8533.35,1237.68,4223.75,-1429.25,-7414.26
3039416930729163776,2020-08,4388.74,3842.15,1152.3,15197.28,-13498.39,-20912.65
3039416930729163776,2020-09,10873.59,2346.31,7053.89,3798.92,11782.25,-9130.4
3039416930729163776,2020-10,6109.75,4620.87,6114.93,4392.03,3211.78,-5918.62
3039416930729163776,2020-11,4552.26,5578.65,5303.41,9026.09,-4749.07,-10667.69
3039416930729163776,2020-12,4034.93,5444.42,7040.54,7562.45,-1931.4,-12599.09
3040394818430681600,2020-01,2591.23,1245.63,2762.18,1078.85,3028.93,3028.93
3040394818430681600,2020-02,1457.22,0,0,0,1457.22,4486.15
3040394818430681600,2020-03,886.15,2746.79,1912.18,4396.3,-4344.76,141.39
3040394818430681600,2020-04,4923.44,0,1027.63,573.07,5378,5519.39
3040394818430681600,2020-05,1179.11,0,2280.75,1822.54,1637.32,7156.71
3040394818430681600,2020-06,2413.31,1303.32,5097.21,0,6207.2,13363.91
3040394818430681600,2020-07,1764.1,4029.8,525.13,1933.58,-3674.15,9689.76
3040394818430681600,2020-08,1105.83,1489.56,999.74,1857.99,-1241.98,8447.78
3040394818430681600,2020-09,1938.31,3189.82,1556.3,992.45,-687.66,7760.12
3040394818430681600,2020-10,1863.7,779.72,0,0,1083.98,8844.1
3040394818430681600,2020-11,574.98,143.67,177.56,393.89,214.98,9059.08
3040394818430681600,2020-12,2416.07,1880.38,491.07,0,1026.76,10085.84
3041906719193672704,2020-01,0,4792.72,5166.31,5366.37,-4992.78,-4992.78
3041906719193672704,2020-02,2293.68,1808.03,6350.8,4899.94,1936.51,-3056.27
3041906719193672704,2020-03,1048.16,4713.53,4626.34,0,960.97,-2095.3
3041906719193672704,2020-04,2892.71,319.57,4579.4,231.26,6921.28,4825.98
3041906719193672704,2020-05,7787.2,4430.87,0,1678.56,1677.77,6503.75
3041906719193672704,2020-06,1812.43,3651.75,3483.01,273.87,1369.82,7873.57
3041906719193672704,2020-07,1276.96,6854.55,4678.73,515.31,-1414.17,6459.4
3041906719193672704,2020-08,3233.46,4715.52,4215.2,4815.48,-2082.34,4377.06
3041906719193672704,2020-09,721.92,2547.87,610.65,742.12,-1957.42,2419.64
3041906719193672704,2020-10,3261.83,1012.65,2758.7,237.29,4770.59,7190.23
3041906719193672704,2020-11,3486.09,1251.01,2982.81,4544.1,673.79,7864.02
3041906719193672704,2020-12,3094.71,7442.7,987.04,4107.53,-7468.48,395.54
3042254446981685248,2020-01,8050.78,2397.09,6774.17,3906.53,8521.33,8521.33
3042254446981685248,2020-02,4313.27,5997.1,2967.26,7784.53,-6501.1,2020.23
3042254446981685248,2020-03,5203.09,4519.45,1490.75,5205.94,-3031.55,-1011.32
3042254446981685248,2020-04,4446.92,3856.16,5983.25,3069.4,3504.61,2493.29
3042254446981685248,2020-05,6720.02,3461.52,2005.88,3239.08,2025.3,4518.59
3042254446981685248,2020-06,5228.74,490.67,3329.88,5291.11,2776.84,7295.43
3042254446981685248,2020-07,994.24,8198.13,2820.77,5470.96,-9854.08,-2558.65
3042254446981685248,2020-08,4532.37,5894.6,1805.55,2279.78,-1836.46,-4395.11
3042254446981685248,2020-09,9202.48,5447.04,1969.64,514.5,5210.58,815.47
3042254446981685248,2020-10,4763.42,673.3,2870.96,6465.2,495.88,1311.35
3042254446981685248,2020-11,4532.71,5616.4,1039.81,2546.11,-2589.99,-1278.64
3042254446981685248,2020-12,6705.88,2292.3,3392.9,988.2,6818.28,5539.64
3042729872965590016,2020-01,4078.34,2831.85,2580.12,2640.07,1186.54,1186.54
3042729872965590016,2020-02,2561.08,4026.77,2264.43,7310.32,-6511.58,-5325.04
3042729872965590016,2020-03,1861.54,4592.18,4655.61,893.44,1031.53,-4293.51
3042729872965590016,2020-04,7700.48,9574.93,7381.59,6556.65,-1049.51,-5343.02
3042729872965590016,2020-05,7455.64,7516.6,3589.19,3898.69,-370.46,-5713.48
3042729872965590016,2020-06,1717.73,1602.35,2688.58,4140.75,-1336.79,-7050.27
3042729872965590016,2020-07,6225.28,693.97,5629.54,4135.73,7025.12,-25.15
3042729872965590016,2020-08,2902.45,6240.47,5432.61,4016.05,-1921.46,-1946.61
3042729872965590016,2020-09,2518.43,3399.28,5489.12,2958.72,1649.55,-297.06
3042729872965590016,2020-10,4281.62,5759.31,144.53,1309.45,-2642.61,-2939.67
3042729872965590016,2020-11,3113.74,3425.06,1514.84,2352.94,-1149.42,-4089.09
3042729872965590016,2020-12,2879.16,1494.41,3269.52,2575.5,2078.77,-2010.32
3043815811744217088,2020-01,1136.21,0,0,425.79,710.42,710.42
3043815811744217088,2020-02,2045.82,491.04,1676.12,393.23,2837.67,3548.09
3043815811744217088,2020-03,0,1836.78,0,0,-1836.78,1711.31
3043815811744217088,2020-04,0,1581.52,0,0,-1581.52,129.79
3043815811744217088,2020-05,578.07,0,0,0,578.07,707.86
3043815811744217088,2020-06,1228.32,489.54,0,868.67,-129.89,577.97
3043815811744217088,2020-09,1531.98,1772.29,1195.15,3196.76,-2241.92,-1663.95
3043815811744217088,2020-10,664.99,662.35,961.75,0,964.39,-699.56
3043815811744217088,2020-11,2422.77,1361.84,1840.38,0,2901.31,2201.75
3043815811744217088,2020-12,0,261.86,1610.1,0,1348.24,3549.99
3044971526824058368,2020-01,1756.05,2508.83,5118.31,5132.96,-767.43,-767.43
3044971526824058368,2020-02,3382.33,972.8,2159.39,2057.28,2511.64,1744.21
3044971526824058368,2020-03,2583.52,709.19,8053.43,7564.14,2363.62,4107.83
3044971526824058368,2020-04,5286.33,0,1922.36,1467.56,5741.13,9848.96
3044971526824058368,2020-05,3454.79,6407.91,2999.42,2345.27,-2298.97,7549.99
3044971526824058368,2020-06,3272.61,1583.71,4755.33,6875.5,-431.27,7118.72
3044971526824058368,2020-07,1709.05,1650.08,3313.41,254.27,3118.11,10236.83
3044971526824058368,2020-08,3512.68,1963,150.35,1327.42,372.61,10609.44
3044971526824058368,2020-09,0,4354.31,2038.63,5231.01,-7546.69,3062.75
3044971526824058368,2020-10,7581.29,1537.99,2888.63,3372.58,5559.35,8622.1
3044971526824058368,2020-11,5587.37,986.13,3521.94,5332.71,2790.47,11412.57
3044971526824058368,2020-12,283.43,1564.61,4584.57,2876.17,427.22,11839.79
3046122557888509440,2020-01,1534.79,0,0,0,1534.79,1534.79
3046122557888509440,2020-08,0,1628.96,1380.28,693.74,-942.42,592.37
3046122557888509440,2020-09,0,1487.28,0,0,-1487.28,-894.91
3046122557888509440,2020-10,240.34,0,1915.64,0,2155.98,1261.07
3046122557888509440,2020-12,222.58,0,0,847.97,-625.39,635.68
3046142284491107328,2020-01,219.53,4553.35,3305.06,4929.57,-5958.33,-5958.33
3046142284491107328,2020-02,5755.4,0,3500.57,1626.82,7629.15,1670.82
3046142284491107328,2020-03,2008.24,2164.48,2184.87,1806.35,222.28,1893.1
3046142284491107328,2020-05,1842.63,3362.01,2021.93,1221.92,-719.37,1173.73
3046142284491107328,2020-06,223.08,3255.27,4086.52,356.11,698.22,1871.95
3046142284491107328,2020-07,1162.67,1803.23,4852.1,750.51,3461.03,5332.98
3046142284491107328,2020-08,1553.72,0,0,1424.2,129.52,5462.5
3046142284491107328,2020-09,1295.13,2574.86,4606.22,2048.01,1278.48,6740.98
3046142284491107328,2020-10,1731.69,134.12,1993.75,346.64,3244.68,9985.66
3046142284491107328,2020-11,345.21,1524.37,5319.37,640.56,3499.65,13485.31
3046142284491107328,2020-12,2209.7,2057.41,1657.79,5836.58,-4026.5,9458.81
3047805910354596352,2020-01,1925.42,691.79,3281.79,1187.4,3328.02,3328.02
3047805910354596352,2020-02,340.51,483.41,4151.39,1819.89,2188.6,5516.62
3047805910354596352,2020-03,1588.95,1943.09,1364.96,1376.61,-365.79,5150.83
3047805910354596352,2020-04,0,3122.18,759.12,0,-2363.06,2787.77
3047805910354596352,2020-05,1148.16,442.95,0,935.61,-230.4,2557.37
3047805910354596352,2020-06,0,2081.19,3610.98,3947.23,-2417.44,139.93
3047805910354596352,2020-07,339.11,1596.37,1279.9,1133.45,-1110.81,-970.88
3047805910354596352,2020-08,0,656.28,0,0,-656.28,-1627.16
3047805910354596352,2020-09,2034.22,1416.79,0,0,617.43,-1009.73
3047805910354596352,2020-10,1151.24,3290.47,5010.21,240.08,2630.9,1621.17
3047805910354596352,2020-12,1196.81,3103.4,153.82,0,-1752.77,-131.6
3048303297335403008,2020-01,2019.67,0,2019.63,0,4039.3,4039.3
3048303297335403008,2020-02,315.98,1479.66,0,1827.15,-2990.83,1048.47
3048303297335403008,2020-03,2518.04,0,19.12,1428.98,1108.18,2156.65
3048303297335403008,2020-04,0,2664.97,1606.56,1999.3,-3057.71,-901.06
3048303297335403008,2020-05,4325.21,773.87,0,0,3551.34,2650.28
3048303297335403008,2020-06,0,516.73,1591.13,0,1074.4,3724.68
3048303297335403008,2020-07,2085.88,0,246.52,0,2332.4,6057.08
3048303297335403008,2020-08,0,151.97,518.34,1863.27,-1496.9,4560.18
3048303297335403008,2020-10,1776.01,1418.76,0,678.53,-321.28,4238.9
3048303297335403008,2020-11,814.58,1960.18,0,0,-1145.6,3093.3
3048303297335403008,2020-12,1953.79,1317.52,3483.71,0,4119.98,7213.28
3048347190496834560,2020-08,0,615.51,0,0,-615.51,-615.51
3049160542681109504,2020-01,4482.4,3001.23,2932.17,1396.54,3016.8,3016.8
3049160542681109504,2020-02,1558.24,2855.18,4788.11,4639.86,-1148.69,1868.11
3049160542681109504,2020-03,5944.89,1083.49,4458.16,1387.87,7931.69,9799.8
3049160542681109504,2020-04,1979.22,4595.34,8010.97,6991.23,-1596.38,8203.42
3049160542681109504,2020-05,1862.59,3478.71,2821.66,880.12,325.42,8528.84
3049160542681109504,2020-06,1087.02,3876.97,4454.81,1826.15,-161.29,8367.55
3049160542681109504,2020-07,2321.67,3068.15,1352.53,3150.95,-2544.9,5822.65
3049160542681109504,2020-08,5853.64,1751.4,7463.2,4405.26,7160.18,12982.83
3049160542681109504,2020-09,2825.43,3617.44,5542.34,1795.97,2954.36,15937.19
3049160542681109504,2020-10,2297.96,1003.93,3914.42,3098.81,2109.64,18046.83
3049160542681109504,2020-11,3028.08,7713.02,1783.26,7377.64,-10279.32,7767.51
3049160542681109504,2020-12,5801.85,4304.21,2815.44,2240.59,2072.49,9840
3050036895499151360,2020-01,4841.2,1107.38,3424.71,4832.47,2326.06,2326.06
3050036895499151360,2020-02,5411.53,5617.54,1008.13,3252.53,-2450.41,-124.35
3050036895499151360,2020-03,5009.48,587.19,4533.81,4594,4362.1,4237.75
3050036895499151360,2020-04,4027.06,3052.63,3506.31,8523.1,-4042.36,195.39
3050036895499151360,2020-05,3532.72,2427.03,1414.83,5340.5,-2819.98,-2624.59
3050036895499151360,2020-06,2602.25,5051.86,1849.22,5446.45,-6046.84,-8671.43
3050036895499151360,2020-07,2073.98,159.99,3751.36,2474.89,3190.46,-5480.97
3050036895499151360,2020-08,7229.9,966.53,1985.15,3472.02,4776.5,-704.47
3050036895499151360,2020-09,4411.46,3673.22,0,4675.02,-3936.78,-4641.25
3050036895499151360,2020-10,233.72,2708.7,2784.26,2076.65,-1767.37,-6408.62
3050036895499151360,2020-11,4424.39,2947.05,396.77,2382.52,-508.41,-6917.03
3050036895499151360,2020-12,6372.79,0,5808.68,464.81,11716.66,4799.63
3050703265089836544,2020-01,1058.47,3717.69,3037.83,2039.92,-1661.31,-1661.31
3050703265089836544,2020-02,3216.24,1660.32,1415.89,0,2971.81,1310.5
3050703265089836544,2020-03,1066.57,1816.2,1427.1,4304.92,-3627.45,-2316.95
3050703265089836544,2020-04,0,3046.53,1945.11,1489.51,-2590.93,-4907.88
3050703265089836544,2020-05,1646.39,486.9,1285.34,0,2444.83,-2463.05
3050703265089836544,2020-06,2807.65,1888.95,0,2545.33,-1626.63,-4089.68
3050703265089836544,2020-07,882,1671.12,1223.51,5526.95,-5092.56,-9182.24
3050703265089836544,2020-08,146.05,4524.66,4862.62,1870.56,-1386.55,-10568.79
3050703265089836544,2020-09,1854.39,1181.05,93.2,1030.25,-263.71,-10832.5
3050703265089836544,2020-10,1207,5033,3774.6,233.26,-284.66,-11117.16
3050703265089836544,2020-11,2836.51,5116.31,3244.02,0,964.22,-10152.94
3050703265089836544,2020-12,1070.97,0,2885.27,2933.82,1022.42,-9130.52
3050993324507138048,2020-01,0,4144.04,0,4200.41,-8344.45,-8344.45
3050993324507138048,2020-02,4473.86,555.5,963.73,819.67,4062.42,-4282.03
3050993324507138048,2020-04,2605.38,282.87,1509.58,1371.68,2460.41,-1821.62
3050993324507138048,2020-05,1426.97,2964.97,1751.47,0,213.47,-1608.15
3050993324507138048,2020-06,118.35,2515.62,2401.07,4085.73,-4081.93,-5690.08
3050993324507138048,2020-07,0,1545.21,1794.63,2128.95,-1879.53,-7569.61
3050993324507138048,2020-08,1523.57,0,1337.37,0,2860.94,-4708.67
3050993324507138048,2020-09,0,2081.31,3445.18,0,1363.87,-3344.8
3050993324507138048,2020-10,1294.08,0,140.53,1468.92,-34.31,-3379.11
3050993324507138048,2020-11,0,2124.35,2237.95,0,113.6,-3265.51
3050993324507138048,2020-12,0,2470.7,52.89,2228.35,-4646.16,-7911.67
3051213839273189888,2020-01,354.19,1042.43,5834.61,0,5146.37,5146.37
3051213839273189888,2020-02,4890.95,3168.45,2485.45,3234.96,972.99,6119.36
3051213839273189888,2020-03,109.93,2824.53,5540.56,928.45,1897.51,8016.87
3051213839273189888,2020-04,6733.42,3418.04,1408.65,1858.07,2865.96,10882.83
3051213839273189888,2020-05,4208.86,4179.11,2597.77,3097.33,-469.81,10413.02
3051213839273189888,2020-06,3153.01,1902.98,1196.04,6611.78,-4165.71,6247.31
3051213839273189888,2020-07,6049.16,1507.01,1716.02,4986.42,1271.75,7519.06
3051213839273189888,2020-08,1628.76,5038.38,4262.12,1838.25,-985.75,6533.31
3051213839273189888,2020-09,1227.53,3417.26,3362.1,6506.17,-5333.8,1199.51
3051213839273189888,2020-10,4804,2834.1,4683.45,4545.53,2107.82,3307.33
3051213839273189888,2020-11,3933.09,2290.82,2880.88,4779.88,-256.73,3050.6
3051213839273189888,2020-12,7512.8,2876.33,5155.69,5782.99,4009.17,7059.77
3052556023421635584,2020-01,0,2288.12,0,1519.6,-3807.72,-3807.72
3052556023421635584,2020-02,0,41.15,2955.18,3304.23,-390.2,-4197.92
3052556023421635584,2020-03,174.76,1244.19,2498.79,1524.46,-95.1,-4293.02
3052556023421635584,2020-04,911.75,0,3702.11,1966.38,2647.48,-1645.54
3052556023421635584,2020-05,1880.94,1643.4,2009.51,0,2247.05,601.51
3052556023421635584,2020-07,0,146.67,329.78,0,183.11,784.62
3052556023421635584,2020-08,890.44,1851.87,523.12,541.09,-979.4,-194.78
3052556023421635584,2020-10,1762.2,1366.82,1744.39,169.51,1970.26,1775.48
3052556023421635584,2020-11,0,1812.43,1339.91,591.42,-1063.94,711.54
3052556023421635584,2020-12,920.37,1271.4,0,0,-351.03,360.51
3052993113185204736,2020-01,1902.14,1338.45,1092.19,845.39,810.49,810.49
3052993113185204736,2020-02,2931.25,1121.76,1717.13,961.57,2565.05,3375.54
3052993113185204736,2020-03,488.53,0,1807.98,2227.32,69.19,3444.73
3052993113185204736,2020-05,209.79,0,2396.44,753.92,1852.31,5297.04
3052993113185204736,2020-06,0,3649.66,0,3520.42,-7170.08,-1873.04
3052993113185204736,2020-07,1395.59,2107.35,692.06,0,-19.7,-1892.74
3052993113185204736,2020-08,1496.28,1662.59,2321.61,357.57,1797.73,-95.01
3052993113185204736,2020-09,566.67,780.69,950.34,3094.68,-2358.36,-2453.37
3052993113185204736,2020-10,1114.15,0,978.5,2185.94,-93.29,-2546.66
3052993113185204736,2020-11,604.38,0,147.79,2508.08,-1755.91,-4302.57
3052993113185204736,2020-12,0,3234.57,3571.38,0,336.81,-3965.76
3053397892902148096,2020-02,1983.47,1639.32,441.05,0,785.2,785.2
3053397892902148096,2020-04,1243.12,889.45,0,0,353.67,1138.87
3053397892902148096,2020-05,0,860.19,0,0,-860.19,278.68
3053397892902148096,2020-06,1545.89,1949.68,966.14,0,562.35,841.03
3053397892902148096,2020-07,0,1861.78,830.43,0,-1031.35,-190.32
3053397892902148096,2020-10,3281.92,0,0,0,3281.92,3091.6
3053397892902148096,2020-11,0,2743.8,0,0,-2743.8,347.8
3053397892902148096,2020-12,975.1,1223.05,0,0,-247.95,99.85
3053645359615140864,2020-01,6979.04,2863.89,2372.92,9526.18,-3038.11,-3038.11
3053645359615140864,2020-02,827.16,4276.29,2830.06,2041.33,-2660.4,-5698.51
3053645359615140864,2020-03,9663.17,1753.22,4331.39,6743.93,5497.41,-201.1
3053645359615140864,2020-04,3538.67,2608.68,4728.96,2008.01,3650.94,3449.84
3053645359615140864,2020-05,5307.16,10990.84,6174.61,5084.89,-4593.96,-1144.12
3053645359615140864,2020-06,4414.2,6523.95,9958.55,5091.94,2756.86,1612.74
3053645359615140864,2020-07,0,2646.13,5008.55,4640.25,-2277.83,-665.09
3053645359615140864,2020-08,171.51,1879.2,4111.67,6294.53,-3890.55,-4555.64
3053645359615140864,2020-09,2224.84,4779.08,2888.08,7013.1,-6679.26,-11234.9
3053645359615140864,2020-10,3111.03,7947.27,6049.57,4527.02,-3313.69,-14548.59
3053645359615140864,2020-11,1526.44,8132.12,9454.49,2855.21,-6.4,-14554.99
3053645359615140864,2020-12,4827.62,4690.55,2721.93,12618.6,-9759.6,-24314.59
3054062368176288256,2020-01,3007.57,1700.63,3435.33,3973.46,768.81,768.81
3054062368176288256,2020-02,5997.52,4773.22,2770.2,7420.4,-3425.9,-2657.09
3054062368176288256,2020-03,7881.25,2717.06,3055.43,6296.26,1923.36,-733.73
3054062368176288256,2020-04,5227.26,1303.65,2018.15,3044.36,2897.4,2163.67
3054062368176288256,2020-05,7094.43,5005.9,2165.46,8224.59,-3970.6,-1806.93
3054062368176288256,2020-06,8420.36,6469.67,3025.8,2056.52,2919.97,1113.04
3054062368176288256,2020-07,7193.32,10683.7,3618.32,5610.88,-5482.94,-4369.9
3054062368176288256,2020-08,4869.19,4598.83,4682.28,3280,1672.64,-2697.26
3054062368176288256,2020-09,5591.21,8129.45,5135.36,7627.72,-5030.6,-7727.86
3054062368176288256,2020-10,7231.67,10364.13,0,919.71,-4052.17,-11780.03
3054062368176288256,2020-11,4749.63,4290.42,574.81,5255.24,-4221.22,-16001.25
3054062368176288256,2020-12,1949.36,4401.38,6306.54,4389.51,-534.99,-16536.24
3055179204717438464,2020-01,4160.63,7970.09,2735.6,5177.71,-6251.57,-6251.57
3055179204717438464,2020-02,1827.48,3356.73,9969.1,9065.45,-625.6,-6877.17
3055179204717438464,2020-03,5476.79,1717.47,2976.39,5229.24,1506.47,-5370.7
3055179204717438464,2020-04,998.87,860.12,0,2802.74,-2663.99,-8034.69
3055179204717438464,2020-05,5331.01,5092.64,2288.87,2304.18,223.06,-7811.63
3055179204717438464,2020-06,4406.74,3517.46,4419.73,5859.87,-550.86,-8362.49
3055179204717438464,2020-07,5445.69,7265.05,3399.66,2795.12,-1214.82,-9577.31
3055179204717438464,2020-08,4461.91,1498.5,7016.18,2530.63,7448.96,-2128.35
3055179204717438464,2020-09,2110,3567.67,937.09,4208.23,-4728.81,-6857.16
3055179204717438464,2020-10,0,3942.33,2851.89,5137.73,-6228.17,-13085.33
3055179204717438464,2020-11,3096.6,6777.98,4003.81,5251.84,-4929.41,-18014.74
3055179204717438464,2020-12,5177.83,2905.03,3998.55,1941.81,4329.54,-13685.2
3057261508181253632,2020-01,1134.28,1624.42,1478.72,1054.36,-65.78,-65.78
3057261508181253632,2020-02,887.06,1758.07,1892.67,167.13,854.53,788.75
3057261508181253632,2020-03,2370.91,967.09,3918.45,2604.62,2717.65,3506.4
3057261508181253632,2020-04,3062.58,1977.11,0,1380.94,-295.47,3210.93
3057261508181253632,2020-05,5116.68,2013.2,1792.23,0,4895.71,8106.64
3057261508181253632,2020-06,1277.55,2160.64,380.4,571.18,-1073.87,7032.77
3057261508181253632,2020-07,3148.78,3231.32,3298.37,2805.98,409.85,7442.62
3057261508181253632,2020-08,911.2,924.28,878.34,5013.76,-4148.5,3294.12
3057261508181253632,2020-09,830.57,0,547.82,2619.61,-1241.22,2052.9
3057261508181253632,2020-10,1745.3,1800.85,445.93,1577.04,-1186.66,866.24
3057261508181253632,2020-11,0,1578.77,0,0,-1578.77,-712.53
3057261508181253632,2020-12,0,271.08,1122.9,1947.55,-1095.73,-1808.26
3057645884556709376,2020-03,1901.83,0,0,0,1901.83,1901.83
3057645884556709376,2020-05,0,1557.98,0,0,-1557.98,343.85
3057645884556709376,2020-06,1994.02,0,0,0,1994.02,2337.87
3057645884556709376,2020-08,0,813.77,1953.6,1929.9,-790.07,1547.8
3057645884556709376,2020-09,519.26,0,0,0,519.26,2067.06
3057645884556709376,2020-11,1603.96,0,0,0,1603.96,3671.02
3057645884556709376,2020-12,0,1871.59,0,0,-1871.59,1799.43
3057668149598321664,2020-01,0,5438.15,0,1684.23,-7122.38,-7122.38
3057668149598321664,2020-02,3335.51,437.66,309.41,1556.51,1650.75,-5471.63
3057668149598321664,2020-03,3572.06,2793.14,3653.11,6641.92,-2209.89,-7681.52
3057668149598321664,2020-04,1344.83,3766.95,2796.11,1718.1,-1344.11,-9025.63
3057668149598321664,2020-05,2568.96,6113.4,6709.09,1873.14,1291.51,-7734.12
3057668149598321664,2020-06,1944.12,0,2027.26,0,3971.38,-3762.74
3057668149598321664,2020-07,3103.55,2933.95,2317.54,0,2487.14,-1275.6
3057668149598321664,2020-08,4652.88,2110.96,408.79,3726.87,-776.16,-2051.76
3057668149598321664,2020-09,1647.9,1340.44,1747.34,1324.49,730.31,-1321.45
3057668149598321664,2020-10,2144.18,1694.6,4946.12,3553.12,1842.58,521.13
3057668149598321664,2020-11,3385.61,1380.8,3056.68,2819.77,2241.72,2762.85
3057668149598321664,2020-12,0,2174.22,0,1810.72,-3984.94,-1222.09
3057695907647025664,2020-01,1751.44,0,43.3,0,1794.74,1794.74
3057695907647025664,2020-02,0,1902.8,0,0,-1902.8,-108.06
3057695907647025664,2020-03,560.45,252.31,1063.02,1344.66,26.5,-81.56
3057695907647025664,2020-06,2202.74,0,1445.98,1693.92,1954.8,1873.24
3057695907647025664,2020-09,0,567.65,0,288.14,-855.79,1017.45
3057695907647025664,2020-11,0,3883.17,0,0,-3883.17,-2865.72
3057695907647025664,2020-12,978.07,0,0,0,978.07,-1887.65
3057858002595124736,2020-01,7946.66,5480.67,3972.95,4878.75,1560.19,1560.19
3057858002595124736,2020-02,6488.75,5707.99,6333.3,6058.09,1055.97,2616.16
3057858002595124736,2020-03,8139.16,2408.03,7698.82,3283.57,10146.38,12762.54
3057858002595124736,2020-04,4576.76,3461.1,7496.97,4408.12,4204.51,16967.05
3057858002595124736,2020-05,4026.63,2918.35,5666.49,2648.56,4126.21,21093.26
3057858002595124736,2020-06,1573.87,726.79,2014.52,10583.99,-7722.39,13370.87
3057858002595124736,2020-07,3510.96,2531.02,4870.83,4047.82,1802.95,15173.82
3057858002595124736,2020-08,3277.08,3327.69,7379.94,2144.76,5184.57,20358.39
3057858002595124736,2020-09,0,5375.35,3945.9,3876.93,-5306.38,15052.01
3057858002595124736,2020-10,8222.67,1856.61,5846.13,9508.32,2703.87,17755.88
3057858002595124736,2020-11,7334.89,4609.72,5161.23,5949.73,1936.67,19692.55
3057858002595124736,2020-12,2556.64,3069.88,3506.98,7475.6,-4481.86,15210.69
3060198278767561728,2020-01,8800.83,4179.89,5190.35,4912.79,4898.5,4898.5
3060198278767561728,2020-02,4445.97,7087.73,1063.84,2146.01,-3723.93,1174.57
3060198278767561728,2020-03,807.04,3611.91,5904.41,5569.7,-2470.16,-1295.59
3060198278767561728,2020-04,6725.18,5058.84,5268.6,3782.87,3152.07,1856.48
3060198278767561728,2020-05,9270.9,2533.31,7721.67,4135.74,10323.52,12180
3060198278767561728,2020-06,2598.42,4168.64,3750.49,4491,-2310.73,9869.27
3060198278767561728,2020-07,6572.49,3257.44,10516.22,3537.43,10293.84,20163.11
3060198278767561728,2020-08,4489.5,5470.53,3842.95,2555.03,306.89,20470
3060198278767561728,2020-09,9210.44,9210.96,7936.1,2129.35,5806.23,26276.23
3060198278767561728,2020-10,3413.08,4972.77,3517.02,1970.13,-12.8,26263.43
3060198278767561728,2020-11,5881.75,4516.2,4521.97,3473.77,2413.75,28677.18
3060198278767561728,2020-12,8728.18,3803.53,1911.03,4023.09,2812.59,31489.77
3060310672437492224,2020-01,0,1245.51,411.92,522.65,-1356.24,-1356.24
3060310672437492224,2020-02,2261.34,2124.78,2396.68,2845.28,-312.04,-1668.28
3060310672437492224,2020-03,1183.32,1868.41,1675.99,1543.54,-552.64,-2220.92
3060310672437492224,2020-04,4205.23,4623.16,1457.29,2815.02,-1775.66,-3996.58
3060310672437492224,2020-05,3217.47,91.93,0,2578.01,547.53,-3449.05
3060310672437492224,2020-06,718.49,899.35,848.11,2395.85,-1728.6,-5177.65
3060310672437492224,2020-07,1447.37,3161.51,2477.68,2234.91,-1471.37,-6649.02
3060310672437492224,2020-08,4319.08,500.86,1282.05,2657.62,2442.65,-4206.37
3060310672437492224,2020-09,2648.09,3178.57,5183.15,1127.94,3524.73,-681.64
3060310672437492224,2020-10,2879.7,0,1830.97,3113.72,1596.95,915.31
3060310672437492224,2020-11,3807.19,1381.67,6575.81,0,9001.33,9916.64
3060310672437492224,2020-12,0,474.76,6648.62,591.92,5581.94,15498.58
3061362685884705280,2020-01,721.62,0,422.07,3217.34,-2073.65,-2073.65
3061362685884705280,2020-02,0,1204.99,3024.39,0,1819.4,-254.25
3061362685884705280,2020-03,4430.47,6009.37,3279.39,3193.47,-1492.98,-1747.23
3061362685884705280,2020-04,1972.99,1809.93,148.82,1136.91,-825.03,-2572.26
3061362685884705280,2020-05,5418.46,2582.31,1136.66,2796.01,1176.8,-1395.46
3061362685884705280,2020-06,60.44,1182.72,2199.83,0,1077.55,-317.91
3061362685884705280,2020-07,2651.7,5455.2,0,1941.53,-4745.03,-5062.94
3061362685884705280,2020-08,1743.81,3536.2,0,4207.36,-5999.75,-11062.69
3061362685884705280,2020-09,2294.77,0,3204.84,1807.85,3691.76,-7370.93
3061362685884705280,2020-10,2531.08,1514.95,4489.21,2453.72,3051.62,-4319.31
3061362685884705280,2020-11,1481.4,781.21,1256.59,4114.05,-2157.27,-6476.58
3061362685884705280,2020-12,1901.07,5566.04,2335.04,2808.64,-4138.57,-10615.15
3062314393397168128,2020-01,40.4,0,0,3462.37,-3421.97,-3421.97
3062314393397168128,2020-02,0,3317.39,850.38,690.6,-3157.61,-6579.58
3062314393397168128,2020-03,256.52,0,1762.53,0,2019.05,-4560.53
3062314393397168128,2020-04,1761.61,770.76,0,0,990.85,-3569.68
3062314393397168128,2020-05,0,3262.78,0,0,-3262.78,-6832.46
3062314393397168128,2020-06,973.6,0,0,806.45,167.15,-6665.31
3062314393397168128,2020-08,798.21,0,1260.42,0,2058.63,-4606.68
3062314393397168128,2020-09,0,811.77,0,0,-811.77,-5418.45
3062314393397168128,2020-10,0,525.15,1987.17,0,1462.02,-3956.43
3062314393397168128,2020-12,442.15,761.1,1083.5,0,764.55,-3191.88
3062828366442967552,2020-01,1654.98,927.2,0,2014.24,-1286.46,-1286.46
3062828366442967552,2020-02,2380.92,3249.13,0,3654.21,-4522.42,-5808.88
3062828366442967552,2020-03,2484.33,0,3128.58,0,5612.91,-195.97
3062828366442967552,2020-04,933.67,694.87,0,4152.38,-3913.58,-4109.55
3062828366442967552,2020-05,1055.9,3564.35,2723.2,3326.11,-3111.36,-7220.91
3062828366442967552,2020-06,4331,3567.21,6662.93,5124.49,2302.23,-4918.68
3062828366442967552,2020-07,849.88,3945.17,0,4309.57,-7404.86,-12323.54
3062828366442967552,2020-08,8006.4,3986.6,674.28,4439.73,254.35,-12069.19
3062828366442967552,2020-09,1899.43,377.17,3102.58,1718.83,2906.01,-9163.18
3062828366442967552,2020-10,7452.53,6536.58,1484.59,2383.94,16.6,-9146.58
3062828366442967552,2020-11,5201.06,2931.48,3751.58,0,6021.16,-3125.42
3062828366442967552,2020-12,1059.11,2107.9,0,2969.76,-4018.55,-7143.97
3064347252527932928,2020-01,951.67,0,0,1615.43,-663.76,-663.76
3064347252527932928,2020-02,1435.58,0,0,1537.81,-102.23,-765.99
3064347252527932928,2020-03,572.21,0,1390.85,3156.25,-1193.19,-1959.18
3064347252527932928,2020-04,0,479.72,777.39,0,297.67,-1661.51
3064347252527932928,2020-05,1268.04,258.75,1771.54,1924.64,856.19,-805.32
3064347252527932928,2020-06,0,1345.67,3413.18,0,2067.51,1262.19
3064347252527932928,2020-07,892.33,0,0,1944.21,-1051.88,210.31
3064347252527932928,2020-08,1033.6,2769.96,1562.22,901.88,-1076.02,-865.71
3064347252527932928,2020-10,0,1345.76,1709.71,818.61,-454.66,-1320.37
3064347252527932928,2020-11,0,1129.49,138.73,0,-990.76,-2311.13
3064347252527932928,2020-12,269.33,1275.41,217.65,0,-788.43,-3099.56
3065261582310682112,2020-01,1389.97,5830.53,2604.03,1617.88,-3454.41,-3454.41
3065261582310682112,2020-02,5962.01,4237.09,4391.06,5336.47,779.51,-2674.9
3065261582310682112,2020-03,4224.39,4973.29,654.42,4423.48,-4517.96,-7192.86
3065261582310682112,2020-04,9152.28,3214.09,1987.18,4869.57,3055.8,-4137.06
3065261582310682112,2020-05,3927.52,2155.14,2919.88,0,4692.26,555.2
3065261582310682112,2020-06,4962.14,3787.91,3575.45,1774.2,2975.48,3530.68
3065261582310682112,2020-07,5794.19,1965.1,1946.14,4341.18,1434.05,4964.73
3065261582310682112,2020-08,2029,327.49,1621.41,8614.56,-5291.64,-326.91
3065261582310682112,2020-09,0,3862.24,6834.22,4710.64,-1738.66,-2065.57
3065261582310682112,2020-10,2170.76,2986.78,5944.34,4703.2,425.12,-1640.45
3065261582310682112,2020-11,4275.8,0,3697.15,1840.41,6132.54,4492.09
3065261582310682112,2020-12,4260.29,2597.63,2312.01,3401.22,573.45,5065.54
3065282141395314688,2020-01,0,1728.69,4950.74,0,3222.05,3222.05
3065282141395314688,2020-02,3083,2050.54,3259.39,936.09,3355.76,6577.81
3065282141395314688,2020-03,3809.23,1543.16,1284.54,1605.05,1945.56,8523.37
3065282141395314688,2020-04,1120.64,3030.9,0,0,-1910.26,6613.11
3065282141395314688,2020-05,3903.4,2655.53,1015.56,1292.71,970.72,7583.83
3065282141395314688,2020-06,0,4308,2942.49,4492.86,-5858.37,1725.46
3065282141395314688,2020-07,2845.97,761.32,0,5005.11,-2920.46,-1195
3065282141395314688,2020-08,1835.42,1651.24,2792.62,1259.13,1717.67,522.67
3065282141395314688,2020-09,1998.81,1391.06,2635.3,2756.53,486.52,1009.19
3065282141395314688,2020-10,2614.01,1376.22,0,1451.19,-213.4,795.79
3065282141395314688,2020-11,1693.38,3428.79,939.11,638.95,-1435.25,-639.46
3065282141395314688,2020-12,4004.05,1803,444.56,1189.77,1455.84,816.38
3066232247883889664,2020-02,0,1797.02,0,428.32,-2225.34,-2225.34
3066232247883889664,2020-03,0,714.11,0,0,-714.11,-2939.45
3066232247883889664,2020-04,1869.96,0,1920.43,0,3790.39,850.94
3066232247883889664,2020-05,589.43,0,0,2549.53,-1960.1,-1109.16
3066232247883889664,2020-06,522.69,0,1186.59,0,1709.28,600.12
3066232247883889664,2020-07,0,450.71,0,0,-450.71,149.41
3066232247883889664,2020-08,0,134.76,0,0,-134.76,14.65
3066232247883889664,2020-09,816.91,39.07,0,0,777.84,792.49
3066232247883889664,2020-11,0,328.24,2301.15,0,1972.91,2765.4
3066232247883889664,2020-12,0,1093.88,0,0,-1093.88,1671.52
3067295166680252928,2020-03,0,57.82,0,0,-57.82,-57.82
3067295166680252928,2020-04,1579.68,43.03,0,0,1536.65,1478.83
3067295166680252928,2020-06,0,1641.38,0,0,-1641.38,-162.55
3067295166680252928,2020-08,1979.86,0,0,0,1979.86,1817.31
3067295166680252928,2020-10,711.43,0,0,0,711.43,2528.74
3067980970409318912,2020-01,2933.01,0,3256.31,0,6189.32,6189.32
3067980970409318912,2020-02,0,1970.88,0,591.23,-2562.11,3627.21
3067980970409318912,2020-03,1288.53,0,0,0,1288.53,4915.74
3067980970409318912,2020-04,1289.8,0,0,0,1289.8,6205.54
3067980970409318912,2020-05,172.72,0,0,2559.1,-2386.38,3819.16
3067980970409318912,2020-06,300.5,0,0,1306.65,-1006.15,2813.01
3067980970409318912,2020-07,2622.69,1232.75,3.09,1942.23,-549.2,2263.81
3067980970409318912,2020-09,139.32,0,0,1966.67,-1827.35,436.46
3067980970409318912,2020-10,2113.83,363.58,2614.47,0,4364.72,4801.18
3067980970409318912,2020-11,1498.25,0,2947.29,0,4445.54,9246.72
3067980970409318912,2020-12,1890.44,1744.82,1277.21,0,1422.83,10669.55
3068842485539721216,2020-01,6660.14,2818.62,5801.91,505.05,9138.38,9138.38
3068842485539721216,2020-02,4129.55,3822.31,7314.16,2197.28,5424.12,14562.5
3068842485539721216,2020-03,1440.76,6110.27,4432.76,4120.32,-4357.07,10205.43
3068842485539721216,2020-04,3377.89,911.55,5923.51,1647.14,6742.71,16948.14
3068842485539721216,2020-05,1462.76,924.46,2790.25,3996.88,-668.33,16279.81
3068842485539721216,2020-06,3289.96,3652.3,877.79,2893.24,-2377.79,13902.02
3068842485539721216,2020-07,3057.1,2509.78,5365.95,3957.43,1955.84,15857.86
3068842485539721216,2020-08,0,6039.88,1262.43,3662.15,-8439.6,7418.26
3068842485539721216,2020-09,2957.23,2420.02,2110.42,6377.18,-3729.55,3688.71
3068842485539721216,2020-10,2816.69,3554.88,7574.64,796.45,6040,9728.71
3068842485539721216,2020-11,4135.44,973.32,306.43,2265.8,1202.75,10931.46
3068842485539721216,2020-12,6638.22,4267.47,1789.67,3646.88,513.54,11445
3069279228388982784,2020-01,2083.44,3452.08,3329.9,3738.36,-1777.1,-1777.1
3069279228388982784,2020-02,5709.96,4004.82,5495.55,3391.93,3808.76,2031.66
3069279228388982784,2020-03,2073.55,778.51,4895.76,6486.81,-296.01,1735.65
3069279228388982784,2020-04,6003.58,2937.58,11114.62,8207.82,5972.8,7708.45
3069279228388982784,2020-05,7021.9,3263.26,4956.29,5936.27,2778.66,10487.11
3069279228388982784,2020-06,7490.48,3073.88,1322.3,6601.56,-862.66,9624.45
3069279228388982784,2020-07,2956.88,5818.94,599.42,5199.78,-7462.42,2162.03
3069279228388982784,2020-08,5630.15,4594.51,4210.47,4145.72,1100.39,3262.42
3069279228388982784,2020-09,5314.04,6839.01,6878.28,495.45,4857.86,8120.28
3069279228388982784,2020-10,6466.56,5696.35,4564.88,5268.91,66.18,8186.46
3069279228388982784,2020-11,9672.21,1197.21,3491.76,5064.08,6902.68,15089.14
3069279228388982784,2020-12,2518.51,998.9,2074.83,3740.65,-146.21,14942.93
3071002751875600384,2020-01,7277.47,792.69,839.59,2566.59,4757.78,4757.78
3071002751875600384,2020-02,4922.9,1933.66,2467.44,727.94,4728.74,9486.52
3071002751875600384,2020-03,3558.93,972.75,4566.43,1369.44,5783.17,15269.69
3071002751875600384,2020-04,3012.53,2144.3,4747.68,5750.95,-135.04,15134.65
3071002751875600384,2020-05,1251.9,1564.23,5111.5,1489.35,3309.82,18444.47
3071002751875600384,2020-06,3111.3,1876.13,1541.59,1729.22,1047.54,19492.01
3071002751875600384,2020-07,4383.92,1999.56,4156.48,0,6540.84,26032.85
3071002751875600384,2020-08,1706.57,169.87,1040.21,6003.93,-3427.02,22605.83
3071002751875600384,2020-09,2593.37,730.74,7011.37,1007.44,7866.56,30472.39
3071002751875600384,2020-10,1715.44,1182.7,3009.53,1273.06,2269.21,32741.6
3071002751875600384,2020-11,3993.31,2827.43,1930.18,994.18,2101.88,34843.48
3071002751875600384,2020-12,4470.97,5184.99,3170.26,1716.26,739.98,35583.46
3071822444147723776,2020-01,4043.28,7964.57,7106.48,2849.42,335.77,335.77
3071822444147723776,2020-02,1725.73,1257.47,6446.95,1844.56,5070.65,5406.42
3071822444147723776,2020-03,5833.18,6768.49,4117.79,5915.32,-2732.84,2673.58
3071822444147723776,2020-04,6185.7,3735.65,4814.12,5144.15,2120.02,4793.6
3071822444147723776,2020-05,1769.28,2725.94,4121.81,6154.36,-2989.21,1804.39
3071822444147723776,2020-06,3962.73,4635.34,1218.82,4421.44,-3875.23,-2070.84
3071822444147723776,2020-07,4155.77,5692.88,3712.02,1273.93,900.98,-1169.86
3071822444147723776,2020-08,4677.7,3997.16,5469.85,5371.03,779.36,-390.5
3071822444147723776,2020-09,3052.12,7013.06,4210.02,4206.96,-3957.88,-4348.38
3071822444147723776,2020-10,3516.75,7462.12,1751.38,13548.95,-15742.94,-20091.32
3071822444147723776,2020-11,3103.65,8423.66,6380.36,6098.93,-5038.58,-25129.9
3071822444147723776,2020-12,3066.6,5652.84,3521.55,5520.93,-4585.62,-29715.52
3072642534890537472,2020-01,0,1906.36,3162.49,0,1256.13,1256.13
3072642534890537472,2020-03,0,1596.55,2883.66,1557.98,-270.87,985.26
3072642534890537472,2020-04,1367.31,1639.54,2237.71,1940.81,24.67,1009.93
3072642534890537472,2020-05,0,4.78,2166.5,0,2161.72,3171.65
3072642534890537472,2020-06,954.1,2306.63,3219.28,3075.78,-1209.03,1962.62
3072642534890537472,2020-07,2101.1,3905.77,0,5921.78,-7726.45,-5763.83
3072642534890537472,2020-08,0,1975.97,0,40.9,-2016.87,-7780.7
3072642534890537472,2020-09,4622.1,0,856.74,3811.61,1667.23,-6113.47
3072642534890537472,2020-10,1693.75,2875.86,5062.66,0,3880.55,-2232.92
3072642534890537472,2020-11,1295.3,0,1909.56,1613.15,1591.71,-641.21
3072642534890537472,2020-12,1978.12,3634.95,3333.78,308.75,1368.2,726.99
3074166036274764800,2020-01,6232.74,4899.64,4210.99,552.71,4991.38,4991.38
3074166036274764800,2020-02,5759.52,1029.95,1776.23,6730.23,-224.43,4766.95
3074166036274764800,2020-03,2999.61,3835.32,5634.46,1451.49,3347.26,8114.21
3074166036274764800,2020-04,0,3162.77,3325.13,1676.52,-1514.16,6600.05
3074166036274764800,2020-05,6385.02,4014.07,3727.32,5174.42,923.85,7523.9
3074166036274764800,2020-06,3800.88,6469.7,9154.91,2931.93,3554.16,11078.06
3074166036274764800,2020-07,1465.45,2595.87,4090.19,1699.7,1260.07,12338.13
3074166036274764800,2020-08,6593.86,8891.13,4865.74,3714.95,-1146.48,11191.65
3074166036274764800,2020-09,3280.43,4254.19,1497.83,7330.99,-6806.92,4384.73
3074166036274764800,2020-10,898.28,3235.13,4718.59,7173.24,-4791.5,-406.77
3074166036274764800,2020-11,9236.69,1759.1,4991.91,6051,6418.5,6011.73
3074166036274764800,2020-12,2764.5,9576.31,2757.31,1330.3,-5384.8,626.93
3074477400137591808,2020-01,8538.39,260.69,0,1877.03,6400.67,6400.67
3074477400137591808,2020-02,2540.44,4420.37,3567.02,2158.82,-471.73,5928.94
3074477400137591808,2020-03,4598.59,1664.82,2225.41,1678.11,3481.07,9410.01
3074477400137591808,2020-04,6417.15,1010.84,2990.43,1990.58,6406.16,15816.17
3074477400137591808,2020-05,3158.42,1588.96,5521.26,3177.38,3913.34,19729.51
3074477400137591808,2020-06,4763.32,5860.93,4671.84,4750.85,-1176.62,18552.89
3074477400137591808,2020-07,5990.42,3680.84,3476.27,10400.03,-4614.18,13938.71
3074477400137591808,2020-08,2384.32,7387.67,3052.87,1968.89,-3919.37,10019.34
3074477400137591808,2020-09,1312.58,5868.82,2549.1,0,-2007.14,8012.2
3074477400137591808,2020-10,1703.54,1525.52,3195.26,4555,-1181.72,6830.48
3074477400137591808,2020-11,2245.61,5062.39,1559.8,2235.88,-3492.86,3337.62
3074477400137591808,2020-12,7217.68,794.03,2805.72,2215.27,7014.1,10351.72
3074788686898732544,2020-01,7059.59,1690.16,0,1498.63,3870.8,3870.8
3074788686898732544,2020-03,1196.17,6307.8,1300.12,1421.77,-5233.28,-1362.48
3074788686898732544,2020-04,3982.24,4371.38,2040.47,660.24,991.09,-371.39
3074788686898732544,2020-05,1193.74,1037.49,548.15,1601.31,-896.91,-1268.3
3074788686898732544,2020-06,0,2809.81,1616.21,2638.63,-3832.23,-5100.53
3074788686898732544,2020-07,551.61,4268.09,1375.82,2824.57,-5165.23,-10265.76
3074788686898732544,2020-08,1252.76,3173.11,3187.58,1894.62,-627.39,-10893.15
3074788686898732544,2020-09,1300.65,740.15,0,3978.43,-3417.93,-14311.08
3074788686898732544,2020-10,0,5328.25,1455.72,3641.78,-7514.31,-21825.39
3074788686898732544,2020-11,1976.39,2490.31,0,0,-513.92,-22339.31
3074788686898732544,2020-12,763.35,3425.84,4055.68,0,1393.19,-20946.12
3074969834844556288,2020-01,2642.69,654.55,1053.71,4015.26,-973.41,-973.41
3074969834844556288,2020-02,2229.42,1845.69,4537.83,2944.36,1977.2,1003.79
3074969834844556288,2020-03,1257.79,893.02,568.78,1396.33,-462.78,541.01
3074969834844556288,2020-04,4514.1,3337.21,0,1811.71,-634.82,-93.81
3074969834844556288,2020-06,719.75,1546.39,4343.78,1543.89,1973.25,1879.44
3074969834844556288,2020-07,1861.06,1022.68,0,269.23,569.15,2448.59
3074969834844556288,2020-08,3286.76,3335.9,324.87,1808.11,-1532.38,916.21
3074969834844556288,2020-09,0,1448.56,0,4656.13,-6104.69,-5188.48
3074969834844556288,2020-10,1172.77,2257.36,0,0,-1084.59,-6273.07
3074969834844556288,2020-11,0,1874.94,0,1194.25,-3069.19,-9342.26
3076577951075780608,2020-07,122.23,0,0,0,122.23,122.23
3078151773382775808,2020-01,2881.87,0,1793.99,0,4675.86,4675.86
3078151773382775808,2020-02,1753.77,0,627.3,0,2381.07,7056.93
3078151773382775808,2020-03,0,1414.83,2889.07,0,1474.24,8531.17
3078151773382775808,2020-04,552.32,1100.39,1365.65,0,817.58,9348.75
3078151773382775808,2020-06,258.42,0,0,0,258.42,9607.17
3078151773382775808,2020-07,5789.92,3262.81,471.69,2144.31,854.49,10461.66
3078151773382775808,2020-08,1850.96,0,1902.26,1418.57,2334.65,12796.31
3078151773382775808,2020-10,0,1616.49,1537.34,0,-79.15,12717.16
3078151773382775808,2020-11,59.26,1554.92,0,1707.8,-3203.46,9513.7
3078151773382775808,2020-12,1617.07,0,0,1918.43,-301.36,9212.34
3078361079741474816,2020-01,1286.4,1893.65,3031.8,2701.86,-277.31,-277.31
3078361079741474816,2020-02,7564.51,5121.41,4499.34,1612.61,5329.83,5052.52
3078361079741474816,2020-03,11166.02,5615.27,3150.54,5338.02,3363.27,8415.79
3078361079741474816,2020-04,5796.58,1282.48,294.91,630.35,4178.66,12594.45
3078361079741474816,2020-05,2176.13,0,1361.68,2723.53,814.28,13408.73
3078361079741474816,2020-06,2744.36,5465.6,5673.31,1004.08,1947.99,15356.72
3078361079741474816,2020-07,4252.4,460.58,2105.43,6201.5,-304.25,15052.47
3078361079741474816,2020-08,2645.13,4722.29,2325.78,1752.91,-1504.29,13548.18
3078361079741474816,2020-09,4839.37,3953.7,3813.93,4495.91,203.69,13751.87
3078361079741474816,2020-10,5058.1,14032.35,3614.76,3456.15,-8815.64,4936.23
3078361079741474816,2020-11,2915.67,3323.16,3525.66,7807.65,-4689.48,246.75
3078361079741474816,2020-12,4172.16,9083.25,1281.23,8029.29,-11659.15,-11412.4
3079116087347519488,2020-03,366.72,0,0,67.5,299.22,299.22
3079116087347519488,2020-04,0,508.89,0,51.18,-560.07,-260.85
3079116087347519488,2020-06,886.27,0,2853.24,0,3739.51,3478.66
3079116087347519488,2020-07,1926.45,0,887.01,854.38,1959.08,5437.74
3079116087347519488,2020-08,0,1958.04,0,0,-1958.04,3479.7
3079116087347519488,2020-09,1792.81,0,1821.12,251.41,3362.52,6842.22
3079116087347519488,2020-10,0,1854.4,0,0,-1854.4,4987.82
3079485839184673792,2020-01,4751.29,0,2762.14,9795.19,-2281.76,-2281.76
3079485839184673792,2020-02,6333.13,3886.59,1921.93,6400.04,-2031.57,-4313.33
3079485839184673792,2020-03,5926.52,3164.21,2292.73,3072.23,1982.81,-2330.52
3079485839184673792,2020-04,1304.63,1988.87,1455.84,5176.33,-4404.73,-6735.25
3079485839184673792,2020-05,1582.99,3576.65,4544.63,3177.35,-626.38,-7361.63
3079485839184673792,2020-06,3519.86,4384.65,6302.55,3307.37,2130.39,-5231.24
3079485839184673792,2020-07,1163.7,6112.49,2895.56,1945.27,-3998.5,-9229.74
3079485839184673792,2020-08,4978.54,2351.93,3000.9,1351.39,4276.12,-4953.62
3079485839184673792,2020-09,1221.01,1484.03,851.04,2133.89,-1545.87,-6499.49
3079485839184673792,2020-10,1380.06,2496.54,2862.3,943.57,802.25,-5697.24
3079485839184673792,2020-11,2992.93,7581.69,4698.76,3579.19,-3469.19,-9166.43
3079485839184673792,2020-12,1714.03,5060.26,3843.51,1179.01,-681.73,-9848.16
3081772590141918208,2020-01,1523.34,0,424.16,0,1947.5,1947.5
3081772590141918208,2020-02,1925.99,0,0,0,1925.99,3873.49
3081772590141918208,2020-03,1853.35,2888.39,1063.49,260.07,-231.62,3641.87
3081772590141918208,2020-04,1872.71,3493.05,2224.63,1560.9,-956.61,2685.26
3081772590141918208,2020-07,231.22,1328.8,0,1893.53,-2991.11,-305.85
3081772590141918208,2020-08,0,835.16,1818.41,0,983.25,677.4
3081772590141918208,2020-09,532.73,0,2812.88,0,3345.61,4023.01
3081772590141918208,2020-11,2021.44,0,3060.68,1473.14,3608.98,7631.99
3081772590141918208,2020-12,0,724.11,0,1848.42,-2572.53,5059.46
3082749169782387712,2020-01,0,2197.37,774.54,0,-1422.83,-1422.83
3082749169782387712,2020-04,1814.65,2008.54,835.33,0,641.44,-781.39
3082749169782387712,2020-06,0,980.07,1265.43,0,285.36,-496.03
3082749169782387712,2020-10,1609.94,115.14,849.11,0,2343.91,1847.88
3082749169782387712,2020-11,1776.2,0,0,0,1776.2,3624.08
3083475144517852160,2020-01,0,1761.39,0,1627.41,-3388.8,-3388.8
3083475144517852160,2020-03,0,1373.92,0,0,-1373.92,-4762.72
3083475144517852160,2020-04,234.39,0,0,0,234.39,-4528.33
3083475144517852160,2020-06,0,1067.08,0,0,-1067.08,-5595.41
3083475144517852160,2020-07,0,62.92,1381.13,0,1318.21,-4277.2
3083475144517852160,2020-08,0,1206.13,0,0,-1206.13,-5483.33
3083475144517852160,2020-09,0,1928.59,0,0,-1928.59,-7411.92
3083475144517852160,2020-10,0,1245.41,1284.64,0,39.23,-7372.69
3083475144517852160,2020-11,854.65,1123.01,1303.32,350.7,684.26,-6688.43
3084104910522319360,2020-01,8267.21,9566.29,4912.82,1819.22,1794.52,1794.52
3084104910522319360,2020-02,3223.03,677.42,8007.75,5778.9,4774.46,6568.98
3084104910522319360,2020-03,4545.88,7902.64,1358.78,3571.68,-5569.66,999.32
3084104910522319360,2020-04,679.6,4594.07,3351.22,844.09,-1407.34,-408.02
3084104910522319360,2020-05,852.16,1128.39,7066.72,1932.02,4858.47,4450.45
3084104910522319360,2020-06,3305.74,4221.11,3986.11,4438.66,-1367.92,3082.53
3084104910522319360,2020-07,3755.94,3264.36,8479.13,3803.68,5167.03,8249.56
3084104910522319360,2020-08,2013.92,677.83,8668.47,2685.97,7318.59,15568.15
3084104910522319360,2020-09,0,8120.24,1223.97,7309.26,-14205.53,1362.62
3084104910522319360,2020-10,3910.25,0,4362.74,4276.54,3996.45,5359.07
3084104910522319360,2020-11,806.06,3962.8,6754.7,3445.78,152.18,5511.25
3084104910522319360,2020-12,4410.68,344.58,4983.39,10077.02,-1027.53,4483.72
3084155319621526016,2020-01,1315.89,1741.96,3600.86,0,3174.79,3174.79
3084155319621526016,2020-03,650.82,824.86,0,502.54,-676.58,2498.21
3084155319621526016,2020-04,17.08,1079.37,970.35,1609.92,-1701.86,796.35
3084155319621526016,2020-06,0,1856.63,0,0,-1856.63,-1060.28
3084155319621526016,2020-07,0,1390.17,280.19,3454.96,-4564.94,-5625.22
3084155319621526016,2020-08,2783.9,1610.6,1289.67,1465.81,997.16,-4628.06
3084155319621526016,2020-09,3153.13,5247.29,2641.16,2687.13,-2140.13,-6768.19
3084155319621526016,2020-10,1772.48,3596.26,4591.01,743.22,2024.01,-4744.18
3084155319621526016,2020-11,1299.52,2372.22,785.08,0,-287.62,-5031.8
3084956367567047168,2020-01,9478.67,6342.12,6319.98,2029.77,7426.76,7426.76
3084956367567047168,2020-02,9891.02,2025.88,4601.47,5838.98,6627.63,14054.39
3084956367567047168,2020-03,4853.33,2897.28,4900.71,6296.54,560.22,14614.61
3084956367567047168,2020-04,3325.09,5553.29,13316.82,3930.99,7157.63,21772.24
3084956367567047168,2020-05,1543.8,6055.25,2850.01,3558.46,-5219.9,16552.34
3084956367567047168,2020-06,4302.06,5388.07,2947.27,3176.79,-1315.53,15236.81
3084956367567047168,2020-07,4276.08,2546.56,5775.32,4452.49,3052.35,18289.16
3084956367567047168,2020-08,4056,8709.77,7172.09,5830.38,-3312.06,14977.1
3084956367567047168,2020-09,3216.22,3204.48,3323.41,2777.44,557.71,15534.81
3084956367567047168,2020-10,2814.43,5259.77,6905.2,691.17,3768.69,19303.5
3084956367567047168,2020-11,1338.85,2177.23,3833.48,2060.35,934.75,20238.25
3084956367567047168,2020-12,6159.01,3943.46,2754.96,2818.9,2151.61,22389.86
3085376923795651072,2020-01,3472.15,1578.79,0,1812.69,80.67,80.67
3085376923795651072,2020-02,3.62,1313.51,5153.69,3567.02,276.78,357.45
3085376923795651072,2020-03,1599.86,3747.38,5637.87,3492.46,-2.11,355.34
3085376923795651072,2020-04,1182.36,3291.17,1296.37,946.91,-1759.35,-1404.01
3085376923795651072,2020-05,3889.19,4090.07,0,3617.27,-3818.15,-5222.16
3085376923795651072,2020-06,0,1961.58,6150.39,6171.77,-1982.96,-7205.12
3085376923795651072,2020-07,1791.17,1704.46,2466.77,2236.98,316.5,-6888.62
3085376923795651072,2020-08,4338.75,1167.65,1400.77,0,4571.87,-2316.75
3085376923795651072,2020-09,3904.84,2494.36,1199.14,0,2609.62,292.87
3085376923795651072,2020-10,59.71,2994.69,3320.43,1504.33,-1118.88,-826.01
3085376923795651072,2020-11,2458.6,623.57,1005.35,3415.05,-574.67,-1400.68
3085376923795651072,2020-12,6469.39,0,1959,3297.66,5130.73,3730.05
3087004207248264192,2020-02,232.91,0,0,1842.13,-1609.22,-1609.22
3087004207248264192,2020-05,1322.01,0,1135.42,0,2457.43,848.21
3087004207248264192,2020-06,0,1325.2,0,0,-1325.2,-476.99
3087004207248264192,2020-07,1531.61,0,1335.91,0,2867.52,2390.53
3087004207248264192,2020-08,0,1782.2,0,0,-1782.2,608.33
3087004207248264192,2020-11,0,160.91,1924.29,0,1763.38,2371.71
3087514978465600000,2020-01,3992.06,2691.1,7953.1,4285.41,4968.65,4968.65
3087514978465600000,2020-02,3412.63,3301.64,3895.24,8541.14,-4534.91,433.74
3087514978465600000,2020-03,3126.86,3354.36,4890.87,4659.63,3.74,437.48
3087514978465600000,2020-04,4674.61,3082.51,6227.97,3548.91,4271.16,4708.64
3087514978465600000,2020-05,6513,8387.98,4942.83,3032.59,35.26,4743.9
3087514978465600000,2020-06,5687.52,3333.72,1283.43,3138.25,498.98,5242.88
3087514978465600000,2020-07,4197.68,2354.73,5947.15,3032.36,4757.74,10000.62
3087514978465600000,2020-08,3479.34,5413.27,5031.23,8969.44,-5872.14,4128.48
3087514978465600000,2020-09,5039.46,576.36,2975.68,12878.86,-5440.08,-1311.6
3087514978465600000,2020-10,8633.44,4833.13,1745.2,2762.95,2782.56,1470.96
3087514978465600000,2020-11,4522.19,4360.12,4976.73,235.19,4903.61,6374.57
3087514978465600000,2020-12,3942.87,2354.28,7105.19,5623.07,3070.71,9445.28
3087844366413279744,2020-01,2802.69,0,2307.48,3097.03,2013.14,2013.14
3087844366413279744,2020-02,2508.15,2674.05,4264,3229.35,868.75,2881.89
3087844366413279744,2020-03,4983.53,7564.63,2860.29,4865.18,-4585.99,-1704.1
3087844366413279744,2020-04,4891.14,4109.88,0,8680.74,-7899.48,-9603.58
3087844366413279744,2020-05,2267.82,7832.46,4176.96,922.01,-2309.69,-11913.27
3087844366413279744,2020-06,3022.52,2558.14,2592.91,0,3057.29,-8855.98
3087844366413279744,2020-07,5001.84,9648.22,11753.66,4051.11,3056.17,-5799.81
3087844366413279744,2020-08,5926.34,1883.1,5403.96,6874.53,2572.67,-3227.14
3087844366413279744,2020-09,4144.09,3648.85,3599.53,2649.11,1445.66,-1781.48
3087844366413279744,2020-10,1574.36,0,3761.3,1306.63,4029.03,2247.55
3087844366413279744,2020-11,5064.11,2679.42,1387.69,2841.48,930.9,3178.45
3087844366413279744,2020-12,6390.77,2276.55,5316.61,2603.08,6827.75,10006.2
3089257826266469376,2020-01,4746.09,2338.58,5234.04,2779.4,4862.15,4862.15
3089257826266469376,2020-02,5901.17,9157.3,1324.78,5529.1,-7460.45,-2598.3
3089257826266469376,2020-03,4064.19,5365.8,2966.87,5869.28,-4204.02,-6802.32
3089257826266469376,2020-04,4931.25,5130.01,2707.86,2096.3,412.8,-6389.52
3089257826266469376,2020-05,836.75,2651.22,6574.19,7067.1,-2307.38,-8696.9
3089257826266469376,2020-06,865.07,1842.24,1922.68,5589.09,-4643.58,-13340.48
3089257826266469376,2020-07,2215.44,3723.18,1459.33,4733.95,-4782.36,-18122.84
3089257826266469376,2020-08,2581.81,4257.01,1821.71,6826.95,-6680.44,-24803.28
3089257826266469376,2020-09,6483.82,6052.79,10652.81,6555.85,4527.99,-20275.29
3089257826266469376,2020-10,5697.94,6894.25,6222.86,2908.33,2118.22,-18157.07
3089257826266469376,2020-11,8739.72,2562.21,1826.14,818.95,7184.7,-10972.37
3089257826266469376,2020-12,4015.04,3458.89,1936.25,5719.43,-3227.03,-14199.4
3089694581740470272,2020-01,1378.28,2008.16,994.07,873.04,-508.85,-508.85
3089694581740470272,2020-02,1306.29,0,0,1401.68,-95.39,-604.24
3089694581740470272,2020-03,3030.9,1457.47,388.2,0,1961.63,1357.39
3089694581740470272,2020-04,936.91,3453.86,3574.83,3478.07,-2420.19,-1062.8
3089694581740470272,2020-05,663.92,0,0,1675.29,-1011.37,-2074.17
3089694581740470272,2020-06,0,2036.5,1218.82,2326.93,-3144.61,-5218.78
3089694581740470272,2020-07,3540.7,2843.34,1666.1,0,2363.46,-2855.32
3089694581740470272,2020-08,1399.98,4671.74,1207.82,1547.19,-3611.13,-6466.45
3089694581740470272,2020-09,1263.13,0,1271.07,0,2534.2,-3932.25
3089694581740470272,2020-10,493.73,2286.81,5960.38,1556.39,2610.91,-1321.34
3089694581740470272,2020-11,3344.63,1727.15,1124.03,127.83,2613.68,1292.34
3089694581740470272,2020-12,0,3569.59,553.21,1575.11,-4591.49,-3299.15
3089826556885067776,2020-07,0,1805.2,0,0,-1805.2,-1805.2
3089826556885067776,2020-10,0,1328.5,0,0,-1328.5,-3133.7
3089826556885067776,2020-11,983.84,0,0,0,983.84,-2149.86
3089826556885067776,2020-12,804.28,636.38,0,0,167.9,-1981.96
3091721395833955328,2020-01,5374.39,3764.21,3044.28,7822.57,-3168.11,-3168.11
3091721395833955328,2020-02,11256.03,5327.57,4048.81,3112.26,6865.01,3696.9
3091721395833955328,2020-03,3039.86,2873.83,6812.66,2063.86,4914.83,8611.73
3091721395833955328,2020-04,7850.38,3283.34,7754.15,4069.99,8251.2,16862.93
3091721395833955328,2020-05,3247.75,4181.9,2677.1,3712.62,-1969.67,14893.26
3091721395833955328,2020-06,8444.98,4097.06,3801.66,575.59,7573.99,22467.25
3091721395833955328,2020-07,2637.69,5894.49,13554.75,9477.31,820.64,23287.89
3091721395833955328,2020-08,4514.94,556.25,3346.82,6350.99,954.52,24242.41
3091721395833955328,2020-09,2726.57,6694.58,9027.7,2317.57,2742.12,26984.53
3091721395833955328,2020-10,64.87,5758.16,1513.68,3335,-7514.61,19469.92
3091721395833955328,2020-11,1639.07,3537.88,6863.13,1686.63,3277.69,22747.61
3091721395833955328,2020-12,5148.65,4104.57,5222.59,7005.34,-738.67,22008.94
3092594654685260288,2020-02,0,1651.38,148.64,881.3,-2384.04,-2384.04
3092594654685260288,2020-04,13.92,1302.55,1065.92,326.99,-549.7,-2933.74
3092594654685260288,2020-05,0,2562.66,0,1196.8,-3759.46,-6693.2
3092594654685260288,2020-06,7.56,0,0,0,7.56,-6685.64
3092594654685260288,2020-08,0,2788.67,0,0,-2788.67,-9474.31
3092594654685260288,2020-09,0,2780.66,1470.72,492.54,-1802.48,-11276.79
3092594654685260288,2020-10,955.22,3622.45,1110.89,0,-1556.34,-12833.13
3092594654685260288,2020-11,2174.93,0,3113.66,1506.97,3781.62,-9051.51
3092594654685260288,2020-12,704.84,732.72,1570.64,505.17,1037.59,-8013.92
3093425826005570048,2020-02,190.05,1155.34,0,621.56,-1586.85,-1586.85
3093425826005570048,2020-04,0,1277.53,0,1389.95,-2667.48,-4254.33
3093425826005570048,2020-05,1803.13,0,0,896.1,907.03,-3347.3
3093425826005570048,2020-08,39.47,1916.37,1628.29,0,-248.61,-3595.91
3093425826005570048,2020-09,1152.7,533.79,1837.94,0,2456.85,-1139.06
3093425826005570048,2020-10,0,1545.96,1431.53,0,-114.43,-1253.49
3093425826005570048,2020-11,0,1986.27,0,1493.27,-3479.54,-4733.03
3093425826005570048,2020-12,2318.41,0,0,0,2318.41,-2414.62
3094576963001298944,2020-01,5122.2,2552.22,2179.89,4470.65,279.22,279.22
3094576963001298944,2020-02,795.88,1785.81,1718.76,2971.79,-2242.96,-1963.74
3094576963001298944,2020-03,1494.7,6306.33,1974.36,1501.16,-4338.43,-6302.17
3094576963001298944,2020-04,2175.63,4530.77,597.5,4629.94,-6387.58,-12689.75
3094576963001298944,2020-05,2727.22,3105.82,707.82,3979.73,-3650.51,-16340.26
3094576963001298944,2020-06,912.25,3604.65,4841.57,3414.2,-1265.03,-17605.29
3094576963001298944,2020-07,2602.01,2417.41,2584.28,2425.61,343.27,-17262.02
3094576963001298944,2020-08,5751.94,1127.38,2206.47,3928.79,2902.24,-14359.78
3094576963001298944,2020-09,676.7,3726.24,3844.29,6306.95,-5512.2,-19871.98
3094576963001298944,2020-10,4203.04,3117.23,4424.24,4237.62,1272.43,-18599.55
3094576963001298944,2020-11,249.31,4388.8,4168.47,4280.7,-4251.72,-22851.27
3094576963001298944,2020-12,6778.32,2588.5,8667.57,5006.6,7850.79,-15000.48
3095945853936949760,2020-01,3587.88,5347.68,872.91,4410.13,-5297.02,-5297.02
3095945853936949760,2020-02,1199.95,1193.86,2690.16,3703.8,-1007.55,-6304.57
3095945853936949760,2020-03,1592.45,2736.26,1831.33,626.65,60.87,-6243.7
3095945853936949760,2020-04,180.98,1723.28,2964.95,797.72,624.93,-5618.77
3095945853936949760,2020-05,6776.53,1697.74,0,3350.19,1728.6,-3890.17
3095945853936949760,2020-06,2079.83,1615.48,2341.8,3947.2,-1141.05,-5031.22
3095945853936949760,2020-07,0,1302.19,1904.98,535.44,67.35,-4963.87
3095945853936949760,2020-08,2097.38,5423.39,6325.84,6192.31,-3192.48,-8156.35
3095945853936949760,2020-09,1498.67,6178.8,181.62,3635.36,-8133.87,-16290.22
3095945853936949760,2020-10,5912.79,0,7016.49,1338.07,11591.21,-4699.01
3095945853936949760,2020-11,59.18,2543.09,1639.12,4253.8,-5098.59,-9797.6
3095945853936949760,2020-12,1550.74,3088.65,1030.08,625.6,-1133.43,-10931.03
3096979387291934720,2020-01,786.33,2274.3,1872.86,1468.76,-1083.87,-1083.87
3096979387291934720,2020-02,4144.86,2839.44,0,6041.55,-4736.13,-5820
3096979387291934720,2020-03,1195.3,1324.61,3061.23,1369.61,1562.31,-4257.69
3096979387291934720,2020-04,1377.45,4715.88,2366.97,0,-971.46,-5229.15
3096979387291934720,2020-05,3753.9,2474.89,3901.57,589.82,4590.76,-638.39
3096979387291934720,2020-06,0,900.81,0,0,-900.81,-1539.2
3096979387291934720,2020-07,4112.14,3114.86,3363.35,2159.1,2201.53,662.33
3096979387291934720,2020-08,1627.03,5354.6,4656.02,1615.51,-687.06,-24.73
3096979387291934720,2020-09,0,2966.63,962.48,3128.13,-5132.28,-5157.01
3096979387291934720,2020-10,1022.83,1893.48,3534.89,0,2664.24,-2492.77
3096979387291934720,2020-11,817.14,2984.15,196.69,683.61,-2653.93,-5146.7
3096979387291934720,2020-12,460.92,0,2102.19,1221.45,1341.66,-3805.04
3097163245596484096,2020-01,729.03,0,0,1227.64,-498.61,-498.61
3097163245596484096,2020-07,359.37,0,0,232.35,127.02,-371.59
3097163245596484096,2020-10,1942.56,0,0,0,1942.56,1570.97
3097922986642288128,2020-01,2418.57,6489.23,3343.05,1538.16,-2265.77,-2265.77
3097922986642288128,2020-02,3370.32,409.29,3613.48,450.9,6123.61,3857.84
3097922986642288128,2020-03,1742.75,2661.71,2768.84,2932.95,-1083.07,2774.77
3097922986642288128,2020-04,1404.42,716.98,2144.29,1764.25,1067.48,3842.25
3097922986642288128,2020-05,2184.65,0,0,2445.78,-261.13,3581.12
3097922986642288128,2020-06,764.06,177.69,1982.49,1633.13,935.73,4516.85
3097922986642288128,2020-07,1826.97,0,2525.2,2914.84,1437.33,5954.18
3097922986642288128,2020-08,4195.08,4424.16,1946.19,4479.55,-2762.44,3191.74
3097922986642288128,2020-09,1579.91,0,0,0,1579.91,4771.65
3097922986642288128,2020-10,2623.41,271.51,1785.3,6505.53,-2368.33,2403.32
3097922986642288128,2020-11,2830.9,3381.24,228.3,4430.37,-4752.41,-2349.09
3097922986642288128,2020-12,707.37,1306.33,1117.59,1055.94,-537.31,-2886.4
3098258058830675456,2020-01,7143.14,3155.31,4192.65,5195.38,2985.1,2985.1
3098258058830675456,2020-02,2324.96,1121.07,3515.01,2803.43,1915.47,4900.57
3098258058830675456,2020-03,3901.34,295.51,2070.33,3842.95,1833.21,6733.78
3098258058830675456,2020-04,848.47,2883.43,5376.27,1105.15,2236.16,8969.94
3098258058830675456,2020-05,4829.95,6818.44,2538.6,1680.27,-1130.16,7839.78
3098258058830675456,2020-06,4248.47,5619.23,6672.28,3077.23,2224.29,10064.07
3098258058830675456,2020-07,4911.45,1815.03,4250.25,564.32,6782.35,16846.42
3098258058830675456,2020-08,3737.68,3441.54,1232.99,2246.48,-717.35,16129.07
3098258058830675456,2020-09,3711.07,3881.61,3089.61,8210.73,-5291.66,10837.41
3098258058830675456,2020-10,4578.13,2005.06,4599.13,5696.19,1476.01,12313.42
3098258058830675456,2020-11,2050.66,2040.75,3406.42,9121.58,-5705.25,6608.17
3098258058830675456,2020-12,1882.96,0,6931.76,3741.7,5073.02,11681.19
3099888010083472384,2020-01,0,1513.29,0,2251.29,-3764.58,-3764.58
3099888010083472384,2020-02,0,753.94,0,0,-753.94,-4518.52
3099888010083472384,2020-03,2907.53,81.83,0,0,2825.7,-1692.82
3099888010083472384,2020-04,0,2745.44,0,0,-2745.44,-4438.26
3099888010083472384,2020-07,0,1402.68,0,0,-1402.68,-5840.94
3099888010083472384,2020-08,1522.99,0,0,784.22,738.77,-5102.17
3099888010083472384,2020-09,1350.6,342.25,445,0,1453.35,-3648.82
3099888010083472384,2020-11,0,1107.94,0,0,-1107.94,-4756.76
3100412017959796224,2020-01,0,144,0,1858.72,-2002.72,-2002.72
3100412017959796224,2020-02,0,1763.05,0,2365.49,-4128.54,-6131.26
3100412017959796224,2020-04,261.87,1899.62,1261.12,835.64,-1212.27,-7343.53
3100412017959796224,2020-05,1756.26,376.69,1246.72,1337.48,1288.81,-6054.72
3100412017959796224,2020-06,571.65,778.37,0,0,-206.72,-6261.44
3100412017959796224,2020-10,1000.74,1954.89,0,827.35,-1781.5,-8042.94
3100412017959796224,2020-11,1849.41,0,0,3412.32,-1562.91,-9605.85
3100412017959796224,2020-12,0,1548.05,0,0,-1548.05,-11153.9
3100585032738042368,2020-01,358.13,1853.53,988.29,467.19,-974.3,-974.3
3100585032738042368,2020-02,2306.92,3773.65,382.66,1822.94,-2907.01,-3881.31
3100585032738042368,2020-03,2887.82,1070.66,4336.64,3353.01,2800.79,-1080.52
3100585032738042368,2020-04,0,2192,2246.4,4236.01,-4181.61,-5262.13
3100585032738042368,2020-05,1102.98,1948.88,1653.53,1110.09,-302.46,-5564.59
3100585032738042368,2020-06,0,4470.58,2584.71,719.67,-2605.54,-8170.13
3100585032738042368,2020-07,1712.39,3098.31,796.06,6032.39,-6622.25,-14792.38
3100585032738042368,2020-08,835.71,5681.97,2918.92,3795.44,-5722.78,-20515.16
3100585032738042368,2020-09,1653.05,2648.67,514.23,4147.56,-4628.95,-25144.11
3100585032738042368,2020-10,7354.9,923.57,2665.69,1685.9,7411.12,-17732.99
3100585032738042368,2020-11,0,3348.73,607.64,0,-2741.09,-20474.08
3100585032738042368,2020-12,7424.16,0,4132.43,2665.97,8890.62,-11583.46
3101443596869565440,2020-01,2490.73,7449.51,4133.62,5208.05,-6033.21,-6033.21
3101443596869565440,2020-02,0,1548.76,2859.86,2416.59,-1105.49,-7138.7
3101443596869565440,2020-03,2745.27,0,10156.5,10860.42,2041.35,-5097.35
3101443596869565440,2020-04,311.39,1616.82,3122.29,6176.01,-4359.15,-9456.5
3101443596869565440,2020-05,6758.82,3875.21,6249.61,6454.85,2678.37,-6778.13
3101443596869565440,2020-06,1492.66,2396.67,1104.62,1152.58,-951.97,-7730.1
3101443596869565440,2020-07,1956.64,2619.79,2606.24,8181.12,-6238.03,-13968.13
3101443596869565440,2020-08,3176.97,5822.68,5147.99,5454.97,-2952.69,-16920.82
3101443596869565440,2020-09,5957.1,1329.79,2295.72,3251.82,3671.21,-13249.61
3101443596869565440,2020-10,522.96,4592.84,4844.9,4968.75,-4193.73,-17443.34
3101443596869565440,2020-11,4453.16,5059.31,3300.92,2428.34,266.43,-17176.91
3101443596869565440,2020-12,1301.71,10410.88,444,750.27,-9415.44,-26592.35
3102098042761774592,2020-01,6036.23,4483.31,5775.98,5143.81,2185.09,2185.09
3102098042761774592,2020-02,2985.16,7020.9,1476.2,2037.12,-4596.66,-2411.57
3102098042761774592,2020-04,1342.33,2478.63,0,0,-1136.3,-3547.87
3102098042761774592,2020-05,3195.71,2881.68,7200.87,5121.18,2393.72,-1154.15
3102098042761774592,2020-06,3293.03,1669.95,4422.77,0,6045.85,4891.7
3102098042761774592,2020-07,1732.15,2571.59,1183.69,1964.96,-1620.71,3270.99
3102098042761774592,2020-08,4206.1,1318.78,3143.85,721.41,5309.76,8580.75
3102098042761774592,2020-09,5729.79,3574.84,1897.75,2578.95,1473.75,10054.5
3102098042761774592,2020-10,3281.39,3627.13,0,2633.02,-2978.76,7075.74
3102098042761774592,2020-11,2068.2,3468.91,4303.26,224.37,2678.18,9753.92
3102098042761774592,2020-12,2239.99,875.21,0,2357.47,-992.69,8761.23
3102990291578779136,2020-01,3580.89,4845.31,0,3662.88,-4927.3,-4927.3
3102990291578779136,2020-02,5.1,8629.29,629.89,4603.6,-12597.9,-17525.2
3102990291578779136,2020-03,429.59,2097.6,143.18,1977.1,-3501.93,-21027.13
3102990291578779136,2020-04,1075.83,4218.58,5584.76,1357.26,1084.75,-19942.38
3102990291578779136,2020-05,1393.9,380.37,1194.27,2215.81,-8.01,-19950.39
3102990291578779136,2020-06,2389.49,149.83,531.31,5317.64,-2546.67,-22497.06
3102990291578779136,2020-07,2082.95,2784.26,0,1898.38,-2599.69,-25096.75
3102990291578779136,2020-08,711.8,5247.89,987.49,3131.65,-6680.25,-31777
3102990291578779136,2020-09,3296.07,1659.95,0,7179.49,-5543.37,-37320.37
3102990291578779136,2020-10,3043.45,6273.67,0,5289.31,-8519.53,-45839.9
3102990291578779136,2020-11,3999.33,2984.38,344.97,2447.76,-1087.84,-46927.74
3102990291578779136,2020-12,6234.09,1318.74,1875.24,2392.78,4397.81,-42529.93
3103258057097348096,2020-01,0,1830.54,696.77,2115.12,-3248.89,-3248.89
3103258057097348096,2020-02,214.67,492.79,1679.24,0,1401.12,-1847.77
3103258057097348096,2020-03,0,959.18,0,3390.97,-4350.15,-6197.92
3103258057097348096,2020-04,2660.88,2095.31,2920.69,0,3486.26,-2711.66
3103258057097348096,2020-05,0,884.16,2009.47,333.74,791.57,-1920.09
3103258057097348096,2020-06,3760.45,143.67,1293.93,2299.93,2610.78,690.69
3103258057097348096,2020-08,148.67,968.65,1968.84,508.19,640.67,1331.36
3103258057097348096,2020-09,2963.36,0,0,347.1,2616.26,3947.62
3103258057097348096,2020-10,125.9,0,0,0,125.9,4073.52
3103258057097348096,2020-12,0,1750.11,1816.6,1888.37,-1821.88,2251.64
3103431794470624256,2020-01,2082.74,2493.72,2207.67,111.1,1685.59,1685.59
3103431794470624256,2020-02,1374.49,0,3809.57,775.04,4409.02,6094.61
3103431794470624256,2020-03,1479.7,56.48,1022.04,337.17,2108.09,8202.7
3103431794470624256,2020-04,1835.85,1784.37,824.27,2802.32,-1926.57,6276.13
3103431794470624256,2020-05,2267.07,3229.28,1725.84,4521.93,-3758.3,2517.83
3103431794470624256,2020-06,4698.67,4412.3,1731.06,5251.56,-3234.13,-716.3
3103431794470624256,2020-07,257.66,2304.35,785.5,2583.18,-3844.37,-4560.67
3103431794470624256,2020-08,817.07,2852.9,1669.21,0,-366.62,-4927.29
3103431794470624256,2020-09,1402.06,730.91,1053.74,2498.73,-773.84,-5701.13
3103431794470624256,2020-10,249.75,3396.74,792.78,2672.11,-5026.32,-10727.45
3103431794470624256,2020-11,2557.37,2745.85,292.64,601.62,-497.46,-11224.91
3103431794470624256,2020-12,163.69,1654.02,2440.3,1817.45,-867.48,-12092.39
3110311746246930432,2020-01,685.47,0,701.87,2078.26,-690.92,-690.92
3110311746246930432,2020-02,3090.93,131.5,510.63,0,3470.06,2779.14
3110311746246930432,2020-03,685.45,0,0,739.56,-54.11,2725.03
3110311746246930432,2020-05,782.04,0,0,0,782.04,3507.07
3110311746246930432,2020-06,790.45,1488.8,0,1360.35,-2058.7,1448.37
3110311746246930432,2020-07,937.79,0,0,0,937.79,2386.16
3110311746246930432,2020-08,1674.59,0,1283.17,0,2957.76,5343.92
3110311746246930432,2020-09,0,1238.66,1429.03,0,190.37,5534.29
3111743975080078848,2020-02,2946.95,0,0,1608.69,1338.26,1338.26
3111743975080078848,2020-03,3853.53,0,348.97,421.06,3781.44,5119.7
3111743975080078848,2020-04,1184.06,1777.31,5316.71,0,4723.46,9843.16
3111743975080078848,2020-05,0,206.31,0,1921.37,-2127.68,7715.48
3111743975080078848,2020-06,1399.94,0,0,1090.38,309.56,8025.04
3111743975080078848,2020-07,755.19,0,1467.05,0,2222.24,10247.28
3111743975080078848,2020-08,2762.58,1119.01,0,2955.91,-1312.34,8934.94
3111743975080078848,2020-09,2016.88,2320.42,143.21,0,-160.33,8774.61
3111743975080078848,2020-10,0,1789.04,459.08,0,-1329.96,7444.65
3111743975080078848,2020-11,2554.17,10.74,0,0,2543.43,9988.08
3111743975080078848,2020-12,0,2907.35,841.03,0,-2066.32,7921.76
3112064943747527168,2020-01,0,4744.92,1307.29,1397.19,-4834.82,-4834.82
3112064943747527168,2020-04,0,3943.47,0,0,-3943.47,-8778.29
3112064943747527168,2020-05,1643.43,1703.36,2176.57,913.57,1203.07,-7575.22
3112064943747527168,2020-06,1816.76,0,0,0,1816.76,-5758.46
3112064943747527168,2020-07,0,5722.68,1984.41,1957.88,-5696.15,-11454.61
3112064943747527168,2020-08,2212.33,0,0,847.67,1364.66,-10089.95
3112064943747527168,2020-09,0,1198.37,654.01,2617.39,-3161.75,-13251.7
3112064943747527168,2020-10,0,2851.8,1188.73,3511.68,-5174.75,-18426.45
3112064943747527168,2020-11,1969.15,804.27,0,0,1164.88,-17261.57
3112064943747527168,2020-12,1200.45,0,0,1352.58,-152.13,-17413.7
3115732773203848192,2020-01,5446.16,3209.37,6412.94,3673.12,4976.61,4976.61
3115732773203848192,2020-02,5248.4,2658.48,5384.42,7113.91,860.43,5837.04
3115732773203848192,2020-03,8582.13,5163.85,1824.29,8591.04,-3348.47,2488.57
3115732773203848192,2020-04,2210.29,5473.52,3602.51,3724.49,-3385.21,-896.64
3115732773203848192,2020-05,7434.49,1344.25,1286.48,4227.35,3149.37,2252.73
3115732773203848192,2020-06,8908.93,215.73,2456.39,9109.94,2039.65,4292.38
3115732773203848192,2020-07,6083.72,3207.96,10083.31,3212.32,9746.75,14039.13
3115732773203848192,2020-08,3284.37,2614.91,938.02,8828.51,-7221.03,6818.1
3115732773203848192,2020-09,2098.17,1346.67,8140.24,7341.31,1550.43,8368.53
3115732773203848192,2020-10,1971.52,8031.53,5598.48,3499.4,-3960.93,4407.6
3115732773203848192,2020-11,2398.79,1530.1,3905.89,1847.65,2926.93,7334.53
3115732773203848192,2020-12,387.29,4162.61,1065.69,2040.43,-4750.06,2584.47
3118350622467018240,2020-01,0,718.27,0,0,-718.27,-718.27
3118350622467018240,2020-02,0,1190.84,0,904.38,-2095.22,-2813.49
3118350622467018240,2020-03,1275.98,2384.11,0,0,-1108.13,-3921.62
3118350622467018240,2020-04,372.65,0,1208.79,0,1581.44,-2340.18
3118350622467018240,2020-05,690.88,0,138.11,0,828.99,-1511.19
3118350622467018240,2020-07,524.46,959.34,0,1384.15,-1819.03,-3330.22
3118350622467018240,2020-08,2409.64,3046.48,466.18,1982.03,-2152.69,-5482.91
3118350622467018240,2020-09,0,3247.1,0,1867.26,-5114.36,-10597.27
3118350622467018240,2020-10,918.06,1160.43,1789.04,2876.57,-1329.9,-11927.17
3118350622467018240,2020-12,0,2366.9,0,1171,-3537.9,-15465.07
3118912692849754624,2020-01,2316.73,6692.61,5826.89,4711.56,-3260.55,-3260.55
3118912692849754624,2020-02,2511.42,6385.17,1781.11,0,-2092.64,-5353.19
3118912692849754624,2020-03,3223.45,3175.7,0,8223.26,-8175.51,-13528.7
3118912692849754624,2020-04,2019.47,3484.19,2951.96,1045.75,441.49,-13087.21
3118912692849754624,2020-05,2836.65,2286.97,3551.98,8358.62,-4256.96,-17344.17
3118912692849754624,2020-06,4040.89,2225.38,3211.27,4429.43,597.35,-16746.82
3118912692849754624,2020-07,4201.8,5580.42,1406.39,9403.91,-9376.14,-26122.96
3118912692849754624,2020-08,589.02,3758.76,3325.85,4437.44,-4281.33,-30404.29
3118912692849754624,2020-09,2377,2021.8,11366.83,3808.42,7913.61,-22490.68
3118912692849754624,2020-10,4304.88,5068.71,9322.01,3412.42,5145.76,-17344.92
3118912692849754624,2020-11,56.81,4132.17,709.01,1033.7,-4400.05,-21744.97
3118912692849754624,2020-12,4979.67,5344.55,3402.81,2444.24,593.69,-21151.28
3120310918772084224,2020-01,189.34,2211.01,1146.83,2695.17,-3570.01,-3570.01
3120310918772084224,2020-02,335.69,0,0,0,335.69,-3234.32
3120310918772084224,2020-03,851.35,83.24,235.33,4643.43,-3639.99,-6874.31
3120310918772084224,2020-04,0,2272.4,3929.19,702.55,954.24,-5920.07
3120310918772084224,2020-05,0,1600.71,1920.4,9.24,310.45,-5609.62
3120310918772084224,2020-06,1857.02,0,0,0,1857.02,-3752.6
3120310918772084224,2020-07,1254.98,1739.38,0,1955.67,-2440.07,-6192.67
3120310918772084224,2020-08,2162.84,1840.8,1373.31,0,1695.35,-4497.32
3120310918772084224,2020-10,0,2208.42,1103.91,0,-1104.51,-5601.83
3120310918772084224,2020-11,0,2871.86,0,1781.97,-4653.83,-10255.66
3120310918772084224,2020-12,0,1361.2,882.37,0,-478.83,-10734.49
3121137211970446336,2020-01,867.45,0,1831.13,2340.56,358.02,358.02
3121137211970446336,2020-02,93.22,3872.21,781.44,1885.38,-4882.93,-4524.91
3121137211970446336,2020-03,0,891.29,1688.14,0,796.85,-3728.06
3121137211970446336,2020-04,3129.19,0,2269.95,2533.38,2865.76,-862.3
3121137211970446336,2020-05,0,3071.49,1664.28,486.2,-1893.41,-2755.71
3121137211970446336,2020-06,443.51,4305.87,269.32,72.36,-3665.4,-6421.11
3121137211970446336,2020-07,3585.53,0,0,0,3585.53,-2835.58
3121137211970446336,2020-08,0,2709.71,0,0,-2709.71,-5545.29
3121137211970446336,2020-09,1046.29,1355.35,2126.95,0,1817.89,-3727.4
3121137211970446336,2020-11,0,2067.08,1590.75,125.95,-602.28,-4329.68
3121137211970446336,2020-12,188.14,1762.02,0,1151.32,-2725.2,-7054.88
3123279595141215232,2020-01,2479.19,5751.38,4106.53,5025.72,-4191.38,-4191.38
3123279595141215232,2020-02,6259.97,2525.69,705.84,2051.03,2389.09,-1802.29
3123279595141215232,2020-03,4319.36,2467.97,2283.91,1718.91,2416.39,614.1
3123279595141215232,2020-04,4873.77,689.2,4773.63,1189.46,7768.74,8382.84
3123279595141215232,2020-05,2969.85,2625.24,6045.7,1770.13,4620.18,13003.02
3123279595141215232,2020-06,7269,4910.24,6696.75,0,9055.51,22058.53
3123279595141215232,2020-07,3449.84,891.25,2666,3504.54,1720.05,23778.58
3123279595141215232,2020-08,2594.92,1362.26,4188.1,0,5420.76,29199.34
3123279595141215232,2020-09,2374.22,0,1574.62,4497.7,-548.86,28650.48
3123279595141215232,2020-10,2387.62,3066.75,1265.68,1729.04,-1142.49,27507.99
3123279595141215232,2020-11,3340.76,3517.89,6324.33,5646.47,500.73,28008.72
3123279595141215232,2020-12,5937.11,288.24,2807.16,196.13,8259.9,36268.62
3124324294208621056,2020-01,4453.97,5942.76,1761.33,0,272.54,272.54
3124324294208621056,2020-02,2852.86,2274.48,4243.87,629.54,4192.71,4465.25
3124324294208621056,2020-03,2184.04,1981.86,0,2230.19,-2028.01,2437.24
3124324294208621056,2020-04,1670.34,3414.67,4512.95,4927.16,-2158.54,278.7
3124324294208621056,2020-05,2431.94,503.31,1327.73,1827.43,1428.93,1707.63
3124324294208621056,2020-06,753.31,171.92,1628.19,1809.49,400.09,2107.72
3124324294208621056,2020-07,0,3005.56,773.45,4307.69,-6539.8,-4432.08
3124324294208621056,2020-08,0,1254.65,4637.14,1177.18,2205.31,-2226.77
3124324294208621056,2020-09,3464.86,0,0,5102.11,-1637.25,-3864.02
3124324294208621056,2020-10,3089.04,354.76,1610.79,3848.26,496.81,-3367.21
3124324294208621056,2020-11,2567.04,238.98,1156.08,610.44,2873.7,-493.51
3124324294208621056,2020-12,2544.65,1053.8,381.53,4958.55,-3086.17,-3579.68
3125830849972486656,2020-01,4541.35,6359.83,7171.33,3131.52,2221.33,2221.33
3125830849972486656,2020-02,3882.42,1422.97,9878.03,3095.59,9241.89,11463.22
3125830849972486656,2020-03,5552.65,2782.78,4793.95,4009.08,3554.74,15017.96
3125830849972486656,2020-04,1771.27,3685.33,3114.32,3211.64,-2011.38,13006.58
3125830849972486656,2020-05,2061.32,682.62,6570.83,4879.39,3070.14,16076.72
3125830849972486656,2020-06,8780.5,7276.69,152.27,6380.59,-4724.51,11352.21
3125830849972486656,2020-07,1930.12,2414.96,6998.87,6115.14,398.89,11751.1
3125830849972486656,2020-08,751.41,5049.69,7653.61,12310.17,-8954.84,2796.26
3125830849972486656,2020-09,2846.78,4627.87,4775.92,4896.97,-1902.14,894.12
3125830849972486656,2020-10,1824.08,4998.68,4717.7,1706.72,-163.62,730.5
3125830849972486656,2020-11,1981.6,4896.78,2247.29,4234.55,-4902.44,-4171.94
3125830849972486656,2020-12,6954.2,944.38,6234.08,5175.41,7068.49,2896.55
3126408266524388352,2020-01,1714.62,2488.77,0,972.16,-1746.31,-1746.31
3126408266524388352,2020-02,0,1868.79,1513.54,733.07,-1088.32,-2834.63
3126408266524388352,2020-03,1590.55,2498.73,1960.51,2581.14,-1528.81,-4363.44
3126408266524388352,2020-04,1369.87,1822.5,0,0,-452.63,-4816.07
3126408266524388352,2020-05,164.18,1671.1,1589.37,0,82.45,-4733.62
3126408266524388352,2020-06,3585.84,1006.6,0,2167.68,411.56,-4322.06
3126408266524388352,2020-07,0,810.88,0,0,-810.88,-5132.94
3126408266524388352,2020-09,1662.71,2763.78,767,3731.55,-4065.62,-9198.56
3126408266524388352,2020-10,377.85,999.24,2508.56,995.57,891.6,-8306.96
3126408266524388352,2020-11,0,896.76,680.47,1896.83,-2113.12,-10420.08
3126408266524388352,2020-12,3314.66,4722.47,0,1094.3,-2502.11,-12922.19
3126715436849760768,2020-01,2825.27,1214.28,2743.33,351.28,4003.04,4003.04
3126715436849760768,2020-02,1599.44,1472.16,4077.43,355.13,3849.58,7852.62
3126715436849760768,2020-03,3502.73,7460.82,886.44,175.48,-3247.13,4605.49
3126715436849760768,2020-04,267.91,2793.08,3777.38,0,1252.21,5857.7
3126715436849760768,2020-05,1589.38,6047.63,444.89,3832.85,-7846.21,-1988.51
3126715436849760768,2020-06,2739.89,687.72,582.52,1747.49,887.2,-1101.31
3126715436849760768,2020-07,1846.36,2595.96,849.27,775.61,-675.94,-1777.25
3126715436849760768,2020-08,2191.95,1229.02,3072.87,1580.09,2455.71,678.46
3126715436849760768,2020-09,459.02,229.35,2692.28,3553.82,-631.87,46.59
3126715436849760768,2020-10,3324.65,1627.12,2337.91,1675.69,2359.75,2406.34
3126715436849760768,2020-11,3304.78,3835.61,0,292.94,-823.77,1582.57
3126715436849760768,2020-12,5924.89,1379.1,2057.06,1744.03,4858.82,6441.39
3129591320601530880,2020-01,0,1590.07,0,0,-1590.07,-1590.07
3129591320601530880,2020-02,0,794.04,0,0,-794.04,-2384.11
3129591320601530880,2020-03,1834.12,0,3117.95,0,4952.07,2567.96
3129591320601530880,2020-07,0,1320.92,0,0,-1320.92,1247.04
3129591320601530880,2020-08,0,391.57,0,0,-391.57,855.47
3129591320601530880,2020-09,1226.41,0,0,0,1226.41,2081.88
3129591320601530880,2020-11,1259.67,0,703.58,0,1963.25,4045.13
3132179889031865344,2020-01,762.71,0,0,1503.92,-741.21,-741.21
3132179889031865344,2020-02,1100.5,0,0,398.34,702.16,-39.05
3132179889031865344,2020-04,0,123.53,0,0,-123.53,-162.58
3132179889031865344,2020-06,0,872.58,1688.15,831.61,-16.04,-178.62
3132179889031865344,2020-09,613.8,1029.67,0,0,-415.87,-594.49
3132179889031865344,2020-12,1129.01,1298.37,34.2,448.75,-583.91,-1178.4
3133285803131044352,2020-01,2532.6,6675.88,10019.22,4335.91,1540.03,1540.03
3133285803131044352,2020-02,3067.95,6721.54,8426.5,3602.44,1170.47,2710.5
3133285803131044352,2020-03,3627.86,5223.53,7384.55,1290.22,4498.66,7209.16
3133285803131044352,2020-04,7408.38,6045.47,4114.03,9696.42,-4219.48,2989.68
3133285803131044352,2020-05,2370.6,132.27,11757.63,3617.07,10378.89,13368.57
3133285803131044352,2020-06,1295.87,848.49,6870.7,10023.93,-2705.85,10662.72
3133285803131044352,2020-07,1785.67,4857.49,7003.42,3864.96,66.64,10729.36
3133285803131044352,2020-08,3425.1,0,7375.49,7640.22,3160.37,13889.73
3133285803131044352,2020-09,2275.86,5119.53,7936.23,8021.88,-2929.32,10960.41
3133285803131044352,2020-10,9955.79,3191.2,8328.77,2924.82,12168.54,23128.95
3133285803131044352,2020-11,2317.51,5569.8,5351.94,3742.22,-1642.57,21486.38
3133285803131044352,2020-12,6044.82,2907.64,5400.69,5474.47,3063.4,24549.78
3133422912269301760,2020-01,2822.53,631.06,5069.32,3080.28,4180.51,4180.51
3133422912269301760,2020-02,1101.62,1076.76,4656.06,4901.3,-220.38,3960.13
3133422912269301760,2020-03,1832.57,3659.78,2351.43,0,524.22,4484.35
3133422912269301760,2020-04,0,2423.08,403.34,1634.19,-3653.93,830.42
3133422912269301760,2020-05,2902.59,4470.12,1777.46,4048.92,-3838.99,-3008.57
3133422912269301760,2020-06,2268.77,760.4,7053.23,2751.41,5810.19,2801.62
3133422912269301760,2020-07,1788.34,4237.05,2298.27,760.26,-910.7,1890.92
3133422912269301760,2020-08,5374.79,1108.57,4826.71,4085.69,5007.24,6898.16
3133422912269301760,2020-09,1621.68,1520.47,2428.89,0,2530.1,9428.26
3133422912269301760,2020-10,2032.9,2064.23,32.81,1374.48,-1373,8055.26
3133422912269301760,2020-11,1389.2,3781.28,2680.14,2774.23,-2486.17,5569.09
3133422912269301760,2020-12,3885.92,0,2312.95,3467.33,2731.54,8300.63
3133527849920780288,2020-01,0,861.36,0,0,-861.36,-861.36
3133527849920780288,2020-05,0,898.93,0,0,-898.93,-1760.29
3134422700821353472,2020-09,529.66,0,0,0,529.66,529.66
3134872444196191232,2020-01,3480.49,6989.14,7385.97,4495.69,-618.37,-618.37
3134872444196191232,2020-02,2225.93,6124.73,3836.65,5276.99,-5339.14,-5957.51
3134872444196191232,2020-03,2788.16,2834.45,1723.39,5757.06,-4079.96,-10037.47
3134872444196191232,2020-04,1060.4,4619.35,4263.38,2260.84,-1556.41,-11593.88
3134872444196191232,2020-05,4283.07,7513.97,5853.1,6443.95,-3821.75,-15415.63
3134872444196191232,2020-06,7283.91,3143.4,2993.19,4676.82,2456.88,-12958.75
3134872444196191232,2020-07,3651.56,5290.32,2768.18,3642.88,-2513.46,-15472.21
3134872444196191232,2020-08,2911.81,5028.21,3698.16,1664.95,-83.19,-15555.4
3134872444196191232,2020-09,4055.15,4684.79,1925.51,3021.63,-1725.76,-17281.16
3134872444196191232,2020-10,4818.7,4416.73,4822.96,7964.3,-2739.37,-20020.53
3134872444196191232,2020-11,7291.19,5618.46,2146.93,5740.84,-1921.18,-21941.71
3134872444196191232,2020-12,1888.12,7386.06,5123.41,8211.23,-8585.76,-30527.47
3135256543807012352,2020-01,1724.85,0,1996,1888.53,1832.32,1832.32
3135256543807012352,2020-02,2340.3,583.84,1552.17,2455.5,853.13,2685.45
3135256543807012352,2020-03,2072.49,4719.11,669.31,1505.13,-3482.44,-796.99
3135256543807012352,2020-04,749.15,2959.03,1732.98,2357.84,-2834.74,-3631.73
3135256543807012352,2020-05,3024.5,0,1203.44,1069.85,3158.09,-473.64
3135256543807012352,2020-06,549.93,634.98,817.11,339.61,392.45,-81.19
3135256543807012352,2020-07,4708.03,0,1933.79,3363.83,3277.99,3196.8
3135256543807012352,2020-08,935.89,3929.78,3245.18,776.7,-525.41,2671.39
3135256543807012352,2020-09,1904.92,2463.28,2050.25,2239.88,-747.99,1923.4
3135256543807012352,2020-10,3065.06,1907.35,1463.29,1660.61,960.39,2883.79
3135256543807012352,2020-11,1573.64,2213.92,3717.54,2403.49,673.77,3557.56
3135256543807012352,2020-12,60.17,2818.37,2286.18,2223.49,-2695.51,862.05
3136855920673398272,2020-01,0,1094.95,0,1141.56,-2236.51,-2236.51
3136855920673398272,2020-03,337.43,0,0,0,337.43,-1899.08
3136855920673398272,2020-04,760.82,1046.71,697.13,0,411.24,-1487.84
3136855920673398272,2020-05,84.83,0,0,561.71,-476.88,-1964.72
3136855920673398272,2020-06,0,1058.37,0,0,-1058.37,-3023.09
3136855920673398272,2020-07,0,456.45,0,1412.9,-1869.35,-4892.44
3136855920673398272,2020-08,1685.49,1830.34,0,1961.88,-2106.73,-6999.17
3136855920673398272,2020-09,1153.23,0,0,0,1153.23,-5845.94
3136855920673398272,2020-10,831.46,0,0,0,831.46,-5014.48
3136855920673398272,2020-11,0,1698.44,0,1968.89,-3667.33,-8681.81
3138404734744784384,2020-01,4777.56,4845.71,5516.49,3787.12,1661.22,1661.22
3138404734744784384,2020-02,2681.42,5043.47,6592.96,2145.26,2085.65,3746.87
3138404734744784384,2020-03,4269.59,4750.4,765.19,5516.66,-5232.28,-1485.41
3138404734744784384,2020-04,2105.51,3041.67,5439.19,5483.47,-980.44,-2465.85
3138404734744784384,2020-05,7774.17,5374.62,3058.94,0,5458.49,2992.64
3138404734744784384,2020-06,6633.7,175.12,3231.62,17,9673.2,12665.84
3138404734744784384,2020-07,2055.82,1666.4,1726.27,2668.16,-552.47,12113.37
3138404734744784384,2020-08,2008.78,7048.01,3707.15,3446.15,-4778.23,7335.14
3138404734744784384,2020-09,493.86,2103.73,1005.56,5984.15,-6588.46,746.68
3138404734744784384,2020-10,1113.6,3142.53,4266.19,4044.28,-1807.02,-1060.34
3138404734744784384,2020-11,3771.36,2733.16,6999.9,2830.02,5208.08,4147.74
3138404734744784384,2020-12,4079.11,1259.63,3237.02,5608.02,448.48,4596.22
3139551518650516992,2020-01,2482.58,1780.41,3951.49,3260.27,1393.39,1393.39
3139551518650516992,2020-02,293.3,6105.4,1062.21,1393.74,-6143.63,-4750.24
3139551518650516992,2020-03,3160.41,4336.4,3164.72,2716.78,-728.05,-5478.29
3139551518650516992,2020-04,4283.89,2563.55,2479.28,2351.1,1848.52,-3629.77
3139551518650516992,2020-05,3976.94,7118.51,5733.54,2394.41,197.56,-3432.21
3139551518650516992,2020-06,6453.96,2985.94,1738.04,0,5206.06,1773.85
3139551518650516992,2020-07,937.3,3375.3,2725.35,1069.08,-781.73,992.12
3139551518650516992,2020-08,4119.88,5826.55,7385.84,4167.06,1512.11,2504.23
3139551518650516992,2020-09,1436.77,5663.96,5408.11,2610.66,-1429.74,1074.49
3139551518650516992,2020-10,5512.42,859.96,3792.02,7627.31,817.17,1891.66
3139551518650516992,2020-11,484.55,2456.09,1736.25,5063.04,-5298.33,-3406.67
3139551518650516992,2020-12,3226.57,1018.05,3623.36,5836.75,-4.87,-3411.54
3140238869192141312,2020-01,4708.61,3961.13,6019.71,4060.1,2707.09,2707.09
3140238869192141312,2020-02,4871.31,3766.66,3337.46,3900.34,541.77,3248.86
3140238869192141312,2020-03,9930.24,5286.86,4220.39,7772.71,1091.06,4339.92
3140238869192141312,2020-04,3371.15,7498.95,3375.29,8907.4,-9659.91,-5319.99
3140238869192141312,2020-05,3593.65,2095.52,2624.66,3260.21,862.58,-4457.41
3140238869192141312,2020-06,5774.12,2056.84,6508.14,3193.29,7032.13,2574.72
3140238869192141312,2020-07,9562.11,3468.38,6207.81,6120.27,6181.27,8755.99
3140238869192141312,2020-08,5664.19,5674.8,1397.4,9967.71,-8580.92,175.07
3140238869192141312,2020-09,5294.28,6171.31,7241.03,4521.05,1842.95,2018.02
3140238869192141312,2020-10,2620.74,4476.02,5965.33,9725.52,-5615.47,-3597.45
3140238869192141312,2020-11,4011.08,307.37,8999.41,6655.5,6047.62,2450.17
3140238869192141312,2020-12,7252.32,3748.78,1581.15,7026.39,-1941.7,508.47
3141209233845446144,2020-01,595.41,1301.54,2124.47,198.88,1219.46,1219.46
3141209233845446144,2020-02,1897.44,2121.64,0,1718.36,-1942.56,-723.1
3141209233845446144,2020-04,0,2798.31,0,2942.15,-5740.46,-6463.56
3141209233845446144,2020-06,0,432.63,83.67,490.32,-839.28,-7302.84
3141209233845446144,2020-07,4001.08,4088.46,0,3183.46,-3270.84,-10573.68
3141209233845446144,2020-08,1188.73,983.38,2154.28,839.61,1520.02,-9053.66
3141209233845446144,2020-09,0,842.99,2461.25,991.26,627,-8426.66
3141209233845446144,2020-10,865.85,0,1023.34,542.53,1346.66,-7080
3141209233845446144,2020-11,1200.47,3335.35,0,287.66,-2422.54,-9502.54
3142666801359146496,2020-01,1138.65,190.05,4007.75,1609.13,3347.22,3347.22
3142666801359146496,2020-02,2253.59,4772.56,3104.74,1002.28,-416.51,2930.71
3142666801359146496,2020-03,617.44,38.2,692.37,4231.81,-2960.2,-29.49
3142666801359146496,2020-04,775.36,696.26,1507.94,2270.39,-683.35,-712.84
3142666801359146496,2020-05,5432.49,536.15,1338.65,3342.57,2892.42,2179.58
3142666801359146496,2020-06,0,2552.17,1152.95,213.01,-1612.23,567.35
3142666801359146496,2020-07,3707.35,1974.63,5988.49,847.9,6873.31,7440.66
3142666801359146496,2020-08,2840.62,6097.67,575.99,2741.51,-5422.57,2018.09
3142666801359146496,2020-09,435.96,7232.84,501.41,512.84,-6808.31,-4790.22
3142666801359146496,2020-10,3536.06,2056.57,2723.78,3510.14,693.13,-4097.09
3142666801359146496,2020-11,1146.46,5009.54,3004.17,2752.44,-3611.35,-7708.44
3142666801359146496,2020-12,3673.7,2003.42,3435.15,5284.73,-179.3,-7887.74
3142685788866604032,2020-01,2481.18,5102.39,3509.88,3868.08,-2979.41,-2979.41
3142685788866604032,2020-02,3151.35,403.49,3692.65,0,6440.51,3461.1
3142685788866604032,2020-03,1409.1,528.45,1539.14,4012.59,-1592.8,1868.3
3142685788866604032,2020-04,4626.04,573.94,970.79,844.56,4178.33,6046.63
3142685788866604032,2020-05,1367.25,3214.56,1789.74,2650.78,-2708.35,3338.28
3142685788866604032,2020-06,1635.4,2676.28,481.69,1908.84,-2468.03,870.25
3142685788866604032,2020-07,2629.81,343.82,3608.06,5545.14,348.91,1219.16
3142685788866604032,2020-08,2241.63,2573.21,7109.2,1656.74,5120.88,6340.04
3142685788866604032,2020-09,1431.27,6638.47,6172.95,953.96,11.79,6351.83
3142685788866604032,2020-10,1878.52,2689.94,184.26,3083.93,-3711.09,2640.74
3142685788866604032,2020-11,2581.94,4627.12,1500.13,5942.87,-6487.92,-3847.18
3142685788866604032,2020-12,872.07,2693.11,1165.24,2156.07,-2811.87,-6659.05
3143182840760689664,2020-01,2219.2,947.01,0,0,1272.19,1272.19
3143182840760689664,2020-02,903.47,5125.69,2908.79,0,-1313.43,-41.24
3143182840760689664,2020-03,0,1577.73,168.5,1930.97,-3340.2,-3381.44
3143182840760689664,2020-04,0,585.69,1477.49,3200.3,-2308.5,-5689.94
3143182840760689664,2020-05,1092.91,888.31,2163.53,1299.82,1068.31,-4621.63
3143182840760689664,2020-06,2544,1325.53,0,1802.95,-584.48,-5206.11
3143182840760689664,2020-07,2875.99,3962.07,3070.26,1596.08,388.1,-4818.01
3143182840760689664,2020-08,1757.44,835.33,2887.31,899.82,2909.6,-1908.41
3143182840760689664,2020-09,1796.1,1486.82,1592.04,3394.34,-1493.02,-3401.43
3143182840760689664,2020-10,4232.52,2711.25,1676.35,5535.73,-2338.11,-5739.54
3143182840760689664,2020-11,2357.93,763.65,359.59,0,1953.87,-3785.67
3143182840760689664,2020-12,680.8,2691.76,1987.25,0,-23.71,-3809.38
3143255789074919936,2020-01,2607.45,2447.69,2237.33,5654.17,-3257.08,-3257.08
3143255789074919936,2020-02,2528.32,6368.97,4283.8,3628.48,-3185.33,-6442.41
3143255789074919936,2020-03,8911.47,5384.42,1202.77,5281.11,-551.29,-6993.7
3143255789074919936,2020-04,2577.51,2217.27,8429.44,5028.51,3761.17,-3232.53
3143255789074919936,2020-05,5043.34,3243.48,1546.86,5045.92,-1699.2,-4931.73
3143255789074919936,2020-06,1296.75,2324.56,7031.68,8146.14,-2142.27,-7074
3143255789074919936,2020-07,2112.73,2671.67,2397.59,5000.48,-3161.83,-10235.83
3143255789074919936,2020-08,2402.02,862.95,5406.1,13333.97,-6388.8,-16624.63
3143255789074919936,2020-09,4948.8,3918.8,292.41,4401.71,-3079.3,-19703.93
3143255789074919936,2020-10,2602.29,6683.81,6016.15,3145.39,-1210.76,-20914.69
3143255789074919936,2020-11,5817.13,5298.38,8093.02,3226.03,5385.74,-15528.95
3143255789074919936,2020-12,1202.72,7030.76,6616.06,8444.02,-7656,-23184.95
3145801783102814208,2020-01,5020.62,7296.15,3657.08,5692.9,-4311.35,-4311.35
3145801783102814208,2020-02,5362.56,10693.89,2519.82,1988.79,-4800.3,-9111.65
3145801783102814208,2020-03,3283.76,4205.97,3745.57,3788.41,-965.05,-10076.7
3145801783102814208,2020-04,9482.02,3535.28,8904.36,2023.93,12827.17,2750.47
3145801783102814208,2020-05,8940.22,823.43,5162.25,6158.63,7120.41,9870.88
3145801783102814208,2020-06,7074.05,4989.28,5722.38,5333.75,2473.4,12344.28
3145801783102814208,2020-07,6316.66,3331.96,1726.77,5432.9,-721.43,11622.85
3145801783102814208,2020-08,4856.52,2434.81,9323.27,3920.25,7824.73,19447.58
3145801783102814208,2020-09,2656.76,12171.15,3539.53,4835.28,-10810.14,8637.44
3145801783102814208,2020-10,5203.84,8465.18,6910.67,3097.54,551.79,9189.23
3145801783102814208,2020-11,4880.23,0,6507.31,4881.9,6505.64,15694.87
3145801783102814208,2020-12,4312.99,3187.61,5663.64,5018.12,1770.9,17465.77
3146023427299291136,2020-01,936.6,983.61,0,142.77,-189.78,-189.78
3146023427299291136,2020-02,973.12,2425.91,1383.55,2963.65,-3032.89,-3222.67
3146023427299291136,2020-03,1597.4,0,1369.65,1606.48,1360.57,-1862.1
3146023427299291136,2020-04,3264.13,1583.19,3295.78,0,4976.72,3114.62
3146023427299291136,2020-05,1301.79,1138.87,1840.06,1188.94,814.04,3928.66
3146023427299291136,2020-06,1448.94,0,0,540.84,908.1,4836.76
3146023427299291136,2020-07,1630.68,0,1183.58,0,2814.26,7651.02
3146023427299291136,2020-09,0,1405.31,0,2825.54,-4230.85,3420.17
3146023427299291136,2020-10,587.09,851.34,1281.72,0,1017.47,4437.64
3146023427299291136,2020-12,2237.96,973.38,0,837.46,427.12,4864.76
3146287274677212672,2020-05,0,378.74,0,1724.87,-2103.61,-2103.61
3146287274677212672,2020-06,0,792.86,1985.78,0,1192.92,-910.69
3146287274677212672,2020-08,2408.1,0,0,0,2408.1,1497.41
3146287274677212672,2020-09,0,1211.13,0,1472.41,-2683.54,-1186.13
3146287274677212672,2020-10,0,323.29,0,0,-323.29,-1509.42
3146287274677212672,2020-11,384.98,0,1840.74,0,2225.72,716.3
3146287274677212672,2020-12,277.67,156.88,282.37,1107.1,-703.94,12.36
3146300864060377088,2020-01,2021.43,1486.58,2605.54,782.67,2357.72,2357.72
3146300864060377088,2020-02,3672.82,3250.86,0,2179,-1757.04,600.68
3146300864060377088,2020-03,313.24,3006.91,4779.76,2218.82,-132.73,467.95
3146300864060377088,2020-04,4031.85,11055.87,6532.81,5659.76,-6150.97,-5683.02
3146300864060377088,2020-05,2160.02,3153.85,877.83,5919.67,-6035.67,-11718.69
3146300864060377088,2020-06,4874.51,3376.1,6636.56,6364.6,1770.37,-9948.32
3146300864060377088,2020-07,0,4263.01,1613.7,2766.01,-5415.32,-15363.64
3146300864060377088,2020-08,1819.04,815.26,3897.69,1314.71,3586.76,-11776.88
3146300864060377088,2020-09,8971.13,7000.91,2209.95,3800.48,379.69,-11397.19
3146300864060377088,2020-10,3658.16,3082.14,3823.32,1801.49,2597.85,-8799.34
3146300864060377088,2020-11,34.91,2797.71,555.48,962.1,-3169.42,-11968.76
3146300864060377088,2020-12,2474.72,1904.15,1058.72,7590.77,-5961.48,-17930.24
3146771717355690496,2020-01,0,3489.42,5486.35,2672.71,-675.78,-675.78
3146771717355690496,2020-02,3324.73,1807.83,6174.08,2232.65,5458.33,4782.55
3146771717355690496,2020-03,1963.08,835.18,66.25,4416.72,-3222.57,1559.98
3146771717355690496,2020-04,1871.23,6655.53,4283.95,1148.89,-1649.24,-89.26
3146771717355690496,2020-05,3211.22,3219.46,7061.44,5560.35,1492.85,1403.59
3146771717355690496,2020-06,1277.07,4917.8,7671,5082.45,-1052.18,351.41
3146771717355690496,2020-07,4491.7,3585.32,1256.87,4183.23,-2019.98,-1668.57
3146771717355690496,2020-08,3705.04,1630.56,452.38,5281.18,-2754.32,-4422.89
3146771717355690496,2020-09,3871.17,6688.27,0,0,-2817.1,-7239.99
3146771717355690496,2020-10,4562.26,1610.35,1551.02,2311.81,2191.12,-5048.87
3146771717355690496,2020-11,1851.74,3411.71,897.38,1252.16,-1914.75,-6963.62
3146771717355690496,2020-12,3127.31,5744.33,6373.08,2750.18,1005.88,-5957.74
3146883132951282688,2020-02,0,1266.67,0,0,-1266.67,-1266.67
3146883132951282688,2020-03,0,1258.31,0,0,-1258.31,-2524.98
3146883132951282688,2020-07,0,1890.53,0,0,-1890.53,-4415.51
3146883132951282688,2020-09,166.96,0,0,1335.63,-1168.67,-5584.18
3146883132951282688,2020-10,0,1124.87,0,0,-1124.87,-6709.05
3147870436158873088,2020-01,4.92,0,0,0,4.92,4.92
3147870436158873088,2020-02,326.58,0,3558.85,1782.12,2103.31,2108.23
3147870436158873088,2020-03,911.52,0,556.5,0,1468.02,3576.25
3147870436158873088,2020-04,1179.98,618.25,0,1847.83,-1286.1,2290.15
3147870436158873088,2020-05,858.58,0,1931.04,2447.14,342.48,2632.63
3147870436158873088,2020-06,0,4064.65,727.43,2222.06,-5559.28,-2926.65
3147870436158873088,2020-07,1781.41,0,2067.34,1643.48,2205.27,-721.38
3147870436158873088,2020-08,400.8,0,0,1805.61,-1404.81,-2126.19
3147870436158873088,2020-09,0,2272.11,1564.02,1063.17,-1771.26,-3897.45
3147870436158873088,2020-11,1883.81,0,0,0,1883.81,-2013.64
3147870436158873088,2020-12,0,400.93,1720.63,0,1319.7,-693.94
3149348296968408576,2020-01,2639.68,2440.1,2923.73,1960.2,1163.11,1163.11
3149348296968408576,2020-02,2466.56,5845.11,4087.73,4231.98,-3522.8,-2359.69
3149348296968408576,2020-03,791.14,1273.89,557.07,528.56,-454.24,-2813.93
3149348296968408576,2020-04,3199.86,2483.53,2115.64,2502.59,329.38,-2484.55
3149348296968408576,2020-05,4457.94,2444.58,1864.95,3901.99,-23.68,-2508.23
3149348296968408576,2020-06,3858.36,3805.73,2240.73,2514.37,-221.01,-2729.24
3149348296968408576,2020-07,5722.18,746.9,3420.53,2731.66,5664.15,2934.91
3149348296968408576,2020-08,4369.5,0,2952.24,1772.09,5549.65,8484.56
3149348296968408576,2020-09,4536.47,5482.61,2102.34,4865.65,-3709.45,4775.11
3149348296968408576,2020-10,1108.06,203.04,1461.24,4750.1,-2383.84,2391.27
3149348296968408576,2020-11,2784.68,2839.1,598.7,2244.72,-1700.44,690.83
3149348296968408576,2020-12,1817.98,150.32,1753.98,598.41,2823.23,3514.06
3154922902358575616,2020-01,2646.83,430.23,3466.48,2203.9,3479.18,3479.18
3154922902358575616,2020-02,718.65,2530.16,881.51,1777.74,-2707.74,771.44
3154922902358575616,2020-03,1232.58,689.25,108.78,4473.49,-3821.38,-3049.94
3154922902358575616,2020-04,779.03,3211.06,956.01,1263.72,-2739.74,-5789.68
3154922902358575616,2020-05,5836.39,2104.18,841.06,3504.68,1068.59,-4721.09
3154922902358575616,2020-06,1220.55,1025.66,0,0,194.89,-4526.2
3154922902358575616,2020-07,1794.69,1449.13,2656.8,1346.73,1655.63,-2870.57
3154922902358575616,2020-08,0,2638.29,378.86,3230.78,-5490.21,-8360.78
3154922902358575616,2020-09,521.91,2150.01,1760.65,401.83,-269.28,-8630.06
3154922902358575616,2020-10,1490.22,3834.97,1679.86,585.45,-1250.34,-9880.4
3154922902358575616,2020-11,893.78,1986.94,5303.7,0,4210.54,-5669.86
3155208734205492736,2020-01,36.5,1371.08,1492.38,3645.34,-3487.54,-3487.54
3155208734205492736,2020-02,0,595.75,0,0,-595.75,-4083.29
3155208734205492736,2020-03,223.17,1478.76,0,0,-1255.59,-5338.88
3155208734205492736,2020-04,614.61,0,376.47,4540.82,-3549.74,-8888.62
3155208734205492736,2020-05,1244.93,2468.98,1676.88,2090.82,-1637.99,-10526.61
3155208734205492736,2020-07,5896.94,0,919.84,1107.62,5709.16,-4817.45
3155208734205492736,2020-08,2885.12,1838.41,818.74,4668.67,-2803.22,-7620.67
3155208734205492736,2020-09,0,3413.97,4204.72,0,790.75,-6829.92
3155208734205492736,2020-11,116.12,1504.28,2739.41,2258.68,-907.43,-7737.35
3155208734205492736,2020-12,605.32,3529.47,1265.67,0,-1658.48,-9395.83
3157067976749419520,2020-01,2593.57,4676.26,1719.49,2175.64,-2538.84,-2538.84
3157067976749419520,2020-02,1177.29,3138.75,3109.07,7367.57,-6219.96,-8758.8
3157067976749419520,2020-03,6872.73,3486,7656.4,3175.72,7867.41,-891.39
3157067976749419520,2020-04,2380.26,1368.57,3931.1,3116.35,1826.44,935.05
3157067976749419520,2020-05,2361.13,5175.49,3017.76,2066.26,-1862.86,-927.81
3157067976749419520,2020-06,1892.95,5555.05,6548,922.05,1963.85,1036.04
3157067976749419520,2020-07,3079.79,6106.52,4965.79,5396.78,-3457.72,-2421.68
3157067976749419520,2020-08,228.65,3098.61,1685.94,254.93,-1438.95,-3860.63
3157067976749419520,2020-09,4026.82,6265.64,4009.11,1350.65,419.64,-3440.99
3157067976749419520,2020-10,7115.67,5777.84,5348.48,0,6686.31,3245.32
3157067976749419520,2020-11,2679.82,1127.08,3370.29,4669.56,253.47,3498.79
3157067976749419520,2020-12,5035.2,7427.03,2297.48,1854.53,-1948.88,1549.91
3158395114767297024,2020-01,4057.96,3739.91,3386.8,2724,980.85,980.85
3158395114767297024,2020-02,3837.63,1746.59,8048.55,1650.46,8489.13,9469.98
3158395114767297024,2020-03,285.47,3786.57,3399.32,2381.97,-2483.75,6986.23
3158395114767297024,2020-04,2444.46,342.5,2242.13,495.97,3848.12,10834.35
3158395114767297024,2020-05,926.02,5071.13,1932.75,0,-2212.36,8621.99
3158395114767297024,2020-06,5782.79,5123.73,2632.94,4894.31,-1602.31,7019.68
3158395114767297024,2020-07,7761.21,3880.64,2132.59,3087.11,2926.05,9945.73
3158395114767297024,2020-08,1328.52,951.83,5300.44,4999.28,677.85,10623.58
3158395114767297024,2020-09,9509.52,2607.18,2133.12,2825.63,6209.83,16833.41
3158395114767297024,2020-10,1683.76,2025.76,3103.28,822.62,1938.66,18772.07
3158395114767297024,2020-11,1607.42,7989.11,3748.77,0,-2632.92,16139.15
3158395114767297024,2020-12,5013.26,3250.3,2204.19,6869.31,-2902.16,13236.99
3159338463382784512,2020-01,4021.45,6114.57,5069.57,3943.09,-966.64,-966.64
3159338463382784512,2020-02,923.4,2412.21,2069.57,2094.09,-1513.33,-2479.97
3159338463382784512,2020-03,1925.82,2120.76,4385.38,1737.45,2452.99,-26.98
3159338463382784512,2020-04,1182.94,1897.16,1785.16,2326.43,-1255.49,-1282.47
3159338463382784512,2020-05,3925.69,8579.4,6560.33,2006.5,-99.88,-1382.35
3159338463382784512,2020-06,6346.18,4973.41,3175.56,5063.59,-515.26,-1897.61
3159338463382784512,2020-07,7161.04,4084.96,4140.44,5600.48,1616.04,-281.57
3159338463382784512,2020-08,2187.41,5064.68,10589.73,2939.3,4773.16,4491.59
3159338463382784512,2020-09,3519.1,9710.48,3398.15,2581.4,-5374.63,-883.04
3159338463382784512,2020-10,4664.12,2319.24,7145.4,2186.3,7303.98,6420.94
3159338463382784512,2020-11,3813.53,9328.33,1956.19,3891.63,-7450.24,-1029.3
3159338463382784512,2020-12,3278.84,4652.79,5503.8,5114.26,-984.41,-2013.71
3159474655966194176,2020-01,5108.08,5818.73,5164.85,4892.15,-437.95,-437.95
3159474655966194176,2020-02,0,7308.76,2635.65,2421.03,-7094.14,-7532.09
3159474655966194176,2020-03,1756.35,2734.09,4860.83,4692.03,-808.94,-8341.03
3159474655966194176,2020-04,5137.83,4689.22,5630.73,3305.62,2773.72,-5567.31
3159474655966194176,2020-05,3714.35,4144.62,3970.6,3539.9,0.43,-5566.88
3159474655966194176,2020-06,8509.51,7637.19,6434.38,3331.39,3975.31,-1591.57
3159474655966194176,2020-07,1869.31,6627.98,3250.76,7585.36,-9093.27,-10684.84
3159474655966194176,2020-08,5004.24,7405.37,11039.08,5121.11,3516.84,-7168
3159474655966194176,2020-09,5330.55,3386,963.52,771.46,2136.61,-5031.39
3159474655966194176,2020-10,2673.79,3456.78,1120.51,4187.42,-3849.9,-8881.29
3159474655966194176,2020-11,4852.6,2347.96,1358.08,2813.68,1049.04,-7832.25
3159474655966194176,2020-12,1249.9,5470.25,5581.71,3252.87,-1891.51,-9723.76
3160315776493030912,2020-01,2143.22,0,922.42,0,3065.64,3065.64
3160315776493030912,2020-02,690.27,776.75,2036.61,5031.09,-3080.96,-15.32
3160315776493030912,2020-03,626.39,4627.87,1821.55,1783.89,-3963.82,-3979.14
3160315776493030912,2020-04,1106.5,0,970.39,1319.92,756.97,-3222.17
3160315776493030912,2020-05,4651.96,523.7,1934.43,2638.85,3423.84,201.67
3160315776493030912,2020-06,903.46,1936.19,1234.37,2929.55,-2727.91,-2526.24
3160315776493030912,2020-07,3400.95,528.19,2473.53,1503.08,3843.21,1316.97
3160315776493030912,2020-08,5351.49,0,0,2797.66,2553.83,3870.8
3160315776493030912,2020-09,1298.11,0,5316.04,638.97,5975.18,9845.98
3160315776493030912,2020-10,2906.61,2944.42,5750.61,1812.68,3900.12,13746.1
3160315776493030912,2020-11,2043.27,1796.09,0,1709.21,-1462.03,12284.07
3160315776493030912,2020-12,631.89,62.84,4640.58,0,5209.63,17493.7
3160601603224729088,2020-01,703.38,3725.15,4550.62,4058.65,-2529.8,-2529.8
3160601603224729088,2020-02,4829.12,1857.89,1367.43,3881.16,457.5,-2072.3
3160601603224729088,2020-03,1297.59,0,3499.01,5047.28,-250.68,-2322.98
3160601603224729088,2020-04,3426.7,0,5102.84,4298.07,4231.47,1908.49
3160601603224729088,2020-05,1428.49,3246.25,3410.63,1502.82,90.05,1998.54
3160601603224729088,2020-06,3713.36,4691.14,239.54,2642.66,-3380.9,-1382.36
3160601603224729088,2020-07,3149.33,697.73,2776.01,1768.77,3458.84,2076.48
3160601603224729088,2020-08,6171.12,3745,2278.72,6252.01,-1547.17,529.31
3160601603224729088,2020-09,989.99,2887.62,5283.35,1118.11,2267.61,2796.92
3160601603224729088,2020-10,781.97,996.84,855.34,0,640.47,3437.39
3160601603224729088,2020-11,3516.33,4845.6,2930.85,1587.45,14.13,3451.52
3160601603224729088,2020-12,2035.24,0,723.88,1861.94,897.18,4348.7
3163427855849648128,2020-01,4609.13,3493.59,9104.88,4332.88,5887.54,5887.54
3163427855849648128,2020-02,3032.24,2834.1,2136.07,6207.6,-3873.39,2014.15
3163427855849648128,2020-03,3962.73,5042.12,3902.61,4592.92,-1769.7,244.45
3163427855849648128,2020-04,3746.63,2808.57,2849.33,4484.75,-697.36,-452.91
3163427855849648128,2020-05,2646.27,4282.51,2571.16,2056.4,-1121.48,-1574.39
3163427855849648128,2020-06,7244.1,2832.84,2863.61,7347.07,-72.2,-1646.59
3163427855849648128,2020-07,1244.94,5900.65,690.95,1190.87,-5155.63,-6802.22
3163427855849648128,2020-08,3082.02,5512.07,4171.88,3351.01,-1609.18,-8411.4
3163427855849648128,2020-09,1446.81,1793.63,2336.25,10218.9,-8229.47,-16640.87
3163427855849648128,2020-10,2343.61,4547.53,2209.52,4134.43,-4128.83,-20769.7
3163427855849648128,2020-11,3098.16,1418.96,769.99,1547.21,901.98,-19867.72
3163427855849648128,2020-12,1546.46,2037.56,2069.62,1219.48,359.04,-19508.68
3163864930091141632,2020-01,5654.4,6587.89,2419.82,3118.91,-1632.58,-1632.58
3163864930091141632,2020-02,2479.41,64.15,5201.99,3444.77,4172.48,2539.9
3163864930091141632,2020-03,5459.33,2118.49,2952.83,4165.38,2128.29,4668.19
3163864930091141632,2020-04,2638.79,2032.5,6167.39,1236.05,5537.63,10205.82
3163864930091141632,2020-05,2857.88,851.4,2726.91,3098.67,1634.72,11840.54
3163864930091141632,2020-06,354.97,4041.55,1067.8,5290.28,-7909.06,3931.48
3163864930091141632,2020-07,6408.57,2321.24,2298.4,2794.75,3590.98,7522.46
3163864930091141632,2020-08,5588.9,2115.19,1512.5,3779.16,1207.05,8729.51
3163864930091141632,2020-09,5882.03,13379.53,3839.87,811.05,-4468.68,4260.83
3163864930091141632,2020-10,5385.87,2526.84,1666.96,7506.29,-2980.3,1280.53
3163864930091141632,2020-11,8421.94,6421.31,7067.28,944.77,8123.14,9403.67
3163864930091141632,2020-12,2345.37,1590.26,3752.63,5433.56,-925.82,8477.85
3166969871959571968,2020-01,3935.3,1699.13,3839.53,3161.73,2913.97,2913.97
3166969871959571968,2020-02,2946.17,843.63,4559.12,5026.18,1635.48,4549.45
3166969871959571968,2020-03,3066.07,4700.5,5121.87,1658.57,1828.87,6378.32
3166969871959571968,2020-04,7962.22,2251.92,5036.68,6671.2,4075.78,10454.1
3166969871959571968,2020-05,4113.99,9042.63,2891.91,6272.51,-8309.24,2144.86
3166969871959571968,2020-06,4286.96,3009.1,1547.93,4541.05,-1715.26,429.6
3166969871959571968,2020-07,5936.11,10550.17,2647.87,3500.28,-5466.47,-5036.87
3166969871959571968,2020-08,5465.81,3835.5,971.92,7161.41,-4559.18,-9596.05
3166969871959571968,2020-09,4018.22,4250.45,2696.29,2472.02,-7.96,-9604.01
3166969871959571968,2020-10,3853.05,1635.93,4484.38,1892.35,4809.15,-4794.86
3166969871959571968,2020-11,3171.01,3696.27,4918.65,1173.09,3220.3,-1574.56
3166969871959571968,2020-12,6009.33,4295.06,2408.19,6017.71,-1895.25,-3469.81
3168784297610952192,2020-01,648.99,877.59,2944.86,4987.08,-2270.82,-2270.82
3168784297610952192,2020-02,5848.14,2572.09,3332.42,2157.08,4451.39,2180.57
3168784297610952192,2020-03,856.98,0,5719.43,2824.15,3752.26,5932.83
3168784297610952192,2020-04,242.89,4722.31,4678.99,1758.63,-1559.06,4373.77
3168784297610952192,2020-05,1314.99,2730.78,4129.56,4272.85,-1559.08,2814.69
3168784297610952192,2020-06,6144.54,4751.99,1043.27,4352.68,-1916.86,897.83
3168784297610952192,2020-07,368.83,3036.85,996.55,6444.03,-8115.5,-7217.67
3168784297610952192,2020-08,4689.39,5732.82,3648.58,3337.14,-731.99,-7949.66
3168784297610952192,2020-09,7403.65,5514.22,2616.72,5246.51,-740.36,-8690.02
3168784297610952192,2020-10,3738.91,4493.21,3241.21,7190.28,-4703.37,-13393.39
3168784297610952192,2020-11,1173.76,5330.5,1519.7,2945.53,-5582.57,-18975.96
3168784297610952192,2020-12,11237.7,4483.22,6109.7,616.04,12248.14,-6727.82
3169944930978841088,2020-01,4645.52,1667.86,4348.19,4655.2,2670.65,2670.65
3169944930978841088,2020-02,2066.87,2539.57,1714.63,2502.21,-1260.28,1410.37
3169944930978841088,2020-03,6876.45,7497.49,3238.17,1668.14,948.99,2359.36
3169944930978841088,2020-04,6670.2,3681.97,1887.67,5401.61,-525.71,1833.65
3169944930978841088,2020-05,4799.96,2635.15,5415.58,10475.43,-2895.04,-1061.39
3169944930978841088,2020-06,6297.77,4429.38,5225.67,754.34,6339.72,5278.33
3169944930978841088,2020-07,4548.79,4884.68,3617.48,6828.6,-3547.01,1731.32
3169944930978841088,2020-08,9370.04,11642.77,1018.71,1599.19,-2853.21,-1121.89
3169944930978841088,2020-09,2001.54,4245.19,3217.8,2756.5,-1782.35,-2904.24
3169944930978841088,2020-10,5195.35,6074.82,7168.33,4581.28,1707.58,-1196.66
3169944930978841088,2020-11,7617.05,6038.35,3985.34,2391.41,3172.63,1975.97
3169944930978841088,2020-12,3777.12,3443.29,6637.49,2173.08,4798.24,6774.21
3170411922402295808,2020-01,0,1071.29,0,0,-1071.29,-1071.29
3170411922402295808,2020-04,0,1039.83,67.19,562.79,-1535.43,-2606.72
3170411922402295808,2020-07,697.85,0,0,0,697.85,-1908.87
3170411922402295808,2020-09,1027.34,0,0,0,1027.34,-881.53
3170411922402295808,2020-11,0,1009.1,0,0,-1009.1,-1890.63
3170411922402295808,2020-12,421.13,0,0,0,421.13,-1469.5
3171310520564571136,2020-01,0,1779.26,0,0,-1779.26,-1779.26
3171906424658827776,2020-01,2112.43,1293.26,4688.09,4331.05,1176.21,1176.21
3171906424658827776,2020-02,1018,1808.06,3554.93,1403.21,1361.66,2537.87
3171906424658827776,2020-03,0,3754.95,1956.05,1600.02,-3398.92,-861.05
3171906424658827776,2020-04,1829.3,1866.88,1509.19,0,1471.61,610.56
3171906424658827776,2020-05,2554.39,2499.57,2834.05,313.4,2575.47,3186.03
3171906424658827776,2020-06,0,2602.42,3393.5,4075.24,-3284.16,-98.13
3171906424658827776,2020-07,1572.24,8435.22,0,1981.59,-8844.57,-8942.7
3171906424658827776,2020-08,3099.99,6478.81,1786.15,4692.48,-6285.15,-15227.85
3171906424658827776,2020-09,6015.7,0,1419.99,1967.2,5468.49,-9759.36
3171906424658827776,2020-10,4464.27,909.88,1669.03,2376.21,2847.21,-6912.15
3171906424658827776,2020-11,1289.83,6217.53,1318.92,433.11,-4041.89,-10954.04
3171906424658827776,2020-12,1035.94,2388.16,0,3317.48,-4669.7,-15623.74
3171925753644344832,2020-01,1014.26,2090.19,0,8399.34,-9475.27,-9475.27
3171925753644344832,2020-02,1158.69,387.02,724.52,134.94,1361.25,-8114.02
3171925753644344832,2020-03,1338.73,1989.73,1532.13,2403.67,-1522.54,-9636.56
3171925753644344832,2020-04,0,94.03,3325.92,0,3231.89,-6404.67
3171925753644344832,2020-05,3192.25,0,1072.04,1569.07,2695.22,-3709.45
3171925753644344832,2020-06,1560.44,0,1832.55,1971.04,1421.95,-2287.5
3171925753644344832,2020-07,1340.28,0,2264.54,2915.24,689.58,-1597.92
3171925753644344832,2020-08,3704.63,0,2572.45,0,6277.08,4679.16
3171925753644344832,2020-09,3311.41,1401.4,4332.95,329.5,5913.46,10592.62
3171925753644344832,2020-10,1050.91,830.29,947.01,1127.78,39.85,10632.47
3171925753644344832,2020-11,2010.06,527.81,3845.33,989.01,4338.57,14971.04
3171925753644344832,2020-12,1842.19,3287.32,1164.65,4912.94,-5193.42,9777.62
3174347158450688000,2020-02,1497.22,1878.59,0,0,-381.37,-381.37
3174347158450688000,2020-03,0,514.14,0,471.9,-986.04,-1367.41
3174347158450688000,2020-04,0,2640.34,0,0,-2640.34,-4007.75
3174347158450688000,2020-06,264.08,0,0,0,264.08,-3743.67
3174347158450688000,2020-08,0,2287.43,0,0,-2287.43,-6031.1
3174347158450688000,2020-09,729.14,0,0,1256.02,-526.88,-6557.98
3174347158450688000,2020-12,1169.52,1000.71,0,0,168.81,-6389.17
3174871936796012544,2020-01,3000.19,96.28,327.12,2278.42,952.61,952.61
3174871936796012544,2020-02,1635.02,2998.9,1110.43,1533.52,-1786.97,-834.36
3174871936796012544,2020-04,0,3336.16,0,997.28,-4333.44,-5167.8
3174871936796012544,2020-05,2385.85,0,87.66,438.97,2034.54,-3133.26
3174871936796012544,2020-07,0,3144.13,1272.39,1861.91,-3733.65,-6866.91
3174871936796012544,2020-08,0,1198.96,845.45,1879.77,-2233.28,-9100.19
3174871936796012544,2020-09,2280.53,0,0,656.49,1624.04,-7476.15
3174871936796012544,2020-10,0,2623.16,0,1920.33,-4543.49,-12019.64
3174871936796012544,2020-11,0,1650.81,1691.08,1163.84,-1123.57,-13143.21
3174871936796012544,2020-12,0,1193.6,613.01,1879.73,-2460.32,-15603.53
3175625331376461824,2020-01,0,2413.8,0,3856.2,-6270,-6270
3175625331376461824,2020-02,7301.07,3277.41,1166.74,4163.12,1027.28,-5242.72
3175625331376461824,2020-03,5759.46,3026.33,3674.93,1637.93,4770.13,-472.59
3175625331376461824,2020-04,627.33,1345.44,3568.07,4501.56,-1651.6,-2124.19
3175625331376461824,2020-05,6042.83,5544.8,3722.13,2034.48,2185.68,61.49
3175625331376461824,2020-06,3028.54,4644.97,2363.07,2779.74,-2033.1,-1971.61
3175625331376461824,2020-07,663.04,3717.39,2930.02,1767.18,-1891.51,-3863.12
3175625331376461824,2020-08,4769.35,3230.81,7486.29,4363.11,4661.72,798.6
3175625331376461824,2020-09,869.14,6864.83,2519.67,0,-3476.02,-2677.42
3175625331376461824,2020-10,2504.97,7523.93,1958.11,2663.65,-5724.5,-8401.92
3175625331376461824,2020-11,7437.04,3332.43,3220.81,424.32,6901.1,-1500.82
3175625331376461824,2020-12,1997.35,5254.13,1403.2,1312.9,-3166.48,-4667.3
3176212238342512640,2020-01,0,1758.71,5366.34,1863.29,1744.34,1744.34
3176212238342512640,2020-02,2220.76,3748.36,1505.15,3759.74,-3782.19,-2037.85
3176212238342512640,2020-03,1399.28,249.21,1096.02,1530.09,716,-1321.85
3176212238342512640,2020-04,3262.31,2552.3,3454.32,228.65,3935.68,2613.83
3176212238342512640,2020-05,2048.3,293.82,907.24,4666.64,-2004.92,608.91
3176212238342512640,2020-06,3134.72,1073.21,3329.28,2057.2,3333.59,3942.5
3176212238342512640,2020-07,0,950.33,0,0,-950.33,2992.17
3176212238342512640,2020-08,2185.45,2454.88,0,3735.61,-4005.04,-1012.87
3176212238342512640,2020-09,3195.85,2451.7,2895.04,4387.12,-747.93,-1760.8
3176212238342512640,2020-10,4785.27,2577.6,4674.25,1720.74,5161.18,3400.38
3176212238342512640,2020-11,1629.82,1880.14,0,2260.79,-2511.11,889.27
3176212238342512640,2020-12,518.12,3562.65,1192.92,183.97,-2035.58,-1146.31
3176743513856808448,2020-01,521.84,5113.93,1114,2497.6,-5975.69,-5975.69
3176743513856808448,2020-02,5268.47,281.98,1728.6,0,6715.09,739.4
3176743513856808448,2020-03,0,3608.29,1216.84,0,-2391.45,-1652.05
3176743513856808448,2020-04,2920.92,1762.37,3651.61,2510.02,2300.14,648.09
3176743513856808448,2020-05,0,3459.38,0,1463.73,-4923.11,-4275.02
3176743513856808448,2020-06,2417.23,2099.82,1204.73,0,1522.14,-2752.88
3176743513856808448,2020-07,93.96,696.43,0,3241.7,-3844.17,-6597.05
3176743513856808448,2020-08,0,1979.55,0,0,-1979.55,-8576.6
3176743513856808448,2020-09,1753.55,3085.54,4910.56,1118.59,2459.98,-6116.62
3176743513856808448,2020-11,4004.91,90.19,2716.48,2202.92,4428.28,-1688.34
3176743513856808448,2020-12,468.24,4343.61,1070.78,780.03,-3584.62,-5272.96
3176800176088513536,2020-01,1967.23,1170.53,0,1630.79,-834.09,-834.09
3176800176088513536,2020-02,2661.44,1795.29,1677.05,551.73,1991.47,1157.38
3176800176088513536,2020-03,4067.37,368.84,2955.16,1703.81,4949.88,6107.26
3176800176088513536,2020-04,874.71,1976.14,0,3297.06,-4398.49,1708.77
3176800176088513536,2020-05,2125.8,1894.69,0,5342.67,-5111.56,-3402.79
3176800176088513536,2020-06,1861.28,1527.21,1663.05,856.43,1140.69,-2262.1
3176800176088513536,2020-07,3621.18,1092.34,3654.51,3811.56,2371.79,109.69
3176800176088513536,2020-08,1518.3,0,2272.64,2185.42,1605.52,1715.21
3176800176088513536,2020-09,2174.96,242.45,4293.69,499.8,5726.4,7441.61
3176800176088513536,2020-10,464.97,332.25,0,1985.15,-1852.43,5589.18
3176800176088513536,2020-11,803.87,667,1825.3,1256.29,705.88,6295.06
3176800176088513536,2020-12,3134.4,1112.43,1042.4,1121.64,1942.73,8237.79
3177190074948503552,2020-01,3461.99,1777.47,3003.42,4231.17,456.77,456.77
3177190074948503552,2020-02,1610.99,1951.21,6576.27,0,6236.05,6692.82
3177190074948503552,2020-03,645.75,0,1818.62,5582.14,-3117.77,3575.05
3177190074948503552,2020-04,3590.11,3667.25,2649.5,554.75,2017.61,5592.66
3177190074948503552,2020-05,3473.39,1218.82,3397.18,3323.6,2328.15,7920.81
3177190074948503552,2020-06,2890.24,3730.37,1705.82,3045.02,-2179.33,5741.48
3177190074948503552,2020-07,3684.65,1230.81,7640.6,2056.92,8037.52,13779
3177190074948503552,2020-08,2706.98,78.22,3366.33,2803.54,3191.55,16970.55
3177190074948503552,2020-09,2923.94,1498.34,4116.02,1468.92,4072.7,21043.25
3177190074948503552,2020-10,3519.89,1499.27,1283.02,2545.06,758.58,21801.83
3177190074948503552,2020-11,1489.55,7306.01,2443.65,2905.81,-6278.62,15523.21
3177190074948503552,2020-12,1392.76,2176.54,1077.12,3266.6,-2973.26,12549.95
3177384749083373056,2020-01,1264.32,0,0,0,1264.32,1264.32
3177384749083373056,2020-05,0,1709.32,1028.01,680.47,-1361.78,-97.46
3177384749083373056,2020-11,0,1548.77,3804.73,1836.74,419.22,321.76
3177384749083373056,2020-12,0,1600.81,0,0,-1600.81,-1279.05
3178196455241484800,2020-01,2242.9,3384.63,4435.3,3052.63,240.94,240.94
3178196455241484800,2020-02,1377.39,2402.55,4906.96,1690.2,2191.6,2432.54
3178196455241484800,2020-03,1934.6,2594.49,1116.33,2091.92,-1635.48,797.06
3178196455241484800,2020-04,3751,2987.38,1271.72,3654.92,-1619.58,-822.52
3178196455241484800,2020-05,1116.62,1696.18,3085.69,2039.18,466.95,-355.57
3178196455241484800,2020-06,1485.99,1593.16,2592.21,1376.46,1108.58,753.01
3178196455241484800,2020-07,869.13,1922.61,1044.78,2848.84,-2857.54,-2104.53
3178196455241484800,2020-08,1586.59,1054.12,1657.14,0,2189.61,85.08
3178196455241484800,2020-09,536.21,683.75,1825.01,49.17,1628.3,1713.38
3178196455241484800,2020-10,3999.74,2064.46,2787.17,3126.11,1596.34,3309.72
3178196455241484800,2020-11,5692.31,4930.9,903.57,916.92,748.06,4057.78
3178196455241484800,2020-12,0,185.2,1021.11,2591.19,-1755.28,2302.5
3178297828601955328,2020-01,9441.99,7354.59,4865.14,6296.69,655.85,655.85
3178297828601955328,2020-02,5219.61,5429.07,3200.78,9882.82,-6891.5,-6235.65
3178297828601955328,2020-03,5234.92,2146.46,6503.07,5937.79,3653.74,-2581.91
3178297828601955328,2020-04,6094.84,5225.4,4746.09,549.45,5066.08,2484.17
3178297828601955328,2020-05,6326.21,6810.23,1906.46,5797.18,-4374.74,-1890.57
3178297828601955328,2020-06,12169.47,2819.48,9629.74,2997.87,15981.86,14091.29
3178297828601955328,2020-07,5784.53,9287.41,6469.81,3688.01,-721.08,13370.21
3178297828601955328,2020-08,7678.98,1647.65,2526.71,5060.31,3497.73,16867.94
3178297828601955328,2020-09,4801.26,3560.82,4822.5,7626.97,-1564.03,15303.91
3178297828601955328,2020-10,1946.11,5664.26,4710.23,4242.85,-3250.77,12053.14
3178297828601955328,2020-11,4087.41,3151.68,5120.36,7789.55,-1733.46,10319.68
3178297828601955328,2020-12,4701.05,2767.57,1420.66,5405.18,-2051.04,8268.64
3178847024647215104,2020-01,0,2520.97,621.79,4587.96,-6487.14,-6487.14
3178847024647215104,2020-02,4267.12,3819.4,200.57,6606.33,-5958.04,-12445.18
3178847024647215104,2020-03,1310.59,2158.69,517.8,225.65,-555.95,-13001.13
3178847024647215104,2020-04,1966.51,355.12,3189.87,1316.72,3484.54,-9516.59
3178847024647215104,2020-05,1994.6,1898.65,654.83,3010.19,-2259.41,-11776
3178847024647215104,2020-06,2322.45,198.34,1891.69,0,4015.8,-7760.2
3178847024647215104,2020-07,1627,893.74,4122.81,1130.97,3725.1,-4035.1
3178847024647215104,2020-08,1691.36,0,3425.36,1710.32,3406.4,-628.7
3178847024647215104,2020-09,1669.03,1864.82,1344.13,1216.45,-68.11,-696.81
3178847024647215104,2020-10,641.77,17.11,1995.26,1529.13,1090.79,393.98
3178847024647215104,2020-11,522.18,3328.6,1976.92,1474.68,-2304.18,-1910.2
3178847024647215104,2020-12,0,2932.56,86.32,3552.02,-6398.26,-8308.46
3179025504497334784,2020-01,1198.47,0,1461.39,3695.67,-1035.81,-1035.81
3179025504497334784,2020-02,0,1340.13,1485.65,4480.67,-4335.15,-5370.96
3179025504497334784,2020-03,1493.75,1664.79,6100.66,1897.14,4032.48,-1338.48
3179025504497334784,2020-04,726.56,1749.38,3360.22,3127.45,-790.05,-2128.53
3179025504497334784,2020-05,1037.71,2985.19,2270.38,2138.84,-1815.94,-3944.47
3179025504497334784,2020-06,1374.04,1728.67,3419.07,2312.36,752.08,-3192.39
3179025504497334784,2020-07,1729.16,1369.52,579.23,0,938.87,-2253.52
3179025504497334784,2020-08,4804.4,1388.91,885.32,708.35,3592.46,1338.94
3179025504497334784,2020-09,2825.08,1096.61,1123.98,477.26,2375.19,3714.13
3179025504497334784,2020-10,986.02,289.3,1744.2,3352.23,-911.31,2802.82
3179025504497334784,2020-11,1966.6,1461.45,1164.13,1810.49,-141.21,2661.61
3179025504497334784,2020-12,3596.12,9.08,1557.24,0,5144.28,7805.89
3180536185832688128,2020-03,1656.13,1097.07,0,0,559.06,559.06
3180536185832688128,2020-04,0,1418.74,0,1615.25,-3033.99,-2474.93
3180536185832688128,2020-06,1507.85,0,0,0,1507.85,-967.08
3180536185832688128,2020-08,1054.32,0,0,2991.22,-1936.9,-2903.98
3180536185832688128,2020-10,1842.95,0,2358.75,1603.36,2598.34,-305.64
3180536185832688128,2020-11,830.49,1390.74,0,0,-560.25,-865.89
3180536185832688128,2020-12,307.47,0,0,0,307.47,-558.42
3181001466314554880,2020-01,4340.19,4947.11,5569.18,4793.43,168.83,168.83
3181001466314554880,2020-02,1314.08,2072.21,4506.48,7833.33,-4084.98,-3916.15
3181001466314554880,2020-03,7390.87,1840.62,2938.94,6683.68,1805.51,-2110.64
3181001466314554880,2020-04,5725.43,1587.38,1480.89,1762.11,3856.83,1746.19
3181001466314554880,2020-05,5069.61,2123.88,6371.42,4097.08,5220.07,6966.26
3181001466314554880,2020-06,3357.23,5095.23,5359.27,3720.85,-99.58,6866.68
3181001466314554880,2020-07,7775.22,6994.17,6173.17,4354.53,2599.69,9466.37
3181001466314554880,2020-08,2468.57,8728.03,6248.89,3584.38,-3594.95,5871.42
3181001466314554880,2020-09,10521.6,8260.26,3892.48,2342.64,3811.18,9682.6
3181001466314554880,2020-10,7385.12,6166.68,6105.46,7338.26,-14.36,9668.24
3181001466314554880,2020-11,1087.85,10934.46,2141.64,4235.03,-11940,-2271.76
3181001466314554880,2020-12,2352.54,7669.83,5894.42,5669.99,-5092.86,-7364.62
3183023179417100288,2020-01,0,1948.64,433.61,0,-1515.03,-1515.03
3183023179417100288,2020-02,843.47,2121.47,0,0,-1278,-2793.03
3183023179417100288,2020-04,690.67,0,0,0,690.67,-2102.36
3183023179417100288,2020-06,1237.97,1495.86,0,0,-257.89,-2360.25
3183023179417100288,2020-07,0,1505.01,0,0,-1505.01,-3865.26
3183023179417100288,2020-08,277.07,247.81,0,0,29.26,-3836
3183023179417100288,2020-09,0,1573.74,1487.6,1329.63,-1415.77,-5251.77
3183023179417100288,2020-10,1611.19,0,0,0,1611.19,-3640.58
3183023179417100288,2020-12,872.93,2778.09,0,0,-1905.16,-5545.74
3183044580187478528,2020-01,1464.11,1153.47,3054.62,2445.72,919.54,919.54
3183044580187478528,2020-02,8494.02,5549.39,1909.23,418.16,4435.7,5355.24
3183044580187478528,2020-03,5362.05,2726.88,4333.51,2333.07,4635.61,9990.85
3183044580187478528,2020-04,3831.11,3798.62,13843.38,4082.13,9793.74,19784.59
3183044580187478528,2020-05,4662.13,0,3075.73,3172.12,4565.74,24350.33
3183044580187478528,2020-06,1266.02,8101.43,5589.87,2533.12,-3778.66,20571.67
3183044580187478528,2020-07,5721.7,6740.3,4320.51,3778.94,-477.03,20094.64
3183044580187478528,2020-08,3508.94,6308.16,7197.38,3703.82,694.34,20788.98
3183044580187478528,2020-09,3437.33,4287.02,4134,2315.51,968.8,21757.78
3183044580187478528,2020-10,1645.53,4337.5,288.49,3282.49,-5685.97,16071.81
3183044580187478528,2020-11,2151.71,229.96,4022.27,5335.23,608.79,16680.6
3183044580187478528,2020-12,5769.4,1857.02,5970.95,2392.77,7490.56,24171.16
3183618135810421760,2020-01,6174.42,321.49,1540.62,6196.06,1197.49,1197.49
3183618135810421760,2020-02,423.47,2252.87,2348.58,3151.47,-2632.29,-1434.8
3183618135810421760,2020-03,559.06,3468.47,2021.48,2146.4,-3034.33,-4469.13
3183618135810421760,2020-04,563.32,4156.36,3727.83,4512.55,-4377.76,-8846.89
3183618135810421760,2020-05,3248.61,2426.84,2786.47,7496.17,-3887.93,-12734.82
3183618135810421760,2020-06,6668.08,919.84,2980.86,1476.32,7252.78,-5482.04
3183618135810421760,2020-07,1533.86,2907.93,4699.91,1432.59,1893.25,-3588.79
3183618135810421760,2020-08,2382.87,2959.3,4658.74,0,4082.31,493.52
3183618135810421760,2020-09,3657.54,4804.84,4689.17,4506.1,-964.23,-470.71
3183618135810421760,2020-10,2294.11,1159.3,338.35,8864.02,-7390.86,-7861.57
3183618135810421760,2020-11,0,3049.43,8136.86,3427.94,1659.49,-6202.08
3183618135810421760,2020-12,1169.86,1910.93,5879.13,400.08,4737.98,-1464.1
3184840330508505600,2020-01,2883.45,1994.7,4976.89,2704.9,3160.74,3160.74
3184840330508505600,2020-02,3824.96,4058.56,1207.59,2501.1,-1527.11,1633.63
3184840330508505600,2020-03,2868.57,5689.27,4198.01,4177.47,-2800.16,-1166.53
3184840330508505600,2020-04,1330.21,4224.39,1243.12,3943.79,-5594.85,-6761.38
3184840330508505600,2020-05,4354.76,2567.72,1051.73,0,2838.77,-3922.61
3184840330508505600,2020-06,2490.63,2752.89,2539.85,2367.31,-89.72,-4012.33
3184840330508505600,2020-07,3500.92,1681.96,3102.46,3203.09,1718.33,-2294
3184840330508505600,2020-08,3262.33,1911.71,2583.64,2353.36,1580.9,-713.1
3184840330508505600,2020-09,3224.51,4097.12,0,4767.37,-5639.98,-6353.08
3184840330508505600,2020-10,4141.12,4808.68,2064.94,1070.34,327.04,-6026.04
3184840330508505600,2020-12,3361.23,94.45,3703,1476.83,5492.95,-533.09
3185395637586934784,2020-12,0,1706.88,0,0,-1706.88,-1706.88
3186327800008138240,2020-01,2888.53,1686.63,3030.32,2467.78,1764.44,1764.44
3186327800008138240,2020-02,6610.11,6551.27,365.08,754.08,-330.16,1434.28
3186327800008138240,2020-03,0,1704.85,5605.81,3130.96,770,2204.28
3186327800008138240,2020-04,2938.29,937.73,7871.18,3970.65,5901.09,8105.37
3186327800008138240,2020-05,3093.78,0,841.53,2713.35,1221.96,9327.33
3186327800008138240,2020-06,2162.5,2225.24,992.13,3087.5,-2158.11,7169.22
3186327800008138240,2020-07,1512.54,2953.18,3863.17,2079.02,343.51,7512.73
3186327800008138240,2020-08,4424.05,1173.52,2487.81,4642.85,1095.49,8608.22
3186327800008138240,2020-09,4571.34,0,1995.17,0,6566.51,15174.73
3186327800008138240,2020-10,3282.58,5532.5,3193.72,926.28,17.52,15192.25
3186327800008138240,2020-11,7498.19,275.36,4936.89,100.69,12059.03,27251.28
3186327800008138240,2020-12,2826.52,4469.15,2320.7,4476.41,-3798.34,23452.94
3190952988136160256,2020-01,1137.85,4496.08,4504.84,3206.01,-2059.4,-2059.4
3190952988136160256,2020-02,0,6013.89,4313.13,2079.2,-3779.96,-5839.36
3190952988136160256,2020-03,436.45,223.57,602.83,3535.66,-2719.95,-8559.31
3190952988136160256,2020-04,539.32,1640.89,831.21,922.05,-1192.41,-9751.72
3190952988136160256,2020-05,3126.39,1570.3,151.92,4328.06,-2620.05,-12371.77
3190952988136160256,2020-06,1938.88,4747.5,0,986.19,-3794.81,-16166.58
3190952988136160256,2020-07,1393.76,1989.02,2620.37,313.2,1711.91,-14454.67
3190952988136160256,2020-08,0,1201.94,189.97,2810.33,-3822.3,-18276.97
3190952988136160256,2020-09,972.03,745.77,6170.66,1888.88,4508.04,-13768.93
3190952988136160256,2020-10,3632.31,0,2395.02,2428.61,3598.72,-10170.21
3190952988136160256,2020-11,61.95,0,3386.95,2688.07,760.83,-9409.38
3190952988136160256,2020-12,3688.33,2003.93,3800.84,2797.34,2687.9,-6721.48
3191588088253289984,2020-01,5916.79,6342.3,5951.36,3178.73,2347.12,2347.12
3191588088253289984,2020-02,6777,2642.06,2499.39,5737.38,896.95,3244.07
3191588088253289984,2020-03,2680.21,4141.68,4173.41,8752.67,-6040.73,-2796.66
3191588088253289984,2020-04,4049.02,3041.57,1996.62,3803.76,-799.69,-3596.35
3191588088253289984,2020-05,4685.06,1962.64,2808.2,2074.3,3456.32,-140.03
3191588088253289984,2020-06,3924.5,3584.35,2196.87,1491.23,1045.79,905.76
3191588088253289984,2020-07,5195.34,6359.21,4376.07,1879.67,1332.53,2238.29
3191588088253289984,2020-08,1073.77,8873.23,4489.97,6377.11,-9686.6,-7448.31
3191588088253289984,2020-09,898.26,2001.72,3355.12,5323.71,-3072.05,-10520.36
3191588088253289984,2020-10,1193.68,4729.75,7860.47,687.49,3636.91,-6883.45
3191588088253289984,2020-11,4690.56,4516.25,3710.88,6709.47,-2824.28,-9707.73
3191588088253289984,2020-12,4205.18,4178.8,3955.82,980.13,3002.07,-6705.66
3192238570480731136,2020-04,1394.1,0,0,0,1394.1,1394.1
3192238570480731136,2020-05,1307.01,0,0,89.79,1217.22,2611.32
3192238570480731136,2020-10,570.37,55.66,0,0,514.71,3126.03
3192238570480731136,2020-11,1402.54,615.52,0,0,787.02,3913.05
3192238570480731136,2020-12,0,1477.82,0,0,-1477.82,2435.23
3192289455836059136,2020-01,0,1048.26,265.87,2382.86,-3165.25,-3165.25
3192289455836059136,2020-02,4126.44,105.3,868.78,1173.47,3716.45,551.2
3192289455836059136,2020-03,572.13,0,3355.69,2401.1,1526.72,2077.92
3192289455836059136,2020-04,705.2,1861.65,829.01,2154.97,-2482.41,-404.49
3192289455836059136,2020-05,1518.42,0,890.1,114.95,2293.57,1889.08
3192289455836059136,2020-06,2347.02,3400.9,6400.77,1625.17,3721.72,5610.8
3192289455836059136,2020-07,1741.69,3935.13,0,6319.61,-8513.05,-2902.25
3192289455836059136,2020-08,3177.72,804.77,182.13,2718.91,-163.83,-3066.08
3192289455836059136,2020-09,0,6773.22,1899.52,797.96,-5671.66,-8737.74
3192289455836059136,2020-10,2298.98,0,1856.21,3108.76,1046.43,-7691.31
3192289455836059136,2020-11,45.1,1925.75,0,480.42,-2361.07,-10052.38
3192289455836059136,2020-12,471.32,710.65,6044.8,0,5805.47,-4246.91
3192350969728391168,2020-01,6141.42,3856.28,924.26,3700.85,-491.45,-491.45
3192350969728391168,2020-02,412.27,1387.69,4170.97,4488.11,-1292.56,-1784.01
3192350969728391168,2020-03,2900.67,2606.54,3377.84,622.18,3049.79,1265.78
3192350969728391168,2020-04,687.91,0,1740.43,517.08,1911.26,3177.04
3192350969728391168,2020-05,1141.67,342.69,5937.38,1883.96,4852.4,8029.44
3192350969728391168,2020-06,4776.73,3819.81,6813.76,2018.04,5752.64,13782.08
3192350969728391168,2020-07,2737.92,0,4936.05,1538.8,6135.17,19917.25
3192350969728391168,2020-08,1627.09,4295.52,3001.17,0,332.74,20249.99
3192350969728391168,2020-09,0,2461.75,4445.65,2334.19,-350.29,19899.7
3192350969728391168,2020-10,2875.15,866.43,1732.68,3603.12,138.28,20037.98
3192350969728391168,2020-11,2175.94,1808.86,1775.09,0,2142.17,22180.15
3192350969728391168,2020-12,1145.22,2603.76,510.22,3627.89,-4576.21,17603.94
3192448919187724288,2020-01,2521.14,3736.46,4386.73,1159.88,2011.53,2011.53
3192448919187724288,2020-02,2055.03,1814.93,5539.17,4672.58,1106.69,3118.22
3192448919187724288,2020-03,4618.98,2223.52,567.11,3114.05,-151.48,2966.74
3192448919187724288,2020-04,1813.44,3798.25,4379.53,6643.79,-4249.07,-1282.33
3192448919187724288,2020-05,637.91,2016.29,2165.34,6067.79,-5280.83,-6563.16
3192448919187724288,2020-06,6456.01,3133.75,4870.73,4817.3,3375.69,-3187.47
3192448919187724288,2020-07,2335.56,4133.27,11326.73,5410.93,4118.09,930.62
3192448919187724288,2020-08,787.98,2427.9,3056.46,1202.51,214.03,1144.65
3192448919187724288,2020-09,4121.42,6941.41,5157.25,2386.89,-49.63,1095.02
3192448919187724288,2020-10,4222.81,6472.88,1948.65,3196.56,-3497.98,-2402.96
3192448919187724288,2020-11,2306.9,5027.22,1112.71,6224.58,-7832.19,-10235.15
3192448919187724288,2020-12,3526.7,5919.34,3165.27,0,772.63,-9462.52
3192798944711251456,2020-01,1183.06,2719.65,3162.56,1950.07,-324.1,-324.1
3192798944711251456,2020-02,1448.38,3769.79,1893.67,4136.59,-4564.33,-4888.43
3192798944711251456,2020-03,1635.66,0,1733.1,1125.02,2243.74,-2644.69
3192798944711251456,2020-04,334.58,2324.05,4771.74,369.73,2412.54,-232.15
3192798944711251456,2020-05,3262.38,1072.34,4272.14,1631.61,4830.57,4598.42
3192798944711251456,2020-06,2078.86,4029.31,1997.92,4107.01,-4059.54,538.88
3192798944711251456,2020-07,1604.78,1443.05,1043.53,2062.79,-857.53,-318.65
3192798944711251456,2020-08,2717.1,6460.15,0,222.39,-3965.44,-4284.09
3192798944711251456,2020-09,1533.33,0,271.72,2825.78,-1020.73,-5304.82
3192798944711251456,2020-10,1998.41,1455.19,1603.38,3914.68,-1768.08,-7072.9
3192798944711251456,2020-11,516.12,2097.42,3002.62,2925.7,-1504.38,-8577.28
3192798944711251456,2020-12,5124.2,823.93,4467.88,1612.95,7155.2,-1422.08
3193116507918286336,2020-01,2680.32,0,1589.66,1073.41,3196.57,3196.57
3193116507918286336,2020-02,2637.88,250.9,302.64,717.34,1972.28,5168.85
3193116507918286336,2020-03,4106.93,127.95,1534.77,3990.48,1523.27,6692.12
3193116507918286336,2020-04,3266.01,1860.12,2699.59,1517.53,2587.95,9280.07
3193116507918286336,2020-05,3228.84,3917.12,7826.98,2376.03,4762.67,14042.74
3193116507918286336,2020-06,5374.61,2948.26,3420.13,575.02,5271.46,19314.2
3193116507918286336,2020-07,1219.22,1584.25,3080.2,383.45,2331.72,21645.92
3193116507918286336,2020-08,3173.91,969.59,1482.65,1042.79,2644.18,24290.1
3193116507918286336,2020-09,2009.7,2110.24,1075.55,2479.64,-1504.63,22785.47
3193116507918286336,2020-10,4947.01,0,1625.57,199.82,6372.76,29158.23
3193116507918286336,2020-11,1514.77,2588.51,4476.39,2396.31,1006.34,30164.57
3193116507918286336,2020-12,810.59,1446.67,9398.17,2200.83,6561.26,36725.83
3193550870194018816,2020-01,3798.29,2668.65,2685.45,941.41,2873.68,2873.68
3193550870194018816,2020-02,1751.12,2233.01,1930.81,3789.45,-2340.53,533.15
3193550870194018816,2020-03,2225.55,2893.25,6124.46,0,5456.76,5989.91
3193550870194018816,2020-04,4542.26,1803.87,3318.83,2798.93,3258.29,9248.2
3193550870194018816,2020-05,1479.61,5824.08,5090.31,2326.03,-1580.19,7668.01
3193550870194018816,2020-06,1668.63,431.37,6593.02,2902.09,4928.19,12596.2
3193550870194018816,2020-07,6019.05,3919.69,1838.26,2984.56,953.06,13549.26
3193550870194018816,2020-08,847.21,1635.19,4089.76,2671.84,629.94,14179.2
3193550870194018816,2020-09,2586.38,2089.25,3113.81,5484.15,-1873.21,12305.99
3193550870194018816,2020-10,2655.5,3561.12,7484.94,1717.47,4861.85,17167.84
3193550870194018816,2020-11,3397.03,6016.94,1777.95,2402.85,-3244.81,13923.03
3193550870194018816,2020-12,306.6,2981.19,4368.16,731.89,961.68,14884.71
3194180351284699648,2020-01,4503.46,3195.07,7063.19,4731.02,3640.56,3640.56
3194180351284699648,2020-02,3194.72,3700.94,4971.02,4982.56,-517.76,3122.8
3194180351284699648,2020-03,1840.23,5870.52,4377.23,4269.91,-3922.97,-800.17
3194180351284699648,2020-04,1901.95,10227,5020.89,14924.88,-18229.04,-19029.21
3194180351284699648,2020-05,2867.09,5572.27,4385.3,3161.88,-1481.76,-20510.97
3194180351284699648,2020-06,5350.47,6735.23,4261.22,3503.4,-626.94,-21137.91
3194180351284699648,2020-07,1841.03,6505.96,6939.94,2687.25,-412.24,-21550.15
3194180351284699648,2020-08,1744.02,6865.85,3804.42,8418.8,-9736.21,-31286.36
3194180351284699648,2020-09,0,2016.81,2066.72,5741.57,-5691.66,-36978.02
3194180351284699648,2020-10,2013.56,7265.35,5063.5,1756.07,-1944.36,-38922.38
3194180351284699648,2020-11,4005.48,6731.96,814.73,5481.26,-7393.01,-46315.39
3194180351284699648,2020-12,4643.75,5000.99,2500.7,1691.58,451.88,-45863.51
3195762307814375936,2020-01,3442.72,3262.75,1256.29,2519.1,-1082.84,-1082.84
3195762307814375936,2020-02,1912.06,2865.51,0,4555,-5508.45,-6591.29
3195762307814375936,2020-03,1061.89,0,0,0,1061.89,-5529.4
3195762307814375936,2020-04,3221.97,0,1705.45,2602.67,2324.75,-3204.65
3195762307814375936,2020-05,5329.98,2576.43,0,1022.09,1731.46,-1473.19
3195762307814375936,2020-06,4063.43,1605.63,766.01,2236.36,987.45,-485.74
3195762307814375936,2020-07,2869.95,3945.93,1156.18,2751.91,-2671.71,-3157.45
3195762307814375936,2020-08,1317.7,769.28,6010.86,979.96,5579.32,2421.87
3195762307814375936,2020-09,3241.11,0,1860.76,0,5101.87,7523.74
3195762307814375936,2020-10,2313.27,0,3957.01,525.79,5744.49,13268.23
3195762307814375936,2020-11,380.34,0,1301.86,2770.28,-1088.08,12180.15
3195762307814375936,2020-12,446.8,737.29,1677.24,1050.05,336.7,12516.85
3198710661471134208,2020-02,3511.5,1499.05,2495.49,286.58,4221.36,4221.36
3198710661471134208,2020-04,3674.37,2283.36,3173.87,172.33,4392.55,8613.91
3198710661471134208,2020-05,4055.95,0,4894.18,0,8950.13,17564.04
3198710661471134208,2020-07,6187.83,453.7,946.81,1134.37,5546.57,23110.61
3198710661471134208,2020-08,1004.53,3250.5,4200.29,3526.95,-1572.63,21537.98
3198710661471134208,2020-09,3481.12,0,2396.94,431.73,5446.33,26984.31
3198710661471134208,2020-10,1058.41,4003.09,0,0,-2944.68,24039.63
3198710661471134208,2020-11,3737.89,0,2792.73,210.88,6319.74,30359.37
3198820889210742784,2020-01,2204.66,1516.87,2647.88,556.16,2779.51,2779.51
3198820889210742784,2020-02,436.11,358.43,0,1220.89,-1143.21,1636.3
3198820889210742784,2020-03,1826.2,5079.76,2819.56,0,-434,1202.3
3198820889210742784,2020-04,0,553.96,491.44,982.06,-1044.58,157.72
3198820889210742784,2020-05,1587.78,1463.66,1882.26,3913.96,-1907.58,-1749.86
3198820889210742784,2020-06,1467.86,1406.06,1639.7,0,1701.5,-48.36
3198820889210742784,2020-07,359.57,576.45,1626.49,1728.19,-318.58,-366.94
3198820889210742784,2020-08,190.33,0,1636.9,2504.06,-676.83,-1043.77
3198820889210742784,2020-09,210.5,883.09,2667.64,2137.2,-142.15,-1185.92
3198820889210742784,2020-10,1290.46,1055.18,2272.79,0,2508.07,1322.15
3198820889210742784,2020-12,3503.56,1812.06,2684.19,405.08,3970.61,5292.76
3200666400098404864,2020-01,399.92,0,0,0,399.92,399.92
3200666400098404864,2020-03,774.55,0,0,1933.27,-1158.72,-758.8
3200666400098404864,2020-05,1882.96,0,0,6.8,1876.16,1117.36
3200666400098404864,2020-08,1200.49,0,0,0,1200.49,2317.85
3200666400098404864,2020-09,0,1869.14,0,0,-1869.14,448.71
3200666400098404864,2020-12,608.05,175.92,3049.22,2319.62,1161.73,1610.44
3201009078241628672,2020-01,1718.34,3683.63,1933.61,0,-31.68,-31.68
3201009078241628672,2020-02,2539.05,6106.33,1464.85,1729.18,-3831.61,-3863.29
3201009078241628672,2020-03,920.72,4627.41,4592.6,1432.87,-546.96,-4410.25
3201009078241628672,2020-04,5776.27,1943.8,3188.85,3197.42,3823.9,-586.35
3201009078241628672,2020-05,1146.32,1829.18,5699.64,1556.64,3460.14,2873.79
3201009078241628672,2020-06,300.4,3960.64,5844.52,841.26,1343.02,4216.81
3201009078241628672,2020-07,2976.63,1469.36,525.11,1770.46,261.92,4478.73
3201009078241628672,2020-08,633.98,3147.95,0,1638.76,-4152.73,326
3201009078241628672,2020-09,3485.51,1790.6,7354.87,2331.98,6717.8,7043.8
3201009078241628672,2020-10,1061.81,1041.65,3835.48,0,3855.64,10899.44
3201009078241628672,2020-11,1909.77,212.3,1451.67,743.15,2405.99,13305.43
3201009078241628672,2020-12,2524.22,3742.08,1720.08,6052.34,-5550.12,7755.31
3201559925147969536,2020-01,977.15,2756.76,4341.52,1166.42,1395.49,1395.49
3201559925147969536,2020-02,722.12,1199.49,3527.8,3870.38,-819.95,575.54
3201559925147969536,2020-03,346.55,2792.35,539.68,4373.46,-6279.58,-5704.04
3201559925147969536,2020-04,0,1240.21,1053.25,162.38,-349.34,-6053.38
3201559925147969536,2020-05,1159.35,4466.7,83.93,1708.08,-4931.5,-10984.88
3201559925147969536,2020-06,6548.95,2397.16,2519.42,2366.81,4304.4,-6680.48
3201559925147969536,2020-07,1949.64,3089.38,3002.35,312.04,1550.57,-5129.91
3201559925147969536,2020-08,6778.3,0,31.29,1118.33,5691.26,561.35
3201559925147969536,2020-09,1729.88,3478.48,0,1855.68,-3604.28,-3042.93
3201559925147969536,2020-10,2467.2,5100.48,182.5,677.56,-3128.34,-6171.27
3201559925147969536,2020-11,3798.45,1394.46,1079.24,1512.67,1970.56,-4200.71
3201559925147969536,2020-12,4202.12,0,3042.38,885.18,6359.32,2158.61
3201760463155440128,2020-01,8946.03,5688.44,3315,6569.04,3.55,3.55
3201760463155440128,2020-02,4569.62,6439.55,5214.28,3860.84,-516.49,-512.94
3201760463155440128,2020-03,4489.3,2428.74,10863.73,10185.1,2739.19,2226.25
3201760463155440128,2020-04,5072.14,2160.03,0,362.13,2549.98,4776.23
3201760463155440128,2020-05,4203.74,6777.66,418.03,5971.49,-8127.38,-3351.15
3201760463155440128,2020-06,4560.73,6892.39,8294.96,9773.54,-3810.24,-7161.39
3201760463155440128,2020-07,2985.25,2492.18,6115.69,9585.33,-2976.57,-10137.96
3201760463155440128,2020-08,1644.48,2543.63,4993.75,7049.56,-2954.96,-13092.92
3201760463155440128,2020-09,3919.96,5642.58,5391.71,5173.48,-1504.39,-14597.31
3201760463155440128,2020-10,2981.87,3135.81,3005.65,9527.95,-6676.24,-21273.55
3201760463155440128,2020-11,6752.14,1955.24,7887.02,6997.33,5686.59,-15586.96
3201760463155440128,2020-12,2728.42,918.15,4523.82,8365.41,-2031.32,-17618.28
3202369809911361536,2020-01,2385.86,4154.04,5340.05,1932.65,1639.22,1639.22
3202369809911361536,2020-02,178.5,2786.21,2390.3,1502.85,-1720.26,-81.04
3202369809911361536,2020-03,2573.02,5788.98,3950.79,8124.86,-7390.03,-7471.07
3202369809911361536,2020-04,2385.63,223.48,4643.57,2019.59,4786.13,-2684.94
3202369809911361536,2020-05,658.58,1558.58,1847.97,0,947.97,-1736.97
3202369809911361536,2020-06,2828.55,5472.03,3676.71,1977.81,-944.58,-2681.55
3202369809911361536,2020-07,4420.5,1483.83,0,4998.39,-2061.72,-4743.27
3202369809911361536,2020-08,4081.17,3048.76,736.27,1074.55,694.13,-4049.14
3202369809911361536,2020-09,824.95,2888.95,6784.71,1795.64,2925.07,-1124.07
3202369809911361536,2020-10,3574.32,5118.43,7025.5,0,5481.39,4357.32
3202369809911361536,2020-11,3443.37,5943.71,2255.96,677.08,-921.46,3435.86
3202369809911361536,2020-12,3140.4,0,6863.09,3806.17,6197.32,9633.18
3202511382873569280,2020-01,4420.64,1369.85,2549.64,7329.4,-1728.97,-1728.97
3202511382873569280,2020-02,1079.01,2234.21,1148.95,3342.46,-3348.71,-5077.68
3202511382873569280,2020-03,1093.18,2121.7,5170.28,757.22,3384.54,-1693.14
3202511382873569280,2020-04,1783.91,1681.02,1731.05,2622.01,-788.07,-2481.21
3202511382873569280,2020-05,3340.1,3723.21,3201.6,267.82,2550.67,69.46
3202511382873569280,2020-06,8144.14,3221.11,654.1,854.53,4722.6,4792.06
3202511382873569280,2020-07,5543.58,0,257.15,5806.86,-6.13,4785.93
3202511382873569280,2020-08,5395.69,1739.13,4326.86,5934.84,2048.58,6834.51
3202511382873569280,2020-09,1701.35,4145.54,2335.11,375.96,-485.04,6349.47
3202511382873569280,2020-10,2835.74,1869.26,3302.03,3783.4,485.11,6834.58
3202511382873569280,2020-11,4180.99,3179.96,3401.57,2970.66,1431.94,8266.52
3202511382873569280,2020-12,2330.24,5846.36,2079.02,673.47,-2110.57,6155.95
3203996261236057600,2020-06,1670.41,1071.31,0,0,599.1,599.1
3203996261236057600,2020-09,1013.1,0,1559.5,0,2572.6,3171.7
3204470508833047552,2020-01,1525.02,2436.64,2638.64,1964.34,-237.32,-237.32
3204470508833047552,2020-02,0,210.4,0,1204.69,-1415.09,-1652.41
3204470508833047552,2020-03,1558.89,5012.11,1308.45,50.45,-2195.22,-3847.63
3204470508833047552,2020-04,2637.31,3689.79,920.11,483.28,-615.65,-4463.28
3204470508833047552,2020-05,0,3279.52,2397.51,160.15,-1042.16,-5505.44
3204470508833047552,2020-06,796.75,2637.12,0,371.63,-2212,-7717.44
3204470508833047552,2020-07,830.21,1836.11,956.2,1047.88,-1097.58,-8815.02
3204470508833047552,2020-08,0,3756.93,1618.33,1995.69,-4134.29,-12949.31
3204470508833047552,2020-09,1630.07,5056.15,0,1616,-5042.08,-17991.39
3204470508833047552,2020-10,3208.43,4900.85,1371.23,981.83,-1303.02,-19294.41
3204470508833047552,2020-11,2157.23,830.66,7002.59,1240.57,7088.59,-12205.82
3204470508833047552,2020-12,2579.31,2012.95,0,505.54,60.82,-12145
3204563854226022912,2020-01,13.17,2715.49,6482.86,2499.95,1280.59,1280.59
3204563854226022912,2020-02,1962.66,1776.36,1083.36,1855.38,-585.72,694.87
3204563854226022912,2020-03,0,4082.94,397.38,2483.88,-6169.44,-5474.57
3204563854226022912,2020-04,6763.25,2695.62,0,4208.45,-140.82,-5615.39
3204563854226022912,2020-05,0,2253.22,1129.41,0,-1123.81,-6739.2
3204563854226022912,2020-06,560.14,4173.39,5040.5,750,677.25,-6061.95
3204563854226022912,2020-07,4446.15,925.4,3778.52,6201.64,1097.63,-4964.32
3204563854226022912,2020-08,2340.56,5207.57,2943.35,898.77,-822.43,-5786.75
3204563854226022912,2020-09,1891.77,1363.1,6883.16,1890.65,5521.18,-265.57
3204563854226022912,2020-10,3508.74,5101.13,0,2494.62,-4087.01,-4352.58
3204563854226022912,2020-11,1294.41,923.69,3328.38,992.77,2706.33,-1646.25
3204563854226022912,2020-12,756.66,2050.95,3765.41,1855.5,615.62,-1030.63
3204739158866399232,2020-01,4763.13,1527.76,1684.11,1920.62,2998.86,2998.86
3204739158866399232,2020-02,0,1915.13,839.99,96.63,-1171.77,1827.09
3204739158866399232,2020-03,2379.15,3895.85,2541.08,1616.68,-592.3,1234.79
3204739158866399232,2020-04,1266.18,0,2277.87,1316.34,2227.71,3462.5
3204739158866399232,2020-05,3864.38,3034.93,1841.47,2743.28,-72.36,3390.14
3204739158866399232,2020-06,3100.95,0,0,974.31,2126.64,5516.78
3204739158866399232,2020-07,418.57,1770.33,2024.49,687.93,-15.2,5501.58
3204739158866399232,2020-08,2057.1,4759.4,4811.38,2127.52,-18.44,5483.14
3204739158866399232,2020-09,1172.24,1422.43,4905.32,0,4655.13,10138.27
3204739158866399232,2020-10,1009.41,4260.92,0,4504.99,-7756.5,2381.77
3204739158866399232,2020-11,3160.22,2110.08,0,0,1050.14,3431.91
3204739158866399232,2020-12,2548.52,1947.19,1208.33,2550.02,-740.36,2691.55
3207401696386642432,2020-01,5440.81,8137.19,8548.05,3076.46,2775.21,2775.21
3207401696386642432,2020-02,4451.36,1859.22,2892.27,3563.44,1920.97,4696.18
3207401696386642432,2020-03,2808,4032.75,8698.02,4647.83,2825.44,7521.62
3207401696386642432,2020-04,4614.79,3539.68,4705.79,5315.87,465.03,7986.65
3207401696386642432,2020-05,2836.73,4117.45,4978.63,4067.54,-369.63,7617.02
3207401696386642432,2020-06,4679.39,8392.88,1555.59,1523.5,-3681.4,3935.62
3207401696386642432,2020-07,3756.96,7856.73,630.61,2045.79,-5514.95,-1579.33
3207401696386642432,2020-08,8083.83,8723.29,2584.72,3888.65,-1943.39,-3522.72
3207401696386642432,2020-09,3110.46,5523.58,3733.64,4198.04,-2877.52,-6400.24
3207401696386642432,2020-10,0,4036.61,5925.2,1943.31,-54.72,-6454.96
3207401696386642432,2020-11,4854.61,5721.6,3197.65,4355.75,-2025.09,-8480.05
3207401696386642432,2020-12,1901.34,1246.66,5166.61,2157.68,3663.61,-4816.44
3209590874655921152,2020-03,1738.19,0,0,0,1738.19,1738.19
3209590874655921152,2020-06,1079.89,0,0,0,1079.89,2818.08
3209590874655921152,2020-07,1758.53,0,0,0,1758.53,4576.61
3209932517401678336,2020-01,130.48,4401.34,1681.62,2697.65,-5286.89,-5286.89
3209932517401678336,2020-02,4673.16,2311.69,360.44,2455.13,266.78,-5020.11
3209932517401678336,2020-03,148.35,1238.02,2432.78,599.8,743.31,-4276.8
3209932517401678336,2020-04,2856.76,2975.98,4988.64,2834.1,2035.32,-2241.48
3209932517401678336,2020-05,1380.54,5314.56,1283.44,0,-2650.58,-4892.06
3209932517401678336,2020-06,2875.44,416.99,1200.44,2520,1138.89,-3753.17
3209932517401678336,2020-07,1441.6,1680.37,1136.33,3015.61,-2118.05,-5871.22
3209932517401678336,2020-08,4373.72,39.29,144.62,4766.81,-287.76,-6158.98
3209932517401678336,2020-09,1883.53,1726.11,2528.61,1229.52,1456.51,-4702.47
3209932517401678336,2020-10,3159.3,5076.51,274.21,1203.21,-2846.21,-7548.68
3209932517401678336,2020-11,2841.68,3001.41,4051.76,1627.49,2264.54,-5284.14
3209932517401678336,2020-12,803.68,1408.23,2876.83,3475.81,-1203.53,-6487.67
3210959319459246592,2020-01,1411.78,0,76.79,589.96,898.61,898.61
3210959319459246592,2020-02,184.61,3073.08,0,2751.39,-5639.86,-4741.25
3210959319459246592,2020-03,0,1689.59,1066.98,0,-622.61,-5363.86
3210959319459246592,2020-04,1424.27,1743.77,0,878.19,-1197.69,-6561.55
3210959319459246592,2020-05,1418.84,567.89,977.07,1990.28,-162.26,-6723.81
3210959319459246592,2020-06,687.82,1927.61,1681.14,4586.81,-4145.46,-10869.27
3210959319459246592,2020-07,1565.94,0,959.65,1751.5,774.09,-10095.18
3210959319459246592,2020-08,0,1091.85,2505.51,0,1413.66,-8681.52
3210959319459246592,2020-09,1161.18,0,0,0,1161.18,-7520.34
3210959319459246592,2020-10,3546.1,3159.25,1816.55,1541.43,661.97,-6858.37
3210959319459246592,2020-11,0,1428.5,1923.99,1088.12,-592.63,-7451
3210959319459246592,2020-12,1177.68,513.97,411.59,1791.95,-716.65,-8167.65
3211221895214389248,2020-01,1995.73,9729.92,4073.83,1486.27,-5146.63,-5146.63
3211221895214389248,2020-02,4118.86,5951.33,2702.26,7425.86,-6556.07,-11702.7
3211221895214389248,2020-03,4498.11,3146.5,2847.53,1018.65,3180.49,-8522.21
3211221895214389248,2020-04,2018.33,5494.39,2643.61,2521.8,-3354.25,-11876.46
3211221895214389248,2020-05,1919.97,3238.55,1712.46,6948.6,-6554.72,-18431.18
3211221895214389248,2020-06,2819.88,6084.28,1299.75,2851.75,-4816.4,-23247.58
3211221895214389248,2020-07,1010.83,1247.75,3889.62,3895.75,-243.05,-23490.63
3211221895214389248,2020-08,3674.16,1799.58,6760.35,2823.53,5811.4,-17679.23
3211221895214389248,2020-09,2967,1533.46,2405.15,5004.56,-1165.87,-18845.1
3211221895214389248,2020-10,3127.61,8118.27,4236.04,3182.11,-3936.73,-22781.83
3211221895214389248,2020-11,1368.17,0,0,8153.09,-6784.92,-29566.75
3211221895214389248,2020-12,4198.15,5712.71,3390.34,1590.94,284.84,-29281.91
3213344683094946816,2020-01,398.85,2027.03,1515.06,5252.66,-5365.78,-5365.78
3213344683094946816,2020-02,891.73,4473.68,0,2588.73,-6170.68,-11536.46
3213344683094946816,2020-03,2056.53,4079.6,1345.66,3349.86,-4027.27,-15563.73
3213344683094946816,2020-04,4323.11,2567.72,5215.48,3655.9,3314.97,-12248.76
3213344683094946816,2020-05,1640.66,3055.04,1600.86,116.68,69.8,-12178.96
3213344683094946816,2020-06,763.85,2299.44,4770.8,2477.08,758.13,-11420.83
3213344683094946816,2020-07,1302.79,1509.35,126.9,2786.06,-2865.72,-14286.55
3213344683094946816,2020-08,125.33,754.92,69.73,4940.13,-5499.99,-19786.54
3213344683094946816,2020-09,2836.84,3390.25,5739.79,0,5186.38,-14600.16
3213344683094946816,2020-10,4356.14,1767.66,3634.31,1903.84,4318.95,-10281.21
3213344683094946816,2020-11,5869.82,7009.61,7123.22,4976.03,1007.4,-9273.81
3213344683094946816,2020-12,416.62,0,1737.32,1348.64,805.3,-8468.51
3213548704746831872,2020-01,3215.24,3522.28,3321.91,4745.72,-1730.85,-1730.85
3213548704746831872,2020-02,0,2883.3,0,866.98,-3750.28,-5481.13
3213548704746831872,2020-03,1508.19,3588.19,3747.36,1822.36,-155,-5636.13
3213548704746831872,2020-04,1373.02,1734.31,0,8233.66,-8594.95,-14231.08
3213548704746831872,2020-05,2780.02,0,988.32,442.77,3325.57,-10905.51
3213548704746831872,2020-06,2386.59,2845.62,1604.45,1682.6,-537.18,-11442.69
3213548704746831872,2020-07,2693.19,2590.67,1152.68,1843.69,-588.49,-12031.18
3213548704746831872,2020-08,6170.21,1041.27,4325.17,1179.66,8274.45,-3756.73
3213548704746831872,2020-09,3264.87,522.42,2116.4,3826.04,1032.81,-2723.92
3213548704746831872,2020-10,2514.15,5867.07,1803.25,1918.17,-3467.84,-6191.76
3213548704746831872,2020-11,2035.35,4318.04,1282.96,2673.2,-3672.93,-9864.69
3213548704746831872,2020-12,1873.5,939.41,2244.48,2481.97,696.6,-9168.09
3213678331568075264,2020-02,0,1319.57,0,1223.9,-2543.47,-2543.47
3213678331568075264,2020-03,578.58,0,0,0,578.58,-1964.89
3213678331568075264,2020-04,1866.55,0,0,0,1866.55,-98.34
3213678331568075264,2020-05,0,343.57,0,1054.26,-1397.83,-1496.17
3213678331568075264,2020-10,736.43,1273.8,0,0,-537.37,-2033.54
3213678331568075264,2020-12,644.84,1156.94,0,0,-512.1,-2545.64
3213866885274016768,2020-01,4358.37,610.05,3827.74,5463.35,2112.71,2112.71
3213866885274016768,2020-02,0,4328.75,2661.88,5091.02,-6757.89,-4645.18
3213866885274016768,2020-03,3609.56,3012.83,2829.51,2940.18,486.06,-4159.12
3213866885274016768,2020-04,3074.3,253.97,5896.19,4285.15,4431.37,272.25
3213866885274016768,2020-05,2748.7,5744.66,15.64,4170.08,-7150.4,-6878.15
3213866885274016768,2020-06,6289.26,1916.28,5361.31,2314.18,7420.11,541.96
3213866885274016768,2020-07,3533.68,1380.39,3458.04,886.48,4724.85,5266.81
3213866885274016768,2020-08,3458.41,2887.39,2823.76,1489.27,1905.51,7172.32
3213866885274016768,2020-09,31.67,2177.14,5736.31,4350.93,-760.09,6412.23
3213866885274016768,2020-10,6235.83,5734.3,5666.76,2748.78,3419.51,9831.74
3213866885274016768,2020-11,5761.17,2655.32,5346.37,3530.93,4921.29,14753.03
3213866885274016768,2020-12,2066.62,6357.74,6212.72,1515.88,405.72,15158.75
3214508502673126912,2020-01,637.36,666.58,1576.56,962.12,585.22,585.22
3214508502673126912,2020-02,2065.7,663.61,147.03,1423.51,125.61,710.83
3214508502673126912,2020-03,0,3571.79,2842.55,0,-729.24,-18.41
3214508502673126912,2020-04,697.82,1719.92,1884.07,3342.3,-2480.33,-2498.74
3214508502673126912,2020-05,2024.72,3545.33,924.17,313.33,-909.77,-3408.51
3214508502673126912,2020-06,3487.83,0,1338.18,1783.68,3042.33,-366.18
3214508502673126912,2020-07,0,1179.47,3227.97,3499.98,-1451.48,-1817.66
3214508502673126912,2020-08,1971.68,0,1048.85,1774.38,1246.15,-571.51
3214508502673126912,2020-09,2621.27,1808.31,2184.33,0,2997.29,2425.78
3214508502673126912,2020-10,1359.3,1973.35,1812.41,2427.26,-1228.9,1196.88
3214508502673126912,2020-12,1554.14,805.17,2767.66,164.55,3352.08,4548.96
3215837977281320960,2020-01,2130.78,1128.66,1961.47,2242.65,720.94,720.94
3215837977281320960,2020-02,705.27,1872.14,1733.1,1721.67,-1155.44,-434.5
3215837977281320960,2020-03,1686.45,3575.05,0,3103.04,-4991.64,-5426.14
3215837977281320960,2020-04,3663.79,3112.71,2409.62,6077.91,-3117.21,-8543.35
3215837977281320960,2020-05,6793.05,6263.26,3785.77,3613.28,702.28,-7841.07
3215837977281320960,2020-06,2505.26,1075.15,0,5689.04,-4258.93,-12100
3215837977281320960,2020-07,3503.36,428.33,3975.74,997.92,6052.85,-6047.15
3215837977281320960,2020-08,303.91,4151.96,4655.46,2010.37,-1202.96,-7250.11
3215837977281320960,2020-09,1067.36,1017.22,224.1,4919.55,-4645.31,-11895.42
3215837977281320960,2020-10,1214.03,746.97,1791.45,5940.61,-3682.1,-15577.52
3215837977281320960,2020-11,497.62,4371.32,2718.88,5266.82,-6421.64,-21999.16
3215837977281320960,2020-12,3138.71,2671.42,1293.12,3472.19,-1711.78,-23710.94
3216025729194184704,2020-01,3148.86,4966.28,2969.48,5227.83,-4075.77,-4075.77
3216025729194184704,2020-02,6531.15,3543.92,1438.48,2660.56,1765.15,-2310.62
3216025729194184704,2020-03,2929.63,2210.77,5270.88,5210.83,778.91,-1531.71
3216025729194184704,2020-04,9492.37,7206.55,6556.49,7757.81,1084.5,-447.21
3216025729194184704,2020-05,3254.05,4988.33,5198.82,3032.46,432.08,-15.13
3216025729194184704,2020-06,1007.76,8462.72,2384.93,6463.86,-11533.89,-11549.02
3216025729194184704,2020-07,6760.05,2718.08,4245.83,6602.2,1685.6,-9863.42
3216025729194184704,2020-08,0,1786.15,4784.42,5206.21,-2207.94,-12071.36
3216025729194184704,2020-09,8783.69,4358.31,6356.58,4024.96,6757,-5314.36
3216025729194184704,2020-10,2699.29,4862.85,6954.49,4931.7,-140.77,-5455.13
3216025729194184704,2020-11,3482.52,2625.47,3712.69,933.75,3635.99,-1819.14
3216025729194184704,2020-12,8073.72,3084.38,4263.45,762.78,8490.01,6670.87
3216834745301530624,2020-01,2239.62,3661.47,1923.82,0,501.97,501.97
3216834745301530624,2020-02,1811.25,3032.61,5051.94,5583.07,-1752.49,-1250.52
3216834745301530624,2020-03,4068.23,1351.37,2305.3,2985.85,2036.31,785.79
3216834745301530624,2020-04,1227.02,3987.36,4093.83,3447.55,-2114.06,-1328.27
3216834745301530624,2020-05,2245.83,6568.99,1699.19,3807.43,-6431.4,-7759.67
3216834745301530624,2020-06,315.87,2812.84,4570.14,3589.88,-1516.71,-9276.38
3216834745301530624,2020-07,5620.46,1863.85,73.4,2860.58,969.43,-8306.95
3216834745301530624,2020-08,4810.05,3107.15,1492.63,2753.42,442.11,-7864.84
3216834745301530624,2020-09,0,5157.62,5358.91,2758.56,-2557.27,-10422.11
3216834745301530624,2020-10,2037.82,2091.69,2695.85,489.23,2152.75,-8269.36
3216834745301530624,2020-11,961.69,1095.67,3436.27,5586.77,-2284.48,-10553.84
3216834745301530624,2020-12,3106.39,4211.07,4831.46,8178.88,-4452.1,-15005.94
3217978873917636608,2020-01,6608.41,374.67,4591.34,401.7,10423.38,10423.38
3217978873917636608,2020-02,5715.6,7580.4,4694.03,130.34,2698.89,13122.27
3217978873917636608,2020-03,6148.07,2390.62,4418.41,1156.3,7019.56,20141.83
3217978873917636608,2020-04,2254.06,2942.62,2707.92,736.79,1282.57,21424.4
3217978873917636608,2020-05,619.46,0,89.64,593.92,115.18,21539.58
3217978873917636608,2020-06,893.8,2730.47,7954.01,1857.35,4259.99,25799.57
3217978873917636608,2020-07,2574.65,1465.53,2096.56,7394.98,-4189.3,21610.27
3217978873917636608,2020-08,2112.69,7218.69,3043.45,2773.23,-4835.78,16774.49
3217978873917636608,2020-09,0,2178.42,1781.27,3090.05,-3487.2,13287.29
3217978873917636608,2020-10,1748.54,2646.21,3460.41,540.64,2022.1,15309.39
3217978873917636608,2020-11,7308.59,6359.59,632.78,2998.35,-1416.57,13892.82
3217978873917636608,2020-12,4051.81,2733.85,1902.65,2460.85,759.76,14652.58
3218186590957509632,2020-01,12112.05,5506.49,400.12,1176.76,5828.92,5828.92
3218186590957509632,2020-02,4170.4,6049.23,2211.36,1387.8,-1055.27,4773.65
3218186590957509632,2020-03,4978.35,4016.87,4024.91,4084.97,901.42,5675.07
3218186590957509632,2020-04,49.6,3972.55,4223.53,7394.25,-7093.67,-1418.6
3218186590957509632,2020-05,7139.83,3863.15,2836.27,6294.76,-181.81,-1600.41
3218186590957509632,2020-06,1788.57,8291.29,3304.88,5664.49,-8862.33,-10462.74
3218186590957509632,2020-07,4150.02,2579.25,9891.59,9129.01,2333.35,-8129.39
3218186590957509632,2020-08,4421.73,7714.09,8398.27,3543.11,1562.8,-6566.59
3218186590957509632,2020-09,2826.08,4098.55,3816.1,1008.37,1535.26,-5031.33
3218186590957509632,2020-10,11487.97,3936.08,4497.47,3618.74,8430.62,3399.29
3218186590957509632,2020-11,7342.75,1267.16,1893.01,4088,3880.6,7279.89
3218186590957509632,2020-12,3409.91,3377,4233.91,5439.17,-1172.35,6107.54
3219063663110289920,2020-01,6080.05,205.91,5504.68,6604.06,4774.76,4774.76
3219063663110289920,2020-02,3480.8,6443.9,2164.88,6130.38,-6928.6,-2153.84
3219063663110289920,2020-03,4945.06,2481.37,7292.93,2155.23,7601.39,5447.55
3219063663110289920,2020-04,1340.21,6071.9,2167.17,7878.52,-10443.04,-4995.49
3219063663110289920,2020-05,4358.53,4572.32,3529.75,5529.24,-2213.28,-7208.77
3219063663110289920,2020-06,5802.59,6791.31,3576.55,3235.24,-647.41,-7856.18
3219063663110289920,2020-07,3625.09,5707.64,8451.37,3696.13,2672.69,-5183.49
3219063663110289920,2020-08,7890.47,3276.85,1478.84,7992.08,-1899.62,-7083.11
3219063663110289920,2020-09,4298.73,4473.05,2565.45,10156.77,-7765.64,-14848.75
3219063663110289920,2020-10,6274.43,5294.67,852.79,3960.83,-2128.28,-16977.03
3219063663110289920,2020-11,4741.59,8380.82,5737.72,8483.85,-6385.36,-23362.39
3219063663110289920,2020-12,4406.67,2926.42,4337.7,4258.78,1559.17,-21803.22
3219116118582615552,2020-01,0,901.28,2164.04,66.18,1196.58,1196.58
3219116118582615552,2020-02,4711.96,2901.49,286.37,0,2096.84,3293.42
3219116118582615552,2020-03,1005.39,1245.09,1629.75,0,1390.05,4683.47
3219116118582615552,2020-04,3312.94,372.92,361.08,4160.74,-859.64,3823.83
3219116118582615552,2020-05,456.5,769.67,1072.11,2672.38,-1913.44,1910.39
3219116118582615552,2020-06,727.44,1724.9,394.9,0,-602.56,1307.83
3219116118582615552,2020-07,2085.91,5354.35,226.08,4127.31,-7169.67,-5861.84
3219116118582615552,2020-08,1002.41,3296.08,2853.35,1203.16,-643.48,-6505.32
3219116118582615552,2020-09,1005.13,345.05,689.41,3089.66,-1740.17,-8245.49
3219116118582615552,2020-10,811.35,3480.81,2366.98,3341.78,-3644.26,-11889.75
3219116118582615552,2020-11,138.57,2260.46,1565.23,2372.46,-2929.12,-14818.87
3219116118582615552,2020-12,722.99,2073.67,1508.11,0,157.43,-14661.44
3222408001963762688,2020-01,3424.12,2838.89,1503.63,4512.88,-2424.02,-2424.02
3222408001963762688,2020-02,1345.4,6563.36,4340.58,1119.19,-1996.57,-4420.59
3222408001963762688,2020-03,3729.56,1744.18,4448.45,5000.88,1432.95,-2987.64
3222408001963762688,2020-04,5017.41,1959.05,8077.1,2660.62,8474.84,5487.2
3222408001963762688,2020-05,878.04,4613.91,6956.63,7608.07,-4387.31,1099.89
3222408001963762688,2020-06,5660.75,3196.2,5638.3,5112.71,2990.14,4090.03
3222408001963762688,2020-07,4046.53,1996.31,7171,6305.71,2915.51,7005.54
3222408001963762688,2020-08,4569.66,4944.54,4547.56,5116.25,-943.57,6061.97
3222408001963762688,2020-09,4045.2,2919.16,2812.79,6315.36,-2376.53,3685.44
3222408001963762688,2020-10,2807.31,2174.21,7842.8,2410.86,6065.04,9750.48
3222408001963762688,2020-11,5268.02,2034.6,5555.44,4987.51,3801.35,13551.83
3222408001963762688,2020-12,3446.66,4487.79,6171.34,3461.27,1668.94,15220.77
3222583045638351360,2020-01,3585.84,2436.92,1668.87,4615.78,-1797.99,-1797.99
3222583045638351360,2020-02,4434.63,884.84,1297.25,4020.32,826.72,-971.27
3222583045638351360,2020-03,1371.64,684.56,3810.46,1902.9,2594.64,1623.37
3222583045638351360,2020-04,146.77,1455.86,1597.81,1756.54,-1467.82,155.55
3222583045638351360,2020-05,0,113.66,1957.07,1402.95,440.46,596.01
3222583045638351360,2020-06,932.34,3045.01,421.64,2952.97,-4644,-4047.99
3222583045638351360,2020-07,2375.95,3924.38,3725.24,2729.61,-552.8,-4600.79
3222583045638351360,2020-08,1361.8,416.02,1982.31,1830.02,1098.07,-3502.72
3222583045638351360,2020-10,0,1409.94,619.81,402.36,-1192.49,-4695.21
3222583045638351360,2020-11,875.27,2070.3,1170.35,1416.73,-1441.41,-6136.62
3222583045638351360,2020-12,1514.68,0,4426.16,4682.37,1258.47,-4878.15
3222674791380959232,2020-01,0,678.64,0,303.1,-981.74,-981.74
3222674791380959232,2020-03,1465.06,2813.12,0,1968.54,-3316.6,-4298.34
3222674791380959232,2020-04,0,2722.11,36.71,0,-2685.4,-6983.74
3222674791380959232,2020-05,1045.08,0,0,0,1045.08,-5938.66
3222674791380959232,2020-06,337.03,934.37,116.99,1304.77,-1785.12,-7723.78
3222674791380959232,2020-08,653.07,356.57,0,722.8,-426.3,-8150.08
3222674791380959232,2020-10,1954.94,0,739.11,2211.51,482.54,-7667.54
3222674791380959232,2020-11,0,1810,0,2500.56,-4310.56,-11978.1
3223289936767877632,2020-01,4024.44,5610.42,3744.42,1923.6,234.84,234.84
3223289936767877632,2020-02,4882.96,4560.58,3211.61,4619.88,-1085.89,-851.05
3223289936767877632,2020-03,6410.38,6164.12,1760.01,5294.5,-3288.23,-4139.28
3223289936767877632,2020-04,3862.33,3099.03,4396.93,3226.76,1933.47,-2205.81
3223289936767877632,2020-05,3272.84,3305.1,812.51,5139.03,-4358.78,-6564.59
3223289936767877632,2020-06,3095.28,4418.75,2500.52,4274.94,-3097.89,-9662.48
3223289936767877632,2020-07,3293.22,3494.9,7625.31,4286.15,3137.48,-6525
3223289936767877632,2020-08,739.89,2933.48,0,3499.28,-5692.87,-12217.87
3223289936767877632,2020-09,1476.7,3078.64,1496.79,5516.99,-5622.14,-17840.01
3223289936767877632,2020-10,3849.18,2886.1,5781.94,2778.38,3966.64,-13873.37
3223289936767877632,2020-11,0,2369.43,1751.13,1733.87,-2352.17,-16225.54
3223289936767877632,2020-12,3433.81,4640.47,5065.99,2420.3,1439.03,-14786.51
3223475612011396608,2020-01,1542.92,6331.14,3021.19,6603.04,-8370.07,-8370.07
3223475612011396608,2020-02,6841.14,8937.73,1724.03,3099.71,-3472.27,-11842.34
3223475612011396608,2020-03,5610.37,4585.92,5763.36,4929.69,1858.12,-9984.22
3223475612011396608,2020-04,10393.29,2767.19,5081.88,3722.41,8985.57,-998.65
3223475612011396608,2020-05,3370.17,3318.73,41.25,3233.62,-3140.93,-4139.58
3223475612011396608,2020-06,6711.51,5781.91,2477.78,4528.76,-1121.38,-5260.96
3223475612011396608,2020-07,8761.36,3688.67,5581.68,4073.49,6580.88,1319.92
3223475612011396608,2020-08,1944.73,3113.71,2187.52,2785.29,-1766.75,-446.83
3223475612011396608,2020-09,2237.68,5578.58,4761.52,3588.98,-2168.36,-2615.19
3223475612011396608,2020-10,4334.8,1514.75,3053.8,4574.22,1299.63,-1315.56
3223475612011396608,2020-11,3567.1,3795.66,4623.64,1867.51,2527.57,1212.01
3223475612011396608,2020-12,4907.52,7819.25,3595.16,4999.59,-4316.16,-3104.15
3223727925612855296,2020-01,985.44,1894.75,5492.13,7146.22,-2563.4,-2563.4
3223727925612855296,2020-02,725.14,7673.21,2930.05,6237.96,-10255.98,-12819.38
3223727925612855296,2020-03,1155.81,5845.81,3496.6,5326.88,-6520.28,-19339.66
3223727925612855296,2020-04,2502.83,1607.11,3296.17,993.84,3198.05,-16141.61
3223727925612855296,2020-05,10055.33,4966.76,7581.46,0,12670.03,-3471.58
3223727925612855296,2020-06,7649.57,5945.26,2625.72,2055.28,2274.75,-1196.83
3223727925612855296,2020-07,12855.04,6977.86,2549.98,5729.96,2697.2,1500.37
3223727925612855296,2020-08,9514.39,3678.53,3223.21,7575.92,1483.15,2983.52
3223727925612855296,2020-09,2173.26,9466.92,5964.51,8791.81,-10120.96,-7137.44
3223727925612855296,2020-10,8916.73,6418.88,7501.69,5192.39,4807.15,-2330.29
3223727925612855296,2020-11,4344.96,196.16,2379.06,5877.12,650.74,-1679.55
3223727925612855296,2020-12,7173.4,4164.04,7848.52,8237.08,2620.8,941.25
3225363919424174592,2020-01,6421.77,5111.03,1192.48,8025.61,-5522.39,-5522.39
3225363919424174592,2020-02,5622.16,1016.36,5389.34,1573.19,8421.95,2899.56
3225363919424174592,2020-03,6791.99,2207.88,2045.2,6162.43,466.88,3366.44
3225363919424174592,2020-04,5013.81,7124.19,1897.49,2456.16,-2669.05,697.39
3225363919424174592,2020-05,8896.6,4399.43,4222.42,5356.77,3362.82,4060.21
3225363919424174592,2020-06,5204.7,1636.5,7220.01,4615.15,6173.06,10233.27
3225363919424174592,2020-07,3535.97,5153.5,2993.36,951.16,424.67,10657.94
3225363919424174592,2020-08,7912.56,5121.74,10617.44,1684.55,11723.71,22381.65
3225363919424174592,2020-09,607.7,3145,6784.87,7101.65,-2854.08,19527.57
3225363919424174592,2020-10,881.59,3396.31,1647.47,7079.69,-7946.94,11580.63
3225363919424174592,2020-11,9621.79,3843.15,1843.77,1993.8,5628.61,17209.24
3225363919424174592,2020-12,2595.11,8665.86,4132.6,8339.96,-10278.11,6931.13
3225498259598392320,2020-01,1737.68,1109.37,2974.27,3034.15,568.43,568.43
3225498259598392320,2020-02,0,2027.06,0,2713.34,-4740.4,-4171.97
3225498259598392320,2020-03,0,3312.24,3001.36,4561.21,-4872.09,-9044.06
3225498259598392320,2020-04,0,1688.3,1871.19,273.01,-90.12,-9134.18
3225498259598392320,2020-05,0,3143.4,1135.93,3407.68,-5415.15,-14549.33
3225498259598392320,2020-06,0,1478.61,1819.96,0,341.35,-14207.98
3225498259598392320,2020-07,789.38,0,970.98,1154.75,605.61,-13602.37
3225498259598392320,2020-08,0,1171.16,189.91,0,-981.25,-14583.62
3225498259598392320,2020-09,1777.75,1015.14,2033.35,1295.89,1500.07,-13083.55
3225498259598392320,2020-10,1203.36,1000.39,4800.09,1356.88,3646.18,-9437.37
3225498259598392320,2020-11,0,1859.17,1701.23,0,-157.94,-9595.31
3225498259598392320,2020-12,1376.23,709.66,0,156.77,509.8,-9085.51
3225628375356700672,2020-01,0,2715.67,990.05,2597.61,-4323.23,-4323.23
3225628375356700672,2020-02,0,4099.47,553.27,1711.94,-5258.14,-9581.37
3225628375356700672,2020-03,0,1508.1,0,4274.33,-5782.43,-15363.8
3225628375356700672,2020-04,2213.32,5668.48,1161.47,4079.86,-6373.55,-21737.35
3225628375356700672,2020-05,1579.45,912.85,3231.4,3801.46,96.54,-21640.81
3225628375356700672,2020-06,418.31,2829.77,6159.33,3590.62,157.25,-21483.56
3225628375356700672,2020-07,1865.63,3757.35,262.25,3080.97,-4710.44,-26194
3225628375356700672,2020-08,3651.18,1289.86,0,1943.31,418.01,-25775.99
3225628375356700672,2020-09,8071.78,5123.23,948.65,599.57,3297.63,-22478.36
3225628375356700672,2020-10,5719.3,7170.26,1498.26,4638.79,-4591.49,-27069.85
3225628375356700672,2020-11,6497.56,1397.5,2079.58,1480.37,5699.27,-21370.58
3225628375356700672,2020-12,1738.33,3666.25,3447.75,4713.94,-3194.11,-24564.69
3226913914048253440,2020-01,2732.96,5725.55,4156.05,1933.07,-769.61,-769.61
3226913914048253440,2020-02,623.17,139.32,6032.78,4802.47,1714.16,944.55
3226913914048253440,2020-03,2103.08,6080.33,686.61,2646.17,-5936.81,-4992.26
3226913914048253440,2020-04,1818.42,2667.75,1532.95,2151.97,-1468.35,-6460.61
3226913914048253440,2020-05,2432.39,1984.02,3223.03,4396.79,-725.39,-7186
3226913914048253440,2020-06,897.97,3865.76,6046.04,4554.88,-1476.63,-8662.63
3226913914048253440,2020-07,2148.25,1275.57,8421.33,6662.8,2631.21,-6031.42
3226913914048253440,2020-08,5837.35,4142.77,3875.5,4364.31,1205.77,-4825.65
3226913914048253440,2020-09,1312.47,2876.9,5855.09,3956.63,334.03,-4491.62
3226913914048253440,2020-10,1345.86,4675.66,2265.56,8666.2,-9730.44,-14222.06
3226913914048253440,2020-11,1896.36,2430.14,4961.52,1533.98,2893.76,-11328.3
3226913914048253440,2020-12,4658.42,3977.72,0,3727.11,-3046.41,-14374.71
3227781091075923968,2020-01,7171.44,6255.83,3903.06,5193.83,-375.16,-375.16
3227781091075923968,2020-02,1700.21,6214.01,6646.4,5013.31,-2880.71,-3255.87
3227781091075923968,2020-03,1415.1,3434.5,5004.15,3381.66,-396.91,-3652.78
3227781091075923968,2020-04,3610.17,1200.63,5388.33,3372.3,4425.57,772.79
3227781091075923968,2020-05,646.82,3666.01,402.8,4464.28,-7080.67,-6307.88
3227781091075923968,2020-06,1376.14,9417.83,1681.36,3051.15,-9411.48,-15719.36
3227781091075923968,2020-07,1489.86,0,1784.22,828.7,2445.38,-13273.98
3227781091075923968,2020-08,4592.41,733.52,5816.88,4431.29,5244.48,-8029.5
3227781091075923968,2020-09,1631.49,810.36,1756.68,3510.76,-932.95,-8962.45
3227781091075923968,2020-10,3102.09,2986.8,5760.6,494.65,5381.24,-3581.21
3227781091075923968,2020-11,1045.81,808.55,3446.54,6347.31,-2663.51,-6244.72
3227781091075923968,2020-12,3629.89,3835.09,458.33,593.79,-340.66,-6585.38
3227974754135694848,2020-01,1802.02,484.15,2651.75,2726.93,1242.69,1242.69
3227974754135694848,2020-02,896.17,0,1352.55,0,2248.72,3491.41
3227974754135694848,2020-03,1063.3,0,2808.49,0,3871.79,7363.2
3227974754135694848,2020-04,789.47,509.2,0,1963.42,-1683.15,5680.05
3227974754135694848,2020-06,1162.19,3362.17,0,490.92,-2690.9,2989.15
3227974754135694848,2020-08,1275.67,6080.08,1434.87,0,-3369.54,-380.39
3227974754135694848,2020-09,2087.12,0,2171.55,0,4258.67,3878.28
3227974754135694848,2020-10,2254.68,2699.04,1901.75,0,1457.39,5335.67
3227974754135694848,2020-11,52.12,836.41,34.83,0,-749.46,4586.21
3227974754135694848,2020-12,664.64,1271.28,342.07,1347.74,-1612.31,2973.9
3228486191562225152,2020-02,3441.32,271.51,0,0,3169.81,3169.81
3228486191562225152,2020-03,38.99,0,0,0,38.99,3208.8
3228486191562225152,2020-04,941.16,0,2534.32,0,3475.48,6684.28
3228486191562225152,2020-05,1833.38,0,0,0,1833.38,8517.66
3228486191562225152,2020-06,2064.96,0,863.8,0,2928.76,11446.42
3228486191562225152,2020-09,2183.38,541.52,0,2970.48,-1328.62,10117.8
3228486191562225152,2020-10,1357.01,1191.41,0,625.98,-460.38,9657.42
3228486191562225152,2020-11,1497.3,1816.58,644.2,1411.34,-1086.42,8571
3228985782073267712,2020-01,5392,217.78,2617.58,1270.77,6521.03,6521.03
3228985782073267712,2020-02,1681.53,0,2299.7,2211.05,1770.18,8291.21
3228985782073267712,2020-03,1876.49,0,0,963.31,913.18,9204.39
3228985782073267712,2020-04,2758.32,4464.32,0,2663.09,-4369.09,4835.3
3228985782073267712,2020-05,756.94,2334.7,1774.79,1944.49,-1747.46,3087.84
3228985782073267712,2020-06,423.58,1501.61,1753.16,0,675.13,3762.97
3228985782073267712,2020-07,2717.03,1156.38,0,322.04,1238.61,5001.58
3228985782073267712,2020-08,2793.23,2557.52,2752.2,1935.17,1052.74,6054.32
3228985782073267712,2020-09,1762.64,1261.87,0,0,500.77,6555.09
3228985782073267712,2020-10,1986.49,2854.49,2474.89,4433.49,-2826.6,3728.49
3228985782073267712,2020-11,1227.93,0,2945.67,1255.17,2918.43,6646.92
3228985782073267712,2020-12,1452.26,2672.58,1666.69,0,446.37,7093.29
3229459163968295424,2020-01,2421.38,3385.45,0,1932.15,-2896.22,-2896.22
3229459163968295424,2020-02,344.89,1469.02,1923.51,0,799.38,-2096.84
3229459163968295424,2020-03,2464.9,0,2570.21,230.14,4804.97,2708.13
3229459163968295424,2020-04,6876.25,5303.33,401.69,3632.51,-1657.9,1050.23
3229459163968295424,2020-05,2948.54,2977.96,2248.61,2143.96,75.23,1125.46
3229459163968295424,2020-06,2755.58,2181.3,0,2747.02,-2172.74,-1047.28
3229459163968295424,2020-07,3277.46,1987.92,0,408.91,880.63,-166.65
3229459163968295424,2020-08,2946.62,2113.36,8601.89,1014.25,8420.9,8254.25
3229459163968295424,2020-09,0,7171.59,3468.59,2119.51,-5822.51,2431.74
3229459163968295424,2020-10,807.95,2035.64,385.71,3168.66,-4010.64,-1578.9
3229459163968295424,2020-11,1829.45,7134.24,3057.37,4434.47,-6681.89,-8260.79
3229459163968295424,2020-12,2835.58,597.88,2957,16.49,5178.21,-3082.58
3229748946702092288,2020-01,4781.24,3696.63,11928.47,1749.25,11263.83,11263.83
3229748946702092288,2020-02,7986.03,1809.49,3245.35,3772.23,5649.66,16913.49
3229748946702092288,2020-03,2132.93,4909.25,10033.33,2108.71,5148.3,22061.79
3229748946702092288,2020-04,2699.95,3796.41,0,1729.56,-2826.02,19235.77
3229748946702092288,2020-05,3239.3,5276.58,3817.37,2453.88,-673.79,18561.98
3229748946702092288,2020-06,2927.08,6494.72,6687.21,6319.83,-3200.26,15361.72
3229748946702092288,2020-07,1385.32,3019.88,3607.59,4384.26,-2411.23,12950.49
3229748946702092288,2020-08,4193.46,5150.35,1961.29,1866.27,-861.87,12088.62
3229748946702092288,2020-09,2427.95,2687.53,1571.81,5638.92,-4326.69,7761.93
3229748946702092288,2020-10,2112.51,2509.65,3366.42,2219.33,749.95,8511.88
3229748946702092288,2020-11,4897.77,2426.22,0,2417.23,54.32,8566.2
3229748946702092288,2020-12,3375.11,2745.45,4519.87,4716.19,433.34,8999.54
3230672960762735104,2020-01,3017.56,2782.64,4648.58,7086.25,-2202.75,-2202.75
3230672960762735104,2020-02,4813.72,6400.54,1832.32,3326.96,-3081.46,-5284.21
3230672960762735104,2020-03,4702.39,7382.56,6816.53,2352.61,1783.75,-3500.46
3230672960762735104,2020-04,1929.9,7078.35,1621.85,6499.24,-10025.84,-13526.3
3230672960762735104,2020-05,5587.34,3264.11,1552.09,1541.3,2334.02,-11192.28
3230672960762735104,2020-06,3727.17,5693.28,3859.52,5234.59,-3341.18,-14533.46
3230672960762735104,2020-07,2796.68,5370.1,4295.02,5590.78,-3869.18,-18402.64
3230672960762735104,2020-08,5941.96,3620.06,3250.69,3862.74,1709.85,-16692.79
3230672960762735104,2020-09,1483.91,3467.67,5712.03,3235.93,492.34,-16200.45
3230672960762735104,2020-10,4509.87,3263.78,6475.34,4481.2,3240.23,-12960.22
3230672960762735104,2020-11,6799.67,4233.36,3758.52,7353.44,-1028.61,-13988.83
3230672960762735104,2020-12,4829.83,7389.23,382.68,6489.77,-8666.49,-22655.32
3230984645324410880,2020-01,0,705.73,2674.54,3870.88,-1902.07,-1902.07
3230984645324410880,2020-02,0,1477.48,0,1577.14,-3054.62,-4956.69
3230984645324410880,2020-03,2080.23,1850.28,945.43,2148.19,-972.81,-5929.5
3230984645324410880,2020-05,1904.7,2280.99,1423.88,3102.51,-2054.92,-7984.42
3230984645324410880,2020-10,2777.87,0,0,2686.46,91.41,-7893.01
3230984645324410880,2020-11,4872.43,0,4777.63,0,9650.06,1757.05
3230984645324410880,2020-12,2868.51,0,0,0,2868.51,4625.56
3231993003774272512,2020-01,1324.03,0,1507.38,2517.91,313.5,313.5
3231993003774272512,2020-02,977.74,669.9,1765.33,1830.31,242.86,556.36
3231993003774272512,2020-03,2137.69,0,1434.94,1686.29,1886.34,2442.7
3231993003774272512,2020-04,0,3877.21,0,0,-3877.21,-1434.51
3231993003774272512,2020-05,2871.5,2904.99,350.85,297.97,19.39,-1415.12
3231993003774272512,2020-07,2847.6,622.19,0,687.62,1537.79,122.67
3231993003774272512,2020-08,1989.84,2098.04,4321.46,1610.87,2602.39,2725.06
3231993003774272512,2020-09,3376.86,0,1296.34,2669.67,2003.53,4728.59
3231993003774272512,2020-10,1461.75,2816.22,3277.39,1874.34,48.58,4777.17
3231993003774272512,2020-11,1251.95,2628.27,0,2429.6,-3805.92,971.25
3231993003774272512,2020-12,4208.7,1512.13,1190.49,0,3887.06,4858.31
3233116106485435904,2020-01,2331.13,0,0,1116.75,1214.38,1214.38
3233116106485435904,2020-06,0,859.68,853.17,0,-6.51,1207.87
3233116106485435904,2020-07,0,1839.12,0,0,-1839.12,-631.25
3233116106485435904,2020-08,3003.09,103.57,0,0,2899.52,2268.27
3233116106485435904,2020-10,0,1684.37,0,454.67,-2139.04,129.23
3233195251328420352,2020-01,871.48,6483.44,7893.83,4530.85,-2248.98,-2248.98
3233195251328420352,2020-02,3786.86,4630.72,9442.82,1195.86,7403.1,5154.12
3233195251328420352,2020-03,3609,4629.62,4594.42,1441.79,2132.01,7286.13
3233195251328420352,2020-04,2701.61,8562.37,1130.44,5735.4,-10465.72,-3179.59
3233195251328420352,2020-05,5767.66,1733.28,2535.61,3336.24,3233.75,54.16
3233195251328420352,2020-06,4347.09,2999.68,8678.22,8631.07,1394.56,1448.72
3233195251328420352,2020-07,1763.95,2440.49,2534.71,5338.1,-3479.93,-2031.21
3233195251328420352,2020-08,4346.8,2115.07,2712.23,2890.99,2052.97,21.76
3233195251328420352,2020-09,1488.04,6372.79,3299.36,5557.51,-7142.9,-7121.14
3233195251328420352,2020-10,6903.58,3350.72,10665.69,4575.52,9643.03,2521.89
3233195251328420352,2020-11,3528.85,1091.14,1487.86,7785.43,-3859.86,-1337.97
3233195251328420352,2020-12,4749.31,3361.23,9011.66,2662.65,7737.09,6399.12
3236882358677294080,2020-01,2911.89,2989.4,3473.85,1141.47,2254.87,2254.87
3236882358677294080,2020-02,2607.73,1865.37,1387.35,0,2129.71,4384.58
3236882358677294080,2020-03,655.47,2214.31,0,3627.92,-5186.76,-802.18
3236882358677294080,2020-04,1221.31,6600.63,0,2737.68,-8117,-8919.18
3236882358677294080,2020-05,542.19,840.08,1607.59,726.21,583.49,-8335.69
3236882358677294080,2020-06,1080.49,932.35,0,0,148.14,-8187.55
3236882358677294080,2020-07,1211.81,3607.29,1564.84,235.18,-1065.82,-9253.37
3236882358677294080,2020-08,4196.64,413.97,900.77,1722.6,2960.84,-6292.53
3236882358677294080,2020-09,0,1167.12,1091.34,0,-75.78,-6368.31
3236882358677294080,2020-10,2139.47,1794.53,866.4,4719.4,-3508.06,-9876.37
3236882358677294080,2020-11,2230.39,3734.86,1957.22,993.07,-540.32,-10416.69
3236882358677294080,2020-12,0,3449.11,0,2246.61,-5695.72,-16112.41
3237526768504265728,2020-01,804.03,0,740.8,1449.75,95.08,95.08
3237526768504265728,2020-03,2621.82,0,3533.55,0,6155.37,6250.45
3237526768504265728,2020-04,3265.49,1432.37,1123.7,0,2956.82,9207.27
3237526768504265728,2020-05,2012.19,1543.72,1418.52,3280.67,-1393.68,7813.59
3237526768504265728,2020-06,1054.73,0,652.98,529.42,1178.29,8991.88
3237526768504265728,2020-07,2087.96,907.49,1102.46,0,2282.93,11274.81
3237526768504265728,2020-08,2620.02,0,617.82,421.97,2815.87,14090.68
3237526768504265728,2020-10,1202.1,3218.54,0,3492.92,-5509.36,8581.32
3237526768504265728,2020-11,2436.39,0,0,2002.18,434.21,9015.53
3237526768504265728,2020-12,0,1347,713.97,0,-633.03,8382.5
3237751688612760064,2020-01,0,1919.1,3867.53,692.18,1256.25,1256.25
3237751688612760064,2020-02,0,3636.36,673.78,2100.89,-5063.47,-3807.22
3237751688612760064,2020-03,1821.4,1761.77,2834.55,2340.7,553.48,-3253.74
3237751688612760064,2020-04,3373.7,2902.68,0,1201.89,-730.87,-3984.61
3237751688612760064,2020-05,1292.56,1327.86,3978.57,5961.71,-2018.44,-6003.05
3237751688612760064,2020-06,1381.44,1989.58,1180.97,0,572.83,-5430.22
3237751688612760064,2020-07,0,1040.98,0,1439.53,-2480.51,-7910.73
3237751688612760064,2020-08,6582.26,4864.46,0,1075.74,642.06,-7268.67
3237751688612760064,2020-09,0,137.3,3407.06,1650.94,1618.82,-5649.85
3237751688612760064,2020-10,3003.68,0,2923.28,656.54,5270.42,-379.43
3237751688612760064,2020-11,6416.28,75.46,3329.17,0,9669.99,9290.56
3237751688612760064,2020-12,5886.68,1285.85,3937.65,590.88,7947.6,17238.16
3239115497270144000,2020-01,910.54,6130.88,8463.3,7995.8,-4752.84,-4752.84
3239115497270144000,2020-02,1027.51,3411.25,9402.42,4229.15,2789.53,-1963.31
3239115497270144000,2020-03,7760.79,9425.52,6948.45,1820,3463.72,1500.41
3239115497270144000,2020-04,5586.15,3404.55,8685,6483.14,4383.46,5883.87
3239115497270144000,2020-05,5614.33,7015.69,6441.2,4778.93,260.91,6144.78
3239115497270144000,2020-06,5787.87,3407.98,3160.71,4989.72,550.88,6695.66
3239115497270144000,2020-07,2302.92,413.22,6166.94,4975.09,3081.55,9777.21
3239115497270144000,2020-08,5800.27,2154.93,5407.43,4454.55,4598.22,14375.43
3239115497270144000,2020-09,539.6,5291.31,3760.02,4731.81,-5723.5,8651.93
3239115497270144000,2020-10,6840.09,6342.65,5616.91,1949.52,4164.83,12816.76
3239115497270144000,2020-11,3186.59,1791.7,3292.17,1476.51,3210.55,16027.31
3239115497270144000,2020-12,6108.08,2717.13,1201.29,5590.85,-998.61,15028.7
3240693883611816448,2020-01,1195.81,4719.57,4755.78,2436.04,-1204.02,-1204.02
3240693883611816448,2020-02,2862.34,1493.57,3734.95,2172.18,2931.54,1727.52
3240693883611816448,2020-03,3859.91,470.21,6650.66,2733.07,7307.29,9034.81
3240693883611816448,2020-04,1953.65,3617.91,586.04,6960.22,-8038.44,996.37
3240693883611816448,2020-05,8399.18,1072.11,6080.94,7494.69,5913.32,6909.69
3240693883611816448,2020-06,4645.14,4054.61,1077.7,3473.83,-1805.6,5104.09
3240693883611816448,2020-07,3240.93,5154.32,1143,5933.05,-6703.44,-1599.35
3240693883611816448,2020-08,6104.67,1872.05,3843.66,2093.98,5982.3,4382.95
3240693883611816448,2020-09,3633.03,2826.28,3302.86,4410.13,-300.52,4082.43
3240693883611816448,2020-10,6043.6,2082.24,3839.07,0,7800.43,11882.86
3240693883611816448,2020-11,5862.51,2377.33,4964.19,6065.87,2383.5,14266.36
3240693883611816448,2020-12,2511.14,6805.66,1957.45,1618.88,-3955.95,10310.41
3241172352076543488,2020-01,266.04,2285.11,614.98,3560.2,-4964.29,-4964.29
3241172352076543488,2020-02,5597.94,26.63,3392.74,1941.29,7022.76,2058.47
3241172352076543488,2020-03,7813.77,483.5,4950.31,1357,10923.58,12982.05
3241172352076543488,2020-04,0,4033.36,4115.04,2771.5,-2689.82,10292.23
3241172352076543488,2020-05,670.06,4405.24,4488.19,3060.87,-2307.86,7984.37
3241172352076543488,2020-06,3072.5,1760.28,2955.76,3143.2,1124.78,9109.15
3241172352076543488,2020-07,4664.36,4057.49,6153.09,7164.34,-404.38,8704.77
3241172352076543488,2020-08,2048.47,2935.13,517.21,2749.84,-3119.29,5585.48
3241172352076543488,2020-09,2080.38,5324.06,3508.52,2510.81,-2245.97,3339.51
3241172352076543488,2020-10,3076.67,0,1009.4,2935.21,1150.86,4490.37
3241172352076543488,2020-11,1346.02,638.74,3733.2,426.6,4013.88,8504.25
3241172352076543488,2020-12,0,931.88,3336.11,4576.52,-2172.29,6331.96
3241376146768708608,2020-01,8267.66,7378.11,1178.7,4138.74,-2070.49,-2070.49
3241376146768708608,2020-02,2323.48,1850.35,3452.67,7161.04,-3235.24,-5305.73
3241376146768708608,2020-03,4130.21,223.71,4274.73,3470.37,4710.86,-594.87
3241376146768708608,2020-04,3523.87,1845.88,1703.95,5576.09,-2194.15,-2789.02
3241376146768708608,2020-05,3570.56,1111.69,3710.57,3005.35,3164.09,375.07
3241376146768708608,2020-06,4495.36,2907.67,4896.19,4823.71,1660.17,2035.24
3241376146768708608,2020-07,4642.99,4039.64,1825.96,2702.55,-273.24,1762
3241376146768708608,2020-08,8573.33,2805.41,10270.45,2790.23,13248.14,15010.14
3241376146768708608,2020-09,1634.29,3668.89,8742.38,5907.92,799.86,15810
3241376146768708608,2020-10,1619.83,7970.58,926.38,5070.56,-10494.93,5315.07
3241376146768708608,2020-11,4057.66,4180.1,2800.9,3136.9,-458.44,4856.63
3241376146768708608,2020-12,866.76,866.5,0,5787.95,-5787.69,-931.06
3241397693964628480,2020-01,1900.07,2357.76,0,1346.84,-1804.53,-1804.53
3241397693964628480,2020-02,0,1481.16,0,0,-1481.16,-3285.69
3241397693964628480,2020-03,0,2018.67,1739.41,1130.49,-1409.75,-4695.44
3241397693964628480,2020-04,338.54,603.43,0,0,-264.89,-4960.33
3241397693964628480,2020-06,524.89,864.59,0,304.09,-643.79,-5604.12
3241397693964628480,2020-07,0,2570.82,811.58,0,-1759.24,-7363.36
3241397693964628480,2020-08,0,1116.54,3226.67,0,2110.13,-5253.23
3241397693964628480,2020-11,1763.16,1894.96,0,1406.65,-1538.45,-6791.68
3241397693964628480,2020-12,0,649.49,0,77.63,-727.12,-7518.8
3241695893665923072,2020-01,4707.05,2255.11,6422.54,2765.99,6108.49,6108.49
3241695893665923072,2020-02,2170.65,1894.64,5051.34,4684.35,643,6751.49
3241695893665923072,2020-03,2345.25,5109.74,3734.26,1314.76,-344.99,6406.5
3241695893665923072,2020-04,609.33,7490.88,1711.84,4987.4,-10157.11,-3750.61
3241695893665923072,2020-05,687.37,3909.11,4238.51,2938.12,-1921.35,-5671.96
3241695893665923072,2020-06,3902.65,2819.8,1115.69,2867.46,-668.92,-6340.88
3241695893665923072,2020-07,1910.19,2994.89,4620.45,8765.9,-5230.15,-11571.03
3241695893665923072,2020-08,2443.19,1904.43,8068.3,7116.88,1490.18,-10080.85
3241695893665923072,2020-09,3815.55,1781.62,30.93,3037,-972.14,-11052.99
3241695893665923072,2020-10,2654.12,5472.9,4586.17,3453.92,-1686.53,-12739.52
3241695893665923072,2020-11,4422.88,0,3978.88,2518.38,5883.38,-6856.14
3241695893665923072,2020-12,1717.19,3844.87,7477.76,7461.85,-2111.77,-8967.91
3241699666339947520,2020-02,1755.72,0,0,0,1755.72,1755.72
3241699666339947520,2020-09,1841.96,0,460.95,0,2302.91,4058.63
3241794631291975168,2020-01,1192.45,4507.16,10912.71,5424.32,2173.68,2173.68
3241794631291975168,2020-02,6012.77,5100.88,4551.37,1001.92,4461.34,6635.02
3241794631291975168,2020-03,8097.32,4049.81,3749.7,2981.51,4815.7,11450.72
3241794631291975168,2020-04,0,5308.78,4559.52,1100.8,-1850.06,9600.66
3241794631291975168,2020-05,5904.97,5188.03,4255.23,7492.77,-2520.6,7080.06
3241794631291975168,2020-06,2240.25,4387.81,3479.49,4167.77,-2835.84,4244.22
3241794631291975168,2020-07,7393.13,5483.52,7608.15,6347.9,3169.86,7414.08
3241794631291975168,2020-08,4903.28,2603.3,4939.99,1417.2,5822.77,13236.85
3241794631291975168,2020-09,2473.99,3407.67,7309.85,1949.19,4426.98,17663.83
3241794631291975168,2020-10,3277.42,7045.41,0,5494.8,-9262.79,8401.04
3241794631291975168,2020-11,661.54,4516.86,4154.46,1592.58,-1293.44,7107.6
3241794631291975168,2020-12,375.09,3104.94,8235.48,9338.24,-3832.61,3274.99
3241858138517946368,2020-01,4217.41,5299.76,3395.65,3942.75,-1629.45,-1629.45
3241858138517946368,2020-02,8616.27,15230.47,4032.13,3615.02,-6197.09,-7826.54
3241858138517946368,2020-03,3922.88,9730.09,2452.25,2974.47,-6329.43,-14155.97
3241858138517946368,2020-04,3812.46,2987.78,4414.99,2954.61,2285.06,-11870.91
3241858138517946368,2020-05,6444.58,7168.35,3710.9,3164.98,-177.85,-12048.76
3241858138517946368,2020-06,4782.29,2528.71,2036.16,1502.74,2787,-9261.76
3241858138517946368,2020-07,3344.73,3948.48,4632.1,853.84,3174.51,-6087.25
3241858138517946368,2020-08,2654.95,11786.63,3673.82,5226.92,-10684.78,-16772.03
3241858138517946368,2020-09,6804.23,5751.82,4091.17,3131.31,2012.27,-14759.76
3241858138517946368,2020-10,1709.23,5536.82,4812.31,6143.78,-5159.06,-19918.82
3241858138517946368,2020-11,5889.6,6668.97,5352.38,3925.75,647.26,-19271.56
3241858138517946368,2020-12,3854.06,6034.03,6295.54,1708.64,2406.93,-16864.63
3241979217776357376,2020-09,0,902.96,0,0,-902.96,-902.96
3241979217776357376,2020-11,887.42,0,0,0,887.42,-15.54
3241979217776357376,2020-12,1244.05,0,0,0,1244.05,1228.51
3242078054869985280,2020-01,343.78,3461.69,3412.66,4159.29,-3864.54,-3864.54
3242078054869985280,2020-02,4352.85,6115.81,4895.84,2494,638.88,-3225.66
3242078054869985280,2020-03,2185.16,5589.97,4415.79,2946.83,-1935.85,-5161.51
3242078054869985280,2020-04,590.66,2662.04,4601.73,1891.84,638.51,-4523
3242078054869985280,2020-05,10386.13,7031.52,0,11114.05,-7759.44,-12282.44
3242078054869985280,2020-06,2201.57,6454.86,3064.08,3529.09,-4718.3,-17000.74
3242078054869985280,2020-07,285.43,2377.97,3434.63,2571.69,-1229.6,-18230.34
3242078054869985280,2020-08,6008.32,4189.42,1481.82,4922.22,-1621.5,-19851.84
3242078054869985280,2020-09,1378.44,2427.41,2591.96,2308.07,-765.08,-20616.92
3242078054869985280,2020-10,3351.72,7239.89,7342.64,4009.43,-554.96,-21171.88
3242078054869985280,2020-11,861.28,2383.86,0,829.36,-2351.94,-23523.82
3242078054869985280,2020-12,3572.26,6084.1,2656.39,2840.17,-2695.62,-26219.44
3242680800406454272,2020-01,2304.13,3783.88,9633.19,1443.67,6709.77,6709.77
3242680800406454272,2020-02,5869.61,8756.03,1389.6,4408.85,-5905.67,804.1
3242680800406454272,2020-03,2919.66,2317.47,3372.78,1213.23,2761.74,3565.84
3242680800406454272,2020-04,3896.96,4792.54,6667.25,7864.96,-2093.29,1472.55
3242680800406454272,2020-05,2805.31,5457.43,4954.38,6196.46,-3894.2,-2421.65
3242680800406454272,2020-06,5517.46,3867.96,4424.71,5193.1,881.11,-1540.54
3242680800406454272,2020-07,1550.93,8399.89,5715.15,10065.48,-11199.29,-12739.83
3242680800406454272,2020-08,4428.26,1016.04,3228.64,10435.7,-3794.84,-16534.67
3242680800406454272,2020-09,1934.94,1248.36,6366.88,7534.86,-481.4,-17016.07
3242680800406454272,2020-10,7123.02,2518.1,3971.35,3740.34,4835.93,-12180.14
3242680800406454272,2020-11,3131.09,5290.65,8865.14,5617.9,1087.68,-11092.46
3242680800406454272,2020-12,939.76,3910.96,6169.43,3721.23,-523,-11615.46
3243071767412851712,2020-01,754.41,0,385.18,904.59,235,235
3243071767412851712,2020-02,0,3029.67,782.88,1704.56,-3951.35,-3716.35
3243071767412851712,2020-03,0,1188.21,0,3385.8,-4574.01,-8290.36
3243071767412851712,2020-04,0,763.85,2229.89,0,1466.04,-6824.32
3243071767412851712,2020-05,0,1614.15,1358.87,322.35,-577.63,-7401.95
3243071767412851712,2020-06,0,2977.02,0,83.86,-3060.88,-10462.83
3243071767412851712,2020-07,579.56,1718.58,0,0,-1139.02,-11601.85
3243071767412851712,2020-08,0,2219.62,1989.34,424.31,-654.59,-12256.44
3243071767412851712,2020-09,0,1090.2,0,1526.63,-2616.83,-14873.27
3243071767412851712,2020-10,1250.06,1740.09,2182.41,1254.42,437.96,-14435.31
3243279304800508928,2020-01,0,1294.05,1293.31,31.57,-32.31,-32.31
3243279304800508928,2020-02,559.49,2788.31,1363.85,1906.71,-2771.68,-2803.99
3243279304800508928,2020-03,1796.76,1730.95,0,2278.54,-2212.73,-5016.72
3243279304800508928,2020-04,0,1012.88,0,618.05,-1630.93,-6647.65
3243279304800508928,2020-05,1221.29,2876.01,70.62,1258.57,-2842.67,-9490.32
3243279304800508928,2020-06,1531.36,4202.64,450.15,1850.76,-4071.89,-13562.21
3243279304800508928,2020-07,4948.36,0,725.54,1272.71,4401.19,-9161.02
3243279304800508928,2020-08,4940.15,0,1596.85,937.16,5599.84,-3561.18
3243279304800508928,2020-09,1717.58,2549.53,0,0,-831.95,-4393.13
3243279304800508928,2020-10,5561.79,6316.77,652.32,1007.44,-1110.1,-5503.23
3243279304800508928,2020-11,1994.84,590.42,0,0,1404.42,-4098.81
3243279304800508928,2020-12,1182.4,2364.49,2353.78,3368.76,-2197.07,-6295.88
3244685360671342592,2020-01,2572.89,0,10125.21,1458.07,11240.03,11240.03
3244685360671342592,2020-02,8407.82,3055.71,586.55,203.56,5735.1,16975.13
3244685360671342592,2020-03,9220.83,7743.75,2896.03,5743.84,-1370.73,15604.4
3244685360671342592,2020-04,330.07,3221.87,6971.47,7784.62,-3704.95,11899.45
3244685360671342592,2020-05,4607.93,383.76,6031.67,3772.59,6483.25,18382.7
3244685360671342592,2020-06,4122.9,5411.85,1571.68,2285.25,-2002.52,16380.18
3244685360671342592,2020-07,1354.29,4988.13,6932.71,5658.75,-2359.88,14020.3
3244685360671342592,2020-08,4349.52,1252.27,9073.88,3322.96,8848.17,22868.47
3244685360671342592,2020-09,5847.9,996.07,6077.41,1308.11,9621.13,32489.6
3244685360671342592,2020-10,3717.05,4261.98,1135.06,6762.89,-6172.76,26316.84
3244685360671342592,2020-11,3654.47,5262.89,4565.66,2203.96,753.28,27070.12
3244685360671342592,2020-12,4247.88,4833.01,6182.44,0,5597.31,32667.43
3244972026605579264,2020-01,4184.89,3945.76,918.61,7925.15,-6767.41,-6767.41
3244972026605579264,2020-02,3848.77,0,6901.71,63.63,10686.85,3919.44
3244972026605579264,2020-03,3097.88,7562.68,3181.26,7150.21,-8433.75,-4514.31
3244972026605579264,2020-04,2279.21,2838.84,0,5434.47,-5994.1,-10508.41
3244972026605579264,2020-05,3004.79,2507.74,4609.02,4150.62,955.45,-9552.96
3244972026605579264,2020-06,3415.53,2067.62,7204.77,760.48,7792.2,-1760.76
3244972026605579264,2020-07,2893.86,316.07,2964.35,8321.35,-2779.21,-4539.97
3244972026605579264,2020-08,6706.56,4394.93,2826.69,4002.97,1135.35,-3404.62
3244972026605579264,2020-09,2848.04,4972.52,9613.52,4095.64,3393.4,-11.22
3244972026605579264,2020-10,9280.12,1544.42,4960.41,1129.37,11566.74,11555.52
3244972026605579264,2020-11,3820.49,4409.12,4392,2767.95,1035.42,12590.94
3244972026605579264,2020-12,3824.72,7798.29,2607.83,1831.04,-3196.78,9394.16
3245046693249771520,2020-01,2073.17,1619.13,1950.15,588.88,1815.31,1815.31
3245046693249771520,2020-02,1554.5,463.04,1570.65,2500.98,161.13,1976.44
3245046693249771520,2020-03,801.88,2435.95,2096.1,0,462.03,2438.47
3245046693249771520,2020-04,1103.09,2760.13,0,356.26,-2013.3,425.17
3245046693249771520,2020-05,365.75,4877.8,1435.18,2738.96,-5815.83,-5390.66
3245046693249771520,2020-06,2382.52,3104.19,1334.74,1762.59,-1149.52,-6540.18
3245046693249771520,2020-07,1914.03,843.77,0,2110.75,-1040.49,-7580.67
3245046693249771520,2020-08,2472.88,3532.2,2600.94,1662.14,-120.52,-7701.19
3245046693249771520,2020-09,1407.43,721.46,4620.83,2616.42,2690.38,-5010.81
3245046693249771520,2020-10,2480.83,1877.53,704.14,0,1307.44,-3703.37
3245046693249771520,2020-11,4128.4,1954.94,3317.48,2310.77,3180.17,-523.2
3245046693249771520,2020-12,939.59,2936.31,1904.15,1381.51,-1474.08,-1997.28
3245519876674842112,2020-01,459.32,0,0,572.9,-113.58,-113.58
3245519876674842112,2020-09,0,771.99,0,0,-771.99,-885.57
3245519876674842112,2020-12,0,135.36,0,0,-135.36,-1020.93
3246669904554489856,2020-01,4869.02,4271.1,7037.47,4578.57,3056.82,3056.82
3246669904554489856,2020-02,4607.97,3886.19,1620.23,6614.62,-4272.61,-1215.79
3246669904554489856,2020-03,3053.23,1712.01,2519.61,2617.76,1243.07,27.28
3246669904554489856,2020-04,8835.87,4064.52,204.29,6290.8,-1315.16,-1287.88
3246669904554489856,2020-05,3390.22,3635.91,3450.16,3970.01,-765.54,-2053.42
3246669904554489856,2020-06,6041.59,2946.96,5075.07,2961.7,5208,3154.58
3246669904554489856,2020-07,7197.93,238.33,461.34,7550.05,-129.11,3025.47
3246669904554489856,2020-08,2673.68,2884.87,6013.47,7744.15,-1941.87,1083.6
3246669904554489856,2020-09,6954.75,8209.87,1161.83,1864.61,-1957.9,-874.3
3246669904554489856,2020-10,11435.69,4017.17,3312.81,2380.13,8351.2,7476.9
3246669904554489856,2020-11,3165.26,10599.08,1077.42,260.67,-6617.07,859.83
3246669904554489856,2020-12,5418.81,4806.3,4523.39,3022.94,2112.96,2972.79
3247829161246061056,2020-01,100.38,2560.49,2430.94,2885.94,-2915.11,-2915.11
3247829161246061056,2020-02,0,1261.72,3927.41,2349.21,316.48,-2598.63
3247829161246061056,2020-03,3353.46,2599.21,820.32,5766.23,-4191.66,-6790.29
3247829161246061056,2020-04,559.2,463.28,2351.14,1213.92,1233.14,-5557.15
3247829161246061056,2020-05,1353.89,3088.11,0,0,-1734.22,-7291.37
3247829161246061056,2020-06,2199.3,3854.78,5362.73,1708.96,1998.29,-5293.08
3247829161246061056,2020-07,5650.4,4161.81,340.09,1484.67,344.01,-4949.07
3247829161246061056,2020-08,3852.09,4623.5,3143.59,0,2372.18,-2576.89
3247829161246061056,2020-09,2052.67,3749.06,2325.84,0,629.45,-1947.44
3247829161246061056,2020-10,1364.49,4389.35,3168.69,3934.81,-3790.98,-5738.42
3247829161246061056,2020-11,0,2942.71,3272.34,2435.71,-2106.08,-7844.5
3247829161246061056,2020-12,0,1440.85,3823.28,3484.17,-1101.74,-8946.24
3248108822834569728,2020-01,2002.74,1630.58,1686.87,1560.16,498.87,498.87
3248108822834569728,2020-02,7569.11,3116.11,99.98,839.81,3713.17,4212.04
3248108822834569728,2020-03,1721.81,1445.48,2689.87,1690.58,1275.62,5487.66
3248108822834569728,2020-04,0,3332.96,4339.32,850.21,156.15,5643.81
3248108822834569728,2020-05,2100.49,0,0,532.57,1567.92,7211.73
3248108822834569728,2020-06,3952.68,35.59,4067.16,0,7984.25,15195.98
3248108822834569728,2020-07,2676.39,5377.95,535.93,5875.56,-8041.19,7154.79
3248108822834569728,2020-08,3938.4,1569.19,5623.71,1653.59,6339.33,13494.12
3248108822834569728,2020-09,2643.29,2254.92,1949.77,1401.8,936.34,14430.46
3248108822834569728,2020-10,3585.43,405.2,1590.77,1716.42,3054.58,17485.04
3248108822834569728,2020-11,4027.86,2753.95,1670.66,1066.19,1878.38,19363.42
3248108822834569728,2020-12,0,319.08,856.15,2290.85,-1753.78,17609.64
3249683341258714112,2020-01,3106.6,1570.6,3289.27,1168.77,3656.5,3656.5
3249683341258714112,2020-02,1763.48,1134.02,4506.54,3544.74,1591.26,5247.76
3249683341258714112,2020-03,2295.44,3160.03,2657.53,4492.95,-2700.01,2547.75
3249683341258714112,2020-04,2189.82,1541.85,2899.35,214.15,3333.17,5880.92
3249683341258714112,2020-05,0,2377.38,5744.13,3022.25,344.5,6225.42
3249683341258714112,2020-06,2888.43,6612.78,1102.28,764.83,-3386.9,2838.52
3249683341258714112,2020-07,2163.04,0,5520.52,8101.24,-417.68,2420.84
3249683341258714112,2020-08,1307.2,2077.04,2469.02,4076.76,-2377.58,43.26
3249683341258714112,2020-09,4223.92,2272.89,2569.36,392.34,4128.05,4171.31
3249683341258714112,2020-10,646.86,1953.45,3305.82,2443.17,-443.94,3727.37
3249683341258714112,2020-11,3813.31,1941.26,5739.58,5739.28,1872.35,5599.72
3249683341258714112,2020-12,1522.94,722.35,4109.03,1809.84,3099.78,8699.5
3250447520863732736,2020-02,0,956.41,1408.62,662.08,-209.87,-209.87
3250447520863732736,2020-03,124.88,2568.5,0,0,-2443.62,-2653.49
3250447520863732736,2020-04,0,541.56,197.57,1695.16,-2039.15,-4692.64
3250447520863732736,2020-05,0,492.91,0,0,-492.91,-5185.55
3250447520863732736,2020-07,1145.15,658.58,3288.36,0,3774.93,-1410.62
3250447520863732736,2020-11,1889.34,0,772.26,0,2661.6,1250.98
3250447520863732736,2020-12,150.54,0,0,1414.35,-1263.81,-12.83
3251085081558853632,2020-01,0,726.05,0,0,-726.05,-726.05
3251085081558853632,2020-02,969.75,0,0,110.33,859.42,133.37
3251085081558853632,2020-08,0,397.45,0,0,-397.45,-264.08
3251085081558853632,2020-09,0,1241.09,0,1196.08,-2437.17,-2701.25
3251985966263779328,2020-01,1436.18,4058.65,3839.05,2234.61,-1018.03,-1018.03
3251985966263779328,2020-02,3064.31,5352.35,1551.33,6148.21,-6884.92,-7902.95
3251985966263779328,2020-03,3059.22,1141.31,2552.73,3822.26,648.38,-7254.57
3251985966263779328,2020-04,2446.22,1487.61,4690.62,769.98,4879.25,-2375.32
3251985966263779328,2020-05,4150.4,0,2183.2,1614.45,4719.15,2343.83
3251985966263779328,2020-06,0,6317.69,1882.51,4031.02,-8466.2,-6122.37
3251985966263779328,2020-07,2603.47,0,4235.11,1960.63,4877.95,-1244.42
3251985966263779328,2020-08,33.07,2819.41,3925.39,4009.55,-2870.5,-4114.92
3251985966263779328,2020-09,1867.24,2380.39,2836.49,574.87,1748.47,-2366.45
3251985966263779328,2020-10,4240.32,1964.35,0,1543.93,732.04,-1634.41
3251985966263779328,2020-11,1824.69,753.02,1772.64,1723.61,1120.7,-513.71
3251985966263779328,2020-12,5200.04,4542.11,0,1804.19,-1146.26,-1659.97
3255048218793952256,2020-01,2026.5,946.86,1544.94,1327.19,1297.39,1297.39
3255048218793952256,2020-02,0,1046.67,1531.88,3717.42,-3232.21,-1934.82
3255048218793952256,2020-03,1042.07,3690.17,275.19,0,-2372.91,-4307.73
3255048218793952256,2020-04,1156.05,3871.21,0,3645.68,-6360.84,-10668.57
3255048218793952256,2020-05,2630.79,1731.47,2677.12,4367.42,-790.98,-11459.55
3255048218793952256,2020-06,1836.56,1792.49,3406.59,0,3450.66,-8008.89
3255048218793952256,2020-07,1723.61,5275.8,3345.95,0,-206.24,-8215.13
3255048218793952256,2020-08,1745.74,1829.13,0,0,-83.39,-8298.52
3255048218793952256,2020-09,1019.93,107.22,3047.13,2917.53,1042.31,-7256.21
3255048218793952256,2020-10,65.4,2848.8,2268.38,534.41,-1049.43,-8305.64
3255048218793952256,2020-11,2038.44,0,2628.4,1310.78,3356.06,-4949.58
3255048218793952256,2020-12,0,5495.14,3287.74,1438.66,-3646.06,-8595.64
3255420672142633472,2020-01,1706.94,3275.34,2752.57,0,1184.17,1184.17
3255420672142633472,2020-02,3116.52,0,1136.38,2160.39,2092.51,3276.68
3255420672142633472,2020-03,862.82,0,2047.89,3875.12,-964.41,2312.27
3255420672142633472,2020-04,4260.77,4433.15,125.4,1427.97,-1474.95,837.32
3255420672142633472,2020-05,4814.08,0,6627.13,1720.24,9720.97,10558.29
3255420672142633472,2020-06,0,1972.28,3414.92,999.56,443.08,11001.37
3255420672142633472,2020-07,1951.34,775.34,78.37,3502.09,-2247.72,8753.65
3255420672142633472,2020-08,1657.6,1008.42,4398.32,3424.97,1622.53,10376.18
3255420672142633472,2020-09,2503.8,1899.84,6247.16,2567.06,4284.06,14660.24
3255420672142633472,2020-10,478.36,0,3269.22,4409.43,-661.85,13998.39
3255420672142633472,2020-11,6101.96,2000.87,4481.5,2326.18,6256.41,20254.8
3255420672142633472,2020-12,5796.85,4648.21,3793.68,4538.01,404.31,20659.11
3255606849723675648,2020-01,2286.6,194.16,1293.85,1027.3,2358.99,2358.99
3255606849723675648,2020-02,278.24,1013.08,0,244.61,-979.45,1379.54
3255606849723675648,2020-03,1973.09,600.63,1408.06,138.04,2642.48,4022.02
3255606849723675648,2020-06,0,616.81,0,0,-616.81,3405.21
3255606849723675648,2020-07,386.66,3491.05,733.15,0,-2371.24,1033.97
3255606849723675648,2020-08,1506.4,0,288.98,854.04,941.34,1975.31
3255606849723675648,2020-10,1157.07,1129.88,974.31,0,1001.5,2976.81
3255606849723675648,2020-12,1173.08,1097.94,2353.06,0,2428.2,5405.01
3256025206066085888,2020-01,7107.53,4639.13,4835.57,5656.74,1647.23,1647.23
3256025206066085888,2020-02,3570.48,1231.97,1544.29,4346.37,-463.57,1183.66
3256025206066085888,2020-03,6881.27,3713.82,12427.22,5854.37,9740.3,10923.96
3256025206066085888,2020-04,3446.35,3462.32,4485.25,6370.2,-1900.92,9023.04
3256025206066085888,2020-05,1851,4912.88,10153.79,8832.29,-1740.38,7282.66
3256025206066085888,2020-06,4896.94,7269.26,6432.59,3731.32,328.95,7611.61
3256025206066085888,2020-07,8318.11,3650.28,2912.72,9340.37,-1759.82,5851.79
3256025206066085888,2020-08,8400.5,3223.66,6402.97,7330.42,4249.39,10101.18
3256025206066085888,2020-09,2389.78,3440.49,5495.58,6243.57,-1798.7,8302.48
3256025206066085888,2020-10,1398.88,2507.91,3365.81,4041.4,-1784.62,6517.86
3256025206066085888,2020-11,2563.45,6010.89,1576.27,3079.58,-4950.75,1567.11
3256025206066085888,2020-12,1627.48,6653.24,3000.78,0,-2024.98,-457.87
3256366214911638016,2020-01,1487.34,2317.04,0,182.34,-1012.04,-1012.04
3256366214911638016,2020-03,268.48,0,3542.63,2631.96,1179.15,167.11
3256366214911638016,2020-04,1052.54,3895.22,3790.12,836.83,110.61,277.72
3256366214911638016,2020-05,0,814.74,914.42,0,99.68,377.4
3256366214911638016,2020-06,0,3447.21,4456.95,948.32,61.42,438.82
3256366214911638016,2020-07,1725.11,631.24,0,767.97,325.9,764.72
3256366214911638016,2020-08,1657.01,0,2757.96,0,4414.97,5179.69
3256366214911638016,2020-09,0,3104.37,1932.32,1828.57,-3000.62,2179.07
3256366214911638016,2020-10,0,2600.05,1139.45,279.94,-1740.54,438.53
3256366214911638016,2020-11,5548.11,1680.56,0,699.86,3167.69,3606.22
3256366214911638016,2020-12,1919.88,872.83,1855.36,0,2902.41,6508.63
3256796197236274688,2020-01,1389.44,4207.88,1947.19,0,-871.25,-871.25
3256796197236274688,2020-02,1671.28,1723.05,545.86,3289.73,-2795.64,-3666.89
3256796197236274688,2020-03,4156.56,1186.25,2975.81,1298.7,4647.42,980.53
3256796197236274688,2020-04,2840.68,5031.31,172.78,1937.32,-3955.17,-2974.64
3256796197236274688,2020-05,6696.5,3823.04,3448.99,4813.3,1509.15,-1465.49
3256796197236274688,2020-06,3532.06,1703.11,1354.51,4111.15,-927.69,-2393.18
3256796197236274688,2020-07,1318.87,2852.26,3275.34,2988.97,-1247.02,-3640.2
3256796197236274688,2020-08,4476.8,2984.38,1820.99,3051.13,262.28,-3377.92
3256796197236274688,2020-09,6124.23,5069.19,5719.03,6278.84,495.23,-2882.69
3256796197236274688,2020-10,3555.33,427.69,83.42,2590.32,620.74,-2261.95
3256796197236274688,2020-11,389.8,4178.3,2814.41,2841.39,-3815.48,-6077.43
3256796197236274688,2020-12,6001.87,3467.39,2658.69,0,5193.17,-884.26
3257134870836947456,2020-04,1839.42,0,0,0,1839.42,1839.42
3257134870836947456,2020-05,0,1137.91,0,1531.08,-2668.99,-829.57
3257134870836947456,2020-06,0,1512.14,0,0,-1512.14,-2341.71
3257134870836947456,2020-10,0,1429.59,0,0,-1429.59,-3771.3
3257134870836947456,2020-11,0,518.77,0,500.99,-1019.76,-4791.06
3257134870836947456,2020-12,0,1616.98,0,0,-1616.98,-6408.04
3257904800572419072,2020-01,3045.9,1250.67,1369.07,4673.39,-1509.09,-1509.09
3257904800572419072,2020-02,0,5548,1977.43,5099.82,-8670.39,-10179.48
3257904800572419072,2020-03,2960.93,3690.78,2026.13,2359.94,-1063.66,-11243.14
3257904800572419072,2020-04,1189.03,1140.26,7501.61,2625.87,4924.51,-6318.63
3257904800572419072,2020-05,7712.19,5405.29,3358.97,1810.68,3855.19,-2463.44
3257904800572419072,2020-06,1635.46,1348.36,1250.7,426.88,1110.92,-1352.52
3257904800572419072,2020-07,2824.74,2520.76,2537.87,3433.12,-591.27,-1943.79
3257904800572419072,2020-08,3081.16,3810.35,4877.67,591.77,3556.71,1612.92
3257904800572419072,2020-09,5902.97,1853.9,0,0,4049.07,5661.99
3257904800572419072,2020-10,419.54,2389.17,0,9114.09,-11083.72,-5421.73
3257904800572419072,2020-11,1953.31,6030.41,5996.89,2541.28,-621.49,-6043.22
3257904800572419072,2020-12,2132.15,4620.82,755.6,2036.11,-3769.18,-9812.4
3259357247583805952,2020-01,4454.96,3036.03,3854.04,1022.82,4250.15,4250.15
3259357247583805952,2020-02,4363.08,6553.35,4397.69,5806.74,-3599.32,650.83
3259357247583805952,2020-03,3339.41,2321.78,2064.97,1039.6,2043,2693.83
3259357247583805952,2020-04,3071.14,3915.59,1309.89,7349.33,-6883.89,-4190.06
3259357247583805952,2020-05,7920.96,2314.92,1571.48,1988,5189.52,999.46
3259357247583805952,2020-06,5885.65,1094.1,2868.37,3846.76,3813.16,4812.62
3259357247583805952,2020-07,5400.33,0,8201.31,4275.23,9326.41,14139.03
3259357247583805952,2020-08,2940.86,247.32,2146.59,2849.68,1990.45,16129.48
3259357247583805952,2020-09,2583.43,2099.1,4842.48,3955.83,1370.98,17500.46
3259357247583805952,2020-10,1442.5,6296.72,2978.87,7186.57,-9061.92,8438.54
3259357247583805952,2020-11,2922.63,7280.81,1379.67,5650.04,-8628.55,-190.01
3259357247583805952,2020-12,4781.24,2780.75,5777.41,1419.61,6358.29,6168.28
3260110734251979264,2020-01,5349.66,3863.25,5321.28,4716.78,2090.91,2090.91
3260110734251979264,2020-02,5511.38,7295.44,5949.98,1271.47,2894.45,4985.36
3260110734251979264,2020-03,6404.29,3511.37,5445.53,3931.11,4407.34,9392.7
3260110734251979264,2020-04,2277.53,5516.25,4687.38,3498.65,-2049.99,7342.71
3260110734251979264,2020-05,8527.37,10273.77,7062.57,1559.47,3756.7,11099.41
3260110734251979264,2020-06,2935.98,3470.69,4433.83,6149.89,-2250.77,8848.64
3260110734251979264,2020-07,962.88,7340.7,3394.16,3473.75,-6457.41,2391.23
3260110734251979264,2020-08,6162.87,2836.85,12725.47,11756.03,4295.46,6686.69
3260110734251979264,2020-09,2800.53,5086.44,2784.29,5475.91,-4977.53,1709.16
3260110734251979264,2020-10,3381.5,7313.93,9288.65,7241.48,-1885.26,-176.1
3260110734251979264,2020-11,5490.27,7145.63,2875.91,3568.82,-2348.27,-2524.37
3260110734251979264,2020-12,674.02,3996.75,3656.91,11648.53,-11314.35,-13838.72
3261023486988820480,2020-01,761.92,1324.66,2552,0,1989.26,1989.26
3261023486988820480,2020-02,4522,0,2398.13,2872.09,4048.04,6037.3
3261023486988820480,2020-03,327.54,1558.08,0,1975.31,-3205.85,2831.45
3261023486988820480,2020-04,2345.61,0,4005.41,586.39,5764.63,8596.08
3261023486988820480,2020-05,2112.96,0,273.17,0,2386.13,10982.21
3261023486988820480,2020-06,4842.2,124.62,78.47,1556.52,3239.53,14221.74
3261023486988820480,2020-07,1593.63,839.51,3881.94,2470.82,2165.24,16386.98
3261023486988820480,2020-08,4042.87,853.71,2862.33,1935.27,4116.22,20503.2
3261023486988820480,2020-09,0,1087.49,1601.97,1398.8,-884.32,19618.88
3261023486988820480,2020-10,2780.96,6954.02,2226.31,1693.45,-3640.2,15978.68
3261023486988820480,2020-11,2124.2,1944.46,0,2688.2,-2508.46,13470.22
3261023486988820480,2020-12,0,1031.41,402.45,0,-628.96,12841.26
3261378166086417408,2020-01,3690.36,2216.58,7407.3,6195.27,2685.81,2685.81
3261378166086417408,2020-02,4307.27,3289.75,2904.96,2836.68,1085.8,3771.61
3261378166086417408,2020-03,1649.72,2420.8,6123.6,3058.23,2294.29,6065.9
3261378166086417408,2020-04,5316.75,7475.83,0,7639.41,-9798.49,-3732.59
3261378166086417408,2020-05,1702.35,1059.32,2456.81,4636.9,-1537.06,-5269.65
3261378166086417408,2020-06,793.53,10388.23,11477.88,6044.64,-4161.46,-9431.11
3261378166086417408,2020-07,6068.04,1048.26,5529.39,1789.32,8759.85,-671.26
3261378166086417408,2020-08,9717.07,4398.05,8477.56,3814.84,9981.74,9310.48
3261378166086417408,2020-09,5436.55,3785.45,3702.35,1897.57,3455.88,12766.36
3261378166086417408,2020-10,12880.88,0,4248.63,4482.12,12647.39,25413.75
3261378166086417408,2020-11,1946.14,3492.05,3290.71,7706.49,-5961.69,19452.06
3261378166086417408,2020-12,2335.95,6803.13,3299.73,4113.98,-5281.43,14170.63
3263688995060358656,2020-01,0,3683.38,1237.71,2495.24,-4940.91,-4940.91
3263688995060358656,2020-02,4559.19,2819.05,711.99,1063.43,1388.7,-3552.21
3263688995060358656,2020-03,637.3,1508.39,2042.59,3656.58,-2485.08,-6037.29
3263688995060358656,2020-04,751.57,2090.22,2126.24,534.66,252.93,-5784.36
3263688995060358656,2020-05,5074.1,773.21,0,3158.66,1142.23,-4642.13
3263688995060358656,2020-06,2595.24,3011.3,3304.85,2727.93,160.86,-4481.27
3263688995060358656,2020-07,978.91,3936.83,3351.59,3582.54,-3188.87,-7670.14
3263688995060358656,2020-08,2404.82,3381.18,614.58,2712.17,-3073.95,-10744.09
3263688995060358656,2020-09,4282.01,104.49,1524.97,2751.11,2951.38,-7792.71
3263688995060358656,2020-10,3161.54,1318.7,6218.88,5930.83,2130.89,-5661.82
3263688995060358656,2020-11,4434.59,4034.69,5119.38,1799.13,3720.15,-1941.67
3263688995060358656,2020-12,2574.16,1930.72,3951.04,1905.22,2689.26,747.59
3264058882562129408,2020-01,6124.97,5191.57,6077.89,3555.36,3455.93,3455.93
3264058882562129408,2020-02,5298.47,6352.66,1630.42,9249.97,-8673.74,-5217.81
3264058882562129408,2020-03,9310.77,4445.61,4583.02,5907.65,3540.53,-1677.28
3264058882562129408,2020-04,4416.03,7013.69,8752.05,6743.08,-588.69,-2265.97
3264058882562129408,2020-05,6072.15,2001.92,1784.87,5564.22,290.88,-1975.09
3264058882562129408,2020-06,1391.89,3908.25,3455.75,3176.94,-2237.55,-4212.64
3264058882562129408,2020-07,1250.79,2302.84,4766.59,3043.22,671.32,-3541.32
3264058882562129408,2020-08,3024.02,4949.9,6953.58,1413.72,3613.98,72.66
3264058882562129408,2020-09,4309.47,3781.11,4573.91,3265.85,1836.42,1909.08
3264058882562129408,2020-10,1770.73,6856.06,9764.06,6719.56,-2040.83,-131.75
3264058882562129408,2020-11,5673.71,2770.47,4932.82,2309.2,5526.86,5395.11
3264058882562129408,2020-12,5514.99,5823.62,3745.87,8038.68,-4601.44,793.67
3264217381129019904,2020-01,0,314.6,1216.38,486.2,415.58,415.58
3264217381129019904,2020-02,1653.41,54.05,0,3565.87,-1966.51,-1550.93
3264217381129019904,2020-03,0,268.71,0,670.61,-939.32,-2490.25
3264217381129019904,2020-04,0,587.53,1738.61,2334.66,-1183.58,-3673.83
3264217381129019904,2020-05,0,2843.32,0,255.58,-3098.9,-6772.73
3264217381129019904,2020-06,0,1674.77,853,564.15,-1385.92,-8158.65
3264217381129019904,2020-09,0.89,0,0,2855.09,-2854.2,-11012.85
3264217381129019904,2020-10,870.32,0,0,1416.02,-545.7,-11558.55
3264217381129019904,2020-11,384.1,0,0,0,384.1,-11174.45
3264217381129019904,2020-12,760.87,0,166.77,0,927.64,-10246.81
3266788702940063744,2020-01,3081.95,0,3166.83,4482.64,1766.14,1766.14
3266788702940063744,2020-02,1914.21,2741.39,1460.66,2791.55,-2158.07,-391.93
3266788702940063744,2020-03,1841.12,5029.51,500.41,0,-2687.98,-3079.91
3266788702940063744,2020-04,3244.14,620.61,8995.45,2169.75,9449.23,6369.32
3266788702940063744,2020-05,4226.74,101.93,3877.15,2123.58,5878.38,12247.7
3266788702940063744,2020-06,710.64,7355.16,2876.67,0,-3767.85,8479.85
3266788702940063744,2020-07,367.99,2255.19,3464.71,2066.39,-488.88,7990.97
3266788702940063744,2020-08,382.22,616.73,0,1519.88,-1754.39,6236.58
3266788702940063744,2020-09,790.67,3652.18,1989.8,0,-871.71,5364.87
3266788702940063744,2020-10,420.58,3476.12,0,1638.12,-4693.66,671.21
3266788702940063744,2020-11,2620.67,1230.8,1832.36,2657.51,564.72,1235.93
3267256018402785792,2020-01,1800.63,1285.55,1849.64,0,2364.72,2364.72
3267256018402785792,2020-02,1432,0,3419.68,17.1,4834.58,7199.3
3267256018402785792,2020-03,1881.3,3556.34,3372.08,3170.26,-1473.22,5726.08
3267256018402785792,2020-04,2269.48,4392.48,571.12,627.13,-2179.01,3547.07
3267256018402785792,2020-05,38.42,3331.49,2738.89,1945.14,-2499.32,1047.75
3267256018402785792,2020-06,2021.25,1265.89,2103.17,4963.1,-2104.57,-1056.82
3267256018402785792,2020-07,3853.29,1119.98,3285.61,967.54,5051.38,3994.56
3267256018402785792,2020-08,1693.24,3046.69,6056.49,507.95,4195.09,8189.65
3267256018402785792,2020-09,2140.92,5356.08,1143.27,1213.19,-3285.08,4904.57
3267256018402785792,2020-10,925.92,2946.16,1073.19,1262.31,-2209.36,2695.21
3267256018402785792,2020-11,3353.24,886.64,1432.31,816.61,3082.3,5777.51
3267256018402785792,2020-12,1181.28,101.38,3162.99,3749.43,493.46,6270.97
3267664057401969664,2020-02,1172.52,1739,0,0,-566.48,-566.48
3267664057401969664,2020-03,1132.11,2652.36,0,0,-1520.25,-2086.73
3267664057401969664,2020-06,1290.78,0,0,0,1290.78,-795.95
3267664057401969664,2020-07,0,1700.85,0,0,-1700.85,-2496.8
3267664057401969664,2020-11,1977.74,0,0,0,1977.74,-519.06
3268312999995719680,2020-01,7545.52,2407.26,2385.14,13676.53,-6153.13,-6153.13
3268312999995719680,2020-02,2894.97,7232.91,371.51,8670.07,-12636.5,-18789.63
3268312999995719680,2020-03,4775.55,3685.13,5550.74,1751.05,4890.11,-13899.52
3268312999995719680,2020-04,7706.65,5897.2,62.44,4950.7,-3078.81,-16978.33
3268312999995719680,2020-05,2458.94,3839.24,3909.37,2910.92,-381.85,-17360.18
3268312999995719680,2020-06,5484.67,5287.69,2846.4,3224.74,-181.36,-17541.54
3268312999995719680,2020-07,0,9910.12,1772.75,3238.95,-11376.32,-28917.86
3268312999995719680,2020-08,9432.74,5409.62,500.98,6232.19,-1708.09,-30625.95
3268312999995719680,2020-09,5158.09,5511.55,8652.24,1004.21,7294.57,-23331.38
3268312999995719680,2020-10,5153.5,2941.01,4014.04,4568.25,1658.28,-21673.1
3268312999995719680,2020-11,2437.54,1739.79,1450.31,6753.52,-4605.46,-26278.56
3268312999995719680,2020-12,9798.66,3526.66,3870.35,5606.72,4535.63,-21742.93
3268458781927331840,2020-01,6007.27,4140.41,7133.13,5093.48,3906.51,3906.51
3268458781927331840,2020-02,5005.01,2921.13,3263.04,6047.28,-700.36,3206.15
3268458781927331840,2020-03,3079.32,10647.48,2083.26,2977.21,-8462.11,-5255.96
3268458781927331840,2020-04,9041.43,2243.68,4264.62,5502.39,5559.98,304.02
3268458781927331840,2020-05,7796,5038.05,4091.04,1136.94,5712.05,6016.07
3268458781927331840,2020-06,6037.38,2715.3,8484.62,1819.6,9987.1,16003.17
3268458781927331840,2020-07,7267.2,6469.39,5541.58,3100.32,3239.07,19242.24
3268458781927331840,2020-08,7955.75,4239.95,9624.02,2102.29,11237.53,30479.77
3268458781927331840,2020-09,7526.96,5174.93,3499.96,1497.8,4354.19,34833.96
3268458781927331840,2020-10,3219.16,5500.73,5418.49,5275.15,-2138.23,32695.73
3268458781927331840,2020-11,5042.11,423.41,8051.56,8051.19,4619.07,37314.8
3268458781927331840,2020-12,1570.74,4925.92,2654.16,2838.06,-3539.08,33775.72
3269070270664064512,2020-01,1992.62,0,3076.74,2884.28,2185.08,2185.08
3269070270664064512,2020-02,2583.23,3489.73,947.31,1501.49,-1460.68,724.4
3269070270664064512,2020-03,1660.93,319.89,227.59,3600.48,-2031.85,-1307.45
3269070270664064512,2020-04,2712.12,2948.54,4140.63,0,3904.21,2596.76
3269070270664064512,2020-05,573.55,6349.14,5131.08,1242.74,-1887.25,709.51
3269070270664064512,2020-06,1311.31,1223.55,774.91,0,862.67,1572.18
3269070270664064512,2020-07,1976.22,1252.48,1296.72,2475.82,-455.36,1116.82
3269070270664064512,2020-08,1579.19,1692.08,1581.48,1203.83,264.76,1381.58
3269070270664064512,2020-09,670.05,1383.99,0,0,-713.94,667.64
3269070270664064512,2020-10,725.04,0,8063.61,2257.09,6531.56,7199.2
3269070270664064512,2020-11,3445.72,1802.95,1703.74,0,3346.51,10545.71
3269715700421783040,2020-01,3578.6,3395.96,4321.28,2885.06,1618.86,1618.86
3269715700421783040,2020-02,4339.95,3614.82,3047.09,4187.58,-415.36,1203.5
3269715700421783040,2020-03,3559.29,801.31,6294.2,7919.14,1133.04,2336.54
3269715700421783040,2020-04,10961.82,3447.69,11260.7,353.01,18421.82,20758.36
3269715700421783040,2020-05,4848.1,7530.04,2883.87,2280.41,-2078.48,18679.88
3269715700421783040,2020-06,3635.53,2346.68,8265.16,3856.65,5697.36,24377.24
3269715700421783040,2020-07,80.9,5981.33,2902.81,3515.81,-6513.43,17863.81
3269715700421783040,2020-08,2750.38,1784.67,3433.87,860.09,3539.49,21403.3
3269715700421783040,2020-09,8494.52,2453.24,4995.62,7048.39,3988.51,25391.81
3269715700421783040,2020-10,8571.68,4150.37,5829.87,6318.57,3932.61,29324.42
3269715700421783040,2020-11,3789.56,4981.45,12032.57,4140.55,6700.13,36024.55
3269715700421783040,2020-12,5270.38,5702.56,4203.16,2512.14,1258.84,37283.39
3270999487477747200,2020-01,3828.59,2213.74,2766.82,1377.64,3004.03,3004.03
3270999487477747200,2020-02,0,1651.38,7564.81,83.24,5830.19,8834.22
3270999487477747200,2020-03,6527.86,3271.31,918.02,6892.42,-2717.85,6116.37
3270999487477747200,2020-04,2331.73,499.7,3242.76,3877.72,1197.07,7313.44
3270999487477747200,2020-05,3407.67,4480.05,1201.69,3342.17,-3212.86,4100.58
3270999487477747200,2020-06,2905.11,1291.62,3496.59,4140.37,969.71,5070.29
3270999487477747200,2020-07,839.3,1821.39,6330.94,2257.54,3091.31,8161.6
3270999487477747200,2020-08,5546.45,851.9,5186.59,2726.25,7154.89,15316.49
3270999487477747200,2020-09,3683.68,0,2504.56,1860.23,4328.01,19644.5
3270999487477747200,2020-10,4818.1,139.03,1611.43,2041.35,4249.15,23893.65
3270999487477747200,2020-11,340.18,1692.64,5557.39,5095.09,-890.16,23003.49
3270999487477747200,2020-12,1036.81,0,782.13,5088.89,-3269.95,19733.54
3271656324808283136,2020-01,1238.48,2811.04,745.7,1223.37,-2050.23,-2050.23
3271656324808283136,2020-02,0,3259.24,176.41,0,-3082.83,-5133.06
3271656324808283136,2020-03,4594.58,0,1933.92,1865.12,4663.38,-469.68
3271656324808283136,2020-04,2044.69,425.62,925.09,5974.45,-3430.29,-3899.97
3271656324808283136,2020-05,1857.29,0,977.8,3082.03,-246.94,-4146.91
3271656324808283136,2020-06,0,925.51,0,471.41,-1396.92,-5543.83
3271656324808283136,2020-07,1307.65,0,1234.79,176.22,2366.22,-3177.61
3271656324808283136,2020-09,564.09,3801.37,784.56,1934.44,-4387.16,-7564.77
3271656324808283136,2020-10,0,64.42,2944.93,1262.63,1617.88,-5946.89
3271656324808283136,2020-11,1678.26,1722.44,0,0,-44.18,-5991.07
3271656324808283136,2020-12,4659.77,2381.93,1786.84,3366.05,698.63,-5292.44
3272510303713615360,2020-01,4630.14,5249.09,1989.8,3927.87,-2557.02,-2557.02
3272510303713615360,2020-02,3051.31,5903.28,3678.33,5185.13,-4358.77,-6915.79
3272510303713615360,2020-03,5884.45,5800.99,7093.36,0,7176.82,261.03
3272510303713615360,2020-04,2991.63,14383.43,7547.06,1788,-5632.74,-5371.71
3272510303713615360,2020-05,3606.92,1512.18,500.96,6191.86,-3596.16,-8967.87
3272510303713615360,2020-06,2921.51,8628.55,2961.94,2473.43,-5218.53,-14186.4
3272510303713615360,2020-07,1821.07,3152.34,4229.14,4784.45,-1886.58,-16072.98
3272510303713615360,2020-08,3618.28,3282.44,3117.51,3343.46,109.89,-15963.09
3272510303713615360,2020-09,1907.08,2450.32,5026.59,2872.97,1610.38,-14352.71
3272510303713615360,2020-10,2476.02,8353.5,993.33,3129.43,-8013.58,-22366.29
3272510303713615360,2020-11,3653.47,5779.88,2350.08,3587.47,-3363.8,-25730.09
3272510303713615360,2020-12,1343.01,2509.45,993.53,3137.59,-3310.5,-29040.59
3272536163477341696,2020-01,1310.69,0,1797.58,1662.13,1446.14,1446.14
3272536163477341696,2020-02,0,1796.38,1079.19,0,-717.19,728.95
3272536163477341696,2020-04,32.29,1476.06,0,0,-1443.77,-714.82
3272536163477341696,2020-05,0,1938.29,0,0,-1938.29,-2653.11
3272536163477341696,2020-07,793.63,1533.27,0,403.56,-1143.2,-3796.31
3272536163477341696,2020-11,1591.93,1631.8,0,1801.36,-1841.23,-5637.54
3272862574335167488,2020-01,1441.82,1451.55,3160.84,3226.77,-75.66,-75.66
3272862574335167488,2020-02,2570.04,1259.14,2272.52,2426.31,1157.11,1081.45
3272862574335167488,2020-03,2059.88,6321.45,4087.54,2906.4,-3080.43,-1998.98
3272862574335167488,2020-04,2311.32,3719.4,3993.85,1830.54,755.23,-1243.75
3272862574335167488,2020-05,4606.62,2269.79,8788.3,6538.35,4586.78,3343.03
3272862574335167488,2020-06,1585.22,3122.38,1613.8,2948.2,-2871.56,471.47
3272862574335167488,2020-07,1657.64,9734.95,6676.21,5566.43,-6967.53,-6496.06
3272862574335167488,2020-08,2338.25,3259.97,6430.61,580.07,4928.82,-1567.24
3272862574335167488,2020-09,5379.29,4906.37,317.54,5585.46,-4795,-6362.24
3272862574335167488,2020-10,3197.09,5284.99,735.32,1857.78,-3210.36,-9572.6
3272862574335167488,2020-11,1810.94,2989,4091.65,6795.81,-3882.22,-13454.82
3272862574335167488,2020-12,3032.16,1845.38,3415.82,1442.38,3160.22,-10294.6
3273140494056545280,2020-02,0,1731.52,0,0,-1731.52,-1731.52
3273140494056545280,2020-05,0,360.97,0,873.28,-1234.25,-2965.77
3273140494056545280,2020-09,0,692.83,0,1060.28,-1753.11,-4718.88
3273140494056545280,2020-11,554.72,0,990.21,0,1544.93,-3173.95
3273210742701929472,2020-01,2639.6,2736.71,4261.57,2158.96,2005.5,2005.5
3273210742701929472,2020-02,5246.91,3664.18,3586.24,1252.72,3916.25,5921.75
3273210742701929472,2020-03,4658.42,1692.87,9224.67,1457.34,10732.88,16654.63
3273210742701929472,2020-04,1765.48,5888.48,1027.74,3338.83,-6434.09,10220.54
3273210742701929472,2020-05,4582.44,1922.17,624.29,914.57,2369.99,12590.53
3273210742701929472,2020-06,2342.25,3020.48,5705.78,554.72,4472.83,17063.36
3273210742701929472,2020-07,2352.77,5074.94,3960.02,1081.33,156.52,17219.88
3273210742701929472,2020-08,1932.74,1729.78,1368.84,7445.31,-5873.51,11346.37
3273210742701929472,2020-09,3062.22,5073.87,234.21,1618.28,-3395.72,7950.65
3273210742701929472,2020-10,1894.61,2058.87,9119.51,1744.67,7210.58,15161.23
3273210742701929472,2020-11,1839.76,2552.02,0,4353.16,-5065.42,10095.81
3273210742701929472,2020-12,3952.93,2505.97,3417.98,420.08,4444.86,14540.67
3273785372768116224,2020-01,585.41,3495.14,2845.53,3132.74,-3196.94,-3196.94
3273785372768116224,2020-02,1353.43,1038.26,3122.73,2460.9,977,-2219.94
3273785372768116224,2020-03,217.24,3330.88,428.76,3009.05,-5693.93,-7913.87
3273785372768116224,2020-04,492.17,3665.47,4745.45,946.93,625.22,-7288.65
3273785372768116224,2020-05,1311.23,3395.75,1589.02,3340.82,-3836.32,-11124.97
3273785372768116224,2020-06,2320.31,0,0,0,2320.31,-8804.66
3273785372768116224,2020-07,2214.9,3826.17,1208.9,256.67,-659.04,-9463.7
3273785372768116224,2020-08,2663.21,799.74,2960.93,0,4824.4,-4639.3
3273785372768116224,2020-09,1686.85,1940.96,1880.39,2025.86,-399.58,-5038.88
3273785372768116224,2020-10,1051.38,4176.13,1467.52,0,-1657.23,-6696.11
3273785372768116224,2020-11,851.65,0,2862.79,168.52,3545.92,-3150.19
3273785372768116224,2020-12,2541.38,705.32,2179.22,0,4015.28,865.09
3275236700112787456,2020-01,0,4920.55,4160.29,1851,-2611.26,-2611.26
3275236700112787456,2020-02,569.53,495.19,699.2,2983.12,-2209.58,-4820.84
3275236700112787456,2020-03,3648.88,1448.39,5844.48,7427.34,617.63,-4203.21
3275236700112787456,2020-04,0,6762.11,1315.63,2527.55,-7974.03,-12177.24
3275236700112787456,2020-05,2954.44,3500.44,4505.17,2956.93,1002.24,-11175
3275236700112787456,2020-06,2000.3,7269.71,3236.37,1602.32,-3635.36,-14810.36
3275236700112787456,2020-07,3603.58,1553.8,0,3277.01,-1227.23,-16037.59
3275236700112787456,2020-08,6508,5537.27,619.69,2863,-1272.58,-17310.17
3275236700112787456,2020-09,6216.91,1982.91,5575.41,1846.9,7962.51,-9347.66
3275236700112787456,2020-10,5174.49,636.34,7808.66,3486.14,8860.67,-486.99
3275236700112787456,2020-11,6107.2,6036.98,1373,10409.98,-8966.76,-9453.75
3275236700112787456,2020-12,3718.05,1349.94,8376.18,1531.61,9212.68,-241.07
3277053838294993408,2020-02,1895.06,0,1454.34,0,3349.4,3349.4
3277053838294993408,2020-03,0,1470.43,0,0,-1470.43,1878.97
3277053838294993408,2020-12,0,1853.19,0,0,-1853.19,25.78
3277979390263658496,2020-01,5002.39,2135.73,6819.42,5583.78,4102.3,4102.3
3277979390263658496,2020-02,1100.52,1651.69,0,946.5,-1497.67,2604.63
3277979390263658496,2020-03,5899.7,5663.64,453.24,0,689.3,3293.93
3277979390263658496,2020-04,9949.42,4399.4,7602.44,3979.94,9172.52,12466.45
3277979390263658496,2020-05,1404.45,19.64,3378.45,1731.91,3031.35,15497.8
3277979390263658496,2020-06,4345.49,0,1514.79,359.74,5500.54,20998.34
3277979390263658496,2020-07,3046.67,8716.77,4787.59,4431.93,-5314.44,15683.9
3277979390263658496,2020-08,382.86,1696.04,2475.09,3276.99,-2115.08,13568.82
3277979390263658496,2020-09,2115.61,5241.12,7512.83,5231.46,-844.14,12724.68
3277979390263658496,2020-10,4369.47,2999.89,4395.54,3444.3,2320.82,15045.5
3277979390263658496,2020-11,498.81,2569.18,3021.42,5639.36,-4688.31,10357.19
3277979390263658496,2020-12,2617.04,2295.76,2252.44,837.69,1736.03,12093.22
3278588752260820992,2020-01,4195.12,4191.57,7520.64,4412,3112.19,3112.19
3278588752260820992,2020-02,2853.3,2254.27,2705.07,2354.71,949.39,4061.58
3278588752260820992,2020-03,2958.39,4482.42,3067.78,3983.82,-2440.07,1621.51
3278588752260820992,2020-04,3489.97,3878.69,3329.73,4256.37,-1315.36,306.15
3278588752260820992,2020-05,4087.2,5101.5,4502.04,5118.9,-1631.16,-1325.01
3278588752260820992,2020-06,3792.31,4513.83,4427.38,2746.29,959.57,-365.44
3278588752260820992,2020-07,0,1153.52,2962.96,2928.3,-1118.86,-1484.3
3278588752260820992,2020-08,4270.95,2765.6,6916.23,8477.39,-55.81,-1540.11
3278588752260820992,2020-09,3467.1,2151.32,4471.6,2739.65,3047.73,1507.62
3278588752260820992,2020-10,1170.44,1078.89,6244.81,287.61,6048.75,7556.37
3278588752260820992,2020-11,2134.43,3632.39,1852.51,7519.46,-7164.91,391.46
3278588752260820992,2020-12,3850.78,1949.06,556.38,2614.97,-156.87,234.59
3278762802776664576,2020-01,5337.97,1487.19,6977.79,2826.56,8002.01,8002.01
3278762802776664576,2020-02,4791.72,3716.94,4192.89,0,5267.67,13269.68
3278762802776664576,2020-03,3485.81,5216.04,1706.56,3461.83,-3485.5,9784.18
3278762802776664576,2020-04,10165.32,3396.53,848.16,3244.8,4372.15,14156.33
3278762802776664576,2020-05,9697.08,5833.96,694.13,0,4557.25,18713.58
3278762802776664576,2020-06,3351.46,5477.02,1299.73,5006.38,-5832.21,12881.37
3278762802776664576,2020-07,6096.66,7336,3786.37,854.68,1692.35,14573.72
3278762802776664576,2020-08,8039.53,8495.66,3785.05,2850.24,478.68,15052.4
3278762802776664576,2020-09,240.98,7965.26,2056.15,2919.16,-8587.29,6465.11
3278762802776664576,2020-10,3200.42,2166.97,5186.64,5789.23,430.86,6895.97
3278762802776664576,2020-11,1080.06,4679.29,6952.64,7298.15,-3944.74,2951.23
3278762802776664576,2020-12,5346.7,6368.4,5350.35,1786.51,2542.14,5493.37
3278842056091521024,2020-01,1555.98,0,0,6574.92,-5018.94,-5018.94
3278842056091521024,2020-02,871.84,319.23,0,1624.92,-1072.31,-6091.25
3278842056091521024,2020-03,1313.04,2834.51,1965.65,1888.64,-1444.46,-7535.71
3278842056091521024,2020-04,2778.95,4015.74,1274.1,3509.86,-3472.55,-11008.26
3278842056091521024,2020-05,967.05,2116.32,1412.17,944.88,-681.98,-11690.24
3278842056091521024,2020-06,2322.89,2404.2,2358.04,0,2276.73,-9413.51
3278842056091521024,2020-07,1885.7,4139.42,2297.25,0,43.53,-9369.98
3278842056091521024,2020-08,587.6,0,858.52,755.87,690.25,-8679.73
3278842056091521024,2020-10,3544.12,2426.4,3272.53,4666.82,-276.57,-8956.3
3278842056091521024,2020-11,1112.95,2045.22,1504.27,1892.05,-1320.05,-10276.35
3278842056091521024,2020-12,92.7,0,535.01,830.84,-203.13,-10479.48
3279377757811562496,2020-01,2407.85,4449.13,6419.43,5900.23,-1522.08,-1522.08
3279377757811562496,2020-02,4205.16,2604.58,925.27,3979.75,-1453.9,-2975.98
3279377757811562496,2020-03,2221.88,1766.54,6497.41,4993.18,1959.57,-1016.41
3279377757811562496,2020-04,2089.75,3473.38,2108.64,5582.73,-4857.72,-5874.13
3279377757811562496,2020-05,1484.41,4081.47,10.5,4455.07,-7041.63,-12915.76
3279377757811562496,2020-06,2181.29,3095.86,8048.12,0,7133.55,-5782.21
3279377757811562496,2020-07,8017.94,2071.25,718.03,0,6664.72,882.51
3279377757811562496,2020-08,2853.13,297.86,2844.21,3446.07,1953.41,2835.92
3279377757811562496,2020-09,387.59,3489.61,1909.02,5278.32,-6471.32,-3635.4
3279377757811562496,2020-10,1868.66,1082.73,3473.14,0,4259.07,623.67
3279377757811562496,2020-11,4945.91,1657.14,2017.91,3130.74,2175.94,2799.61
3279377757811562496,2020-12,1463.92,0,3692.42,3043.17,2113.17,4912.78
3280260396146287104,2020-01,0,2021.75,5367.88,3584.2,-238.07,-238.07
3280260396146287104,2020-02,4640.85,5015.82,3013.9,1278.04,1360.89,1122.82
3280260396146287104,2020-03,3333.74,1821.62,2308.21,3846.02,-25.69,1097.13
3280260396146287104,2020-04,4796.04,2479.4,1875.32,2699.69,1492.27,2589.4
3280260396146287104,2020-05,8917.02,1741.34,979.81,2052.6,6102.89,8692.29
3280260396146287104,2020-06,7799.67,2282.32,2363.64,6339.43,1541.56,10233.85
3280260396146287104,2020-07,1255.92,2345.67,0,3431.77,-4521.52,5712.33
3280260396146287104,2020-08,1185.69,2642.99,3845.58,3008.49,-620.21,5092.12
3280260396146287104,2020-09,1688.84,1088.04,3708.05,3590.39,718.46,5810.58
3280260396146287104,2020-10,5416.96,7000.76,637.64,1740.72,-2686.88,3123.7
3280260396146287104,2020-11,5897.74,5142.36,5423.35,4762.61,1416.12,4539.82
3280260396146287104,2020-12,726.05,2728.8,0,4426.95,-6429.7,-1889.88
3281262254031159808,2020-01,3641.71,3347.03,3488.04,927.25,2855.47,2855.47
3281262254031159808,2020-02,3174.23,947.61,890.2,5132.82,-2016,839.47
3281262254031159808,2020-03,1725.56,925.61,256.46,0,1056.41,1895.88
3281262254031159808,2020-04,2472.77,3022.08,0,4679,-5228.31,-3332.43
3281262254031159808,2020-05,0,683.17,3410.75,2485.12,242.46,-3089.97
3281262254031159808,2020-06,553.37,3811.12,0,2769.65,-6027.4,-9117.37
3281262254031159808,2020-07,2062.81,32.74,937.81,246.59,2721.29,-6396.08
3281262254031159808,2020-08,0,1519.78,2749.95,1410.42,-180.25,-6576.33
3281262254031159808,2020-09,2215.06,3027.28,3098.36,4198.31,-1912.17,-8488.5
3281262254031159808,2020-10,4669.6,1704.24,2323.74,726.47,4562.63,-3925.87
3281262254031159808,2020-11,615.61,1746.44,1964.8,2345.49,-1511.52,-5437.39
3281262254031159808,2020-12,2878.97,1989.66,2296.15,0,3185.46,-2251.93
3281948945899053568,2020-01,2806.49,3364.81,2802.87,1815.1,429.45,429.45
3281948945899053568,2020-02,3982.26,182.05,1880.91,5636.68,44.44,473.89
3281948945899053568,2020-03,1601.6,4508.96,3645.94,1481.86,-743.28,-269.39
3281948945899053568,2020-04,1653.32,1415.63,6590.58,2364.1,4464.17,4194.78
3281948945899053568,2020-05,2317.48,5483.88,2391.67,1110.69,-1885.42,2309.36
3281948945899053568,2020-06,4390.88,6224.03,7477.09,8347.53,-2703.59,-394.23
3281948945899053568,2020-07,4427.3,2005.12,6908.15,514.03,8816.3,8422.07
3281948945899053568,2020-08,1388.25,3848.93,5900.25,6985.91,-3546.34,4875.73
3281948945899053568,2020-09,2383.57,6993.58,9196.17,930.72,3655.44,8531.17
3281948945899053568,2020-10,7338.22,772.33,2545.25,6194.35,2916.79,11447.96
3281948945899053568,2020-11,3722.28,2518.61,6339.71,1226.47,6316.91,17764.87
3281948945899053568,2020-12,2595.1,3107.02,4840.05,1664.39,2663.74,20428.61
3282330153492757504,2020-01,1443.63,0,721.09,0,2164.72,2164.72
3282330153492757504,2020-03,1038.07,2302.14,1505.9,1314.4,-1072.57,1092.15
3282330153492757504,2020-05,1819.47,1367.26,411.2,3049.77,-2186.36,-1094.21
3282330153492757504,2020-07,929.14,1629.26,1035.04,2637.32,-2302.4,-3396.61
3282330153492757504,2020-08,2248.87,3473.39,0,1315.7,-2540.22,-5936.83
3282330153492757504,2020-09,3762.86,0,1737.12,949.46,4550.52,-1386.31
3282330153492757504,2020-10,2891.16,0,0,730.29,2160.87,774.56
3282330153492757504,2020-11,73.09,595.33,1907.27,385.71,999.32,1773.88
3282330153492757504,2020-12,0,1717.07,28.78,0,-1688.29,85.59
3282506837330691584,2020-03,1951.68,0,0,0,1951.68,1951.68
3282506837330691584,2020-05,1263.26,0,0,1842.26,-579,1372.68
3282506837330691584,2020-10,0,658.8,960.82,0,302.02,1674.7
3282506837330691584,2020-12,335.96,0,1289.69,0,1625.65,3300.35
3283358264527015936,2020-01,1627.95,832.78,2429.24,0,3224.41,3224.41
3283358264527015936,2020-02,1377.35,908.38,544.03,0,1013,4237.41
3283358264527015936,2020-03,5192.99,3520.85,223.08,3364.42,-1469.2,2768.21
3283358264527015936,2020-04,852.21,0,0,1297.93,-445.72,2322.49
3283358264527015936,2020-05,977.24,1507.31,1006.55,1353.3,-876.82,1445.67
3283358264527015936,2020-06,3760.16,1167.44,1215.4,2002.87,1805.25,3250.92
3283358264527015936,2020-07,376.43,1628.57,0,793.17,-2045.31,1205.61
3283358264527015936,2020-08,3524.83,3790.44,0,1439.07,-1704.68,-499.07
3283358264527015936,2020-09,1877.19,1720.49,1375.81,2035.54,-503.03,-1002.1
3283358264527015936,2020-10,0,1226.83,1231.25,2219.8,-2215.38,-3217.48
3283358264527015936,2020-11,1843.33,0,1089.86,1917.86,1015.33,-2202.15
3283358264527015936,2020-12,1034.78,1232.83,0,0,-198.05,-2400.2
3283430474985122816,2020-01,0,1780.79,1983.18,1037.35,-834.96,-834.96
3283430474985122816,2020-02,2978.4,5665.83,864.79,2407.18,-4229.82,-5064.78
3283430474985122816,2020-03,757.5,1893.33,1644.84,5943.94,-5434.93,-10499.71
3283430474985122816,2020-04,3537.44,2963.37,2022.24,1438.65,1157.66,-9342.05
3283430474985122816,2020-05,2133.67,3594.99,1923.17,333.2,128.65,-9213.4
3283430474985122816,2020-06,1357.26,2030.95,4443.56,342.89,3426.98,-5786.42
3283430474985122816,2020-07,2637.66,1300.57,0,3142.1,-1805.01,-7591.43
3283430474985122816,2020-08,1243.69,2705.92,5088.13,2619.69,1006.21,-6585.22
3283430474985122816,2020-09,3175.62,4243.44,8054.93,1747.81,5239.3,-1345.92
3283430474985122816,2020-10,3318.86,2585.18,2593.18,4089.23,-762.37,-2108.29
3283430474985122816,2020-11,1304.48,1090.1,154.98,1363.45,-994.09,-3102.38
3283430474985122816,2020-12,4515.72,1798.5,2473.43,3277.17,1913.48,-1188.9
3283502433701884928,2020-01,2443.81,1498.63,4156.32,2617.56,2483.94,2483.94
3283502433701884928,2020-02,1441.78,2382.62,2177.56,0,1236.72,3720.66
3283502433701884928,2020-03,3787.7,0,3533.11,1680.87,5639.94,9360.6
3283502433701884928,2020-04,2729.91,2027.59,2479.38,4983.14,-1801.44,7559.16
3283502433701884928,2020-05,1137.85,2395.65,1952.82,3208.38,-2513.36,5045.8
3283502433701884928,2020-06,0,3088.12,3351.96,1801.83,-1537.99,3507.81
3283502433701884928,2020-07,1070.51,0,1447.92,2175.39,343.04,3850.85
3283502433701884928,2020-08,2288.93,999.61,103.75,1308.9,84.17,3935.02
3283502433701884928,2020-10,4030.23,2437.75,6728.43,2367.48,5953.43,9888.45
3283502433701884928,2020-11,2414.58,3712.99,2974.02,1240.08,435.53,10323.98
3283502433701884928,2020-12,1527.37,2219.65,2523.53,2655.57,-824.32,9499.66
3283921769975809536,2020-01,2564.77,985.75,2422.16,1094.41,2906.77,2906.77
3283921769975809536,2020-02,0,4759.34,0,5137.49,-9896.83,-6990.06
3283921769975809536,2020-03,3474.48,0,0,2828.77,645.71,-6344.35
3283921769975809536,2020-05,0,1908.68,1935.97,0,27.29,-6317.06
3283921769975809536,2020-06,250.48,0,0,0,250.48,-6066.58
3283921769975809536,2020-07,919.33,0,1181.04,1114.31,986.06,-5080.52
3283921769975809536,2020-08,73.71,3266.19,818.97,2796.99,-5170.5,-10251.02
3283921769975809536,2020-12,3141.57,0,0,0,3141.57,-7109.45
3284423597980383744,2020-01,3447,1023.07,527.76,1354.03,1597.66,1597.66
3284423597980383744,2020-02,1973.25,373.44,1683.21,0,3283.02,4880.68
3284423597980383744,2020-03,3930.96,2486.26,894.96,1971.03,368.63,5249.31
3284423597980383744,2020-04,2731.22,3402.86,2171.77,5117.19,-3617.06,1632.25
3284423597980383744,2020-05,1205.14,3337.47,4783.35,1415.05,1235.97,2868.22
3284423597980383744,2020-06,403.33,2484.83,0,7396.5,-9478,-6609.78
3284423597980383744,2020-07,2086.58,587.79,747.97,0,2246.76,-4363.02
3284423597980383744,2020-08,1697.52,3495.71,959.73,4422.37,-5260.83,-9623.85
3284423597980383744,2020-09,1605.5,0,2493.78,2536.92,1562.36,-8061.49
3284423597980383744,2020-10,0,200.1,1500.9,2398.44,-1097.64,-9159.13
3284423597980383744,2020-11,962.66,2330.09,1971.42,4757.39,-4153.4,-13312.53
3284423597980383744,2020-12,4691.76,2047.94,3210.54,2331.8,3522.56,-9789.97
3286305951660850688,2020-01,2653.02,1637.91,1009.12,2395.11,-370.88,-370.88
3286305951660850688,2020-02,2450.6,3167.9,797.52,3481.91,-3401.69,-3772.57
3286305951660850688,2020-03,0,1425.03,0,880.65,-2305.68,-6078.25
3286305951660850688,2020-04,2923.94,1228.38,4750.75,0,6446.31,368.06
3286305951660850688,2020-05,0,2833.81,4318.86,1354.81,130.24,498.3
3286305951660850688,2020-06,5207.48,135.92,3977.4,3680.43,5368.53,5866.83
3286305951660850688,2020-07,3104.35,2833.93,2665.13,3051.64,-116.09,5750.74
3286305951660850688,2020-08,2106.76,3708.19,673.82,5375.99,-6303.6,-552.86
3286305951660850688,2020-09,6180.1,3823.79,0,1049.9,1306.41,753.55
3286305951660850688,2020-10,648.85,1393.47,4740.9,1611.7,2384.58,3138.13
3286305951660850688,2020-11,2692.68,0,2822.13,1949.25,3565.56,6703.69
3286305951660850688,2020-12,5522.95,5249.44,6309.87,1527.39,5055.99,11759.68
3286972901723977728,2020-01,2965.92,6491.11,1863.77,7116.35,-8777.77,-8777.77
3286972901723977728,2020-02,2902.12,1147.23,6443.35,141.35,8056.89,-720.88
3286972901723977728,2020-03,7259.28,1804.96,4406.57,3765.66,6095.23,5374.35
3286972901723977728,2020-04,6744.7,4202.39,1696.06,0,4238.37,9612.72
3286972901723977728,2020-05,3964.41,1602.68,5349.32,3486.21,4224.84,13837.56
3286972901723977728,2020-06,1885.67,2337.1,4238.98,4618.12,-830.57,13006.99
3286972901723977728,2020-07,3523.17,5784.32,1971.18,3676.65,-3966.62,9040.37
3286972901723977728,2020-08,4133.87,3077.32,5427.37,6583.32,-99.4,8940.97
3286972901723977728,2020-09,6626.88,3706,5495.65,5280.75,3135.78,12076.75
3286972901723977728,2020-10,4694.84,1472.52,3770.18,579.73,6412.77,18489.52
3286972901723977728,2020-11,2886.02,5975.22,4271.69,5207.39,-4024.9,14464.62
3286972901723977728,2020-12,2167.62,1183.8,8243.94,6091.99,3135.77,17600.39
3287018695953817088,2020-01,1675.58,2833.24,2372.45,5808.22,-4593.43,-4593.43
3287018695953817088,2020-02,3058.71,834.22,3206.09,0,5430.58,837.15
3287018695953817088,2020-03,4712.06,1929.82,20.72,1741.54,1061.42,1898.57
3287018695953817088,2020-04,1115.89,1552.49,2926.1,4011.33,-1521.83,376.74
3287018695953817088,2020-05,3371.73,1186.52,4483.72,842.88,5826.05,6202.79
3287018695953817088,2020-06,741.94,2873.2,2690.7,2161.77,-1602.33,4600.46
3287018695953817088,2020-07,5674.66,1161.66,996.23,3265.73,2243.5,6843.96
3287018695953817088,2020-08,2221.09,3954.74,1317.1,4424.71,-4841.26,2002.7
3287018695953817088,2020-09,17.6,2142.89,1030.83,3868.76,-4963.22,-2960.52
3287018695953817088,2020-10,1706.83,2485,1782.49,705.6,298.72,-2661.8
3287018695953817088,2020-11,2015.03,3374.08,264.74,0,-1094.31,-3756.11
3287018695953817088,2020-12,3970.05,2667.67,967.83,3658.15,-1387.94,-5144.05
3287868340542996480,2020-01,2250.11,7133.26,8182.71,3691.75,-392.19,-392.19
3287868340542996480,2020-02,4046.47,7007.36,5865,1772.23,1131.88,739.69
3287868340542996480,2020-03,2800.07,1720.15,1961.85,6811.93,-3770.16,-3030.47
3287868340542996480,2020-04,2128.6,1719.39,5025.03,2760.38,2673.86,-356.61
3287868340542996480,2020-05,1545.08,5269.42,3885.34,4230.67,-4069.67,-4426.28
3287868340542996480,2020-06,7137.99,5326.35,2764.16,2875.87,1699.93,-2726.35
3287868340542996480,2020-07,1299.29,3930.23,3328.43,54.85,642.64,-2083.71
3287868340542996480,2020-08,10296.35,2861.56,5219.1,821.64,11832.25,9748.54
3287868340542996480,2020-09,2481.21,1084.12,906.61,551.23,1752.47,11501.01
3287868340542996480,2020-10,8063.15,5051.65,3126.07,3458.46,2679.11,14180.12
3287868340542996480,2020-11,4808.56,9064.93,4306.53,7061.23,-7011.07,7169.05
3287868340542996480,2020-12,2299.95,1673.47,526.26,723.73,429.01,7598.06
3288466113706772992,2020-01,1992.53,1993.07,0,395.49,-396.03,-396.03
3288466113706772992,2020-02,3477.49,0,377.02,0,3854.51,3458.48
3288466113706772992,2020-03,582.62,0,1958.25,3293.12,-752.25,2706.23
3288466113706772992,2020-04,1313.4,2803.45,2586.59,3911.82,-2815.28,-109.05
3288466113706772992,2020-05,667.07,1590.51,4746.52,1509.02,2314.06,2205.01
3288466113706772992,2020-06,697.62,1239.25,1256.09,0,714.46,2919.47
3288466113706772992,2020-07,1544.57,787.97,947.12,1360.18,343.54,3263.01
3288466113706772992,2020-08,1446.12,494.6,0,674.7,276.82,3539.83
3288466113706772992,2020-10,0,2545.7,0,2317.48,-4863.18,-1323.35
3288466113706772992,2020-11,1641.94,2206.72,274.72,2483.08,-2773.14,-4096.49
3288466113706772992,2020-12,0,3770.16,793.97,0,-2976.19,-7072.68
3289208471304485888,2020-01,6768.01,8848.74,1684.2,3626.12,-4022.65,-4022.65
3289208471304485888,2020-02,10853.87,2971.51,4398.11,2928.58,9351.89,5329.24
3289208471304485888,2020-03,4628.26,3541.81,7191.46,2420.56,5857.35,11186.59
3289208471304485888,2020-04,1265.59,8275.38,1961.86,1967.23,-7015.16,4171.43
3289208471304485888,2020-05,6079.88,2908.79,1658.95,3915.47,914.57,5086
3289208471304485888,2020-06,4831.19,1605.87,1185.77,1133.15,3277.94,8363.94
3289208471304485888,2020-07,3786.46,4321.37,6787.65,2802.86,3449.88,11813.82
3289208471304485888,2020-08,3375.51,8211.66,3143.53,7599.68,-9292.3,2521.52
3289208471304485888,2020-09,598.23,4191.93,3812.85,7160.07,-6940.92,-4419.4
3289208471304485888,2020-10,5353.1,7437.9,4209.07,6708.01,-4583.74,-9003.14
3289208471304485888,2020-11,7434.82,355.63,1998.6,4947.74,4130.05,-4873.09
3289208471304485888,2020-12,1034.73,6237.02,2604.12,2286.87,-4885.04,-9758.13
3290363966638027264,2020-01,2541.92,711.27,3676.78,1576.27,3931.16,3931.16
3290363966638027264,2020-02,1937.08,2646.61,3695.83,2855.56,130.74,4061.9
3290363966638027264,2020-03,6129.57,2936.25,1564.09,8006.95,-3249.54,812.36
3290363966638027264,2020-04,6218.28,3573.03,8223.3,5831.04,5037.51,5849.87
3290363966638027264,2020-05,1036.2,2672.08,844.15,4514.72,-5306.45,543.42
3290363966638027264,2020-06,3140.88,5880.77,4217.52,2896.86,-1419.23,-875.81
3290363966638027264,2020-07,8568.57,6051.87,5004.9,7193.15,328.45,-547.36
3290363966638027264,2020-08,4494.86,6715.43,6914.58,1870.85,2823.16,2275.8
3290363966638027264,2020-09,308.82,6171.18,3740.67,7042.89,-9164.58,-6888.78
3290363966638027264,2020-10,2164.78,1110.56,2514.68,1944.09,1624.81,-5263.97
3290363966638027264,2020-11,3554.58,2320.29,2281.34,4175.72,-660.09,-5924.06
3290363966638027264,2020-12,3185.45,2665.38,3657.78,4967.85,-790,-6714.06
3291166808146569728,2020-01,4790.21,322.02,3939.23,0,8407.42,8407.42
3291166808146569728,2020-02,1192.47,2575.95,481.12,4630.34,-5532.7,2874.72
3291166808146569728,2020-03,1743.39,2789.27,0,5825.69,-6871.57,-3996.85
3291166808146569728,2020-04,646.97,1886.53,2827.51,1299.46,288.49,-3708.36
3291166808146569728,2020-05,1865.37,3518.38,4168.08,4877.92,-2362.85,-6071.21
3291166808146569728,2020-06,4085.93,6037.46,4845.06,103.26,2790.27,-3280.94
3291166808146569728,2020-07,111.96,1283.4,7019.39,6530.62,-682.67,-3963.61
3291166808146569728,2020-08,2083.34,1938.47,7834.89,0,7979.76,4016.15
3291166808146569728,2020-09,4484.76,4570.47,6026.04,0,5940.33,9956.48
3291166808146569728,2020-10,2165.97,1223.37,60.94,2361.92,-1358.38,8598.1
3291166808146569728,2020-11,5178.62,2781.27,3097.87,3486.03,2009.19,10607.29
3291166808146569728,2020-12,3532.99,4513,893.58,4107.36,-4193.79,6413.5
3291659121480913408,2020-01,1418.8,3300.39,947.44,0,-934.15,-934.15
3291659121480913408,2020-03,430.08,390.45,795.56,3346.85,-2511.66,-3445.81
3291659121480913408,2020-04,378.95,241.03,1213.69,1299.47,52.14,-3393.67
3291659121480913408,2020-05,1843.18,0,0,0,1843.18,-1550.49
3291659121480913408,2020-06,0,1236.9,446.2,2072.98,-2863.68,-4414.17
3291659121480913408,2020-07,41.2,1447.19,383.9,0,-1022.09,-5436.26
3291659121480913408,2020-09,1305.53,0,0,1718.55,-413.02,-5849.28
3291659121480913408,2020-11,1030.32,0,0,932.48,97.84,-5751.44
3291659121480913408,2020-12,1868.83,1967.36,0,293.9,-392.43,-6143.87
3292391390291119616,2020-01,0,320.38,1548.59,1784.42,-556.21,-556.21
3292391390291119616,2020-02,0,7563.34,0,45.91,-7609.25,-8165.46
3292391390291119616,2020-03,859.35,708.01,664.33,1779.71,-964.04,-9129.5
3292391390291119616,2020-04,1750.48,2677.69,156.51,353.58,-1124.28,-10253.78
3292391390291119616,2020-05,1655.38,2937.78,2099.43,1084.45,-267.42,-10521.2
3292391390291119616,2020-06,4140.67,972.93,1945.68,0,5113.42,-5407.78
3292391390291119616,2020-07,0,1458.26,2868.61,2343.48,-933.13,-6340.91
3292391390291119616,2020-08,2179.34,3474.52,0,0,-1295.18,-7636.09
3292391390291119616,2020-09,1196.21,1020.26,1677.12,1301.62,551.45,-7084.64
3292391390291119616,2020-10,0,2815.52,0,963.26,-3778.78,-10863.42
3292391390291119616,2020-11,1590.3,0,0,1154.2,436.1,-10427.32
3292606133626449920,2020-01,0,799.73,1354.35,436.14,118.48,118.48
3292606133626449920,2020-02,0,4770.52,0,2477.54,-7248.06,-7129.58
3292606133626449920,2020-03,1096.36,1451.78,0,571.79,-927.21,-8056.79
3292606133626449920,2020-04,632.96,915.92,2348.84,3036.78,-970.9,-9027.69
3292606133626449920,2020-05,2554.24,1148.12,0,0,1406.12,-7621.57
3292606133626449920,2020-06,1211.59,0,1630.28,1970.4,871.47,-6750.1
3292606133626449920,2020-07,1867.31,1007.22,527.76,1876.79,-488.94,-7239.04
3292606133626449920,2020-08,2978.48,2028.58,1302.28,0,2252.18,-4986.86
3292606133626449920,2020-09,4053.79,27.11,1580.05,0,5606.73,619.87
3292606133626449920,2020-10,1190.84,822.72,2476.06,0,2844.18,3464.05
3292606133626449920,2020-11,959.76,1252.18,80.16,1916.66,-2128.92,1335.13
3292606133626449920,2020-12,1456.51,1134.4,0,0,322.11,1657.24
3293023819533272064,2020-01,6324.05,8843.5,6522.74,3085.52,917.77,917.77
3293023819533272064,2020-02,3351.46,4871.67,3614.35,4436.78,-2342.64,-1424.87
3293023819533272064,2020-03,3448.82,6221.76,559.58,3054.26,-5267.62,-6692.49
3293023819533272064,2020-04,0,2111.15,4046.48,2536.78,-601.45,-7293.94
3293023819533272064,2020-05,5437.88,4293.08,2074.72,789.37,2430.15,-4863.79
3293023819533272064,2020-06,2816.5,2240.64,0,3933.05,-3357.19,-8220.98
3293023819533272064,2020-07,4783.39,7238.25,5827.69,1487.34,1885.49,-6335.49
3293023819533272064,2020-08,3057.12,7286.23,3136.09,6352.75,-7445.77,-13781.26
3293023819533272064,2020-09,4151.97,287.34,3201.83,1481.75,5584.71,-8196.55
3293023819533272064,2020-10,6467.07,4580.49,1183.42,8911.52,-5841.52,-14038.07
3293023819533272064,2020-11,3710.83,2742.93,8537.53,3879.85,5625.58,-8412.49
3293023819533272064,2020-12,4281.9,1007.51,7526.96,2759.45,8041.9,-370.59
3293600785620191232,2020-01,1216.09,3506.15,4340.71,6120.92,-4070.27,-4070.27
3293600785620191232,2020-02,5884.15,2877.92,3109.64,3165.56,2950.31,-1119.96
3293600785620191232,2020-03,4087.92,798.31,5360.56,6498.44,2151.73,1031.77
3293600785620191232,2020-04,3682.63,681.43,5982.04,3389.63,5593.61,6625.38
3293600785620191232,2020-05,5037.44,4345.11,4507.97,3723.6,1476.7,8102.08
3293600785620191232,2020-06,1551.08,879.65,2124.84,3370.27,-574,7528.08
3293600785620191232,2020-07,3568.97,3593.78,1792.37,3609.34,-1841.78,5686.3
3293600785620191232,2020-08,3360.26,716.05,4304.37,1924.26,5024.32,10710.62
3293600785620191232,2020-09,5085.83,3768.94,0,2219.24,-902.35,9808.27
3293600785620191232,2020-10,1713.06,2359.86,5067.37,1702.73,2717.84,12526.11
3293600785620191232,2020-11,2225.7,3477.26,605.45,6290.51,-6936.62,5589.49
3293600785620191232,2020-12,1503.91,3592.03,1897.3,6516.45,-6707.27,-1117.78
3295563812046364672,2020-01,1287.6,4125.4,7449.91,5151.86,-539.75,-539.75
3295563812046364672,2020-02,3980.49,2537.55,8400.18,5719.91,4123.21,3583.46
3295563812046364672,2020-03,4218.73,4274.08,2207.86,5446.73,-3294.22,289.24
3295563812046364672,2020-04,6624.59,2871.42,1806.65,899.51,4660.31,4949.55
3295563812046364672,2020-05,10173.06,4825.91,3544.92,3685.37,5206.7,10156.25
3295563812046364672,2020-06,3330.79,6098.12,1441.64,5219.72,-6545.41,3610.84
3295563812046364672,2020-07,3017.46,4646.71,4870.57,6956.77,-3715.45,-104.61
3295563812046364672,2020-08,0,11254.35,3166.46,3740.28,-11828.17,-11932.78
3295563812046364672,2020-09,8570.8,3975.28,2796.16,2965.84,4425.84,-7506.94
3295563812046364672,2020-10,4037.94,3809.61,7417.07,4588.93,3056.47,-4450.47
3295563812046364672,2020-11,5087.74,1209.88,3887.16,1891.71,5873.31,1422.84
3295563812046364672,2020-12,0,474.96,3941.88,2754.09,712.83,2135.67
3296133002390909440,2020-01,5141.13,4478.77,1098.99,1107.22,654.13,654.13
3296133002390909440,2020-02,1876.21,3342.27,654.03,531.5,-1343.53,-689.4
3296133002390909440,2020-03,5460.85,1662.14,1315.56,0,5114.27,4424.87
3296133002390909440,2020-04,424.51,5345.44,1380.33,1971.1,-5511.7,-1086.83
3296133002390909440,2020-05,1163.68,0,1274.32,0,2438,1351.17
3296133002390909440,2020-06,2466.34,0,4921.89,2491.99,4896.24,6247.41
3296133002390909440,2020-07,1915.8,4965.31,3369.58,416.39,-96.32,6151.09
3296133002390909440,2020-08,3436.9,3362.89,2773.51,358.85,2488.67,8639.76
3296133002390909440,2020-09,2957.09,384.98,1806.8,1542.66,2836.25,11476.01
3296133002390909440,2020-10,0,1245.45,2620.6,399.3,975.85,12451.86
3296133002390909440,2020-11,3762.07,9279.5,3105.56,12.48,-2424.35,10027.51
3296133002390909440,2020-12,1012.33,4438.63,212.63,3724.5,-6938.17,3089.34
3297136392135741952,2020-01,2840.17,6005.43,1552.96,4896.89,-6509.19,-6509.19
3297136392135741952,2020-02,4347.3,3838.79,1421.5,0,1930.01,-4579.18
3297136392135741952,2020-03,2321.44,7605.67,579.05,3773.11,-8478.29,-13057.47
3297136392135741952,2020-04,634.68,2269.87,4030.29,9746.18,-7351.08,-20408.55
3297136392135741952,2020-05,2537.55,3691.45,0,0,-1153.9,-21562.45
3297136392135741952,2020-06,1635.43,1156.9,5504.6,1539.47,4443.66,-17118.79
3297136392135741952,2020-07,4400.03,3192.36,987.13,2966.08,-771.28,-17890.07
3297136392135741952,2020-08,2552.03,6987.97,0,2378.09,-6814.03,-24704.1
3297136392135741952,2020-09,1761.89,6446.46,1778.02,1723.94,-4630.49,-29334.59
3297136392135741952,2020-10,4827.98,4193.83,4477.35,999.28,4112.22,-25222.37
3297136392135741952,2020-11,3186.84,3420.97,2756.84,0,2522.71,-22699.66
3297136392135741952,2020-12,1944.43,7191.17,135.15,2897.9,-8009.49,-30709.15
3297939544648407552,2020-01,4696.17,1939.63,1228.67,1381.99,2603.22,2603.22
3297939544648407552,2020-03,48.48,303.11,2065.82,2689.59,-878.4,1724.82
3297939544648407552,2020-04,2119.11,0,1629.81,1166.38,2582.54,4307.36
3297939544648407552,2020-05,0,3259.73,0,2110.07,-5369.8,-1062.44
3297939544648407552,2020-06,170.18,1120.97,2329.28,1500.9,-122.41,-1184.85
3297939544648407552,2020-07,0,2838.24,2783.29,1162.22,-1217.17,-2402.02
3297939544648407552,2020-08,216.23,1725.53,1500.21,0,-9.09,-2411.11
3297939544648407552,2020-09,2432.47,360.12,518.83,0,2591.18,180.07
3297939544648407552,2020-10,3317.54,2964.14,1831.58,3778.26,-1593.28,-1413.21
3297939544648407552,2020-11,0,1288.37,0,1332.98,-2621.35,-4034.56
3297939544648407552,2020-12,0,1776.51,3536.44,2160.43,-400.5,-4435.06
3298364747192051200,2020-01,6310.04,1045.21,4619.29,2305.12,7579,7579
3298364747192051200,2020-02,1807.38,2625.67,2375.69,2139.62,-582.22,6996.78
3298364747192051200,2020-03,1465.19,3419.78,3350.68,5872.62,-4476.53,2520.25
3298364747192051200,2020-04,487.38,2880,2035.43,2587.9,-2945.09,-424.84
3298364747192051200,2020-05,4232.23,4850.94,3238.65,1437.47,1182.47,757.63
3298364747192051200,2020-06,1801.19,2167.46,4053.37,0,3687.1,4444.73
3298364747192051200,2020-07,2446.54,1744.41,0,6927.35,-6225.22,-1780.49
3298364747192051200,2020-08,1712.33,3148.68,5193.05,2872.62,884.08,-896.41
3298364747192051200,2020-09,1659.75,1924.56,3019.49,1671.11,1083.57,187.16
3298364747192051200,2020-10,4618.39,3346.83,4410.42,2925.77,2756.21,2943.37
3298364747192051200,2020-11,3329.01,156.36,3337.03,728.15,5781.53,8724.9
3298364747192051200,2020-12,583.38,1920.13,492.9,2336.38,-3180.23,5544.67
3298861134205913088,2020-01,1951.04,0,527.31,0,2478.35,2478.35
3298861134205913088,2020-02,0,1553.71,0,0,-1553.71,924.64
3298861134205913088,2020-03,268.27,863.89,363.24,0,-232.38,692.26
3298861134205913088,2020-06,1437.25,0,0,0,1437.25,2129.51
3298861134205913088,2020-07,0,360.65,0,0,-360.65,1768.86
3298861134205913088,2020-10,0,710.31,0,0,-710.31,1058.55
3298861134205913088,2020-11,432.17,0,0,0,432.17,1490.72
3300208504358714368,2020-01,5656.91,0,0,846.92,4809.99,4809.99
3300208504358714368,2020-02,1457.35,524.46,0,1208.42,-275.53,4534.46
3300208504358714368,2020-03,1462.8,0,684.75,2142.38,5.17,4539.63
3300208504358714368,2020-04,1910.35,3896.43,5622.85,709.74,2927.03,7466.66
3300208504358714368,2020-05,651.19,3442.91,0,628.65,-3420.37,4046.29
3300208504358714368,2020-06,852.95,2397.35,3009.09,2621.27,-1156.58,2889.71
3300208504358714368,2020-07,0,857.23,2968.99,1183.57,928.19,3817.9
3300208504358714368,2020-08,1318.31,0,0,1627.64,-309.33,3508.57
3300208504358714368,2020-09,537.8,0,0,466.66,71.14,3579.71
3300208504358714368,2020-10,1063.67,0,2502.92,1025.42,2541.17,6120.88
3300208504358714368,2020-11,2068.19,0,732.6,2052.35,748.44,6869.32
3300208504358714368,2020-12,1927.89,0,0,1967.67,-39.78,6829.54
3300235125260505088,2020-01,2524.93,3680.22,2981.25,4932.93,-3106.97,-3106.97
3300235125260505088,2020-02,3988.46,2195.45,5385.56,3297.18,3881.39,774.42
3300235125260505088,2020-03,1665.05,7017.86,3463.02,3043.41,-4933.2,-4158.78
3300235125260505088,2020-04,5169.53,3005.67,3538.38,7756.3,-2054.06,-6212.84
3300235125260505088,2020-05,2062.47,1001.19,4658.19,2557.15,3162.32,-3050.52
3300235125260505088,2020-06,45.31,0,682.33,1782.99,-1055.35,-4105.87
3300235125260505088,2020-07,2757.79,5937.81,2061.71,3046.38,-4164.69,-8270.56
3300235125260505088,2020-08,1692.72,6460.7,1884.1,7675.88,-10559.76,-18830.32
3300235125260505088,2020-09,2630.99,3875.5,2151.56,2356.16,-1449.11,-20279.43
3300235125260505088,2020-10,3264.6,5032.29,2096.99,3530.56,-3201.26,-23480.69
3300235125260505088,2020-11,6347.16,1560.19,6695.71,757.79,10724.89,-12755.8
3300235125260505088,2020-12,1687.54,92.26,2651.33,5913.63,-1667.02,-14422.82
3301056053165480960,2020-01,5682.08,11373.19,2696.92,3059.63,-6053.82,-6053.82
3301056053165480960,2020-02,3837.39,2702.77,3064.02,707,3491.64,-2562.18
3301056053165480960,2020-03,2073.1,6930.22,6218.95,6387.19,-5025.36,-7587.54
3301056053165480960,2020-04,3104.71,3452.07,5369.38,3881.81,1140.21,-6447.33
3301056053165480960,2020-05,2869.21,0,3536.09,6977.01,-571.71,-7019.04
3301056053165480960,2020-06,9353.19,6669.62,3071.62,8112.79,-2357.6,-9376.64
3301056053165480960,2020-07,1056.11,5302.31,4675.96,2846.68,-2416.92,-11793.56
3301056053165480960,2020-08,1338.75,6333.66,4739.98,4530.6,-4785.53,-16579.09
3301056053165480960,2020-09,7758.4,1827.58,8969.04,8340.16,6559.7,-10019.39
3301056053165480960,2020-10,3430.27,2358.48,1493.67,3381.21,-815.75,-10835.14
3301056053165480960,2020-11,7285.31,8847.84,7893.28,2079.8,4250.95,-6584.19
3301056053165480960,2020-12,3922.19,895.94,2740.23,1519.02,4247.46,-2336.73
3301600711858870784,2020-01,335.06,0,0,514.72,-179.66,-179.66
3301600711858870784,2020-02,0,1620.75,0,0,-1620.75,-1800.41
3301600711858870784,2020-03,396.88,154.98,3040.62,0,3282.52,1482.11
3301600711858870784,2020-04,1812.92,1202.44,0,0,610.48,2092.59
3301600711858870784,2020-05,1609.17,2341.91,337.37,0,-395.37,1697.22
3301600711858870784,2020-08,873.65,0,1729.75,0,2603.4,4300.62
3301600711858870784,2020-09,1508.46,129.56,0,1855.27,-476.37,3824.25
3301600711858870784,2020-10,1272.83,557.25,0,0,715.58,4539.83
3301600711858870784,2020-11,0,1336.43,1417.54,0,81.11,4620.94
3301600711858870784,2020-12,1426.99,0,0,0,1426.99,6047.93
3302036926289291264,2020-01,5437.64,3285.39,4582.46,3428.86,3305.85,3305.85
3302036926289291264,2020-02,794.66,2023.73,4930.35,9357.17,-5655.89,-2350.04
3302036926289291264,2020-03,7481.67,3012.41,10149.98,9149.8,5469.44,3119.4
3302036926289291264,2020-04,3471.66,2902.33,5845.3,10035.6,-3620.97,-501.57
3302036926289291264,2020-05,1706.88,9446.71,105.38,2787.71,-10422.16,-10923.73
3302036926289291264,2020-06,4819.49,7262.78,5591.68,8741.67,-5593.28,-16517.01
3302036926289291264,2020-07,5843.06,521.75,3524.5,7951.34,894.47,-15622.54
3302036926289291264,2020-08,1993.51,8158.15,3933.26,4437.53,-6668.91,-22291.45
3302036926289291264,2020-09,1457.33,4278.18,6099.37,1743.21,1535.31,-20756.14
3302036926289291264,2020-10,4351.41,8193.64,2646.49,4628.34,-5824.08,-26580.22
3302036926289291264,2020-11,8005.96,6214.19,4109.04,5707.54,193.27,-26386.95
3302036926289291264,2020-12,1525.64,3792.43,2861.16,7513.9,-6919.53,-33306.48
3302594525968176640,2020-01,3019.07,3357.19,3229.14,3878.93,-987.91,-987.91
3302594525968176640,2020-02,4685.63,1696.92,0,631.96,2356.75,1368.84
3302594525968176640,2020-03,3122.01,4376.31,726.47,2336.35,-2864.18,-1495.34
3302594525968176640,2020-04,3441.38,3613.26,1635.73,6769.47,-5305.62,-6800.96
3302594525968176640,2020-05,5835.82,492.14,2890.85,1677.13,6557.4,-243.56
3302594525968176640,2020-06,4313.44,1166.5,0,3747.33,-600.39,-843.95
3302594525968176640,2020-07,0,7673.22,668.27,5304.79,-12309.74,-13153.69
3302594525968176640,2020-08,3409.37,6959.97,2876.98,2475.63,-3149.25,-16302.94
3302594525968176640,2020-09,0,5592.27,6265.51,6232.17,-5558.93,-21861.87
3302594525968176640,2020-10,1263.72,2055.32,4930.08,6205.88,-2067.4,-23929.27
3302594525968176640,2020-11,1881.89,6075.62,2961.64,530.16,-1762.25,-25691.52
3302594525968176640,2020-12,3603.19,9010.16,2506.17,3930.18,-6830.98,-32522.5
3303973102479611904,2020-01,2315.41,0,5635.25,3839.28,4111.38,4111.38
3303973102479611904,2020-02,9679.21,2010.63,4877.58,3950.43,8595.73,12707.11
3303973102479611904,2020-03,4295.82,211.8,1692.87,4124.14,1652.75,14359.86
3303973102479611904,2020-04,5294.52,3317.48,4629.24,4687.43,1918.85,16278.71
3303973102479611904,2020-05,2370.5,8506.38,415.02,2752.23,-8473.09,7805.62
3303973102479611904,2020-06,6132.55,4368.62,0,1947.84,-183.91,7621.71
3303973102479611904,2020-07,2753.38,1244.32,0,669.31,839.75,8461.46
3303973102479611904,2020-08,3385.31,3304.91,1043.12,3400.1,-2276.58,6184.88
3303973102479611904,2020-09,2541.72,1480.12,2609.84,3316.6,354.84,6539.72
3303973102479611904,2020-10,553.66,2259.26,3007.38,5071.5,-3769.72,2770
3303973102479611904,2020-11,3607.12,7418.91,8212.83,0,4401.04,7171.04
3303973102479611904,2020-12,6412.56,891.97,1168.6,3079.85,3609.34,10780.38
3304825389237051904,2020-01,1017.38,611.11,0,524.46,-118.19,-118.19
3304825389237051904,2020-02,0,3495.77,214.8,2148.57,-5429.54,-5547.73
3304825389237051904,2020-03,0,1222.23,0,0,-1222.23,-6769.96
3304825389237051904,2020-05,1027.75,2274.95,0,1741.05,-2988.25,-9758.21
3304825389237051904,2020-06,937.62,2168.4,1475.22,0,244.44,-9513.77
3304825389237051904,2020-08,1666.59,534.98,0,0,1131.61,-8382.16
3304825389237051904,2020-11,140.12,96.56,0,0,43.56,-8338.6
3305471752566675968,2020-01,1109.12,188.27,0,901.45,19.4,19.4
3305471752566675968,2020-02,1658.99,1132.16,1583.62,0,2110.45,2129.85
3305471752566675968,2020-03,1211.47,4.32,4450.99,1934.25,3723.89,5853.74
3305471752566675968,2020-04,3015.68,1483.01,0,0,1532.67,7386.41
3305471752566675968,2020-05,0,1958.66,1942.9,1999.12,-2014.88,5371.53
3305471752566675968,2020-06,154.39,0,0,40.68,113.71,5485.24
3305471752566675968,2020-07,0,1634.07,0,1962.17,-3596.24,1889
3305471752566675968,2020-08,834.35,0,0,776.87,57.48,1946.48
3305471752566675968,2020-09,694.05,4346.47,1459.21,356.33,-2549.54,-603.06
3305471752566675968,2020-10,722.55,0,0,1988.65,-1266.1,-1869.16
3305471752566675968,2020-12,0,820.6,1214.43,0,393.83,-1475.33
3306001702085967872,2020-01,0,1612.98,1920.53,0,307.55,307.55
3306001702085967872,2020-03,1107.92,0,329.65,0,1437.57,1745.12
3306001702085967872,2020-05,969.13,0,0,0,969.13,2714.25
3306001702085967872,2020-06,1974.81,0,0,0,1974.81,4689.06
3306001702085967872,2020-10,0,551.1,0,0,-551.1,4137.96
3306628124659522560,2020-01,1934.11,5453.09,8246.79,6771.37,-2043.56,-2043.56
3306628124659522560,2020-02,3329.27,6378.27,4011.69,2687.12,-1724.43,-3767.99
3306628124659522560,2020-03,781.27,6094.36,1866.89,2266.38,-5712.58,-9480.57
3306628124659522560,2020-04,0,4194.33,5003.5,2754.94,-1945.77,-11426.34
3306628124659522560,2020-05,4490.57,5324.26,6620.88,7707.83,-1920.64,-13346.98
3306628124659522560,2020-06,4621.87,10314.64,7348.05,7748.5,-6093.22,-19440.2
3306628124659522560,2020-07,3524.16,4535.29,4267.44,492.94,2763.37,-16676.83
3306628124659522560,2020-08,4671.74,2866.15,2633.58,8064.61,-3625.44,-20302.27
3306628124659522560,2020-09,435.01,1156.23,9035.77,3562.01,4752.54,-15549.73
3306628124659522560,2020-10,9238.05,6073.99,1511.56,1622.32,3053.3,-12496.43
3306628124659522560,2020-11,5273.8,4943.74,6221.76,4280.05,2271.77,-10224.66
3306628124659522560,2020-12,6035.48,5729.99,6775.03,7563.22,-482.7,-10707.36
3307177159800443392,2020-01,0,3427.39,261.48,0,-3165.91,-3165.91
3307177159800443392,2020-02,0,1687.57,0,903.63,-2591.2,-5757.11
3307177159800443392,2020-05,371.33,1811.42,214.97,0,-1225.12,-6982.23
3307177159800443392,2020-06,0,1513.52,1678.45,870.29,-705.36,-7687.59
3307177159800443392,2020-09,0,1635.85,0,0,-1635.85,-9323.44
3307177159800443392,2020-10,1347.13,887.81,1498.17,5318.38,-3360.89,-12684.33
3307177159800443392,2020-11,2936.17,1709.63,1509.36,3685.04,-949.14,-13633.47
3307177159800443392,2020-12,0,646.91,0,0,-646.91,-14280.38
3309722123994710528,2020-01,3176.51,6469.79,4260.16,4089.63,-3122.75,-3122.75
3309722123994710528,2020-02,1773.69,796.4,3957.67,2436.32,2498.64,-624.11
3309722123994710528,2020-03,5445.84,7480.62,3741.09,1307.07,399.24,-224.87
3309722123994710528,2020-04,2767.05,3306.23,4049.6,2932.58,577.84,352.97
3309722123994710528,2020-05,2208.45,7267.33,5433.44,0,374.56,727.53
3309722123994710528,2020-06,3768.08,2994.57,5648.38,906.47,5515.42,6242.95
3309722123994710528,2020-07,0,3715.87,4685.48,3469.5,-2499.89,3743.06
3309722123994710528,2020-08,5288.68,1234.04,2059.39,1091.58,5022.45,8765.51
3309722123994710528,2020-09,2956.94,1037.88,3677.84,1791.23,3805.67,12571.18
3309722123994710528,2020-10,480.32,10323.07,5079.39,2577.22,-7340.58,5230.6
3309722123994710528,2020-11,4518.23,3862.56,2124.09,2679.19,100.57,5331.17
3309722123994710528,2020-12,3077.57,4534.68,2066.74,2138.12,-1528.49,3802.68
3310627602364094464,2020-01,827.75,4975.28,279.86,12030.53,-15898.2,-15898.2
3310627602364094464,2020-02,5614.84,4414.76,5860.76,1736.72,5324.12,-10574.08
3310627602364094464,2020-03,6733.91,8042,5922.34,4399.2,215.05,-10359.03
3310627602364094464,2020-04,4458.82,7281.75,3170.43,2895.11,-2547.61,-12906.64
3310627602364094464,2020-05,1585.45,2267.17,3674.43,15652.1,-12659.39,-25566.03
3310627602364094464,2020-06,4772.89,4695.6,3772,1594.76,2254.53,-23311.5
3310627602364094464,2020-07,1782.96,3395.16,7006.27,3805.2,1588.87,-21722.63
3310627602364094464,2020-08,1900.66,4386.07,3754.67,6122.66,-4853.4,-26576.03
3310627602364094464,2020-09,4868.94,2522.73,4083.92,6153.96,276.17,-26299.86
3310627602364094464,2020-10,4873.16,421.35,4522.42,236.15,8738.08,-17561.78
3310627602364094464,2020-11,4733.53,1362.86,5050.82,3562.73,4858.76,-12703.02
3310627602364094464,2020-12,1505.87,2287.49,2725.12,1929.94,13.56,-12689.46
3312254318742125568,2020-03,1997.13,2542.95,770.35,0,224.53,224.53
3312254318742125568,2020-04,749.16,69.46,0,122.68,557.02,781.55
3312254318742125568,2020-05,76.51,281.13,209.14,132.55,-128.03,653.52
3312254318742125568,2020-06,2675.58,0,1504.39,2562.76,1617.21,2270.73
3312254318742125568,2020-07,190.95,0,1713.81,0,1904.76,4175.49
3312254318742125568,2020-08,110.54,1058.11,893.41,1851.31,-1905.47,2270.02
3312254318742125568,2020-10,1246.7,0,1774.4,0,3021.1,5291.12
3312254318742125568,2020-11,1862.63,0,545.66,0,2408.29,7699.41
3312254318742125568,2020-12,1995.97,0,530.3,1970.15,556.12,8255.53
3312368221330859008,2020-01,361.33,3330.17,7526.77,4811.82,-253.89,-253.89
3312368221330859008,2020-02,1508.36,2644.84,5150.73,6244.22,-2229.97,-2483.86
3312368221330859008,2020-03,2894.53,938.84,6086.18,5019.51,3022.36,538.5
3312368221330859008,2020-04,1264.87,8443.85,2473.14,2730.03,-7435.87,-6897.37
3312368221330859008,2020-05,1689.13,2773.81,6884.17,855.51,4943.98,-1953.39
3312368221330859008,2020-06,3029.76,1429.94,5906.21,7169.17,336.86,-1616.53
3312368221330859008,2020-07,9678.46,2943.82,4328.76,4060.3,7003.1,5386.57
3312368221330859008,2020-08,2456.01,5396.34,6636.4,1459.01,2237.06,7623.63
3312368221330859008,2020-09,2545.3,9073.27,4069.17,6388.32,-8847.12,-1223.49
3312368221330859008,2020-10,10981.06,2976.45,3982.99,3897.11,8090.49,6867
3312368221330859008,2020-11,7243.89,6693.62,1038.3,4890.19,-3301.62,3565.38
3312368221330859008,2020-12,5381.62,2110.48,8865.64,4509.87,7626.91,11192.29
3312815297576418816,2020-01,834.26,0,1870.99,3072.58,-367.33,-367.33
3312815297576418816,2020-04,2547.83,1233.49,0,315.16,999.18,631.85
3312815297576418816,2020-05,0,1043.68,0,0,-1043.68,-411.83
3312815297576418816,2020-06,285.71,0,1621.99,793.74,1113.96,702.13
3312815297576418816,2020-07,0,703.98,0,831.66,-1535.64,-833.51
3312815297576418816,2020-08,0,270.73,2221.12,947.63,1002.76,169.25
3312815297576418816,2020-09,180.41,0,1023.79,1013.11,191.09,360.34
3312815297576418816,2020-10,1429.32,177.44,1208.58,359.42,2101.04,2461.38
3312815297576418816,2020-12,493.51,0,1516.28,282.86,1726.93,4188.31
3312827118448186880,2020-01,5185.65,3906.82,3803.35,3702.79,1379.39,1379.39
3312827118448186880,2020-02,0,1635.6,2386.83,1628.09,-876.86,502.53
3312827118448186880,2020-03,2068.55,6087.04,2373.62,8280.63,-9925.5,-9422.97
3312827118448186880,2020-04,4574.91,2748.7,5619.49,4777.32,2668.38,-6754.59
3312827118448186880,2020-05,3277.44,6304.67,2085.62,4251.31,-5192.92,-11947.51
3312827118448186880,2020-06,3887.12,2981.71,1092.05,2035.44,-37.98,-11985.49
3312827118448186880,2020-07,6842.81,3814,3844.03,9944.62,-3071.78,-15057.27
3312827118448186880,2020-08,2444.96,2834.78,3264.93,3858.63,-983.52,-16040.79
3312827118448186880,2020-09,2195.47,1790.92,1966.04,4725.63,-2355.04,-18395.83
3312827118448186880,2020-10,2041.74,67.93,1946.13,516.38,3403.56,-14992.27
3312827118448186880,2020-11,2024.23,4646.66,3760.81,2084.15,-945.77,-15938.04
3312827118448186880,2020-12,3464.61,4496.02,4036.51,64.87,2940.23,-12997.81
3313685911410666496,2020-03,1602.26,612.84,0,0,989.42,989.42
3313685911410666496,2020-04,0,1303.92,0,615.76,-1919.68,-930.26
3313685911410666496,2020-05,2172.17,0,1990.4,0,4162.57,3232.31
3313685911410666496,2020-07,0,1705.16,0,0,-1705.16,1527.15
3313685911410666496,2020-08,351.41,1376.26,0,0,-1024.85,502.3
3313685911410666496,2020-09,0,767.54,1618.61,0,851.07,1353.37
3313685911410666496,2020-10,1816.04,650.98,1271.16,0,2436.22,3789.59
3313685911410666496,2020-11,0,742.69,0,0,-742.69,3046.9
3313685911410666496,2020-12,1082.94,0,1334.76,0,2417.7,5464.6
3314621722168538112,2020-01,1305.01,4948.33,0,998.15,-4641.47,-4641.47
3314621722168538112,2020-02,1186.95,1931.78,3335.68,1178.36,1412.49,-3228.98
3314621722168538112,2020-03,3925.35,2270.76,1905.66,1871.69,1688.56,-1540.42
3314621722168538112,2020-04,1424.29,3860.03,2823.7,2766.49,-2378.53,-3918.95
3314621722168538112,2020-05,5858.45,3419.67,0,2767.64,-328.86,-4247.81
3314621722168538112,2020-06,1377.16,2264.33,2409.64,1445.74,76.73,-4171.08
3314621722168538112,2020-07,1340.98,4890.75,6656.32,3045.05,61.5,-4109.58
3314621722168538112,2020-08,1982.36,1132.44,1735.69,5348.6,-2762.99,-6872.57
3314621722168538112,2020-09,2684.01,1660.06,6195.23,3932.74,3286.44,-3586.13
3314621722168538112,2020-10,1693.09,5496.6,4017.16,0,213.65,-3372.48
3314621722168538112,2020-11,5716.45,3211.34,1611.69,1022.23,3094.57,-277.91
3314621722168538112,2020-12,5431.19,4599.44,2113.05,1318.81,1625.99,1348.08
3314770633217553408,2020-02,1859.31,0,0,0,1859.31,1859.31
3314770633217553408,2020-03,0,2256.94,0,0,-2256.94,-397.63
3314770633217553408,2020-04,3266.07,0,963.84,809.97,3419.94,3022.31
3314770633217553408,2020-05,360.22,607.13,0,2010.54,-2257.45,764.86
3314770633217553408,2020-06,0,1118.4,1750.24,0,631.84,1396.7
3314770633217553408,2020-07,83.69,0,0,0,83.69,1480.39
3314770633217553408,2020-08,0,1662.68,636.24,739.99,-1766.43,-286.04
3314770633217553408,2020-10,1476.8,0,0,369.18,1107.62,821.58
3314770633217553408,2020-12,0,1889.99,1703.65,0,-186.34,635.24
3316662466738155008,2020-01,3770.23,5715.01,7280.22,5882.42,-546.98,-546.98
3316662466738155008,2020-02,1888.51,6565.54,5055.83,6524.14,-6145.34,-6692.32
3316662466738155008,2020-03,315.06,2690.68,4110.64,3985.46,-2250.44,-8942.76
3316662466738155008,2020-04,6305.78,1604.3,4206.56,10163.31,-1255.27,-10198.03
3316662466738155008,2020-05,6569.82,5354.99,5964.07,5374.95,1803.95,-8394.08
3316662466738155008,2020-06,2513.82,6202.96,4701.48,3186.73,-2174.39,-10568.47
3316662466738155008,2020-07,8236.58,8902.67,7290.25,9770.88,-3146.72,-13715.19
3316662466738155008,2020-08,5009.43,142.41,2902.46,4598.09,3171.39,-10543.8
3316662466738155008,2020-09,9088.66,905.16,4135.8,6873.41,5445.89,-5097.91
3316662466738155008,2020-10,4271.18,2465.09,2046.15,8458.96,-4606.72,-9704.63
3316662466738155008,2020-11,5011.66,8508.36,3359.28,3556.62,-3694.04,-13398.67
3316662466738155008,2020-12,6736.4,3722.16,4712.49,1715.26,6011.47,-7387.2
3316813425968539648,2020-01,5045.39,0,4615.2,6181.35,3479.24,3479.24
3316813425968539648,2020-02,4031.57,5920.35,7505.46,3701.85,1914.83,5394.07
3316813425968539648,2020-03,4559.61,0,2134.35,449.89,6244.07,11638.14
3316813425968539648,2020-04,3645.01,2001.66,2048.38,3206.93,484.8,12122.94
3316813425968539648,2020-05,5930.95,3370.27,2627.68,967.82,4220.54,16343.48
3316813425968539648,2020-06,5351.45,6824.87,4067.18,2417.34,176.42,16519.9
3316813425968539648,2020-07,2189.5,8762.65,7652.06,2441.66,-1362.75,15157.15
3316813425968539648,2020-08,7631.58,0,2235.36,5442.38,4424.56,19581.71
3316813425968539648,2020-09,7281.62,5741.54,6581.59,248.74,7872.93,27454.64
3316813425968539648,2020-10,3667.12,7333.19,4425.44,1296.55,-537.18,26917.46
3316813425968539648,2020-11,3592.58,8541.25,4437.32,2044.79,-2556.14,24361.32
3316813425968539648,2020-12,9016.01,2680.43,4043.6,1267.22,9111.96,33473.28
3317595513412590592,2020-01,238.31,0,452.15,0,690.46,690.46
3317595513412590592,2020-03,605.97,0,1111.88,0,1717.85,2408.31
3317595513412590592,2020-04,963.5,1195.33,276.46,0,44.63,2452.94
3317595513412590592,2020-05,1411.71,0,0,0,1411.71,3864.65
3317595513412590592,2020-06,1423.01,2404.63,1070.42,373.24,-284.44,3580.21
3317595513412590592,2020-07,578.54,0,1427.79,0,2006.33,5586.54
3317595513412590592,2020-08,0,801.64,1483.59,0,681.95,6268.49
3317595513412590592,2020-09,590.97,0,0,0,590.97,6859.46
3317595513412590592,2020-12,512.14,0,0,1272.65,-760.51,6098.95
3317651153513810432,2020-01,3852.79,6463.21,4623.57,2318.61,-305.46,-305.46
3317651153513810432,2020-02,5682.54,1995.12,4762.76,1452.6,6997.58,6692.12
3317651153513810432,2020-03,2242.94,2499.85,2403.21,3950.16,-1803.86,4888.26
3317651153513810432,2020-04,6430.14,2234.07,6222.66,6811.08,3607.65,8495.91
3317651153513810432,2020-05,3463.11,9236.05,7177.62,2572.5,-1167.82,7328.09
3317651153513810432,2020-06,5175.69,4103.83,4418.28,1054.94,4435.2,11763.29
3317651153513810432,2020-07,10147.7,2983.19,8137.55,4291.78,11010.28,22773.57
3317651153513810432,2020-08,5910.98,1298.17,4809.67,2056.94,7365.54,30139.11
3317651153513810432,2020-09,5741.48,4510.72,8635.68,6163.65,3702.79,33841.9
3317651153513810432,2020-10,2751.64,670.2,3394.36,5486.84,-11.04,33830.86
3317651153513810432,2020-11,3112.97,4926.68,1918.73,1002.08,-897.06,32933.8
3317651153513810432,2020-12,7882.8,1184.76,8880.84,10665.44,4913.44,37847.24
3317833496230819328,2020-01,1525.74,0,1616.48,2918.69,223.53,223.53
3317833496230819328,2020-02,94.25,39.64,0,0,54.61,278.14
3317833496230819328,2020-03,3600.7,661.89,1214.97,308.43,3845.35,4123.49
3317833496230819328,2020-04,5022.9,4891.98,1796.65,2819.76,-892.19,3231.3
3317833496230819328,2020-05,349.01,0,2179.79,436.62,2092.18,5323.48
3317833496230819328,2020-06,0,3336.37,0,1981.33,-5317.7,5.78
3317833496230819328,2020-08,417.07,0,975.81,1262.12,130.76,136.54
3317833496230819328,2020-09,3382.21,1108.28,1971.07,1899.46,2345.54,2482.08
3317833496230819328,2020-10,1347.26,2792.41,883.27,242.16,-804.04,1678.04
3317833496230819328,2020-11,0,3104.55,1707.2,1837,-3234.35,-1556.31
3317833496230819328,2020-12,1866.56,2494.44,0,639.17,-1267.05,-2823.36
3319973510348615168,2020-03,1361.06,0,0,1888.9,-527.84,-527.84
3319973510348615168,2020-04,0,1427.14,0,0,-1427.14,-1954.98
3319973510348615168,2020-06,1056.59,0,0,1463.02,-406.43,-2361.41
3319973510348615168,2020-08,213.28,1402.88,0,0,-1189.6,-3551.01
3319973510348615168,2020-09,2643.63,87.33,0,0,2556.3,-994.71
3319973510348615168,2020-12,1590.6,0,0,410.12,1180.48,185.77
3320391950001729536,2020-01,1216.57,8591.73,8865.54,3426.99,-1936.61,-1936.61
3320391950001729536,2020-02,5403,3453.86,0,4258.2,-2309.06,-4245.67
3320391950001729536,2020-03,2539.97,5813.42,4430.15,3705.37,-2548.67,-6794.34
3320391950001729536,2020-04,1515.86,2029.12,7486.42,4291.97,2681.19,-4113.15
3320391950001729536,2020-05,7681.55,3479.5,6644.12,2484.36,8361.81,4248.66
3320391950001729536,2020-06,6184.33,5454.2,5369.8,4053.84,2046.09,6294.75
3320391950001729536,2020-07,4256.04,5640.66,2436.57,6767.31,-5715.36,579.39
3320391950001729536,2020-08,6396.22,8144.16,6560.31,9575,-4762.63,-4183.24
3320391950001729536,2020-09,6690.62,4332.97,5970.68,5098.52,3229.81,-953.43
3320391950001729536,2020-10,1576.69,6065.73,1811.37,6901.64,-9579.31,-10532.74
3320391950001729536,2020-11,2829.96,6291.48,6309.21,3529.06,-681.37,-11214.11
3320391950001729536,2020-12,5086.07,7135.92,5340.78,3663.88,-372.95,-11587.06
3321992514029293056,2020-01,0,415.12,2478.45,2161.44,-98.11,-98.11
3321992514029293056,2020-02,3456.08,5823.64,3413.95,4260.56,-3214.17,-3312.28
3321992514029293056,2020-03,6277.86,2513.78,2994.92,4165.05,2593.95,-718.33
3321992514029293056,2020-04,2870.27,0,2161.01,1239.03,3792.25,3073.92
3321992514029293056,2020-05,3512.83,4983.43,4511.44,3234.1,-193.26,2880.66
3321992514029293056,2020-06,2987.42,2594.28,1688.35,2607.56,-526.07,2354.59
3321992514029293056,2020-07,1310.01,1452.04,4674.66,2555.11,1977.52,4332.11
3321992514029293056,2020-08,11130.03,1999.01,11915.01,2443.6,18602.43,22934.54
3321992514029293056,2020-09,177.68,2680.69,2064.2,4376.03,-4814.84,18119.7
3321992514029293056,2020-10,3791.07,0,6794.74,1335.9,9249.91,27369.61
3321992514029293056,2020-11,7345.77,5022.14,1109.4,2822.88,610.15,27979.76
3321992514029293056,2020-12,4346.82,4227.32,931.15,4939.86,-3889.21,24090.55
3322326090882911744,2020-01,5632.85,6245.45,5761.75,4328.05,821.1,821.1
3322326090882911744,2020-02,5462.23,4668.75,692.54,6107.25,-4621.23,-3800.13
3322326090882911744,2020-03,3311.65,1690.8,1180.89,4640.02,-1838.28,-5638.41
3322326090882911744,2020-04,2613.19,3865.38,830.08,2054.05,-2476.16,-8114.57
3322326090882911744,2020-05,602.87,6350.14,9850.85,3879.43,224.15,-7890.42
3322326090882911744,2020-06,8161.84,1148.42,4855.35,6590.01,5278.76,-2611.66
3322326090882911744,2020-07,6770.83,7899.52,1754.77,7369.39,-6743.31,-9354.97
3322326090882911744,2020-08,7394.32,6832.12,5235.85,4032.74,1765.31,-7589.66
3322326090882911744,2020-09,8526.25,1643.33,0,1994.71,4888.21,-2701.45
3322326090882911744,2020-10,4294.52,1591.93,4584.66,5667.7,1619.55,-1081.9
3322326090882911744,2020-11,944.86,3813.96,8046.92,1813.64,3364.18,2282.28
3322326090882911744,2020-12,1249.67,4207.14,1792.46,952.64,-2117.65,164.63
3323497329125536768,2020-01,2233.3,1873.77,2965.39,3683.17,-358.25,-358.25
3323497329125536768,2020-02,3207.1,0,2544.14,553.01,5198.23,4839.98
3323497329125536768,2020-03,0,4215.76,596.64,1885.68,-5504.8,-664.82
3323497329125536768,2020-04,337.28,7905.9,2382.81,2555.56,-7741.37,-8406.19
3323497329125536768,2020-05,2528.57,4201.97,1232.87,3005.96,-3446.49,-11852.68
3323497329125536768,2020-06,1522.43,2047.79,4141.54,789.39,2826.79,-9025.89
3323497329125536768,2020-07,7.92,2917.14,788.5,2015.85,-4136.57,-13162.46
3323497329125536768,2020-08,1815.7,1726.72,2029.08,0,2118.06,-11044.4
3323497329125536768,2020-09,293.91,361.21,903.09,0,835.79,-10208.61
3323497329125536768,2020-10,0,796.6,2709.07,866.17,1046.3,-9162.31
3323497329125536768,2020-11,1552.27,4139.15,1795.4,3846.97,-4638.45,-13800.76
3323497329125536768,2020-12,1354.01,0,851.19,859.89,1345.31,-12455.45
3323612506815057408,2020-01,2186.78,1788.03,2979.19,1673.4,1704.54,1704.54
3323612506815057408,2020-02,1544.84,955.66,1606.91,1554.07,642.02,2346.56
3323612506815057408,2020-03,0,2480.55,1461.64,0,-1018.91,1327.65
3323612506815057408,2020-04,7274.83,468.92,1313.36,0,8119.27,9446.92
3323612506815057408,2020-05,5283.61,1499.15,1237.24,80.28,4941.42,14388.34
3323612506815057408,2020-06,1570.07,0,310.26,5478.63,-3598.3,10790.04
3323612506815057408,2020-07,2928.07,2259.01,8.51,1418.94,-741.37,10048.67
3323612506815057408,2020-08,3711.38,4368.46,3000.53,3722.85,-1379.4,8669.27
3323612506815057408,2020-09,0,1737.1,216.54,2233.13,-3753.69,4915.58
3323612506815057408,2020-10,7591.6,838.68,915.07,2870.52,4797.47,9713.05
3323612506815057408,2020-11,2973.97,2506.43,5006.86,2657.74,2816.66,12529.71
3323612506815057408,2020-12,1677.91,2939.93,1227.77,297.4,-331.65,12198.06
3323952436313540096,2020-01,1769.76,2920.77,5762.49,1919.48,2692,2692
3323952436313540096,2020-02,1471.79,2896.46,33.85,5872.09,-7262.91,-4570.91
3323952436313540096,2020-03,1042.28,191.62,4979.64,1455.2,4375.1,-195.81
3323952436313540096,2020-04,5722.74,2348.93,1387.02,4041.73,719.1,523.29
3323952436313540096,2020-05,0,1882.56,3851.05,1098.7,869.79,1393.08
3323952436313540096,2020-06,1632.17,3245.01,4077.04,1570.97,893.23,2286.31
3323952436313540096,2020-07,0,5402.64,3958.59,7116.03,-8560.08,-6273.77
3323952436313540096,2020-08,368.13,1534.36,0,3916.01,-5082.24,-11356.01
3323952436313540096,2020-09,2741.4,2583.64,5690.3,1778.91,4069.15,-7286.86
3323952436313540096,2020-10,5597.25,2077.68,3192.39,3223.65,3488.31,-3798.55
3323952436313540096,2020-11,1798.72,5270.81,1851.54,5359.99,-6980.54,-10779.09
3323952436313540096,2020-12,744.3,1563.39,927.37,3707.11,-3598.83,-14377.92
3325071311926477312,2020-01,4401.48,3826.63,0,1033.69,-458.84,-458.84
3325071311926477312,2020-02,1835.39,0,677.29,1172.93,1339.75,880.91
3325071311926477312,2020-03,2630.37,1183.78,845.44,0,2292.03,3172.94
3325071311926477312,2020-05,6087.47,2773.59,1531.52,361.14,4484.26,7657.2
3325071311926477312,2020-06,2656.72,1160.88,1037.63,1323.43,1210.04,8867.24
3325071311926477312,2020-07,2584.86,479.87,3717.65,3534.78,2287.86,11155.1
3325071311926477312,2020-08,640.28,1048.58,2779.56,1334.69,1036.57,12191.67
3325071311926477312,2020-09,0,2454.32,1000.64,3281.08,-4734.76,7456.91
3325071311926477312,2020-10,2768.15,2032.99,4017.33,0,4752.49,12209.4
3325071311926477312,2020-11,2694.45,676.16,1966.52,0,3984.81,16194.21
3325071311926477312,2020-12,976.19,388.87,1427.16,3471.63,-1457.15,14737.06
3326926762476669952,2020-01,0,963.39,2146.42,0,1183.03,1183.03
3326926762476669952,2020-02,0,609.53,91.73,0,-517.8,665.23
3326926762476669952,2020-03,5383.16,0,1348.87,304.23,6427.8,7093.03
3326926762476669952,2020-04,531.5,608.33,2664.7,0,2587.87,9680.9
3326926762476669952,2020-05,13.48,0,0,0,13.48,9694.38
3326926762476669952,2020-06,0,1030.09,734.52,1995.34,-2290.91,7403.47
3326926762476669952,2020-08,1906.98,658.04,3537.99,2641.47,2145.46,9548.93
3326926762476669952,2020-09,0,700.87,0,1305.04,-2005.91,7543.02
3326926762476669952,2020-10,0,165.82,0,397.59,-563.41,6979.61
3326926762476669952,2020-12,0,1977.85,1705.44,0,-272.41,6707.2
3327841469385338880,2020-01,2125.74,1789.83,7874.69,3099.9,5110.7,5110.7
3327841469385338880,2020-02,7420.28,854.11,3745.06,4830.54,5480.69,10591.39
3327841469385338880,2020-03,4670.56,2583.64,2397.45,3363.42,1120.95,11712.34
3327841469385338880,2020-04,2776.82,2075,3043.95,3069.65,676.12,12388.46
3327841469385338880,2020-05,5871.48,2251.28,1653.96,2817.2,2456.96,14845.42
3327841469385338880,2020-06,3837.67,2779.91,2236.06,10420.4,-7126.58,7718.84
3327841469385338880,2020-07,2874.8,1094.73,4434.32,2555.68,3658.71,11377.55
3327841469385338880,2020-08,4702.83,8320.24,2148.32,2405.35,-3874.44,7503.11
3327841469385338880,2020-09,2195.18,5906.18,4878.04,4835.35,-3668.31,3834.8
3327841469385338880,2020-10,4084.41,6279.07,4944.93,2631.84,118.43,3953.23
3327841469385338880,2020-11,866.11,2467.37,3302.43,4278.23,-2577.06,1376.17
3327841469385338880,2020-12,3543.44,625.66,7084.57,5582.11,4420.24,5796.41
3328740470744951808,2020-02,88.73,0,2373.79,1930.72,531.8,531.8
3328740470744951808,2020-03,0,1262.39,0,596.73,-1859.12,-1327.32
3328740470744951808,2020-04,0,1750.08,0,0,-1750.08,-3077.4
3328740470744951808,2020-05,0,556.24,0,0,-556.24,-3633.64
3328740470744951808,2020-06,0,1622.52,401.92,1781.48,-3002.08,-6635.72
3328740470744951808,2020-07,0,1338.59,0,0,-1338.59,-7974.31
3328740470744951808,2020-09,1682.9,0,109.68,1750.57,42.01,-7932.3
3328740470744951808,2020-11,1908.96,1937.06,542.45,836.85,-322.5,-8254.8
3328740470744951808,2020-12,0,1410.71,0,0,-1410.71,-9665.51
3330615857295274496,2020-01,357.02,10068.7,5288.63,3379.52,-7802.57,-7802.57
3330615857295274496,2020-02,6524.45,3686.94,4008.73,4909.17,1937.07,-5865.5
3330615857295274496,2020-03,9762.59,5112.4,4043.51,7048,1645.7,-4219.8
3330615857295274496,2020-04,3722.78,15809.81,25.13,1782.18,-13844.08,-18063.88
3330615857295274496,2020-05,5316.41,3091.06,4453.35,7275.02,-596.32,-18660.2
3330615857295274496,2020-06,2645.04,4277.39,2104.18,4421.22,-3949.39,-22609.59
3330615857295274496,2020-07,7822.95,8088.62,10612.81,1454.07,8893.07,-13716.52
3330615857295274496,2020-08,660.57,4866.77,3358.39,10193.56,-11041.37,-24757.89
3330615857295274496,2020-09,4977.82,9327.91,5829.59,1687.19,-207.69,-24965.58
3330615857295274496,2020-10,3981.69,8879.98,8365.21,2006.41,1460.51,-23505.07
3330615857295274496,2020-11,2902.24,7707.19,2891.5,5109.48,-7022.93,-30528
3330615857295274496,2020-12,3687.34,3922.95,3767.05,5705.11,-2173.67,-32701.67
3331863607364941824,2020-01,8436.5,2081.09,7128.38,4014.38,9469.41,9469.41
3331863607364941824,2020-02,3105.41,601.76,2537.07,9542.11,-4501.39,4968.02
3331863607364941824,2020-03,2498.78,4059.03,0,2417.41,-3977.66,990.36
3331863607364941824,2020-04,499.11,2686.58,2426.3,3302.08,-3063.25,-2072.89
3331863607364941824,2020-05,1784.6,6492.83,4988.31,6312.29,-6032.21,-8105.1
3331863607364941824,2020-06,2283.68,4502.34,11062.03,4944.95,3898.42,-4206.68
3331863607364941824,2020-07,4502.19,2002.77,4679.87,3128.6,4050.69,-155.99
3331863607364941824,2020-08,6673.9,1525.49,9055.91,4924.63,9279.69,9123.7
3331863607364941824,2020-09,3121.51,3481.83,2857.56,3030.84,-533.6,8590.1
3331863607364941824,2020-10,6581.73,1103.46,2234.89,4651.02,3062.14,11652.24
3331863607364941824,2020-11,4950.88,2405.75,4096.29,5931.18,710.24,12362.48
3331863607364941824,2020-12,1796.29,4779.49,0,3339.16,-6322.36,6040.12
3335728277786511360,2020-01,2243.75,2004.01,2317.16,3082.87,-525.97,-525.97
3335728277786511360,2020-02,0,2138.18,835.43,3660.53,-4963.28,-5489.25
3335728277786511360,2020-03,5134.04,4736.98,3188.73,984.03,2601.76,-2887.49
3335728277786511360,2020-04,2371.84,3841.7,0,1417.43,-2887.29,-5774.78
3335728277786511360,2020-05,1198.83,0,2080.34,0,3279.17,-2495.61
3335728277786511360,2020-06,4523.16,217.68,2727.64,1121.87,5911.25,3415.64
3335728277786511360,2020-07,2589.61,1225.39,2163.5,1312.47,2215.25,5630.89
3335728277786511360,2020-08,2864.78,1385.07,2365.28,1473.39,2371.6,8002.49
3335728277786511360,2020-09,4143.54,3487.71,0,1117.08,-461.25,7541.24
3335728277786511360,2020-10,450.41,3005.23,3806.28,4451.35,-3199.89,4341.35
3335728277786511360,2020-11,1012.4,1869.57,969.53,4458.84,-4346.48,-5.13
3335728277786511360,2020-12,4547.73,2492.26,519.85,6536.78,-3961.46,-3966.59
3335788786656594432,2020-01,1853.67,2828.74,5078.53,769.07,3334.39,3334.39
3335788786656594432,2020-02,4902.69,4554.28,5032.2,2948.8,2431.81,5766.2
3335788786656594432,2020-03,2508.93,485.02,3119.69,3752.18,1391.42,7157.62
3335788786656594432,2020-04,2390.25,2266.15,5976.39,338.97,5761.52,12919.14
3335788786656594432,2020-05,2129.97,1129.51,2318.01,6298.11,-2979.64,9939.5
3335788786656594432,2020-06,1179.45,3086.51,2845.08,2842.41,-1904.39,8035.11
3335788786656594432,2020-07,3612.7,4009.96,1298.89,0,901.63,8936.74
3335788786656594432,2020-08,2185.61,4591.75,804.04,62.23,-1664.33,7272.41
3335788786656594432,2020-09,922.72,1168.74,3480.9,4479.35,-1244.47,6027.94
3335788786656594432,2020-10,3504.29,1234.81,719.6,2543.25,445.83,6473.77
3335788786656594432,2020-11,2206.92,4067.15,2827.42,2090.82,-1123.63,5350.14
3335788786656594432,2020-12,1211.68,4306.48,1234.09,2418.23,-4278.94,1071.2
3336184589562769408,2020-01,2226.91,1336.17,1694.95,2591.38,-5.69,-5.69
3336184589562769408,2020-02,2120.68,1894.3,2891.5,3753.69,-635.81,-641.5
3336184589562769408,2020-03,6012.49,2379.73,1012.68,1577.55,3067.89,2426.39
3336184589562769408,2020-04,1246.53,4229.18,5651.62,2855.53,-186.56,2239.83
3336184589562769408,2020-05,1269.6,0,3496.99,3253,1513.59,3753.42
3336184589562769408,2020-06,1669.01,1981.38,1597.3,79.75,1205.18,4958.6
3336184589562769408,2020-07,806.3,207.4,1062.39,761.45,899.84,5858.44
3336184589562769408,2020-08,1701.7,835.38,1552.37,1124.3,1294.39,7152.83
3336184589562769408,2020-09,1236.61,3154.52,1882.61,1579.17,-1614.47,5538.36
3336184589562769408,2020-10,395.71,1043.44,3009.99,0,2362.26,7900.62
3336184589562769408,2020-11,0,3510.14,5854.89,1752.37,592.38,8493
3336184589562769408,2020-12,1639.4,1754.76,3249.24,1581.28,1552.6,10045.6
3337459096998124032,2020-01,4770.3,3699.9,8890.05,1600.25,8360.2,8360.2
3337459096998124032,2020-02,5111.87,5575.32,1173.66,2887.27,-2177.06,6183.14
3337459096998124032,2020-03,6783,4730.83,4832,6950.93,-66.76,6116.38
3337459096998124032,2020-04,7210.01,0,11523.81,3803.91,14929.91,21046.29
3337459096998124032,2020-05,13210.62,4842.67,3313.87,5972.04,5709.78,26756.07
3337459096998124032,2020-06,8414.66,4008.25,3829.35,1734.21,6501.55,33257.62
3337459096998124032,2020-07,2821.54,10053.88,3238.7,2279,-6272.64,26984.98
3337459096998124032,2020-08,230.44,5587.77,1462.85,4504.45,-8398.93,18586.05
3337459096998124032,2020-09,2705.83,4314.63,2347.79,3435.49,-2696.5,15889.55
3337459096998124032,2020-10,7650.55,2667.36,3152.19,0,8135.38,24024.93
3337459096998124032,2020-11,3164.33,7731.51,4673.44,3630.26,-3524,20500.93
3337459096998124032,2020-12,796.77,2058.96,2453.03,1665.67,-474.83,20026.1
3337501183937761792,2020-01,2907.07,493.64,5540.72,625.11,7329.04,7329.04
3337501183937761792,2020-02,1875.87,5360.74,0,1096.86,-4581.73,2747.31
3337501183937761792,2020-03,2744.73,2900.49,5211.82,4098.13,957.93,3705.24
3337501183937761792,2020-04,6577.58,5064.09,0,2000.28,-486.79,3218.45
3337501183937761792,2020-05,3674.46,3748.19,5444.53,2576.36,2794.44,6012.89
3337501183937761792,2020-06,1612.05,3590.87,6484.74,1264.01,3241.91,9254.8
3337501183937761792,2020-07,1413.12,3799.36,3324.36,1543.11,-604.99,8649.81
3337501183937761792,2020-08,3095.54,3613.9,2656.69,5104.4,-2966.07,5683.74
3337501183937761792,2020-09,643.42,2509.14,293.79,3627.63,-5199.56,484.18
3337501183937761792,2020-10,1475.14,1715.79,4726.52,7418.84,-2932.97,-2448.79
3337501183937761792,2020-11,6457.62,1288.97,8815.57,3786.36,10197.86,7749.07
3337501183937761792,2020-12,6015.59,6092.92,3000.84,5706.12,-2782.61,4966.46
3337794250026123776,2020-01,2596.1,1122.66,3441.93,5747.52,-832.15,-832.15
3337794250026123776,2020-02,2581.37,2807.33,2985.34,2320.95,438.43,-393.72
3337794250026123776,2020-03,0,4065.16,3683.08,1551.38,-1933.46,-2327.18
3337794250026123776,2020-04,4031.31,662.69,5448.4,3426.61,5390.41,3063.23
3337794250026123776,2020-05,2381.88,4374.02,1651.44,2357.03,-2697.73,365.5
3337794250026123776,2020-06,9751.88,4689.12,2080.97,0,7143.73,7509.23
3337794250026123776,2020-07,5041.56,3934.07,6306.22,1152.67,6261.04,13770.27
3337794250026123776,2020-08,3757.5,5214.55,1045.58,4283.69,-4695.16,9075.11
3337794250026123776,2020-09,3020.82,1264.92,230.39,3406.31,-1420.02,7655.09
3337794250026123776,2020-10,1951.3,5521.53,4016.5,4853.5,-4407.23,3247.86
3337794250026123776,2020-11,0,3758.45,3949.1,7539.18,-7348.53,-4100.67
3337794250026123776,2020-12,4184.53,3125.86,5057.2,1083.84,5032.03,931.36
3339412447622618112,2020-01,4597.55,5837.15,2546.68,6954.02,-5646.94,-5646.94
3339412447622618112,2020-02,3226.21,5856.4,1501.88,4132.48,-5260.79,-10907.73
3339412447622618112,2020-03,6947.24,2383.57,1245.28,859.98,4948.97,-5958.76
3339412447622618112,2020-04,9124.01,5893.45,875.22,2439.75,1666.03,-4292.73
3339412447622618112,2020-05,4991.36,10842.12,3540.68,2405.91,-4715.99,-9008.72
3339412447622618112,2020-06,3047.18,5329.51,2441.57,8709.6,-8550.36,-17559.08
3339412447622618112,2020-07,2383.06,2682.96,2101.59,4982.36,-3180.67,-20739.75
3339412447622618112,2020-08,3419.09,5781.17,10072.81,1686.06,6024.67,-14715.08
3339412447622618112,2020-09,1370.72,2677.48,7077.97,3675.54,2095.67,-12619.41
3339412447622618112,2020-10,3014.69,0,1548.77,2071.35,2492.11,-10127.3
3339412447622618112,2020-11,1828.26,2862.44,5874.07,3007.35,1832.54,-8294.76
3339412447622618112,2020-12,2448.92,5484.35,663.14,296.12,-2668.41,-10963.17
3339497975028261888,2020-01,4383.88,2957.71,1374.65,6148.9,-3348.08,-3348.08
3339497975028261888,2020-02,4139.66,1821.12,4410.58,1205.35,5523.77,2175.69
3339497975028261888,2020-03,1086.08,2028.69,2927.35,5516.35,-3531.61,-1355.92
3339497975028261888,2020-04,1005.29,5265.89,830.81,4349.93,-7779.72,-9135.64
3339497975028261888,2020-05,3037.62,7889.02,2281.39,288.57,-2858.58,-11994.22
3339497975028261888,2020-06,5903.97,2998.62,1569.58,1609.33,2865.6,-9128.62
3339497975028261888,2020-07,4369.23,2752.05,2316.94,3129.22,804.9,-8323.72
3339497975028261888,2020-08,3092.41,3638.64,3144.55,7876.25,-5277.93,-13601.65
3339497975028261888,2020-09,39.69,3433.8,994.88,3771.76,-6170.99,-19772.64
3339497975028261888,2020-10,4260.08,2701.45,3937.03,4538.01,957.65,-18814.99
3339497975028261888,2020-11,2619.96,2571.33,3081.39,2868.87,261.15,-18553.84
3339497975028261888,2020-12,767.92,952.5,5893.7,523.56,5185.56,-13368.28
3339650829568202752,2020-01,0,1649.9,0,0,-1649.9,-1649.9
3339650829568202752,2020-02,150.5,0,0,0,150.5,-1499.4
3339650829568202752,2020-03,1173.44,2412.89,1800.69,0,561.24,-938.16
3339650829568202752,2020-04,1037.51,1847.4,811.63,0,1.74,-936.42
3339650829568202752,2020-05,363.98,0,1737.94,630.83,1471.09,534.67
3339650829568202752,2020-07,1595.76,0,0,1555.58,40.18,574.85
3339650829568202752,2020-08,762.98,0,0,1011.7,-248.72,326.13
3339650829568202752,2020-10,0,425.75,367.22,0,-58.53,267.6
3339650829568202752,2020-11,1798.42,1567.46,0,1739.45,-1508.49,-1240.89
3339650829568202752,2020-12,4000.85,1501.92,741.42,0,3240.35,1999.46
3342253335502203904,2020-01,2199.59,0,473.12,2863.92,-191.21,-191.21
3342253335502203904,2020-02,3492.04,3388.96,1967.81,1785.35,285.54,94.33
3342253335502203904,2020-03,3609.44,2336.37,5197.89,446.76,6024.2,6118.53
3342253335502203904,2020-04,1980.76,2853.27,2550.27,290.84,1386.92,7505.45
3342253335502203904,2020-05,445.42,1599.68,0,2855.35,-4009.61,3495.84
3342253335502203904,2020-06,65.83,0,0,1894.7,-1828.87,1666.97
3342253335502203904,2020-07,703.48,1157.06,1677.57,1212.3,11.69,1678.66
3342253335502203904,2020-08,1417.16,1485.53,3726.44,2375.5,1282.57,2961.23
3342253335502203904,2020-09,2301.02,586.34,4419.73,1837.6,4296.81,7258.04
3342253335502203904,2020-10,2701.14,0,1564.54,743.9,3521.78,10779.82
3342253335502203904,2020-11,7040.97,0,4222.32,2091.13,9172.16,19951.98
3342253335502203904,2020-12,3600.66,0,1957.58,4543.8,1014.44,20966.42
3343915495882977792,2020-01,4936.78,4187.5,5734.12,7486.3,-1002.9,-1002.9
3343915495882977792,2020-02,1222.98,1080.81,3387.77,4604.99,-1075.05,-2077.95
3343915495882977792,2020-03,4053.9,5635.21,5791.35,2065.11,2144.93,66.98
3343915495882977792,2020-04,1402.84,2381.8,10684.95,6156.94,3549.05,3616.03
3343915495882977792,2020-05,5655.11,1766.73,2761.28,7071.67,-422.01,3194.02
3343915495882977792,2020-06,3803.79,1318.18,2542.65,3658.52,1369.74,4563.76
3343915495882977792,2020-07,4583.99,4850.9,3318.89,4686.25,-1634.27,2929.49
3343915495882977792,2020-08,5344.28,4001.61,4924.82,6669.55,-402.06,2527.43
3343915495882977792,2020-09,7460.18,3035.86,2820.21,4046.75,3197.78,5725.21
3343915495882977792,2020-10,2891.66,3187.1,4753.7,4611.6,-153.34,5571.87
3343915495882977792,2020-11,6878.32,5289.24,4135.99,5453.56,271.51,5843.38
3343915495882977792,2020-12,7297.91,5110.56,3826.22,11551.71,-5538.14,305.24
3344240549756460544,2020-01,2262.06,4997.44,9589.13,5439.22,1414.53,1414.53
3344240549756460544,2020-02,4787.94,4642.42,3445.95,898.6,2692.87,4107.4
3344240549756460544,2020-03,5291.06,6289.83,2132.77,8110.91,-6976.91,-2869.51
3344240549756460544,2020-04,4446.76,4136.62,769.3,3062.68,-1983.24,-4852.75
3344240549756460544,2020-05,1122.55,7348.74,3359.46,5730.39,-8597.12,-13449.87
3344240549756460544,2020-06,2216.85,8917.86,7317.27,2836.51,-2220.25,-15670.12
3344240549756460544,2020-07,7626.16,1944.75,1006.63,0,6688.04,-8982.08
3344240549756460544,2020-08,2465.15,2661.38,4547.97,2404.75,1946.99,-7035.09
3344240549756460544,2020-09,4633.65,1627.8,5944.08,1627.93,7322,286.91
3344240549756460544,2020-10,3542.69,7960.58,1623.92,7519.95,-10313.92,-10027.01
3344240549756460544,2020-11,8696.85,2858.48,8267.29,5155.43,8950.23,-1076.78
3344240549756460544,2020-12,5669.34,4084.68,6212.67,3465.47,4331.86,3255.08
3348370523920562176,2020-01,131.48,1346.41,4531.94,5168.51,-1851.5,-1851.5
3348370523920562176,2020-02,0,3781.52,6713.36,0,2931.84,1080.34
3348370523920562176,2020-03,0,3402.77,1962.59,778.72,-2218.9,-1138.56
3348370523920562176,2020-04,9313.09,954.33,3672.89,3818.58,8213.07,7074.51
3348370523920562176,2020-05,4017.15,1800.16,0,3804.4,-1587.41,5487.1
3348370523920562176,2020-06,555,1431.95,3550.38,3598.92,-925.49,4561.61
3348370523920562176,2020-07,35.27,1442.41,2948.46,6013.73,-4472.41,89.2
3348370523920562176,2020-08,480.32,1746.81,1616.47,0,349.98,439.18
3348370523920562176,2020-09,1724.79,1838.05,4600.47,6688.26,-2201.05,-1761.87
3348370523920562176,2020-10,378.07,2679.21,4716.19,1842.18,572.87,-1189
3348370523920562176,2020-11,4705.36,1534,0,4490.66,-1319.3,-2508.3
3348370523920562176,2020-12,3408.73,3607.36,1548.72,375.38,974.71,-1533.59
3348869645119662080,2020-01,2200.38,2737.78,3115.84,2548.06,30.38,30.38
3348869645119662080,2020-02,2842.98,5552.03,1627.41,1406.03,-2487.67,-2457.29
3348869645119662080,2020-03,3858.44,1813.75,2230.19,2960.91,1313.97,-1143.32
3348869645119662080,2020-04,49.99,1318.86,4058.74,2488.1,301.77,-841.55
3348869645119662080,2020-05,2183.71,3223.7,1350.58,2385.28,-2074.69,-2916.24
3348869645119662080,2020-06,0,3470.76,1124.74,1477.97,-3823.99,-6740.23
3348869645119662080,2020-07,377.71,2664.77,2452.95,1637.04,-1471.15,-8211.38
3348869645119662080,2020-08,0,2955.33,2536.34,4737.71,-5156.7,-13368.08
3348869645119662080,2020-09,2398.74,4217.68,968.18,0,-850.76,-14218.84
3348869645119662080,2020-10,3824.14,1919.18,1100.92,86.55,2919.33,-11299.51
3348869645119662080,2020-11,3939.05,1977.14,3845.15,1260,4547.06,-6752.45
3348869645119662080,2020-12,1854.88,4847.1,2224.24,4305.07,-5073.05,-11825.5
3350918286622199296,2020-01,2587.13,1085.6,0,0,1501.53,1501.53
3350918286622199296,2020-02,1256.08,0,0,1734.32,-478.24,1023.29
3350918286622199296,2020-03,1679.91,0,1690.4,0,3370.31,4393.6
3350918286622199296,2020-04,1590.67,1498.6,2075.94,1236.65,931.36,5324.96
3350918286622199296,2020-05,0,2890.98,583.85,1542.47,-3849.6,1475.36
3350918286622199296,2020-07,1374.72,3572.14,0,1472.86,-3670.28,-2194.92
3350918286622199296,2020-08,1575.1,1413.48,910.2,670.97,400.85,-1794.07
3350918286622199296,2020-10,0,649.65,57.71,639.49,-1231.43,-3025.5
3350918286622199296,2020-11,1041.21,1654.34,31,0,-582.13,-3607.63
3350918286622199296,2020-12,1266.03,0,1381.46,2435.34,212.15,-3395.48
3351265965437110784,2020-01,4618.62,4957.92,7294.4,3489.97,3465.13,3465.13
3351265965437110784,2020-02,5789.15,1693.9,2205.18,286.8,6013.63,9478.76
3351265965437110784,2020-03,7834.18,4358.2,4576.65,7119.36,933.27,10412.03
3351265965437110784,2020-04,2747.53,7531.43,5398.61,6088.4,-5473.69,4938.34
3351265965437110784,2020-05,5276.2,965.75,2770.28,7029.97,50.76,4989.1
3351265965437110784,2020-06,10333.83,2488.28,6935.48,4702.45,10078.58,15067.68
3351265965437110784,2020-07,6576.97,3427.17,4229.68,4077.19,3302.29,18369.97
3351265965437110784,2020-08,4792.45,1473.41,6264.6,4572.19,5011.45,23381.42
3351265965437110784,2020-09,3516.52,4922.38,1629.03,5468.8,-5245.63,18135.79
3351265965437110784,2020-10,6721.7,4945.56,2642.53,2952.56,1466.11,19601.9
3351265965437110784,2020-11,3543.61,2650.42,5027.83,5109.32,811.7,20413.6
3351265965437110784,2020-12,6390.94,2859.29,6460.48,6196.77,3795.36,24208.96
3352045946510250496,2020-01,8555.73,7862.67,3281.63,5269.51,-1294.82,-1294.82
3352045946510250496,2020-02,958.96,3264.74,4802.86,4719.44,-2222.36,-3517.18
3352045946510250496,2020-03,40.29,9496.2,3108.99,3842.82,-10189.74,-13706.92
3352045946510250496,2020-04,7313.59,2431.7,3987.16,7105.59,1763.46,-11943.46
3352045946510250496,2020-05,5535.63,7817.98,3711.56,4290.76,-2861.55,-14805.01
3352045946510250496,2020-06,2565.33,3317.43,1659.08,4685.5,-3778.52,-18583.53
3352045946510250496,2020-07,6096.44,6378.24,6776.74,7508.23,-1013.29,-19596.82
3352045946510250496,2020-08,2641.85,2819.14,3708.09,3422.27,108.53,-19488.29
3352045946510250496,2020-09,2514.6,3268.79,7447.92,1518.72,5175.01,-14313.28
3352045946510250496,2020-10,9909.41,9766.83,4297.46,2100.16,2339.88,-11973.4
3352045946510250496,2020-11,4793.47,4133.48,6826.03,2845.92,4640.1,-7333.3
3352045946510250496,2020-12,5928.85,2902.39,4674.09,5991.88,1708.67,-5624.63
3352944306534462464,2020-01,739.63,0,1506.18,2798.02,-552.21,-552.21
3352944306534462464,2020-02,3381.42,0,760.51,0,4141.93,3589.72
3352944306534462464,2020-03,1228.57,0,0,0,1228.57,4818.29
3352944306534462464,2020-05,1738.16,0,1588.05,1713.92,1612.29,6430.58
3352944306534462464,2020-07,1317.34,0,3698.53,36.74,4979.13,11409.71
3352944306534462464,2020-08,0,3224.25,0,1076.12,-4300.37,7109.34
3352944306534462464,2020-09,551.3,0,1227.95,0,1779.25,8888.59
3352944306534462464,2020-10,0,404.97,1032.82,0,627.85,9516.44
3352944306534462464,2020-11,0,1822.81,2043.85,1039.18,-818.14,8698.3
3352944306534462464,2020-12,295.56,0,0,1907.13,-1611.57,7086.73
3353214557561610752,2020-06,0,1754.8,0,0,-1754.8,-1754.8
3353214557561610752,2020-11,1463.17,0,0,0,1463.17,-291.63
3353224750407238144,2020-01,6216.34,6789.16,3487.85,1245.25,1669.78,1669.78
3353224750407238144,2020-02,955.53,2012.42,2991.4,0,1934.51,3604.29
3353224750407238144,2020-03,5466.95,2980.72,3738.56,6086.57,138.22,3742.51
3353224750407238144,2020-04,6222.86,4241.51,6957.99,2516.53,6422.81,10165.32
3353224750407238144,2020-05,4879.08,5473.45,4432.4,1188.61,2649.42,12814.74
3353224750407238144,2020-06,2379.73,4231.04,2507.57,4916.34,-4260.08,8554.66
3353224750407238144,2020-07,4307.08,534.53,3465.88,7558.33,-319.9,8234.76
3353224750407238144,2020-08,5660.4,8733.94,4715.13,3640.5,-1998.91,6235.85
3353224750407238144,2020-09,3387.23,2498.31,5488.26,5361.04,1016.14,7251.99
3353224750407238144,2020-10,1414.92,5081.65,10088.6,3553.27,2868.6,10120.59
3353224750407238144,2020-11,6749.59,4105.55,5342.05,3861.75,4124.34,14244.93
3353224750407238144,2020-12,1869.9,6720.06,7855.82,2104.27,901.39,15146.32
3353747177081125376,2020-01,816.75,2705.05,0,4608.21,-6496.51,-6496.51
3353747177081125376,2020-02,1149.56,1278.94,1350.04,2671.78,-1451.12,-7947.63
3353747177081125376,2020-03,1939.93,1821.25,4319.73,1501.16,2937.25,-5010.38
3353747177081125376,2020-04,1988.72,691.61,1582.35,2023.89,855.57,-4154.81
3353747177081125376,2020-06,304,565.3,299.63,3677.61,-3639.28,-7794.09
3353747177081125376,2020-07,3141.41,0,2217.97,909.49,4449.89,-3344.2
3353747177081125376,2020-08,3320.38,923.4,0,1826.39,570.59,-2773.61
3353747177081125376,2020-09,2577.03,1173.87,3268.6,2390.32,2281.44,-492.17
3353747177081125376,2020-10,4899.83,2056.52,1731.96,1995.58,2579.69,2087.52
3353747177081125376,2020-11,560.32,1408.75,230.14,2949.72,-3568.01,-1480.49
3353747177081125376,2020-12,1722.28,4621.98,3232.65,1978.59,-1645.64,-3126.13
3353809635369274368,2020-01,1951.98,1996.26,3427.01,4924.1,-1541.37,-1541.37
3353809635369274368,2020-02,1120.8,2300.11,2875.09,2988.15,-1292.37,-2833.74
3353809635369274368,2020-03,757.15,1482.3,544.17,3516.83,-3697.81,-6531.55
3353809635369274368,2020-04,3828.89,2227.01,2191.24,8175.55,-4382.43,-10913.98
3353809635369274368,2020-05,3161.43,0,0,2186.5,974.93,-9939.05
3353809635369274368,2020-06,4658.83,2893.85,2920.05,0,4685.03,-5254.02
3353809635369274368,2020-07,2244.45,6057.15,1838.97,3354.54,-5328.27,-10582.29
3353809635369274368,2020-08,579.88,65.4,930.97,3288.48,-1843.03,-12425.32
3353809635369274368,2020-09,4468.92,0,2202.43,0,6671.35,-5753.97
3353809635369274368,2020-10,0,1512.29,1012.86,0,-499.43,-6253.4
3353809635369274368,2020-11,2061.6,2958.93,4560.38,0,3663.05,-2590.35
3353809635369274368,2020-12,2645.26,0,3141.32,4318.87,1467.71,-1122.64
3354284729525865984,2020-01,1473.52,2608.52,1436.66,2012.83,-1711.17,-1711.17
3354284729525865984,2020-02,7723.18,3219.79,0,2628.84,1874.55,163.38
3354284729525865984,2020-03,0,502.01,301.32,2866.37,-3067.06,-2903.68
3354284729525865984,2020-04,1586.05,967.98,728.17,1321.21,25.03,-2878.65
3354284729525865984,2020-05,64.16,1960.94,4109.15,181.51,2030.86,-847.79
3354284729525865984,2020-06,3438.62,4493.75,3884.57,60.43,2769.01,1921.22
3354284729525865984,2020-07,1883.43,7369.44,911.19,2385.89,-6960.71,-5039.49
3354284729525865984,2020-08,2775.19,3601.75,2375.72,1849.89,-300.73,-5340.22
3354284729525865984,2020-09,3811.35,2632.37,4988.74,3152.79,3014.93,-2325.29
3354284729525865984,2020-10,1816.48,1955.27,4397.59,3057.9,1200.9,-1124.39
3354284729525865984,2020-11,3418.35,766.47,0,5796.83,-3144.95,-4269.34
3354284729525865984,2020-12,3848.65,4414.75,585.8,94.29,-74.59,-4343.93
3355426770005374464,2020-01,3340.67,2277.23,5391.71,1203.04,5252.11,5252.11
3355426770005374464,2020-02,3681.1,2356.82,1220.86,5712.91,-3167.77,2084.34
3355426770005374464,2020-03,1346.26,2848,1422.55,6231.46,-6310.65,-4226.31
3355426770005374464,2020-04,2068.02,1660.71,5873.94,4958.57,1322.68,-2903.63
3355426770005374464,2020-05,3359.94,1595.01,942.27,5003.36,-2296.16,-5199.79
3355426770005374464,2020-06,3247.66,2990.02,37.19,2923.64,-2628.81,-7828.6
3355426770005374464,2020-07,3161.02,3024.57,1312.91,4310.95,-2861.59,-10690.19
3355426770005374464,2020-08,11023.37,5315.69,4618.19,3543.02,6782.85,-3907.34
3355426770005374464,2020-09,3644.54,1452.31,3329.56,5667.67,-145.88,-4053.22
3355426770005374464,2020-10,1479.07,2427.64,2843.28,3415.96,-1521.25,-5574.47
3355426770005374464,2020-11,6013.22,0,1048.62,3330.09,3731.75,-1842.72
3355426770005374464,2020-12,6104.4,3371.7,4079.29,5247.02,1564.97,-277.75
3357750898159945728,2020-01,0,156.38,0,0,-156.38,-156.38
3357750898159945728,2020-02,928.39,0,2998.24,0,3926.63,3770.25
3357750898159945728,2020-03,1097.67,0,0,2193.1,-1095.43,2674.82
3357750898159945728,2020-04,1604.72,0,0,0,1604.72,4279.54
3357750898159945728,2020-06,1156.04,1701.27,6.44,0,-538.79,3740.75
3357750898159945728,2020-07,0,865,1403.3,788.36,-250.06,3490.69
3357750898159945728,2020-08,3615.53,496.62,659.44,1695.46,2082.89,5573.58
3357750898159945728,2020-10,0,2470.3,1920.73,0,-549.57,5024.01
3357750898159945728,2020-11,0,606.93,452.08,1320.21,-1475.06,3548.95
3357750898159945728,2020-12,2553,1965.07,0,639.58,-51.65,3497.3
3358052491693418496,2020-01,242.52,1861.98,0,0,-1619.46,-1619.46
3358052491693418496,2020-02,148.86,0,1598,1520.84,226.02,-1393.44
3358052491693418496,2020-05,837.11,0,890.38,0,1727.49,334.05
3358052491693418496,2020-08,158.76,907.73,1142.66,0,393.69,727.74
3358052491693418496,2020-09,0,1592.85,0,2777.48,-4370.33,-3642.59
3358052491693418496,2020-10,330.96,0,1198.68,1016.87,512.77,-3129.82
3358052491693418496,2020-11,0,3297.14,0,170.39,-3467.53,-6597.35
3358052491693418496,2020-12,1453.5,0,5286.85,3354.42,3385.93,-3211.42
3358256573963249664,2020-01,536.39,7239.92,1679.53,4515.92,-9539.92,-9539.92
3358256573963249664,2020-02,3536.5,3450.71,6414.29,182.18,6317.9,-3222.02
3358256573963249664,2020-03,3833.39,2183.49,3746.7,2310.34,3086.26,-135.76
3358256573963249664,2020-04,2557.56,1704.99,3040.44,5746.61,-1853.6,-1989.36
3358256573963249664,2020-05,4344.61,4275.49,5285.36,959.62,4394.86,2405.5
3358256573963249664,2020-06,3282.3,1927.45,3835.1,3353.2,1836.75,4242.25
3358256573963249664,2020-07,3632.29,1266.51,2579.45,2727.91,2217.32,6459.57
3358256573963249664,2020-08,1763.67,1140.18,2155.89,6525.75,-3746.37,2713.2
3358256573963249664,2020-09,3474.89,3271.69,2272.19,458.37,2017.02,4730.22
3358256573963249664,2020-10,5262.73,2520.29,2293.4,1244.38,3791.46,8521.68
3358256573963249664,2020-11,2562.08,1805.59,7584.36,2449.58,5891.27,14412.95
3358256573963249664,2020-12,3337.55,4351.9,1595.15,4753.13,-4172.33,10240.62
3360132086834001408,2020-01,0,3226.88,765.21,1565.05,-4026.72,-4026.72
3360132086834001408,2020-02,0,1224.48,0,1986,-3210.48,-7237.2
3360132086834001408,2020-03,633.27,3841.53,0,50.14,-3258.4,-10495.6
3360132086834001408,2020-04,3050.97,0,0,2926.77,124.2,-10371.4
3360132086834001408,2020-05,1752.41,1351.56,0,190.81,210.04,-10161.36
3360132086834001408,2020-06,2497.34,3744.38,2751.61,0,1504.57,-8656.79
3360132086834001408,2020-07,4793.64,2133.63,629.76,2814.73,475.04,-8181.75
3360132086834001408,2020-08,2312.31,3309.84,910.53,594.54,-681.54,-8863.29
3360132086834001408,2020-09,1713.25,874.13,0,324.31,514.81,-8348.48
3360132086834001408,2020-10,3067.67,2171.45,1694.25,819.3,1771.17,-6577.31
3360132086834001408,2020-11,1486.39,1232.37,731.77,1275.19,-289.4,-6866.71
3360132086834001408,2020-12,0,871.27,1782.9,1709.81,-798.18,-7664.89
3360265311232431616,2020-01,1689.36,2708.91,0,4457.76,-5477.31,-5477.31
3360265311232431616,2020-02,448.32,2829.58,5060.47,2842.11,-162.9,-5640.21
3360265311232431616,2020-03,7091.02,0,4662.98,1866.15,9887.85,4247.64
3360265311232431616,2020-04,3292.79,936.6,0,2969.1,-612.91,3634.73
3360265311232431616,2020-05,3970.55,0,2174.87,1942.85,4202.57,7837.3
3360265311232431616,2020-06,1815.94,0,3602.98,0,5418.92,13256.22
3360265311232431616,2020-07,0,6743.9,2174.39,0,-4569.51,8686.71
3360265311232431616,2020-08,1210.98,2884.01,1428.31,753.75,-998.47,7688.24
3360265311232431616,2020-09,1061.38,2948.82,2573.54,2595.1,-1909,5779.24
3360265311232431616,2020-10,3742.37,936.28,1980.31,2813.73,1972.67,7751.91
3360265311232431616,2020-11,1655.85,2121.88,0,1491.9,-1957.93,5793.98
3360265311232431616,2020-12,2504.44,2303.03,2443.57,1621.66,1023.32,6817.3
3360522544455141376,2020-01,2712.63,0,0,412.19,2300.44,2300.44
3360522544455141376,2020-03,0,640.08,0,0,-640.08,1660.36
3360522544455141376,2020-04,995.69,0,0,0,995.69,2656.05
3360522544455141376,2020-05,0,1183.02,0,351.98,-1535,1121.05
3360522544455141376,2020-06,1632.84,1003.63,166.02,0,795.23,1916.28
3360522544455141376,2020-09,0,1357.31,0,0,-1357.31,558.97
3360522544455141376,2020-10,948.88,0,631.01,0,1579.89,2138.86
3360522544455141376,2020-11,551.72,0,1753.33,0,2305.05,4443.91
3360522544455141376,2020-12,0,2432.55,0,0,-2432.55,2011.36
3360554586803883008,2020-01,4583.89,6139.86,9935.48,6581.16,1798.35,1798.35
3360554586803883008,2020-02,3253.38,7325.85,3256.62,4149.2,-4965.05,-3166.7
3360554586803883008,2020-03,6599.97,4993.87,3224.07,2200.94,2629.23,-537.47
3360554586803883008,2020-04,7162.03,7232.33,3223.51,2945.96,207.25,-330.22
3360554586803883008,2020-05,0,6607.38,7765.29,946.15,211.76,-118.46
3360554586803883008,2020-06,5572.73,2547.69,5019.04,3020.39,5023.69,4905.23
3360554586803883008,2020-07,4525.28,3462.98,5345.05,3765.3,2642.05,7547.28
3360554586803883008,2020-08,6189.16,4329.46,6536.15,3904.1,4491.75,12039.03
3360554586803883008,2020-09,6567.72,5712.6,4172.39,3591.94,1435.57,13474.6
3360554586803883008,2020-10,950.06,8571.18,6107.94,6717.51,-8230.69,5243.91
3360554586803883008,2020-11,7609.03,5734.83,7769.73,5303.73,4340.2,9584.11
3360554586803883008,2020-12,5719.17,7502.9,3652.34,3346.53,-1477.92,8106.19
3361280530325802496,2020-01,1531.25,861.24,2106.38,2288.06,488.33,488.33
3361280530325802496,2020-02,2458.96,8580.33,5788.33,358.8,-691.84,-203.51
3361280530325802496,2020-03,2654.89,0,2500.72,1209.64,3945.97,3742.46
3361280530325802496,2020-04,1950.88,9873.62,2773.41,1682.01,-6831.34,-3088.88
3361280530325802496,2020-05,2940.66,635.99,2252.76,1795.83,2761.6,-327.28
3361280530325802496,2020-06,3147.15,520.84,269.93,1700.59,1195.65,868.37
3361280530325802496,2020-07,1731.4,2665.42,2952.09,892.99,1125.08,1993.45
3361280530325802496,2020-08,8346.63,1048.03,528.45,1746.79,6080.26,8073.71
3361280530325802496,2020-09,625.59,2528.27,672.09,1475.41,-2706,5367.71
3361280530325802496,2020-10,2870.03,3424.21,630.76,2422.53,-2345.95,3021.76
3361280530325802496,2020-11,7186.84,6027.19,309.07,1674.57,-205.85,2815.91
3361280530325802496,2020-12,5389.31,4338.82,84.49,553.87,581.11,3397.02
3362397753278414848,2020-01,2289.39,4977.16,1654.75,5096.8,-6129.82,-6129.82
3362397753278414848,2020-02,2749.01,1278.65,4715.4,3193.57,2992.19,-3137.63
3362397753278414848,2020-03,2279.03,3750.85,4008.68,1458.54,1078.32,-2059.31
3362397753278414848,2020-04,6105.57,6179.62,7375.67,2083.08,5218.54,3159.23
3362397753278414848,2020-05,3681.1,0,4464.9,3224.9,4921.1,8080.33
3362397753278414848,2020-06,3018.04,0,6643.91,3534.71,6127.24,14207.57
3362397753278414848,2020-07,3987.88,4089.29,671.34,3763.14,-3193.21,11014.36
3362397753278414848,2020-08,2509.6,3828.51,5046.77,7008.16,-3280.3,7734.06
3362397753278414848,2020-09,6916.34,4189.75,8539.03,6305.66,4959.96,12694.02
3362397753278414848,2020-10,5534.47,1056.19,4115.08,2410.55,6182.81,18876.83
3362397753278414848,2020-11,8546.18,7817.53,3338.38,7657.65,-3590.62,15286.21
3362397753278414848,2020-12,7831.11,4275.09,7733.38,2427.9,8861.5,24147.71
3362494176217189376,2020-04,0,1285.07,0,0,-1285.07,-1285.07
3362494176217189376,2020-10,440.85,0,0,0,440.85,-844.22
3362494176217189376,2020-12,0,694.96,0,312.96,-1007.92,-1852.14
3362962046774618624,2020-01,2787.67,5118.52,5247.47,3777.46,-860.84,-860.84
3362962046774618624,2020-02,3325.89,5197.61,4815,3664.56,-721.28,-1582.12
3362962046774618624,2020-03,7436.42,2434.7,4552.68,859.49,8694.91,7112.79
3362962046774618624,2020-04,4935.4,5342.03,1685.18,2547.22,-1268.67,5844.12
3362962046774618624,2020-05,5935.99,10950.04,4022.24,5659.15,-6650.96,-806.84
3362962046774618624,2020-06,7740.79,11663.79,6598.66,3417.85,-742.19,-1549.03
3362962046774618624,2020-07,4324.04,7105.22,5103.8,2437.48,-114.86,-1663.89
3362962046774618624,2020-08,7277.55,4157.46,5968.77,3184.77,5904.09,4240.2
3362962046774618624,2020-09,3872.54,4018.71,5919.13,16669.21,-10896.25,-6656.05
3362962046774618624,2020-10,5410.57,5249.95,2340.31,6779.65,-4278.72,-10934.77
3362962046774618624,2020-11,2104.32,7780.92,4903.42,5127.05,-5900.23,-16835
3362962046774618624,2020-12,2581.74,9216.06,5777.35,0,-856.97,-17691.97
3363053841655129088,2020-01,920.62,0,181.54,2930.96,-1828.8,-1828.8
3363053841655129088,2020-02,1440.99,4587.15,1274.66,4469.58,-6341.08,-8169.88
3363053841655129088,2020-03,205.26,373.24,1753.58,733.8,851.8,-7318.08
3363053841655129088,2020-04,5402.75,1511.95,2909.53,3697.19,3103.14,-4214.94
3363053841655129088,2020-06,1822.19,205.92,1136.27,0,2752.54,-1462.4
3363053841655129088,2020-07,515.79,2692.16,0.62,940.45,-3116.2,-4578.6
3363053841655129088,2020-08,0,2608.28,3196.88,0,588.6,-3990
3363053841655129088,2020-09,0,2304.11,1354.64,1985.45,-2934.92,-6924.92
3363053841655129088,2020-10,0,684.8,486.81,0,-197.99,-7122.91
3363053841655129088,2020-11,0,2592.28,0,0,-2592.28,-9715.19
3363053841655129088,2020-12,0,454.18,0,493.48,-947.66,-10662.85
3363702457803075584,2020-01,4934.56,938.43,0,1498.53,2497.6,2497.6
3363702457803075584,2020-02,1191.45,0,0,1791.56,-600.11,1897.49
3363702457803075584,2020-03,0,1608.24,0,0,-1608.24,289.25
3363702457803075584,2020-05,3738.11,0,0,0,3738.11,4027.36
3363702457803075584,2020-08,1642.85,0,0,1467.19,175.66,4203.02
3363702457803075584,2020-09,3128.31,0,0,0,3128.31,7331.33
3363702457803075584,2020-11,1730.72,0,95.59,0,1826.31,9157.64
3363882730729298944,2020-01,5395.56,2757.26,5088.13,5631.42,2095.01,2095.01
3363882730729298944,2020-02,5283.11,2465.78,3040.42,3437.4,2420.35,4515.36
3363882730729298944,2020-03,2506.28,1632.22,6916.91,2487.86,5303.11,9818.47
3363882730729298944,2020-04,8076.54,3105.59,1487.32,3570.85,2887.42,12705.89
3363882730729298944,2020-05,2702.99,1642.6,5279.02,1872.52,4466.89,17172.78
3363882730729298944,2020-06,1477.39,13.85,1991.78,7269,-3813.68,13359.1
3363882730729298944,2020-07,1375.53,5726.64,6017.88,0,1666.77,15025.87
3363882730729298944,2020-08,5163.49,9000.14,3232.68,338.22,-942.19,14083.68
3363882730729298944,2020-09,2281.74,2010.13,6680.08,3376.5,3575.19,17658.87
3363882730729298944,2020-10,7257.89,3937.23,7083.59,1036.84,9367.41,27026.28
3363882730729298944,2020-11,1416.09,4447,3233.84,6068.47,-5865.54,21160.74
3363882730729298944,2020-12,1650.91,1923.65,8597.62,5240.06,3084.82,24245.56
3368230353299611136,2020-01,1329.36,1101.96,2188.25,2325.94,89.71,89.71
3368230353299611136,2020-02,285.05,3075.31,3035.22,2075.05,-1830.09,-1740.38
3368230353299611136,2020-03,1505.96,2371.16,553.05,3622.75,-3934.9,-5675.28
3368230353299611136,2020-04,1586.9,457.65,817.98,4795.62,-2848.39,-8523.67
3368230353299611136,2020-05,1572.84,1022.5,0,72.89,477.45,-8046.22
3368230353299611136,2020-06,0,229.33,0,4509.63,-4738.96,-12785.18
3368230353299611136,2020-07,1975.67,3495.35,124.96,4313.5,-5708.22,-18493.4
3368230353299611136,2020-08,143.27,2210.36,1687.51,4360.26,-4739.84,-23233.24
3368230353299611136,2020-09,1629.78,122.23,1352.61,0,2860.16,-20373.08
3368230353299611136,2020-10,1842.24,1313.61,4520.58,322.63,4726.58,-15646.5
3368230353299611136,2020-11,1950.03,4425.41,0,2146.09,-4621.47,-20267.97
3368230353299611136,2020-12,1850.9,1390.39,4557.1,1986.51,3031.1,-17236.87
3368542293835443200,2020-01,4475.39,5216.7,2607.29,2251.53,-385.55,-385.55
3368542293835443200,2020-02,5556.83,4221.25,5533.92,1686.79,5182.71,4797.16
3368542293835443200,2020-03,1572.48,1773.36,7419.66,4751.46,2467.32,7264.48
3368542293835443200,2020-04,5847.78,7715.96,6564.59,3312.11,1384.3,8648.78
3368542293835443200,2020-05,8563.17,1768.58,4500.67,10897.12,398.14,9046.92
3368542293835443200,2020-06,5020.99,3236.23,238.96,3962.74,-1939.02,7107.9
3368542293835443200,2020-07,5736.64,4826.66,294.22,1344.98,-140.78,6967.12
3368542293835443200,2020-08,948.02,8918.1,2916.97,4456.78,-9509.89,-2542.77
3368542293835443200,2020-09,1370.68,1948.41,4158.99,4827.87,-1246.61,-3789.38
3368542293835443200,2020-10,1721.73,1553.33,3040.75,3792.96,-583.81,-4373.19
3368542293835443200,2020-11,2130.97,83.6,815.29,2203.2,659.46,-3713.73
3368542293835443200,2020-12,790.1,4778.1,5232.58,6066.42,-4821.84,-8535.57
3371735796544466432,2020-01,1350.55,0,1228.08,1585.68,992.95,992.95
3371735796544466432,2020-03,2809.98,3035.83,938.84,156.67,556.32,1549.27
3371735796544466432,2020-04,2691.35,0,592.45,3323.99,-40.19,1509.08
3371735796544466432,2020-05,2615.16,0,1625.21,0,4240.37,5749.45
3371735796544466432,2020-06,1331.56,838.52,1942.91,2778.26,-342.31,5407.14
3371735796544466432,2020-07,1487.12,640.37,1356.3,0,2203.05,7610.19
3371735796544466432,2020-08,2364.16,0,42.52,340.4,2066.28,9676.47
3371735796544466432,2020-09,0,2726.58,1141.71,2701.35,-4286.22,5390.25
3371735796544466432,2020-10,342,428.62,890.38,2267.14,-1463.38,3926.87
3371735796544466432,2020-11,2611.19,0,0,2748.76,-137.57,3789.3
3371735796544466432,2020-12,1699.82,3151.29,1119.17,1126.2,-1458.5,2330.8
3372619267518931456,2020-01,6582.27,6591.44,3820.22,570.17,3240.88,3240.88
3372619267518931456,2020-02,4263.86,4386.57,1599.43,7368.84,-5892.12,-2651.24
3372619267518931456,2020-03,2306.36,4947.41,2592.71,6221.97,-6270.31,-8921.55
3372619267518931456,2020-04,5926.46,3317.45,5747.09,2911.89,5444.21,-3477.34
3372619267518931456,2020-05,6544.21,6976.37,3355.78,5045.85,-2122.23,-5599.57
3372619267518931456,2020-06,8685.35,5773.26,4961.87,0,7873.96,2274.39
3372619267518931456,2020-07,905.8,6919.59,6920.63,2214.06,-1307.22,967.17
3372619267518931456,2020-08,6082.68,3786.91,2925.05,5293.43,-72.61,894.56
3372619267518931456,2020-09,4471.88,1380.69,1721.29,3677.3,1135.18,2029.74
3372619267518931456,2020-10,4433.25,1435.52,7260.93,4580.42,5678.24,7707.98
3372619267518931456,2020-11,4120.7,5936.93,1041.6,3682.23,-4456.86,3251.12
3372619267518931456,2020-12,6612.35,10571.34,4300.61,6659.72,-6318.1,-3066.98
3376484716108352512,2020-01,2287.4,5012.23,1588.04,2448.97,-3585.76,-3585.76
3376484716108352512,2020-02,3446.95,5285.25,6439.66,2190.68,2410.68,-1175.08
3376484716108352512,2020-03,3306.21,2210.15,5905.62,3489.33,3512.35,2337.27
3376484716108352512,2020-04,1384,3245.88,4152.03,992.55,1297.6,3634.87
3376484716108352512,2020-05,4298.53,529.41,964.93,5031.37,-297.32,3337.55
3376484716108352512,2020-06,1658.14,1128.46,2377.57,7093.85,-4186.6,-849.05
3376484716108352512,2020-07,45.95,4371.62,3087.39,2316.51,-3554.79,-4403.84
3376484716108352512,2020-08,5988.24,7341.16,1440.04,1217.82,-1130.7,-5534.54
3376484716108352512,2020-09,4334.73,6093.15,621.35,2734.96,-3872.03,-9406.57
3376484716108352512,2020-10,3056.1,0,3291.11,0,6347.21,-3059.36
3376484716108352512,2020-11,2375.42,2748.57,3730.91,2980.43,377.33,-2682.03
3376484716108352512,2020-12,6375.85,2293.49,4255.31,2715.89,5621.78,2939.75
3376848556803483648,2020-01,2606.39,4598.01,1074.41,4326.97,-5244.18,-5244.18
3376848556803483648,2020-02,3751.33,5576.12,4052.49,793.36,1434.34,-3809.84
3376848556803483648,2020-03,3198.31,3608.37,1078.2,1205.58,-537.44,-4347.28
3376848556803483648,2020-04,4330.79,2392.47,2942.36,2096.27,2784.41,-1562.87
3376848556803483648,2020-05,1108.93,1760.73,398.66,645.74,-898.88,-2461.75
3376848556803483648,2020-06,3365.83,1023.98,6208.04,954.88,7595.01,5133.26
3376848556803483648,2020-07,2291.33,1549.52,2898.17,434.71,3205.27,8338.53
3376848556803483648,2020-08,1226.21,1986.55,1456.21,1121.63,-425.76,7912.77
3376848556803483648,2020-09,2603.45,5016.38,1849.02,262.21,-826.12,7086.65
3376848556803483648,2020-10,3611.49,1768.11,5386.48,1446.68,5783.18,12869.83
3376848556803483648,2020-11,0,4593.55,349.62,5966.42,-10210.35,2659.48
3376848556803483648,2020-12,4861.97,1680,902.42,3013.57,1070.82,3730.3
3377046299488173056,2020-01,2512.34,2722.54,4165.4,3129.59,825.61,825.61
3377046299488173056,2020-02,3276.11,1990.77,1372.44,0,2657.78,3483.39
3377046299488173056,2020-03,3142.1,1716.09,1340.69,3016.11,-249.41,3233.98
3377046299488173056,2020-04,4154.02,336.97,5376.02,2116.81,7076.26,10310.24
3377046299488173056,2020-05,813.04,3765.6,4968.21,1730.24,285.41,10595.65
3377046299488173056,2020-06,2428.27,7288.29,2362.89,1711.76,-4208.89,6386.76
3377046299488173056,2020-07,5112.09,3659.49,687.6,777.51,1362.69,7749.45
3377046299488173056,2020-08,5114.97,1352.12,6448.44,1506.37,8704.92,16454.37
3377046299488173056,2020-09,4698.77,3790.69,1437.08,6816.93,-4471.77,11982.6
3377046299488173056,2020-10,30.45,2697.54,4324.95,1128.64,529.22,12511.82
3377046299488173056,2020-11,1161.03,1576.07,2994.25,1467.83,1111.38,13623.2
3377046299488173056,2020-12,123.07,361.81,2566.22,4003.62,-1676.14,11947.06
3377454893055734272,2020-01,752.2,0,508.16,2035.18,-774.82,-774.82
3377454893055734272,2020-03,0,1236.96,1317.87,0,80.91,-693.91
3377454893055734272,2020-04,1397.14,2668.82,74.89,1775.73,-2972.52,-3666.43
3377454893055734272,2020-05,1844.18,572.5,590.52,3195.02,-1332.82,-4999.25
3377454893055734272,2020-06,2618.4,1425.62,2881.8,0,4074.58,-924.67
3377454893055734272,2020-07,0,1057.14,1790.2,1413.46,-680.4,-1605.07
3377454893055734272,2020-08,3143.54,111.89,90.69,704.63,2417.71,812.64
3377454893055734272,2020-09,960.56,0,0,1369.74,-409.18,403.46
3377454893055734272,2020-10,809.97,1415.37,0,1430.61,-2036.01,-1632.55
3377454893055734272,2020-11,0,1810.91,0,972.29,-2783.2,-4415.75
3377454893055734272,2020-12,92.72,0,0,2789.29,-2696.57,-7112.32
3377502790097490944,2020-01,2063.42,7139.79,3359.52,1262.62,-2979.47,-2979.47
3377502790097490944,2020-02,4224.53,1588.86,6948.8,4373.71,5210.76,2231.29
3377502790097490944,2020-03,6991.14,9954.52,180.65,4737.34,-7520.07,-5288.78
3377502790097490944,2020-04,9560.62,2216.24,3699.53,5389.44,5654.47,365.69
3377502790097490944,2020-05,1216.11,1984.94,3117.83,6689.97,-4340.97,-3975.28
3377502790097490944,2020-06,5194.69,10360.83,1346.95,323.71,-4142.9,-8118.18
3377502790097490944,2020-07,6558.1,5237.09,9498.3,7325.83,3493.48,-4624.7
3377502790097490944,2020-08,3487.67,7458.82,2362.04,4308.31,-5917.42,-10542.12
3377502790097490944,2020-09,2600.08,5642.4,2941.84,3093.3,-3193.78,-13735.9
3377502790097490944,2020-10,8743.73,6209.53,3974.36,6398.91,109.65,-13626.25
3377502790097490944,2020-11,9594.76,945.16,3568.27,1546.16,10671.71,-2954.54
3377502790097490944,2020-12,5829.05,2914.8,5663.96,6196.45,2381.76,-572.78
3377942094764422656,2020-01,5955.88,7165.45,4675.26,5899.59,-2433.9,-2433.9
3377942094764422656,2020-02,7214.1,3057.02,2834.49,7403.17,-411.6,-2845.5
3377942094764422656,2020-03,9462.17,3317.8,4784.14,9345.18,1583.33,-1262.17
3377942094764422656,2020-04,4976.47,1308.47,5022.51,5394.16,3296.35,2034.18
3377942094764422656,2020-05,4082.59,9310.65,5641.33,8986.51,-8573.24,-6539.06
3377942094764422656,2020-06,4206.71,3290.73,2739.61,4698.07,-1042.48,-7581.54
3377942094764422656,2020-07,4115.63,5258.21,3591.97,1996.51,452.88,-7128.66
3377942094764422656,2020-08,6375.14,3905.05,288.58,2711.68,46.99,-7081.67
3377942094764422656,2020-09,1771.18,2248.59,3711.01,3823.11,-589.51,-7671.18
3377942094764422656,2020-10,4332.4,3236.29,3663.12,5282.15,-522.92,-8194.1
3377942094764422656,2020-11,7679.44,7561.35,2732.47,9793.97,-6943.41,-15137.51
3377942094764422656,2020-12,3009.72,4074.48,5805.32,3422.82,1317.74,-13819.77
3379246157253920768,2020-01,6141.43,4840.31,6020.98,269.56,7052.54,7052.54
3379246157253920768,2020-02,1987.6,3038.08,6709.85,1996.61,3662.76,10715.3
3379246157253920768,2020-03,4848.53,0,1636.36,2420.25,4064.64,14779.94
3379246157253920768,2020-04,4401.99,1204.45,4893.6,3020.2,5070.94,19850.88
3379246157253920768,2020-05,2458.46,3831.17,3811.11,3866.8,-1428.4,18422.48
3379246157253920768,2020-06,1894.49,2293.28,4829.42,2619.4,1811.23,20233.71
3379246157253920768,2020-07,516.14,1485.63,907.19,2362.2,-2424.5,17809.21
3379246157253920768,2020-08,0,4462.05,203.17,194.08,-4452.96,13356.25
3379246157253920768,2020-09,441.17,1426.98,5984.57,1584.85,3413.91,16770.16
3379246157253920768,2020-10,2121.94,2440.93,2404.4,1669.06,416.35,17186.51
3379246157253920768,2020-11,5331.11,887.08,4965.91,383.3,9026.64,26213.15
3379246157253920768,2020-12,2131.53,5163.48,3355.74,4100.16,-3776.37,22436.78
3380326633499297280,2020-03,0,1669.97,0,1995.1,-3665.07,-3665.07
3380489794173473792,2020-01,1938.63,2200.73,372.18,1927.94,-1817.86,-1817.86
3380489794173473792,2020-03,0,1326.15,0,923.95,-2250.1,-4067.96
3380489794173473792,2020-04,0,1568.37,0,2595.91,-4164.28,-8232.24
3380489794173473792,2020-06,5316.82,0,2437.73,0,7754.55,-477.69
3380489794173473792,2020-07,2367.97,1892.96,1252.07,1959.37,-232.29,-709.98
3380489794173473792,2020-09,0,121.59,395.99,2653.92,-2379.52,-3089.5
3380489794173473792,2020-10,0,350.54,0,0,-350.54,-3440.04
3380489794173473792,2020-11,1660.6,0,0,0,1660.6,-1779.44
3380489794173473792,2020-12,1182.82,0,1352.1,0,2534.92,755.48
3381074873596995072,2020-01,1032.3,1332.5,0,0,-300.2,-300.2
3381074873596995072,2020-02,0,201.02,0,0,-201.02,-501.22
3381074873596995072,2020-03,122.08,0,556.23,0,678.31,177.09
3381074873596995072,2020-04,2480.29,0,0,1401.99,1078.3,1255.39
3381074873596995072,2020-06,1282.77,1589.7,0,0,-306.93,948.46
3381074873596995072,2020-07,247.91,701.67,890.36,2577.38,-2140.78,-1192.32
3381074873596995072,2020-08,0,2329.91,0,0,-2329.91,-3522.23
3381074873596995072,2020-09,1978.89,0,1132.43,2497.6,613.72,-2908.51
3381074873596995072,2020-10,410.1,1146.83,3214.57,2403.51,74.33,-2834.18
3381074873596995072,2020-11,949.3,1271.07,276.49,0,-45.28,-2879.46
3381818243227240448,2020-01,3415.69,2630.17,2998.98,0,3784.5,3784.5
3381818243227240448,2020-02,0,1320.54,1219.85,2931.18,-3031.87,752.63
3381818243227240448,2020-03,401.85,3977.4,0,8542.62,-12118.17,-11365.54
3381818243227240448,2020-04,4435.4,3134.45,3709.68,108.23,4902.4,-6463.14
3381818243227240448,2020-05,2673.49,3801.91,0,407.33,-1535.75,-7998.89
3381818243227240448,2020-06,1860.57,0,4615.57,1958.8,4517.34,-3481.55
3381818243227240448,2020-07,442.2,0,5847.99,1584.21,4705.98,1224.43
3381818243227240448,2020-08,1308.09,0,1931.4,5813.96,-2574.47,-1350.04
3381818243227240448,2020-09,672.09,1709.13,4612.77,3830.84,-255.11,-1605.15
3381818243227240448,2020-10,1950.24,418.99,3079.79,2428.9,2182.14,576.99
3381818243227240448,2020-11,4949.7,5153.05,4463.54,1560.72,2699.47,3276.46
3381818243227240448,2020-12,3430.84,121.59,3694.2,2208.77,4794.68,8071.14
3385076049865010688,2020-01,2516.58,1652.85,795.44,0,1659.17,1659.17
3385076049865010688,2020-02,473.16,2362.47,3067.25,2309.33,-1131.39,527.78
3385076049865010688,2020-03,0,1444.82,4595.85,4774.88,-1623.85,-1096.07
3385076049865010688,2020-04,920.73,2562,2909.34,3571.14,-2303.07,-3399.14
3385076049865010688,2020-05,3522.05,7474.91,2507.16,974.83,-2420.53,-5819.67
3385076049865010688,2020-06,1111.29,1202.67,1523.82,1852.98,-420.54,-6240.21
3385076049865010688,2020-07,2828.55,490.47,6842.36,0,9180.44,2940.23
3385076049865010688,2020-08,1118.57,1299.41,1888.17,253.19,1454.14,4394.37
3385076049865010688,2020-09,560.46,63,1467.57,350.8,1614.23,6008.6
3385076049865010688,2020-10,3300.14,1495.84,2342.67,3696.17,450.8,6459.4
3385076049865010688,2020-11,3194.06,2773.52,666.65,1572.04,-484.85,5974.55
3385076049865010688,2020-12,0,3651.39,631.15,1729.26,-4749.5,1225.05
3387168921531099136,2020-01,1861.89,4982.83,385.26,811.32,-3547,-3547
3387168921531099136,2020-02,423.99,0,0,1747.66,-1323.67,-4870.67
3387168921531099136,2020-03,1778.51,1459.38,1808.55,959.92,1167.76,-3702.91
3387168921531099136,2020-04,0,1229.33,1233.17,0,3.84,-3699.07
3387168921531099136,2020-05,1317.89,3848.79,2831.94,5675.62,-5374.58,-9073.65
3387168921531099136,2020-06,1785.79,1780.56,0,1630.57,-1625.34,-10698.99
3387168921531099136,2020-07,1109.37,1162.72,1345.33,2361.42,-1069.44,-11768.43
3387168921531099136,2020-08,1982.95,393.55,0,1698.85,-109.45,-11877.88
3387168921531099136,2020-09,1071.55,514.39,0,1063.1,-505.94,-12383.82
3387168921531099136,2020-10,1978.3,747.09,1316.84,3144.25,-596.2,-12980.02
3387168921531099136,2020-11,1659.43,0,1097.81,0,2757.24,-10222.78
3387168921531099136,2020-12,2225.78,2234.77,2779.66,1096.67,1674,-8548.78
3389521459820486656,2020-01,6362.11,9838.04,4725.94,4204.06,-2954.05,-2954.05
3389521459820486656,2020-02,3455.98,4976.88,3846.16,5770.23,-3444.97,-6399.02
3389521459820486656,2020-03,1641.95,2967.33,6473.26,868.64,4279.24,-2119.78
3389521459820486656,2020-04,0,3356.67,4468.19,3811.93,-2700.41,-4820.19
3389521459820486656,2020-05,4631.51,1137.73,1911.9,2943.5,2462.18,-2358.01
3389521459820486656,2020-06,4512.91,5213.63,5185.24,6189.27,-1704.75,-4062.76
3389521459820486656,2020-07,5176.65,1352.77,658.3,6702.72,-2220.54,-6283.3
3389521459820486656,2020-08,5554.38,1092.75,620.13,3956.38,1125.38,-5157.92
3389521459820486656,2020-09,4271.46,1679.87,2909.78,1755.75,3745.62,-1412.3
3389521459820486656,2020-10,6235.8,7200.48,2659.52,3353.82,-1658.98,-3071.28
3389521459820486656,2020-11,3847.13,2048.29,8410.62,1336.71,8872.75,5801.47
3389521459820486656,2020-12,3387.02,1893.18,6541,2629.65,5405.19,11206.66
3390160534766221824,2020-01,1307.57,830.72,0,2782.31,-2305.46,-2305.46
3390160534766221824,2020-02,443.56,0,1132.07,1987.77,-412.14,-2717.6
3390160534766221824,2020-03,1494.28,2510.4,1859.01,1463.42,-620.53,-3338.13
3390160534766221824,2020-04,461.97,994.2,0,1882.85,-2415.08,-5753.21
3390160534766221824,2020-05,272.29,1649.39,240.11,2405.27,-3542.26,-9295.47
3390160534766221824,2020-06,4492.54,713.28,2052.74,1583.05,4248.95,-5046.52
3390160534766221824,2020-07,5319.16,558.7,968.16,0,5728.62,682.1
3390160534766221824,2020-08,671.78,2847.09,2032.35,1334.04,-1477,-794.9
3390160534766221824,2020-09,0,3589.59,4454.54,4516.33,-3651.38,-4446.28
3390160534766221824,2020-10,624.94,1884.33,2300.47,1247.41,-206.33,-4652.61
3390160534766221824,2020-11,1518.51,2758.85,418.64,2141.92,-2963.62,-7616.23
3390160534766221824,2020-12,2355,0,1735.66,2972.35,1118.31,-6497.92
3390235348359843840,2020-01,4210.92,1527.05,5692.54,4880.5,3495.91,3495.91
3390235348359843840,2020-02,2735.11,0,5012.71,3754.99,3992.83,7488.74
3390235348359843840,2020-03,4359.2,2938.39,5210.23,3678.88,2952.16,10440.9
3390235348359843840,2020-04,1834.29,5566.14,2762.54,5459.66,-6428.97,4011.93
3390235348359843840,2020-05,2907.8,1837.29,5632.66,1142.83,5560.34,9572.27
3390235348359843840,2020-06,1810.64,2025.64,8949.57,6953.57,1781,11353.27
3390235348359843840,2020-07,1719.93,3181.3,3362.72,740.88,1160.47,12513.74
3390235348359843840,2020-08,5955.21,3189.26,1250.35,2775.05,1241.25,13754.99
3390235348359843840,2020-09,3118.01,3487.98,2664.73,1406.99,887.77,14642.76
3390235348359843840,2020-10,6626.59,4179.65,1984.19,5111.64,-680.51,13962.25
3390235348359843840,2020-11,1120.12,6267.1,5884.97,3222.99,-2485,11477.25
3390235348359843840,2020-12,3161.63,2878.17,0,4920.12,-4636.66,6840.59
3391309936867384832,2020-01,221.97,0,3007.2,0,3229.17,3229.17
3391309936867384832,2020-03,0,416.32,0,0,-416.32,2812.85
3391309936867384832,2020-04,0,1722.24,1588.71,1914.23,-2047.76,765.09
3391309936867384832,2020-05,1905.7,1311.09,0,1804.32,-1209.71,-444.62
3391309936867384832,2020-06,994.3,0,0,0,994.3,549.68
3391309936867384832,2020-07,264.11,2328.33,0,0,-2064.22,-1514.54
3391309936867384832,2020-08,478.71,0,1941.1,1377.78,1042.03,-472.51
3391309936867384832,2020-09,1320.98,1010.47,0,0,310.51,-162
3391309936867384832,2020-11,221.82,0,599.74,1262.46,-440.9,-602.9
3392258448293805056,2020-01,3471.78,6477.78,5356.07,3156.38,-806.31,-806.31
3392258448293805056,2020-02,1167.91,2094.26,3311.99,5729.28,-3343.64,-4149.95
3392258448293805056,2020-03,925.4,3147.64,4565.4,2672.44,-329.28,-4479.23
3392258448293805056,2020-04,3963.38,5359.69,2405.69,327.42,681.96,-3797.27
3392258448293805056,2020-05,2581.57,6641.31,5717.36,4753.18,-3095.56,-6892.83
3392258448293805056,2020-06,2622.2,1456.98,2539.01,2386.58,1317.65,-5575.18
3392258448293805056,2020-07,6856.73,8351.23,3253.3,6937.36,-5178.56,-10753.74
3392258448293805056,2020-08,4625.11,4129.53,8320.61,4659.67,4156.52,-6597.22
3392258448293805056,2020-09,3775.37,4378.39,3234.19,4743.56,-2112.39,-8709.61
3392258448293805056,2020-10,2147.29,3726.69,5269.85,1143.33,2547.12,-6162.49
3392258448293805056,2020-11,7136.63,5676.31,1116.48,3106.06,-529.26,-6691.75
3392258448293805056,2020-12,6149.03,3681.55,3112.29,5537.14,42.63,-6649.12
3392860857942952960,2020-01,2973.39,1252.33,1992.64,725.52,2988.18,2988.18
3392860857942952960,2020-02,442.62,0,1719.42,1124.19,1037.85,4026.03
3392860857942952960,2020-03,742.56,1328.93,340.63,4737.36,-4983.1,-957.07
3392860857942952960,2020-04,246.49,0,1745.44,5155.32,-3163.39,-4120.46
3392860857942952960,2020-05,1314.22,0,3718.5,1571.36,3461.36,-659.1
3392860857942952960,2020-06,690.97,1826.18,4102.88,1973.96,993.71,334.61
3392860857942952960,2020-07,3636.38,4258.47,2850.78,1504.08,724.61,1059.22
3392860857942952960,2020-08,0,460.75,883.7,3590.41,-3167.46,-2108.24
3392860857942952960,2020-09,1133.65,1668.19,1794.8,831.36,428.9,-1679.34
3392860857942952960,2020-10,7880.63,582.42,3024.93,243.75,10079.39,8400.05
3392860857942952960,2020-11,862.58,0,2880.49,3810.32,-67.25,8332.8
3392860857942952960,2020-12,856.67,1339.94,0,2158.4,-2641.67,5691.13
3393302718320484864,2020-01,8851.91,9368.19,9906.83,5468.94,3921.61,3921.61
3393302718320484864,2020-02,5878.37,2156.38,434.53,6911.03,-2754.51,1167.1
3393302718320484864,2020-03,11297.91,4888,5804.61,3424.44,8790.08,9957.18
3393302718320484864,2020-04,2673.31,4421.07,10106.23,3095.41,5263.06,15220.24
3393302718320484864,2020-05,6031.51,6117.46,4795.68,5225.66,-515.93,14704.31
3393302718320484864,2020-06,3248.14,4760.65,832.44,5188.6,-5868.67,8835.64
3393302718320484864,2020-07,6593.54,1984.64,4690.66,1283.77,8015.79,16851.43
3393302718320484864,2020-08,3908.97,1959.27,7767.12,6653.46,3063.36,19914.79
3393302718320484864,2020-09,4087.48,3203.82,2693.16,2943.77,633.05,20547.84
3393302718320484864,2020-10,1631.52,6065.67,5075.26,2511.6,-1870.49,18677.35
3393302718320484864,2020-11,5274.07,2142.3,6064.67,5660.96,3535.48,22212.83
3393302718320484864,2020-12,5146.8,4280.56,3997.03,3829.63,1033.64,23246.47
3394013474738198016,2020-01,3607.2,3099.9,5048.41,4331.08,1224.63,1224.63
3394013474738198016,2020-02,9196.49,6207.94,3102.35,3539.99,2550.91,3775.54
3394013474738198016,2020-03,3509.38,592.03,2859.35,2702.92,3073.78,6849.32
3394013474738198016,2020-04,6666.26,1516.35,2792.84,4747.39,3195.36,10044.68
3394013474738198016,2020-05,5746.18,2786.16,725.78,2079.86,1605.94,11650.62
3394013474738198016,2020-06,1204.28,748.22,6419.07,2485.01,4390.12,16040.74
3394013474738198016,2020-07,4289.8,5540.76,2375.1,7451.8,-6327.66,9713.08
3394013474738198016,2020-08,4095.71,2937.28,8715.72,2826.97,7047.18,16760.26
3394013474738198016,2020-09,2490.25,1429.05,7636.02,224.27,8472.95,25233.21
3394013474738198016,2020-10,0,4889.54,1085.57,0,-3803.97,21429.24
3394013474738198016,2020-11,1843.57,1603.06,6136.07,2831.94,3544.64,24973.88
3394013474738198016,2020-12,3905.16,1849.84,7093.59,5205.73,3943.18,28917.06
3394078476278519808,2020-01,0,1361.64,1173.58,1636.73,-1824.79,-1824.79
3394078476278519808,2020-02,1497.84,0,0,2632.81,-1134.97,-2959.76
3394078476278519808,2020-03,3529.13,2075.69,648.45,151.14,1950.75,-1009.01
3394078476278519808,2020-04,562.4,1253.06,2873.33,0,2182.67,1173.66
3394078476278519808,2020-05,4762.76,1496.97,1538.34,1573.9,3230.23,4403.89
3394078476278519808,2020-06,2515.39,3601.95,1613.53,1809.43,-1282.46,3121.43
3394078476278519808,2020-07,841.42,0,3405.88,2029.5,2217.8,5339.23
3394078476278519808,2020-08,1242.43,0,1611.42,1.25,2852.6,8191.83
3394078476278519808,2020-09,1685.34,35.84,937.74,0,2587.24,10779.07
3394078476278519808,2020-10,1162.12,2775.21,4754.54,0,3141.45,13920.52
3394078476278519808,2020-11,0,4025.75,545.47,0,-3480.28,10440.24
3394078476278519808,2020-12,0,1066.74,0,872.71,-1939.45,8500.79
3395267889065823232,2020-02,0,1235.71,0,0,-1235.71,-1235.71
3395267889065823232,2020-04,126.73,0,0,0,126.73,-1108.98
3395267889065823232,2020-10,0,236.77,0,0,-236.77,-1345.75
3395450434735509504,2020-01,6439.34,1756.62,6974.81,1396.9,10260.63,10260.63
3395450434735509504,2020-02,5819.4,9664.45,4281.02,4472.35,-4036.38,6224.25
3395450434735509504,2020-03,4047.2,2628.72,3773.68,8825.87,-3633.71,2590.54
3395450434735509504,2020-04,3212.81,6950.48,312.99,2544.11,-5968.79,-3378.25
3395450434735509504,2020-05,8674.91,3831.31,3688.9,4127.03,4405.47,1027.22
3395450434735509504,2020-06,6992.23,6243.98,10884.38,2495.66,9136.97,10164.19
3395450434735509504,2020-07,2345.4,4596.14,4440.47,980.2,1209.53,11373.72
3395450434735509504,2020-08,3297.16,7412.85,1823.01,3960.95,-6253.63,5120.09
3395450434735509504,2020-09,1842.04,1939.24,317.93,0,220.73,5340.82
3395450434735509504,2020-10,8834.43,3705.65,4517.75,0,9646.53,14987.35
3395450434735509504,2020-11,2128.81,4858.08,3708.29,8458.11,-7479.09,7508.26
3395450434735509504,2020-12,675.7,3812.73,4214.7,5419.32,-4341.65,3166.61
3395564746740898304,2020-01,3357.4,4159.43,1964,2302.32,-1140.35,-1140.35
3395564746740898304,2020-02,5310.41,793.56,2569.29,1955.71,5130.43,3990.08
3395564746740898304,2020-03,2753.07,4974.65,2028.98,3611.98,-3804.58,185.5
3395564746740898304,2020-04,851.07,2796.42,0,0,-1945.35,-1759.85
3395564746740898304,2020-05,1604.82,8269.57,0,648.29,-7313.04,-9072.89
3395564746740898304,2020-06,884.92,1784.15,1306.53,1673.22,-1265.92,-10338.81
3395564746740898304,2020-07,969.99,1686.04,0,1268.94,-1984.99,-12323.8
3395564746740898304,2020-08,2415.89,635.86,1100.72,4633.34,-1752.59,-14076.39
3395564746740898304,2020-09,3147.17,3044.58,2196.02,983.27,1315.34,-12761.05
3395564746740898304,2020-10,1831.07,0,4149.62,0,5980.69,-6780.36
3395564746740898304,2020-11,2794.68,3215.95,0,2506.28,-2927.55,-9707.91
3395564746740898304,2020-12,2649.02,5633.51,0,9534.91,-12519.4,-22227.31
3395638773080093184,2020-01,3513.72,8128.6,0,4495.15,-9110.03,-9110.03
3395638773080093184,2020-02,433.26,1225.83,0,3081.25,-3873.82,-12983.85
3395638773080093184,2020-03,989.67,2902.08,1249.02,6233.79,-6897.18,-19881.03
3395638773080093184,2020-04,3248.62,1464.65,3208.09,66.98,4925.08,-14955.95
3395638773080093184,2020-05,3469.93,3593.86,1064.29,2253.49,-1313.13,-16269.08
3395638773080093184,2020-06,125.49,3148.69,2483.88,830.92,-1370.24,-17639.32
3395638773080093184,2020-07,284.72,2392.51,1717.2,0,-390.59,-18029.91
3395638773080093184,2020-08,4930.02,1428.09,1262.71,3342.98,1421.66,-16608.25
3395638773080093184,2020-09,2718.35,4627.79,1894.54,589.38,-604.28,-17212.53
3395638773080093184,2020-10,2162.05,0,6289.65,2727.09,5724.61,-11487.92
3395638773080093184,2020-11,7814.87,2559.98,5195.15,3978.6,6471.44,-5016.48
3395638773080093184,2020-12,4403.51,1939.39,645.99,1335,1775.11,-3241.37
3396433109424210432,2020-01,3003.68,4246.15,3086.53,4019.17,-2175.11,-2175.11
3396433109424210432,2020-02,4214.65,4304.01,1706.29,2409.86,-792.93,-2968.04
3396433109424210432,2020-03,7846.84,6945.6,3872.92,4585.87,188.29,-2779.75
3396433109424210432,2020-04,6169.98,0,2630.43,3643.83,5156.58,2376.83
3396433109424210432,2020-05,4254.24,8010.96,3408.27,650.63,-999.08,1377.75
3396433109424210432,2020-06,3791.34,1817.52,9863.11,5521.88,6315.05,7692.8
3396433109424210432,2020-07,1971.82,6649.95,1900.27,847.82,-3625.68,4067.12
3396433109424210432,2020-08,3481.56,8511.81,5385.57,6467.48,-6112.16,-2045.04
3396433109424210432,2020-09,3987.11,6549.99,3500.53,5733.42,-4795.77,-6840.81
3396433109424210432,2020-10,5388.39,10525.74,5107.27,2088.07,-2118.15,-8958.96
3396433109424210432,2020-11,2180.51,5826.54,3208.51,822.73,-1260.25,-10219.21
3396433109424210432,2020-12,4592.43,6431.83,4947.97,2015.43,1093.14,-9126.07
3396831123317009408,2020-01,0,4249.33,525.3,5093.01,-8817.04,-8817.04
3396831123317009408,2020-02,3036.54,3910.83,0,1982.68,-2856.97,-11674.01
3396831123317009408,2020-03,0,5437.65,9067.3,2213.61,1416.04,-10257.97
3396831123317009408,2020-04,4412.72,3942.81,3397.69,4908.55,-1040.95,-11298.92
3396831123317009408,2020-05,5810.83,2758.29,3330.5,2050.02,4333.02,-6965.9
3396831123317009408,2020-06,3176.25,1940.88,2655.17,10881.19,-6990.65,-13956.55
3396831123317009408,2020-07,2693.16,2230.61,4169.12,1791.17,2840.5,-11116.05
3396831123317009408,2020-08,137.69,4248.38,3681.82,510.67,-939.54,-12055.59
3396831123317009408,2020-09,3270.02,956.28,0,3121.93,-808.19,-12863.78
3396831123317009408,2020-10,1718.53,1196.93,566.49,3153.77,-2065.68,-14929.46
3396831123317009408,2020-11,3178.77,0,2531.58,2526.59,3183.76,-11745.7
3396831123317009408,2020-12,4093.59,983.77,50.94,2015.63,1145.13,-10600.57
3398938011292177408,2020-01,3111.74,2704.15,6136.6,1352.76,5191.43,5191.43
3398938011292177408,2020-02,0,3365.94,3305.18,4459.53,-4520.29,671.14
3398938011292177408,2020-03,6674.3,2235.11,1924.06,0,6363.25,7034.39
3398938011292177408,2020-04,2692.01,2925.65,4493.05,3512.85,746.56,7780.95
3398938011292177408,2020-05,2243.49,1222.32,2631.9,2641.6,1011.47,8792.42
3398938011292177408,2020-06,1910.13,6090.79,7376.03,4061.8,-866.43,7925.99
3398938011292177408,2020-07,4877.81,1339.48,5446.32,5388.45,3596.2,11522.19
3398938011292177408,2020-08,2380.6,4719.62,8096.04,0,5757.02,17279.21
3398938011292177408,2020-09,2964.6,1801.12,3113.06,4120.12,156.42,17435.63
3398938011292177408,2020-10,983.18,4061.25,2375.96,1850.69,-2552.8,14882.83
3398938011292177408,2020-11,3402.97,3721.51,1237.69,4829.41,-3910.26,10972.57
3398938011292177408,2020-12,1669.49,4289.42,11724.43,6328.51,2775.99,13748.56
3399289871416729600,2020-01,4210.72,9095.89,3061.41,3553.65,-5377.41,-5377.41
3399289871416729600,2020-02,3135.22,7707.19,4649.35,7156.03,-7078.65,-12456.06
3399289871416729600,2020-03,5777.37,4947.28,7311.11,4375.55,3765.65,-8690.41
3399289871416729600,2020-04,7027.56,6051.97,4015.72,2462.87,2528.44,-6161.97
3399289871416729600,2020-05,3294.26,2466.34,605.81,2103.07,-669.34,-6831.31
3399289871416729600,2020-06,3923.92,6281.31,1382.28,1111.44,-2086.55,-8917.86
3399289871416729600,2020-07,1329.76,5010.99,5844.83,1855.63,307.97,-8609.89
3399289871416729600,2020-08,4172.91,4631.5,4119.05,7335.8,-3675.34,-12285.23
3399289871416729600,2020-09,8299.4,6092.01,4195,2868.54,3533.85,-8751.38
3399289871416729600,2020-10,5201.36,2989.79,1306.1,2545.62,972.05,-7779.33
3399289871416729600,2020-11,8327.57,147.13,2308.42,0,10488.86,2709.53
3399289871416729600,2020-12,6164.42,5181.39,726.5,3313.42,-1603.89,1105.64
3399600764927357440,2020-01,0,513.8,0,0,-513.8,-513.8
3399600764927357440,2020-03,753.42,1899.11,0,1877.27,-3022.96,-3536.76
3399600764927357440,2020-05,359.41,0,0,0,359.41,-3177.35
3399600764927357440,2020-07,357.2,0,1963.55,0,2320.75,-856.6
3399600764927357440,2020-08,584.4,1141.42,0,0,-557.02,-1413.62
3399600764927357440,2020-10,0,854.62,0,0,-854.62,-2268.24
3399600764927357440,2020-11,1853.59,0,0,0,1853.59,-414.65
3400124156894274560,2020-01,2046.61,3862.34,2294.2,1086.76,-608.29,-608.29
3400124156894274560,2020-02,916.73,1405.67,1712.02,2583.57,-1360.49,-1968.78
3400124156894274560,2020-03,672.15,1898.69,1992.76,447.96,318.26,-1650.52
3400124156894274560,2020-04,1215.28,3695.3,1789.74,134.68,-824.96,-2475.48
3400124156894274560,2020-05,25.28,1300.88,0,2321.93,-3597.53,-6073.01
3400124156894274560,2020-06,3841.82,956.27,3007.13,0,5892.68,-180.33
3400124156894274560,2020-07,1818.47,3444.91,1422.21,0,-204.23,-384.56
3400124156894274560,2020-08,611.23,3597.6,4225.47,0,1239.1,854.54
3400124156894274560,2020-09,1565.78,1850.76,3851.93,965.96,2600.99,3455.53
3400124156894274560,2020-10,1817.09,1934.01,1108.05,0,991.13,4446.66
3400124156894274560,2020-11,713.05,3894.16,1166.42,3309.8,-5324.49,-877.83
3400652106661595648,2020-01,0,1093.54,3268.74,4636.33,-2461.13,-2461.13
3400652106661595648,2020-02,1892.81,3640.68,5663.27,1873.32,2042.08,-419.05
3400652106661595648,2020-03,1786.72,2233.32,701.36,3156.25,-2901.49,-3320.54
3400652106661595648,2020-04,2632.69,2775.21,87.73,169.54,-224.33,-3544.87
3400652106661595648,2020-05,2249.9,0,6157,448.01,7958.89,4414.02
3400652106661595648,2020-06,2475.96,3843.66,3695.67,1120.36,1207.61,5621.63
3400652106661595648,2020-07,1661.7,0,2605.12,2425.87,1840.95,7462.58
3400652106661595648,2020-08,1975.51,3023.69,1274.2,0,226.02,7688.6
3400652106661595648,2020-10,261.47,0,2879.96,1854.11,1287.32,8975.92
3400652106661595648,2020-11,3354.14,2073.71,4155.9,444.37,4991.96,13967.88
3400652106661595648,2020-12,0,3422,997.94,0,-2424.06,11543.82
3401319746738791424,2020-03,0,1008.17,0,0,-1008.17,-1008.17
3401319746738791424,2020-06,0,1924.28,0,0,-1924.28,-2932.45
3401644032600548864,2020-01,3049.74,682.9,2678.88,0,5045.72,5045.72
3401644032600548864,2020-02,1901.41,4391.95,5781.29,0,3290.75,8336.47
3401644032600548864,2020-03,3298.56,4864.49,759.53,9405.85,-10212.25,-1875.78
3401644032600548864,2020-04,4955.75,5663.58,5426.16,4972.13,-253.8,-2129.58
3401644032600548864,2020-05,2304.12,3188.65,5092.16,3496.97,710.66,-1418.92
3401644032600548864,2020-06,658.04,7866.01,1707.12,5663.84,-11164.69,-12583.61
3401644032600548864,2020-07,6463.79,0,4025.3,531.03,9958.06,-2625.55
3401644032600548864,2020-08,1523.46,1708.54,6508.88,1883.67,4440.13,1814.58
3401644032600548864,2020-09,4839.49,4036.93,4082.16,6974.21,-2089.49,-274.91
3401644032600548864,2020-10,1474.15,1607.39,5224.58,3917.2,1174.14,899.23
3401644032600548864,2020-11,2667.84,3994.33,8279.61,3787.6,3165.52,4064.75
3401644032600548864,2020-12,5501.22,1734.47,4814.78,5792,2789.53,6854.28
3402047266755723264,2020-01,1969.64,1096.31,70.69,517.75,426.27,426.27
3402047266755723264,2020-02,2083.87,1645.03,0,1369.96,-931.12,-504.85
3402047266755723264,2020-03,0,4041.66,975.36,1751.11,-4817.41,-5322.26
3402047266755723264,2020-04,0,5086.25,3344.86,1652.63,-3394.02,-8716.28
3402047266755723264,2020-05,0,2568.17,1073.19,0,-1494.98,-10211.26
3402047266755723264,2020-06,2022.38,5408.01,1829.86,331.54,-1887.31,-12098.57
3402047266755723264,2020-07,638.13,0,2568.22,1979.23,1227.12,-10871.45
3402047266755723264,2020-08,1035.03,1673.42,0,3022.96,-3661.35,-14532.8
3402047266755723264,2020-09,1066.09,705.52,1352.13,2840.07,-1127.37,-15660.17
3402047266755723264,2020-10,0,310.53,876.13,2727.8,-2162.2,-17822.37
3402047266755723264,2020-11,488.51,3118.85,2142.03,2773.94,-3262.25,-21084.62
3402047266755723264,2020-12,1275.05,1306.24,4961.05,707.88,4221.98,-16862.64
3402164927390067200,2020-01,1375.59,0,1860.87,2507.42,729.04,729.04
3402164927390067200,2020-02,1872.78,1366.64,3792.33,1060.3,3238.17,3967.21
3402164927390067200,2020-03,3624.98,5000.62,3927.47,6630.13,-4078.3,-111.09
3402164927390067200,2020-04,5197.32,785.63,1902.15,1778.16,4535.68,4424.59
3402164927390067200,2020-05,0,1816.54,2019.22,1046.12,-843.44,3581.15
3402164927390067200,2020-06,869.39,0,2350.53,4793.12,-1573.2,2007.95
3402164927390067200,2020-07,0,3639.61,2428.12,366.53,-1578.02,429.93
3402164927390067200,2020-08,150.01,5653.11,95.31,232.72,-5640.51,-5210.58
3402164927390067200,2020-09,1688.49,2132.99,254.54,2465.3,-2655.26,-7865.84
3402164927390067200,2020-10,2420.79,3254.32,1825.66,0,992.13,-6873.71
3402164927390067200,2020-11,1204.42,3.29,353.55,2187.63,-632.95,-7506.66
3402164927390067200,2020-12,1966.55,3398.42,2702.51,676.06,594.58,-6912.08
3402757528457126912,2020-01,2236.83,1097.77,975.91,2934.99,-820.02,-820.02
3402757528457126912,2020-02,1101.11,58.48,0,952.57,90.06,-729.96
3402757528457126912,2020-03,0,213.74,0,0,-213.74,-943.7
3402757528457126912,2020-04,1830.9,1297.64,1985.49,1469.98,1048.77,105.07
3402757528457126912,2020-05,109.59,118.06,1379.4,2703.11,-1332.18,-1227.11
3402757528457126912,2020-07,2841.14,0,1023.33,0,3864.47,2637.36
3402757528457126912,2020-08,456.48,2183.72,1926.92,1604.14,-1404.46,1232.9
3402757528457126912,2020-09,1295.89,0,0,0,1295.89,2528.79
3402757528457126912,2020-10,788.13,3434.99,698.84,0,-1948.02,580.77
3402757528457126912,2020-12,1744.36,2402.4,1260,0,601.96,1182.73
